presenting a case, suing	<b>提訴<b> <br> ていそ <br>[sound:k-2536_提訴.mp3]
[sound:k-2536_提訴.mp3]	presenting a case, suing<br> <b>提訴</b> <br> (ていそ)
<b>締め切り</b> <br> レポートの締め切りは来週の金曜日です。	[sound:s-2536_レポートの締め切りは来週の金曜日です。.mp3] <br> れぽーとのしめきりはらいしゅうのきんようびです。 <br>The deadline for the report is next Friday.
[sound:s-2536_レポートの締め切りは来週の金曜日です。.mp3]	<b>締め切り</b> <br> レポートの締め切りは来週の金曜日です。<br> れぽーとのしめきりはらいしゅうのきんようびです <br>The deadline for the report is next Friday.
提示	[sound:k-2537_提示.mp3]<br>ていじ <br> presentation, exhibit, suggest, citation
presentation, exhibit, suggest, citation	<b>提示<b> <br> ていじ <br>[sound:k-2537_提示.mp3]
[sound:k-2537_提示.mp3]	presentation, exhibit, suggest, citation<br> <b>提示</b> <br> (ていじ)
<b>切手</b> <br> 手紙に切手を貼り付ける。	[sound:s-2537_手紙に切手を貼り付ける。.mp3] <br> てがみにきってをはりつける。 <br>Affix a stamp to the letter.
[sound:s-2537_手紙に切手を貼り付ける。.mp3]	<b>切手</b> <br> 手紙に切手を貼り付ける。<br> てがみにきってをはりつける <br>Affix a stamp to the letter.
提供者	[sound:k-2538_提供者.mp3]<br>ていきょうしゃ <br> donor, contributer, provider
donor, contributer, provider	<b>提供者<b> <br> ていきょうしゃ <br>[sound:k-2538_提供者.mp3]
[sound:k-2538_提供者.mp3]	donor, contributer, provider<br> <b>提供者</b> <br> (ていきょうしゃ)
<b>施行</b> <br> 新しい法律が施行された。	[sound:s-2538_新しい法律が施行された。.mp3] <br> あたらしいほうりつがしこうされた。 <br>The new law has been enforced.
[sound:s-2538_新しい法律が施行された。.mp3]	<b>施行</b> <br> 新しい法律が施行された。<br> あたらしいほうりつがしこうされた <br>The new law has been enforced.
提起	[sound:k-2539_提起.mp3]<br>ていき <br> bring suit, file a claim, raise a question
bring suit, file a claim, raise a question	<b>提起<b> <br> ていき <br>[sound:k-2539_提起.mp3]
[sound:k-2539_提起.mp3]	bring suit, file a claim, raise a question<br> <b>提起</b> <br> (ていき)
<b>施政</b> <br> 政府の施政方針が発表された。	[sound:s-2539_政府の施政方針が発表された。.mp3] <br> せいふのせいせいほうしんがはっぴょうされた。 <br>The government's policy direction has been announced.
[sound:s-2539_政府の施政方針が発表された。.mp3]	<b>施政</b> <br> 政府の施政方針が発表された。<br> せいふのせいせいほうしんがはっぴょうされた <br>The government's policy direction has been announced.
運	[sound:k-2540_運.mp3]<br>うん <br> fortune, luck
fortune, luck	<b>運<b> <br> うん <br>[sound:k-2540_運.mp3]
[sound:k-2540_運.mp3]	fortune, luck<br> <b>運</b> <br> (うん)
<b>施工</b> <br> 工事の施工が完了した。	[sound:s-2540_工事の施工が完了した。.mp3] <br> こうじのしこうがかんりょうした。 <br>The construction work has been completed.
[sound:s-2540_工事の施工が完了した。.mp3]	<b>施工</b> <br> 工事の施工が完了した。<br> こうじのしこうがかんりょうした <br>The construction work has been completed.
運ぶ	[sound:k-2541_運ぶ.mp3]<br>はこぶ <br> to carry, to transport, to move, to convey; to come, to go; to wield (a tool, etc.), to use; to go (well, etc.), to proceed, to progress
to carry, to transport, to move, to convey; to come, to go; to wield (a tool, etc.), to use; to go (well, etc.), to proceed, to progress	<b>運ぶ<b> <br> はこぶ <br>[sound:k-2541_運ぶ.mp3]
[sound:k-2541_運ぶ.mp3]	to carry, to transport, to move, to convey; to come, to go; to wield<br> <b>a tool, etc.), to use; to go (well, etc.), to proceed, to progress (運ぶ</b> <br> (はこぶ)
<b>施す</b> <br> 助けを必要とする人々に援助を施す。	[sound:s-2541_助けを必要とする人々に援助を施す。.mp3] <br> たすけをひつようとするひとびとにえんじょをほどこす。 <br>Provide assistance to those in need of help.
[sound:s-2541_助けを必要とする人々に援助を施す。.mp3]	<b>施す</b> <br> 助けを必要とする人々に援助を施す。<br> たすけをひつようとするひとびとにえんじょをほどこす <br>Provide assistance to those in need of help.
運動	[sound:k-2542_運動.mp3]<br>うんどう <br> motion, exercise
motion, exercise	<b>運動<b> <br> うんどう <br>[sound:k-2542_運動.mp3]
[sound:k-2542_運動.mp3]	motion, exercise<br> <b>運動</b> <br> (うんどう)
<b>防衛施設庁</b> <br> 防衛施設庁が国内の基地を管理している。	[sound:s-2542_防衛施設庁が国内の基地を管理している。.mp3] <br> ぼうえいしせつちょうがこくないのきちをかんりしている。 <br>The Defense Facilities Administration Agency manages domestic bases.
[sound:s-2542_防衛施設庁が国内の基地を管理している。.mp3]	<b>防衛施設庁</b> <br> 防衛施設庁が国内の基地を管理している。<br> ぼうえいしせつちょうがこくないのきちをかんりしている <br>The Defense Facilities Administration Agency manages domestic bases.
運営	[sound:k-2543_運営.mp3]<br>うんえい <br> management, administration, operation
management, administration, operation	<b>運営<b> <br> うんえい <br>[sound:k-2543_運営.mp3]
[sound:k-2543_運営.mp3]	management, administration, operation<br> <b>運営</b> <br> (うんえい)
<b>施錠</b> <br> ドアを施錠して、外出します。	[sound:s-2543_ドアを施錠して、外出します。.mp3] <br> ドアをせじょうして、がいしゅつします。 <br>Lock the door and go out.
[sound:s-2543_ドアを施錠して、外出します。.mp3]	<b>施錠</b> <br> ドアを施錠して、外出します。<br> ドアをせじょうして、がいしゅつします <br>Lock the door and go out.
運転	[sound:k-2544_運転.mp3]<br>うんてん <br> operation, motion, driving
operation, motion, driving	<b>運転<b> <br> うんてん <br>[sound:k-2544_運転.mp3]
[sound:k-2544_運転.mp3]	operation, motion, driving<br> <b>運転</b> <br> (うんてん)
<b>大切</b> <br> 家族との時間はとても大切です。	[sound:s-2544_家族との時間はとても大切です。.mp3] <br> かぞくとのじかんはとてもたいせつです。 <br>Time with family is very important.
[sound:s-2544_家族との時間はとても大切です。.mp3]	<b>大切</b> <br> 家族との時間はとても大切です。<br> かぞくとのじかんはとてもたいせつです <br>Time with family is very important.
運輸	[sound:k-2545_運輸.mp3]<br>うんゆ <br> transportation
transportation	<b>運輸<b> <br> うんゆ <br>[sound:k-2545_運輸.mp3]
[sound:k-2545_運輸.mp3]	transportation<br> <b>運輸</b> <br> (うんゆ)
<b>切っ掛け</b> <br> その出来事が彼の転職の切っ掛けになった。	[sound:s-2545_その出来事が彼の転職の切っ掛けになった。.mp3] <br> そのできごとがかれのてんしょくのきっかけになった。 <br>That incident became the trigger for his job change.
[sound:s-2545_その出来事が彼の転職の切っ掛けになった。.mp3]	<b>切っ掛け</b> <br> その出来事が彼の転職の切っ掛けになった。<br> そのできごとがかれのてんしょくのきっかけになった <br>That incident became the trigger for his job change.
運輸省	[sound:k-2546_運輸省.mp3]<br>うんゆしょう <br> Ministry of Transport
Ministry of Transport	<b>運輸省<b> <br> うんゆしょう <br>[sound:k-2546_運輸省.mp3]
[sound:k-2546_運輸省.mp3]	Ministry of Transport<br> <b>運輸省</b> <br> (うんゆしょう)
<b>一切</b> <br> 彼は一切の手助けも受けたくない。	[sound:s-2546_彼は一切の手助けも受けたくない。.mp3] <br> かれはいっさいのてだすけもうけたくない。 <br>He doesn't want any help at all.
[sound:s-2546_彼は一切の手助けも受けたくない。.mp3]	<b>一切</b> <br> 彼は一切の手助けも受けたくない。<br> かれはいっさいのてだすけもうけたくない <br>He doesn't want any help at all.
運用	[sound:k-2547_運用.mp3]<br>うんよう <br> making use of, application, investment, practical use
making use of, application, investment, practical use	<b>運用<b> <br> うんよう <br>[sound:k-2547_運用.mp3]
[sound:k-2547_運用.mp3]	making use of, application, investment, practical use<br> <b>運用</b> <br> (うんよう)
<b>適切</b> <br> 適切な処置をとる必要があります。	[sound:s-2547_適切な処置をとる必要があります。.mp3] <br> てきせつなしょちをとるひつようがあります。 <br>It's necessary to take appropriate measures.
[sound:s-2547_適切な処置をとる必要があります。.mp3]	<b>適切</b> <br> 適切な処置をとる必要があります。<br> てきせつなしょちをとるひつようがあります <br>It's necessary to take appropriate measures.
運び	[sound:k-2548_運び.mp3]<br>はこび <br> progress, pace, carriage, step, stage
progress, pace, carriage, step, stage	<b>運び<b> <br> はこび <br>[sound:k-2548_運び.mp3]
[sound:k-2548_運び.mp3]	progress, pace, carriage, step, stage<br> <b>運び</b> <br> (はこび)
<b>切り</b> <br> 彼は包丁で野菜を切りました。	[sound:s-2548_彼は包丁で野菜を切りました。.mp3] <br> かれはほうちょうでやさいをきりました。 <br>He cut the vegetables with a knife.
[sound:s-2548_彼は包丁で野菜を切りました。.mp3]	<b>切り</b> <br> 彼は包丁で野菜を切りました。<br> かれはほうちょうでやさいをきりました <br>He cut the vegetables with a knife.
運転手	[sound:k-2549_運転手.mp3]<br>うんてんしゅ <br> driver, chauffeur
driver, chauffeur	<b>運転手<b> <br> うんてんしゅ <br>[sound:k-2549_運転手.mp3]
[sound:k-2549_運転手.mp3]	driver, chauffeur<br> <b>運転手</b> <br> (うんてんしゅ)
<b>思い切って</b> <br> 思い切って新しいことに挑戦してみよう。	[sound:s-2549_思い切って新しいことに挑戦してみよう。.mp3] <br> おもいきってあたらしいことにちょうせんしてみよう。 <br>Let's dare to try something new.
[sound:s-2549_思い切って新しいことに挑戦してみよう。.mp3]	<b>思い切って</b> <br> 思い切って新しいことに挑戦してみよう。<br> おもいきってあたらしいことにちょうせんしてみよう <br>Let's dare to try something new.
終わり	[sound:k-2550_終わり.mp3]<br>おわり <br> the end
the end	<b>終わり<b> <br> おわり <br>[sound:k-2550_終わり.mp3]
[sound:k-2550_終わり.mp3]	the end<br> <b>終わり</b> <br> (おわり)
<b>切らす</b> <br> お金がなくて電気を切らすしかなかった。	[sound:s-2550_お金がなくて電気を切らすしかなかった。.mp3] <br> おかねがなくてでんきをきらすしかなかった。 <br>We had no choice but to turn off the electricity because we had no money.
[sound:s-2550_お金がなくて電気を切らすしかなかった。.mp3]	<b>切らす</b> <br> お金がなくて電気を切らすしかなかった。<br> おかねがなくてでんきをきらすしかなかった <br>We had no choice but to turn off the electricity because we had no money.
最終	[sound:k-2551_最終.mp3]<br>さいしゅう <br> last, final, closing
last, final, closing	<b>最終<b> <br> さいしゅう <br>[sound:k-2551_最終.mp3]
[sound:k-2551_最終.mp3]	last, final, closing<br> <b>最終</b> <br> (さいしゅう)
<b>切る</b> <br> 野菜を切って、スープに入れる。	[sound:s-2551_野菜を切って、スープに入れる。.mp3] <br> やさいをきって、スープにいれる。 <br>Cut the vegetables and put them in the soup.
[sound:s-2551_野菜を切って、スープに入れる。.mp3]	<b>切る</b> <br> 野菜を切って、スープに入れる。<br> やさいをきって、スープにいれる <br>Cut the vegetables and put them in the soup.
終える	[sound:k-2552_終える.mp3]<br>おえる <br> to finish
to finish	<b>終える<b> <br> おえる <br>[sound:k-2552_終える.mp3]
[sound:k-2552_終える.mp3]	to finish<br> <b>終える</b> <br> (おえる)
<b>締め切り</b> <br> レポートの締め切りは来週の金曜日です。	[sound:s-2552_レポートの締め切りは来週の金曜日です。.mp3] <br> れぽーとのしめきりはらいしゅうのきんようびです。 <br>The deadline for the report is next Friday.
[sound:s-2552_レポートの締め切りは来週の金曜日です。.mp3]	<b>締め切り</b> <br> レポートの締め切りは来週の金曜日です。<br> れぽーとのしめきりはらいしゅうのきんようびです <br>The deadline for the report is next Friday.
終結	[sound:k-2553_終結.mp3]<br>しゅうけつ <br> end, close
end, close	<b>終結<b> <br> しゅうけつ <br>[sound:k-2553_終結.mp3]
[sound:k-2553_終結.mp3]	end, close<br> <b>終結</b> <br> (しゅうけつ)
<b>切手</b> <br> 手紙に切手を貼り付ける。	[sound:s-2553_手紙に切手を貼り付ける。.mp3] <br> てがみにきってをはりつける。 <br>Affix a stamp to the letter.
[sound:s-2553_手紙に切手を貼り付ける。.mp3]	<b>切手</b> <br> 手紙に切手を貼り付ける。<br> てがみにきってをはりつける <br>Affix a stamp to the letter.
最終的	[sound:k-2554_最終的.mp3]<br>さいしゅうてき <br> finally
finally	<b>最終的<b> <br> さいしゅうてき <br>[sound:k-2554_最終的.mp3]
[sound:k-2554_最終的.mp3]	finally<br> <b>最終的</b> <br> (さいしゅうてき)
<b>由</b> <br> 彼女の行動の由はよくわからない。	[sound:s-2554_彼女の行動の由はよくわからない。.mp3] <br> かのじょのこうどうのゆはよくわからない。 <br>The reason behind her actions is unclear.
[sound:s-2554_彼女の行動の由はよくわからない。.mp3]	<b>由</b> <br> 彼女の行動の由はよくわからない。<br> かのじょのこうどうのゆはよくわからない <br>The reason behind her actions is unclear.
終値	[sound:k-2555_終値.mp3]<br>おわりね <br> closing price (stock exchange, etc.)
closing price (stock exchange, etc.)	<b>終値<b> <br> おわりね <br>[sound:k-2555_終値.mp3]
[sound:k-2555_終値.mp3]	closing price<br> <b>stock exchange, etc.) (終値</b> <br> (おわりね)
<b>自由</b> <br> 自由な時間を楽しむ。	[sound:s-2555_自由な時間を楽しむ。.mp3] <br> じゆうなじかんをたのしむ。 <br>Enjoy free time.
[sound:s-2555_自由な時間を楽しむ。.mp3]	<b>自由</b> <br> 自由な時間を楽しむ。<br> じゆうなじかんをたのしむ <br>Enjoy free time.
終了後	[sound:k-2556_終了後.mp3]<br>しゅうりょうご <br> after the end (of something)
after the end (of something)	<b>終了後<b> <br> しゅうりょうご <br>[sound:k-2556_終了後.mp3]
[sound:k-2556_終了後.mp3]	after the end<br> <b>of something) (終了後</b> <br> (しゅうりょうご)
<b>理由</b> <br> 彼の欠席の理由を知っていますか？	[sound:s-2556_彼の欠席の理由を知っていますか？.mp3] <br> かれのけっせきのりゆうをしっていますか？ <br>Do you know the reason for his absence?
[sound:s-2556_彼の欠席の理由を知っていますか？.mp3]	(<b>理由</b>) 彼の欠席の理由を知っていますか？	かれのけっせきのりゆうをしっていますか？ <br>Do you know the reason for his absence?
終戦	[sound:k-2557_終戦.mp3]<br>しゅうせん <br> end of war, cessation of hostilities
end of war, cessation of hostilities	<b>終戦<b> <br> しゅうせん <br>[sound:k-2557_終戦.mp3]
[sound:k-2557_終戦.mp3]	end of war, cessation of hostilities<br> <b>終戦</b> <br> (しゅうせん)
<b>経由</b> <br> アムステルダム経由でパリに行く。	[sound:s-2557_アムステルダム経由でパリに行く。.mp3] <br> アムステルダムけいゆでパリにいく。 <br>Go to Paris via Amsterdam.
[sound:s-2557_アムステルダム経由でパリに行く。.mp3]	<b>経由</b> <br> アムステルダム経由でパリに行く。<br> アムステルダムけいゆでパリにいく <br>Go to Paris via Amsterdam.
終日	[sound:k-2558_終日.mp3]<br>しゅうじつ, ひねもす, ひめもす, ひもすがら <br> all day, for a whole day
all day, for a whole day	<b>終日<b> <br> しゅうじつ, ひねもす, ひめもす, ひもすがら <br>[sound:k-2558_終日.mp3]
[sound:k-2558_終日.mp3]	all day, for a whole day<br> <b>終日</b> <br> (しゅうじつ, ひねもす, ひめもす, ひもすがら)
<b>不自由</b> <br> 足が不自由な人に席を譲る。	[sound:s-2558_足が不自由な人に席を譲る。.mp3] <br> あしがふじゆうなひとにせきをゆずる。 <br>Give up your seat to someone with mobility issues.
[sound:s-2558_足が不自由な人に席を譲る。.mp3]	<b>不自由</b> <br> 足が不自由な人に席を譲る。<br> あしがふじゆうなひとにせきをゆずる <br>Give up your seat to someone with mobility issues.
終盤	[sound:k-2559_終盤.mp3]<br>しゅうばん <br> endgame, final stage
endgame, final stage	<b>終盤<b> <br> しゅうばん <br>[sound:k-2559_終盤.mp3]
[sound:k-2559_終盤.mp3]	endgame, final stage<br> <b>終盤</b> <br> (しゅうばん)
<b>自由化</b> <br> その国は市場の自由化を進めている。	[sound:s-2559_その国は市場の自由化を進めている。.mp3] <br> そのくにはしじょうのじゆうかをすすめている。 <br>The country is advancing market liberalization.
[sound:s-2559_その国は市場の自由化を進めている。.mp3]	<b>自由化</b> <br> その国は市場の自由化を進めている。<br> そのくにはしじょうのじゆうかをすすめている <br>The country is advancing market liberalization.
挙げる	[sound:k-2560_挙げる.mp3]<br>あげる <br> to raise, to elevate; to do up (one's hair); to fly (a kite, etc.), to launch (fireworks, etc.), to surface (a submarine, etc.); to land (a boat); to deep-fry; to show someone (into a room); (uk) to summon (for geishas, etc.); to send someone (away); to enrol (one's child in school) (enroll); to increase (price, quality, status, etc.); to make (a loud sound), to raise (one's voice); to earn (something desirable); to praise; to give (an example, etc.), to cite; to summon up (all of one's energy, etc.); to arrest; to nominate; to give; to offer up (incense, a prayer, etc.) to the gods (or Buddha, etc.); to bear (a child); to conduct (a ceremony, esp. a wedding); (of the tide) to come in; to vomit; (after the -te form of a verb) to do for (the sake of someone else); (after the -masu stem of a verb) to complete; used after the -masu stem of a humble verb to increase the level of humility
to raise, to elevate; to do up (one's hair); to fly (a kite, etc.), to launch (fireworks, etc.), to surface (a submarine, etc.); to land (a boat); to deep-fry; to show someone (into a room); (uk) to summon (for geishas, etc.); to send someone (away); to enrol (one's child in school) (enroll); to increase (price, quality, status, etc.); to make (a loud sound), to raise (one's voice); to earn (something desirable); to praise; to give (an example, etc.), to cite; to summon up (all of one's energy, etc.); to arrest; to nominate; to give; to offer up (incense, a prayer, etc.) to the gods (or Buddha, etc.); to bear (a child); to conduct (a ceremony, esp. a wedding); (of the tide) to come in; to vomit; (after the -te form of a verb) to do for (the sake of someone else); (after the -masu stem of a verb) to complete; used after the -masu stem of a humble verb to increase the level of humility	<b>挙げる<b> <br> あげる <br>[sound:k-2560_挙げる.mp3]
[sound:k-2560_挙げる.mp3]	to raise, to elevate; to do up<br> <b>one's hair); to fly (a kite, etc.), to launch (fireworks, etc.), to surface (a submarine, etc.); to land (a boat); to deep-fry; to show someone (into a room); (uk) to summon (for geishas, etc.); to send someone (away); to enrol (one's child in school) (enroll); to increase (price, quality, status, etc.); to make (a loud sound), to raise (one's voice); to earn (something desirable); to praise; to give (an example, etc.), to cite; to summon up (all of one's energy, etc.); to arrest; to nominate; to give; to offer up (incense, a prayer, etc.) to the gods (or Buddha, etc.); to bear (a child); to conduct (a ceremony, esp. a wedding); (of the tide) to come in; to vomit; (after the -te form of a verb) to do for (the sake of someone else); (after the -masu stem of a verb) to complete; used after the -masu stem of a humble verb to increase the level of humility (挙げる</b> <br> (あげる)
<b>自由形</b> <br> 水泳の自由形が彼の得意種目です。	[sound:s-2560_水泳の自由形が彼の得意種目です。.mp3] <br> すいえいのじゆうがたがかれのとくいしゅもくです。 <br>Freestyle swimming is his specialty event.
[sound:s-2560_水泳の自由形が彼の得意種目です。.mp3]	<b>自由形</b> <br> 水泳の自由形が彼の得意種目です。<br> すいえいのじゆうがたがかれのとくいしゅもくです <br>Freestyle swimming is his specialty event.
選挙	[sound:k-2561_選挙.mp3]<br>せんきょ <br> election
election	<b>選挙<b> <br> せんきょ <br>[sound:k-2561_選挙.mp3]
[sound:k-2561_選挙.mp3]	election<br> <b>選挙</b> <br> (せんきょ)
<b>自由主義</b> <br> 彼は自由主義の政治家です。	[sound:s-2561_彼は自由主義の政治家です。.mp3] <br> かれはじゆうしゅぎのせいじかです。 <br>He is a liberal politician.
[sound:s-2561_彼は自由主義の政治家です。.mp3]	<b>自由主義</b> <br> 彼は自由主義の政治家です。<br> かれはじゆうしゅぎのせいじかです <br>He is a liberal politician.
総選挙	[sound:k-2562_総選挙.mp3]<br>そうせんきょ <br> general election (of the lower house)
general election (of the lower house)	<b>総選挙<b> <br> そうせんきょ <br>[sound:k-2562_総選挙.mp3]
[sound:k-2562_総選挙.mp3]	general election<br> <b>of the lower house) (総選挙</b> <br> (そうせんきょ)
<b>由来</b> <br> その言葉の由来は古い言語に遡る。	[sound:s-2562_その言葉の由来は古い言語に遡る。.mp3] <br> そのことばのゆらいはふるいげんごにさかのぼる。 <br>The origin of that word dates back to an ancient language.
[sound:s-2562_その言葉の由来は古い言語に遡る。.mp3]	<b>由来</b> <br> その言葉の由来は古い言語に遡る。<br> そのことばのゆらいはふるいげんごにさかのぼる <br>The origin of that word dates back to an ancient language.
小選挙区	[sound:k-2563_小選挙区.mp3]<br>しょうせんきょく <br> small electoral district, single-member constituency
small electoral district, single-member constituency	<b>小選挙区<b> <br> しょうせんきょく <br>[sound:k-2563_小選挙区.mp3]
[sound:k-2563_小選挙区.mp3]	small electoral district, single-member constituency<br> <b>小選挙区</b> <br> (しょうせんきょく)
<b>自由経済</b> <br> 自由経済の国々は競争が激しい。	[sound:s-2563_自由経済の国々は競争が激しい。.mp3] <br> じゆうけいざいのくにはきょうそうがはげしい。 <br>Countries with free-market economies have intense competition.
[sound:s-2563_自由経済の国々は競争が激しい。.mp3]	<b>自由経済</b> <br> 自由経済の国々は競争が激しい。<br> じゆうけいざいのくにはきょうそうがはげしい <br>Countries with free-market economies have intense competition.
一挙	[sound:k-2564_一挙.mp3]<br>いっきょ <br> one effort, one action
one effort, one action	<b>一挙<b> <br> いっきょ <br>[sound:k-2564_一挙.mp3]
[sound:k-2564_一挙.mp3]	one effort, one action<br> <b>一挙</b> <br> (いっきょ)
<b>演説</b> <br> 政治家は市民に向けて演説を行った。	[sound:s-2564_政治家は市民に向けて演説を行った。.mp3] <br> せいじかはしみんにむけてえんぜつをおこなった。 <br>The politician delivered a speech to the citizens.
[sound:s-2564_政治家は市民に向けて演説を行った。.mp3]	<b>演説</b> <br> 政治家は市民に向けて演説を行った。<br> せいじかはしみんにむけてえんぜつをおこなった <br>The politician delivered a speech to the citizens.
選挙戦	[sound:k-2565_選挙戦.mp3]<br>せんきょせん <br> election campaign
election campaign	<b>選挙戦<b> <br> せんきょせん <br>[sound:k-2565_選挙戦.mp3]
[sound:k-2565_選挙戦.mp3]	election campaign<br> <b>選挙戦</b> <br> (せんきょせん)
<b>説明</b> <br> その問題の解決方法を説明してください。	[sound:s-2565_その問題の解決方法を説明してください。.mp3] <br> そのもんだいのかいけつほうほうをせつめいしてください。 <br>Please explain the solution to the problem.
[sound:s-2565_その問題の解決方法を説明してください。.mp3]	<b>説明</b> <br> その問題の解決方法を説明してください。<br> そのもんだいのかいけつほうほうをせつめいしてください <br>Please explain the solution to the problem.
挙がる	[sound:k-2566_挙がる.mp3]<br>あがる <br> to rise, to go up, to come up, to ascend, to be raised; to enter (esp. from outdoors), to come in, to go in; to enter (a school), to advance to the next grade; to get out (of water), to come ashore; to increase; to improve, to make progress; to be promoted, to advance; to be made (of profit, etc.); to occur (esp. of a favourable result); to be adequate (to cover expenses, etc.); to be finished, to be done, to be over; (of rain) to stop, to lift; to stop (working properly), to cut out, to give out, to die; to win (in a card game, etc.); to be arrested; to turn up (of evidence, etc.); to be deep fried; to be spoken loudly; to get stage fright; to be offered (to the gods, etc.); to go, to visit; to eat, to drink; to be listed (as a candidate); to serve (in one's master's home); (in Kyoto) to go north; (after the -masu stem of a verb) indicates completion
to rise, to go up, to come up, to ascend, to be raised; to enter (esp. from outdoors), to come in, to go in; to enter (a school), to advance to the next grade; to get out (of water), to come ashore; to increase; to improve, to make progress; to be promoted, to advance; to be made (of profit, etc.); to occur (esp. of a favourable result); to be adequate (to cover expenses, etc.); to be finished, to be done, to be over; (of rain) to stop, to lift; to stop (working properly), to cut out, to give out, to die; to win (in a card game, etc.); to be arrested; to turn up (of evidence, etc.); to be deep fried; to be spoken loudly; to get stage fright; to be offered (to the gods, etc.); to go, to visit; to eat, to drink; to be listed (as a candidate); to serve (in one's master's home); (in Kyoto) to go north; (after the -masu stem of a verb) indicates completion	<b>挙がる<b> <br> あがる <br>[sound:k-2566_挙がる.mp3]
[sound:k-2566_挙がる.mp3]	to rise, to go up, to come up, to ascend, to be raised; to enter<br> <b>esp. from outdoors), to come in, to go in; to enter (a school), to advance to the next grade; to get out (of water), to come ashore; to increase; to improve, to make progress; to be promoted, to advance; to be made (of profit, etc.); to occur (esp. of a favourable result); to be adequate (to cover expenses, etc.); to be finished, to be done, to be over; (of rain) to stop, to lift; to stop (working properly), to cut out, to give out, to die; to win (in a card game, etc.); to be arrested; to turn up (of evidence, etc.); to be deep fried; to be spoken loudly; to get stage fright; to be offered (to the gods, etc.); to go, to visit; to eat, to drink; to be listed (as a candidate); to serve (in one's master's home); (in Kyoto) to go north; (after the -masu stem of a verb) indicates completion (挙がる</b> <br> (あがる)
<b>小説</b> <br> 彼女は毎晩小説を読むのが好きだ。	[sound:s-2566_彼女は毎晩小説を読むのが好きだ。.mp3] <br> かのじょはまいばんしょうせつをよむのがすきだ。 <br>She likes to read novels every night.
[sound:s-2566_彼女は毎晩小説を読むのが好きだ。.mp3]	<b>小説</b> <br> 彼女は毎晩小説を読むのが好きだ。<br> かのじょはまいばんしょうせつをよむのがすきだ <br>She likes to read novels every night.
選挙運動	[sound:k-2567_選挙運動.mp3]<br>せんきょうんどう <br> participation in election campaign
participation in election campaign	<b>選挙運動<b> <br> せんきょうんどう <br>[sound:k-2567_選挙運動.mp3]
[sound:k-2567_選挙運動.mp3]	participation in election campaign<br> <b>選挙運動</b> <br> (せんきょうんどう)
<b>解説</b> <br> テレビ番組でサッカーの試合を解説する。	[sound:s-2567_テレビ番組でサッカーの試合を解説する。.mp3] <br> テレビばんぐみでサッカーのしあいをかいせつする。 <br>Provide commentary on soccer matches on TV.
[sound:s-2567_テレビ番組でサッカーの試合を解説する。.mp3]	<b>解説</b> <br> テレビ番組でサッカーの試合を解説する。<br> テレビばんぐみでサッカーのしあいをかいせつする <br>Provide commentary on soccer matches on TV.
快挙	[sound:k-2568_快挙.mp3]<br>かいきょ <br> brilliant achievement
brilliant achievement	<b>快挙<b> <br> かいきょ <br>[sound:k-2568_快挙.mp3]
[sound:k-2568_快挙.mp3]	brilliant achievement<br> <b>快挙</b> <br> (かいきょ)
<b>説得</b> <br> 彼を説得してその計画を受け入れさせる。	[sound:s-2568_彼を説得してその計画を受け入れさせる。.mp3] <br> かれをせっとくしてそのけいかくをうけいれさせる。 <br>Persuade him to accept the plan.
[sound:s-2568_彼を説得してその計画を受け入れさせる。.mp3]	<b>説得</b> <br> 彼を説得してその計画を受け入れさせる。<br> かれをせっとくしてそのけいかくをうけいれさせる <br>Persuade him to accept the plan.
選挙権	[sound:k-2569_選挙権.mp3]<br>せんきょけん <br> suffrage
suffrage	<b>選挙権<b> <br> せんきょけん <br>[sound:k-2569_選挙権.mp3]
[sound:k-2569_選挙権.mp3]	suffrage<br> <b>選挙権</b> <br> (せんきょけん)
<b>伝説</b> <br> その場所には古い伝説が残っている。	[sound:s-2569_その場所には古い伝説が残っている。.mp3] <br> そのばしょにはふるいでんせつがのこっている。 <br>There are old legends remaining in that place.
[sound:s-2569_その場所には古い伝説が残っている。.mp3]	<b>伝説</b> <br> その場所には古い伝説が残っている。<br> そのばしょにはふるいでんせつがのこっている <br>There are old legends remaining in that place.
結果	[sound:k-2570_結果.mp3]<br>けっか <br> result, consequence
result, consequence	<b>結果<b> <br> けっか <br>[sound:k-2570_結果.mp3]
[sound:k-2570_結果.mp3]	result, consequence<br> <b>結果</b> <br> (けっか)
<b>遊説</b> <br> 政治家が選挙のために地域を遊説する。	[sound:s-2570_政治家が選挙のために地域を遊説する。.mp3] <br> せいじかがせんきょのためにちいきをゆうせつする。 <br>Politicians tour the region for elections.
[sound:s-2570_政治家が選挙のために地域を遊説する。.mp3]	<b>遊説</b> <br> 政治家が選挙のために地域を遊説する。<br> せいじかがせんきょのためにちいきをゆうせつする <br>Politicians tour the region for elections.
効果	[sound:k-2571_効果.mp3]<br>こうか <br> effect, effectiveness, efficacy, result
effect, effectiveness, efficacy, result	<b>効果<b> <br> こうか <br>[sound:k-2571_効果.mp3]
[sound:k-2571_効果.mp3]	effect, effectiveness, efficacy, result<br> <b>効果</b> <br> (こうか)
<b>力説</b> <br> 彼は自分の主張を力説した。	[sound:s-2571_彼は自分の主張を力説した。.mp3] <br> かれはじぶんのしゅちょうをりょくせつした。 <br>He strongly advocated his own opinion.
[sound:s-2571_彼は自分の主張を力説した。.mp3]	<b>力説</b> <br> 彼は自分の主張を力説した。<br> かれはじぶんのしゅちょうをりょくせつした <br>He strongly advocated his own opinion.
果たして	[sound:k-2572_果たして.mp3]<br>はたして <br> as was expected, just as one thought, sure enough, as a result; really? (in questions), ever?
as was expected, just as one thought, sure enough, as a result; really? (in questions), ever?	<b>果たして<b> <br> はたして <br>[sound:k-2572_果たして.mp3]
[sound:k-2572_果たして.mp3]	as was expected, just as one thought, sure enough, as a result; really?<br> <b>in questions), ever? (果たして</b> <br> (はたして)
<b>社説</b> <br> 新聞の社説が注目されている。	[sound:s-2572_新聞の社説が注目されている。.mp3] <br> しんぶんのしゃせつがちゅうもくされている。 <br>The editorial of the newspaper is receiving attention.
[sound:s-2572_新聞の社説が注目されている。.mp3]	<b>社説</b> <br> 新聞の社説が注目されている。<br> しんぶんのしゃせつがちゅうもくされている <br>The editorial of the newspaper is receiving attention.
成果	[sound:k-2573_成果.mp3]<br>せいか <br> results, fruits
results, fruits	<b>成果<b> <br> せいか <br>[sound:k-2573_成果.mp3]
[sound:k-2573_成果.mp3]	results, fruits<br> <b>成果</b> <br> (せいか)
<b>論説</b> <br> その問題に関する論説を書く。	[sound:s-2573_その問題に関する論説を書く。.mp3] <br> そのもんだいにかんするろんせつをかく。 <br>Write an essay on the issue.
[sound:s-2573_その問題に関する論説を書く。.mp3]	<b>論説</b> <br> その問題に関する論説を書く。<br> そのもんだいにかんするろんせつをかく <br>Write an essay on the issue.
効果的	[sound:k-2574_効果的.mp3]<br>こうかてき <br> effective, successful
effective, successful	<b>効果的<b> <br> こうかてき <br>[sound:k-2574_効果的.mp3]
[sound:k-2574_効果的.mp3]	effective, successful<br> <b>効果的</b> <br> (こうかてき)
<b>運転</b> <br> 彼は車の運転が上手です。	[sound:s-2574_彼は車の運転が上手です。.mp3] <br> かれはくるまのうんてんがじょうずです。 <br>He is good at driving a car.
[sound:s-2574_彼は車の運転が上手です。.mp3]	<b>運転</b> <br> 彼は車の運転が上手です。<br> かれはくるまのうんてんがじょうずです <br>He is good at driving a car.
果物	[sound:k-2575_果物.mp3]<br>くだもの, かぶつ <br> fruit
fruit	<b>果物<b> <br> くだもの, かぶつ <br>[sound:k-2575_果物.mp3]
[sound:k-2575_果物.mp3]	fruit<br> <b>果物</b> <br> (くだもの, かぶつ)
<b>転換</b> <br> 会社は新しい市場への転換を図っている。	[sound:s-2575_会社は新しい市場への転換を図っている。.mp3] <br> かいしゃはあたらしいしじょうへのてんかんをはかっている。 <br>The company is attempting to transition to a new market.
[sound:s-2575_会社は新しい市場への転換を図っている。.mp3]	<b>転換</b> <br> 会社は新しい市場への転換を図っている。<br> かいしゃはあたらしいしじょうへのてんかんをはかっている <br>The company is attempting to transition to a new market.
果て	[sound:k-2576_果て.mp3]<br>はて <br> the end, the extremity, the limit(s), the result
the end, the extremity, the limit(s), the result	<b>果て<b> <br> はて <br>[sound:k-2576_果て.mp3]
[sound:k-2576_果て.mp3]	the end, the extremity, the limit(s), the result<br> <b>果て</b> <br> (はて)
<b>逆転</b> <br> チームは試合で逆転勝利を収めた。	[sound:s-2576_チームは試合で逆転勝利を収めた。.mp3] <br> チームはしあいでぎゃくてんしょうりをおさめた。 <br>The team achieved a come-from-behind victory in the game.
[sound:s-2576_チームは試合で逆転勝利を収めた。.mp3]	<b>逆転</b> <br> チームは試合で逆転勝利を収めた。<br> チームはしあいでぎゃくてんしょうりをおさめた <br>The team achieved a come-from-behind victory in the game.
因果	[sound:k-2577_因果.mp3]<br>いんが <br> cause and effect, karma, fate
cause and effect, karma, fate	<b>因果<b> <br> いんが <br>[sound:k-2577_因果.mp3]
[sound:k-2577_因果.mp3]	cause and effect, karma, fate<br> <b>因果</b> <br> (いんが)
<b>移転</b> <br> 本社を新しい場所に移転する。	[sound:s-2577_本社を新しい場所に移転する。.mp3] <br> ほんしゃをあたらしいばしょにいてんする。 <br>Move the headquarters to a new location.
[sound:s-2577_本社を新しい場所に移転する。.mp3]	<b>移転</b> <br> 本社を新しい場所に移転する。<br> ほんしゃをあたらしいばしょにいてんする <br>Move the headquarters to a new location.
果実	[sound:k-2578_果実.mp3]<br>かじつ <br> fruit, nut, berry
fruit, nut, berry	<b>果実<b> <br> かじつ <br>[sound:k-2578_果実.mp3]
[sound:k-2578_果実.mp3]	fruit, nut, berry<br> <b>果実</b> <br> (かじつ)
<b>運転手</b> <br> バスの運転手が交代する。	[sound:s-2578_バスの運転手が交代する。.mp3] <br> バスのうんてんしゅがこうたいする。 <br>The bus driver is changing.
[sound:s-2578_バスの運転手が交代する。.mp3]	<b>運転手</b> <br> バスの運転手が交代する。<br> バスのうんてんしゅがこうたいする <br>The bus driver is changing.
果敢	[sound:k-2579_果敢.mp3]<br>かかん <br> resolute, determined, bold
resolute, determined, bold	<b>果敢<b> <br> かかん <br>[sound:k-2579_果敢.mp3]
[sound:k-2579_果敢.mp3]	resolute, determined, bold<br> <b>果敢</b> <br> (かかん)
<b>自転車</b> <br> 自転車で学校に行く。	[sound:s-2579_自転車で学校に行く。.mp3] <br> じてんしゃでがっこうにいく。 <br>Go to school by bicycle.
[sound:s-2579_自転車で学校に行く。.mp3]	<b>自転車</b> <br> 自転車で学校に行く。<br> じてんしゃでがっこうにいく <br>Go to school by bicycle.
西	[sound:k-2580_西.mp3]<br>にし <br> west
west	<b>西<b> <br> にし <br>[sound:k-2580_西.mp3]
[sound:k-2580_西.mp3]	west<br> <b>西</b> <br> (にし)
<b>回転</b> <br> ファンが回転して空気を循環させる。	[sound:s-2580_ファンが回転して空気を循環させる。.mp3] <br> ファンがかいてんしてくうきをじゅんかんさせる。 <br>The fan rotates to circulate air.
[sound:s-2580_ファンが回転して空気を循環させる。.mp3]	<b>回転</b> <br> ファンが回転して空気を循環させる。<br> ファンがかいてんしてくうきをじゅんかんさせる <br>The fan rotates to circulate air.
関西	[sound:k-2581_関西.mp3]<br>かんさい, かんせい <br> Kansai (south-western half of Japan, including Osaka)
Kansai (south-western half of Japan, including Osaka)	<b>関西<b> <br> かんさい, かんせい <br>[sound:k-2581_関西.mp3]
[sound:k-2581_関西.mp3]	Kansai<br> <b>south-western half of Japan, including Osaka) (関西</b> <br> (かんさい, かんせい)
<b>転じる</b> <br> 彼の興味は経済から政治に転じた。	[sound:s-2581_彼の興味は経済から政治に転じた。.mp3] <br> かれのきょうみはけいざいからせいじにてんじた。 <br>His interest shifted from economics to politics.
[sound:s-2581_彼の興味は経済から政治に転じた。.mp3]	<b>転じる</b> <br> 彼の興味は経済から政治に転じた。<br> かれのきょうみはけいざいからせいじにてんじた <br>His interest shifted from economics to politics.
西側	[sound:k-2582_西側.mp3]<br>にしがわ <br> west side, west bank
west side, west bank	<b>西側<b> <br> にしがわ <br>[sound:k-2582_西側.mp3]
[sound:k-2582_西側.mp3]	west side, west bank<br> <b>西側</b> <br> (にしがわ)
<b>逆転勝ち</b> <br> チームは逆転勝ちで優勝を決めた。	[sound:s-2582_チームは逆転勝ちで優勝を決めた。.mp3] <br> チームはぎゃくてんがちでゆうしょうをきめた。 <br>The team won the championship with a come-from-behind victory.
[sound:s-2582_チームは逆転勝ちで優勝を決めた。.mp3]	<b>逆転勝ち</b> <br> チームは逆転勝ちで優勝を決めた。<br> チームはぎゃくてんがちでゆうしょうをきめた <br>The team won the championship with a come-from-behind victory.
東西	[sound:k-2583_東西.mp3]<br>とうざい <br> East and West; whole country; Orient and Occident, Western and Eastern; Your attention, please!
East and West; whole country; Orient and Occident, Western and Eastern; Your attention, please!	<b>東西<b> <br> とうざい <br>[sound:k-2583_東西.mp3]
[sound:k-2583_東西.mp3]	East and West; whole country; Orient and Occident, Western and Eastern; Your attention, please!<br> <b>東西</b> <br> (とうざい)
<b>転勤</b> <br> 彼は転勤で新しい町に引っ越した。	[sound:s-2583_彼は転勤で新しい町に引っ越した。.mp3] <br> かれはてんきんであたらしいまちにひっこした。 <br>He moved to a new town due to a job transfer.
[sound:s-2583_彼は転勤で新しい町に引っ越した。.mp3]	<b>転勤</b> <br> 彼は転勤で新しい町に引っ越した。<br> かれはてんきんであたらしいまちにひっこした <br>He moved to a new town due to a job transfer.
西欧	[sound:k-2584_西欧.mp3]<br>せいおう <br> Western Europe
Western Europe	<b>西欧<b> <br> せいおう <br>[sound:k-2584_西欧.mp3]
[sound:k-2584_西欧.mp3]	Western Europe<br> <b>西欧</b> <br> (せいおう)
<b>食</b> <br> 朝食をとるのを忘れないでください。	[sound:s-2584_朝食をとるのを忘れないでください。.mp3] <br> ちょうしょくをとるのをわすれないでください。 <br>Don't forget to have breakfast.
[sound:s-2584_朝食をとるのを忘れないでください。.mp3]	<b>食</b> <br> 朝食をとるのを忘れないでください。<br> ちょうしょくをとるのをわすれないでください <br>Don't forget to have breakfast.
大西洋	[sound:k-2585_大西洋.mp3]<br>たいせいよう <br> Atlantic Ocean
Atlantic Ocean	<b>大西洋<b> <br> たいせいよう <br>[sound:k-2585_大西洋.mp3]
[sound:k-2585_大西洋.mp3]	Atlantic Ocean<br> <b>大西洋</b> <br> (たいせいよう)
<b>食事</b> <br> 夕食に何を食べるか決めてください。	[sound:s-2585_夕食に何を食べるか決めてください。.mp3] <br> ゆうしょくになにをたべるかきめてください。 <br>Please decide what to eat for dinner.
[sound:s-2585_夕食に何を食べるか決めてください。.mp3]	<b>食事</b> <br> 夕食に何を食べるか決めてください。<br> ゆうしょくになにをたべるかきめてください <br>Please decide what to eat for dinner.
西部	[sound:k-2586_西部.mp3]<br>せいぶ <br> the west, western part, the West
the west, western part, the West	<b>西部<b> <br> せいぶ <br>[sound:k-2586_西部.mp3]
[sound:k-2586_西部.mp3]	the west, western part, the West<br> <b>西部</b> <br> (せいぶ)
<b>食品</b> <br> 健康的な食品を選ぶことが大切です。	[sound:s-2586_健康的な食品を選ぶことが大切です。.mp3] <br> けんこうてきなしょくひんをえらぶことがたいせつです。 <br>Choosing healthy food is important.
[sound:s-2586_健康的な食品を選ぶことが大切です。.mp3]	<b>食品</b> <br> 健康的な食品を選ぶことが大切です。<br> けんこうてきなしょくひんをえらぶことがたいせつです <br>Choosing healthy food is important.
南西	[sound:k-2587_南西.mp3]<br>なんせい, みなみにし <br> southwest
southwest	<b>南西<b> <br> なんせい, みなみにし <br>[sound:k-2587_南西.mp3]
[sound:k-2587_南西.mp3]	southwest<br> <b>南西</b> <br> (なんせい, みなみにし)
<b>食料</b> <br> 食料の備蓄を増やす必要がある。	[sound:s-2587_食料の備蓄を増やす必要がある。.mp3] <br> しょくりょうのびちくをふやすひつようがある。 <br>It is necessary to increase food reserves.
[sound:s-2587_食料の備蓄を増やす必要がある。.mp3]	<b>食料</b> <br> 食料の備蓄を増やす必要がある。<br> しょくりょうのびちくをふやすひつようがある <br>It is necessary to increase food reserves.
西日本	[sound:k-2588_西日本.mp3]<br>にしにほん, にしにっぽん <br> western Japan
western Japan	<b>西日本<b> <br> にしにほん, にしにっぽん <br>[sound:k-2588_西日本.mp3]
[sound:k-2588_西日本.mp3]	western Japan<br> <b>西日本</b> <br> (にしにほん, にしにっぽん)
<b>食糧</b> <br> 食糧不足が深刻な問題となっている。	[sound:s-2588_食糧不足が深刻な問題となっている。.mp3] <br> しょくりょうぶそくがしんこくなもんだいとなっている。 <br>Food shortages have become a serious problem.
[sound:s-2588_食糧不足が深刻な問題となっている。.mp3]	<b>食糧</b> <br> 食糧不足が深刻な問題となっている。<br> しょくりょうぶそくがしんこくなもんだいとなっている <br>Food shortages have become a serious problem.
西洋	[sound:k-2589_西洋.mp3]<br>せいよう <br> the west, Western countries
the west, Western countries	<b>西洋<b> <br> せいよう <br>[sound:k-2589_西洋.mp3]
[sound:k-2589_西洋.mp3]	the west, Western countries<br> <b>西洋</b> <br> (せいよう)
<b>昼食</b> <br> 昼食にサンドイッチを食べました。	[sound:s-2589_昼食にサンドイッチを食べました。.mp3] <br> ちゅうしょくにサンドイッチをたべました。 <br>I had a sandwich for lunch.
[sound:s-2589_昼食にサンドイッチを食べました。.mp3]	<b>昼食</b> <br> 昼食にサンドイッチを食べました。<br> ちゅうしょくにサンドイッチをたべました <br>I had a sandwich for lunch.
勢い	[sound:k-2590_勢い.mp3]<br>いきおい <br> force, vigor, vigour, energy, spirit, life; influence, authority, power, might; impetus, momentum, course (of events); naturally, necessarily
force, vigor, vigour, energy, spirit, life; influence, authority, power, might; impetus, momentum, course (of events); naturally, necessarily	<b>勢い<b> <br> いきおい <br>[sound:k-2590_勢い.mp3]
[sound:k-2590_勢い.mp3]	force, vigor, vigour, energy, spirit, life; influence, authority, power, might; impetus, momentum, course<br> <b>of events); naturally, necessarily (勢い</b> <br> (いきおい)
<b>飲食</b> <br> 公共の場での飲食は禁止されています。	[sound:s-2590_公共の場での飲食は禁止されています。.mp3] <br> こうきょうのばでのいんしょくはきんしされています。 <br>Eating and drinking are prohibited in public places.
[sound:s-2590_公共の場での飲食は禁止されています。.mp3]	<b>飲食</b> <br> 公共の場での飲食は禁止されています。<br> こうきょうのばでのいんしょくはきんしされています <br>Eating and drinking are prohibited in public places.
勢み	[sound:k-2591_勢み.mp3]<br>はずみ <br> bounce, spring, rebound; momentum, inertia; spur of the moment, impulse
bounce, spring, rebound; momentum, inertia; spur of the moment, impulse	<b>勢み<b> <br> はずみ <br>[sound:k-2591_勢み.mp3]
[sound:k-2591_勢み.mp3]	bounce, spring, rebound; momentum, inertia; spur of the moment, impulse<br> <b>勢み</b> <br> (はずみ)
<b>給食</b> <br> 学校で給食を提供しています。	[sound:s-2591_学校で給食を提供しています。.mp3] <br> がっこうできゅうしょくをていきょうしています。 <br>School provides lunch.
[sound:s-2591_学校で給食を提供しています。.mp3]	<b>給食</b> <br> 学校で給食を提供しています。<br> がっこうできゅうしょくをていきょうしています <br>School provides lunch.
姿勢	[sound:k-2592_姿勢.mp3]<br>しせい <br> attitude, posture
attitude, posture	<b>姿勢<b> <br> しせい <br>[sound:k-2592_姿勢.mp3]
[sound:k-2592_姿勢.mp3]	attitude, posture<br> <b>姿勢</b> <br> (しせい)
<b>夕食</b> <br> 家族で美味しい夕食を楽しんだ。	[sound:s-2592_家族で美味しい夕食を楽しんだ。.mp3] <br> かぞくでおいしいゆうしょくをたのしんだ。 <br>Enjoyed a delicious dinner with the family.
[sound:s-2592_家族で美味しい夕食を楽しんだ。.mp3]	<b>夕食</b> <br> 家族で美味しい夕食を楽しんだ。<br> かぞくでおいしいゆうしょくをたのしんだ <br>Enjoyed a delicious dinner with the family.
情勢	[sound:k-2593_情勢.mp3]<br>じょうせい <br> state of things, state of affairs, condition, situation, circumstances
state of things, state of affairs, condition, situation, circumstances	<b>情勢<b> <br> じょうせい <br>[sound:k-2593_情勢.mp3]
[sound:k-2593_情勢.mp3]	state of things, state of affairs, condition, situation, circumstances<br> <b>情勢</b> <br> (じょうせい)
<b>食べ物</b> <br> 野菜や果物などの健康的な食べ物を摂る。	[sound:s-2593_野菜や果物などの健康的な食べ物を摂る。.mp3] <br> やさいやくだものなどのけんこうてきなたべものをとる。 <br>Consume healthy foods like vegetables and fruits.
[sound:s-2593_野菜や果物などの健康的な食べ物を摂る。.mp3]	<b>食べ物</b> <br> 野菜や果物などの健康的な食べ物を摂る。<br> やさいやくだものなどのけんこうてきなたべものをとる <br>Consume healthy foods like vegetables and fruits.
勢力	[sound:k-2594_勢力.mp3]<br>せいりょく <br> influence, power, might, strength, potency, force, energy
influence, power, might, strength, potency, force, energy	<b>勢力<b> <br> せいりょく <br>[sound:k-2594_勢力.mp3]
[sound:k-2594_勢力.mp3]	influence, power, might, strength, potency, force, energy<br> <b>勢力</b> <br> (せいりょく)
<b>比べる</b> <br> これらの製品を比べてみてください。	[sound:s-2594_これらの製品を比べてみてください。.mp3] <br> これらのせいひんをくらべてみてください。 <br>Please compare these products.
[sound:s-2594_これらの製品を比べてみてください。.mp3]	<b>比べる</b> <br> これらの製品を比べてみてください。<br> これらのせいひんをくらべてみてください <br>Please compare these products.
態勢	[sound:k-2595_態勢.mp3]<br>たいせい <br> attitude, conditions, preparations
attitude, conditions, preparations	<b>態勢<b> <br> たいせい <br>[sound:k-2595_態勢.mp3]
[sound:k-2595_態勢.mp3]	attitude, conditions, preparations<br> <b>態勢</b> <br> (たいせい)
<b>比例</b> <br> この二つの変数は比例関係にある。	[sound:s-2595_この二つの変数は比例関係にある。.mp3] <br> このふたつのへんすうはひれいかんけいにある。 <br>These two variables are in direct proportion.
[sound:s-2595_この二つの変数は比例関係にある。.mp3]	<b>比例</b> <br> この二つの変数は比例関係にある。<br> このふたつのへんすうはひれいかんけいにある <br>These two variables are in direct proportion.
大勢	[sound:k-2596_大勢.mp3]<br>おおぜい, たいぜい <br> many, crowd, great number of people
many, crowd, great number of people	<b>大勢<b> <br> おおぜい, たいぜい <br>[sound:k-2596_大勢.mp3]
[sound:k-2596_大勢.mp3]	many, crowd, great number of people<br> <b>大勢</b> <br> (おおぜい, たいぜい)
<b>比率</b> <br> 成績を比率で表示する。	[sound:s-2596_成績を比率で表示する。.mp3] <br> せいせきをひりつでひょうじする。 <br>Display the results in ratio.
[sound:s-2596_成績を比率で表示する。.mp3]	<b>比率</b> <br> 成績を比率で表示する。<br> せいせきをひりつでひょうじする <br>Display the results in ratio.
攻勢	[sound:k-2597_攻勢.mp3]<br>こうせい <br> offensive (movement), aggression
offensive (movement), aggression	<b>攻勢<b> <br> こうせい <br>[sound:k-2597_攻勢.mp3]
[sound:k-2597_攻勢.mp3]	offensive<br> <b>movement), aggression (攻勢</b> <br> (こうせい)
<b>比較</b> <br> この商品と他の商品を比較してください。	[sound:s-2597_この商品と他の商品を比較してください。.mp3] <br> このしょうひんとほかのしょうひんをひかくしてください。 <br>Please compare this product with others.
[sound:s-2597_この商品と他の商品を比較してください。.mp3]	<b>比較</b> <br> この商品と他の商品を比較してください。<br> このしょうひんとほかのしょうひんをひかくしてください <br>Please compare this product with others.
伊勢丹	[sound:k-2598_伊勢丹.mp3]<br>いせたん <br> Isetan (department store)
Isetan (department store)	<b>伊勢丹<b> <br> いせたん <br>[sound:k-2598_伊勢丹.mp3]
[sound:k-2598_伊勢丹.mp3]	Isetan<br> <b>department store) (伊勢丹</b> <br> (いせたん)
<b>比べ</b> <br> 二つのグラフを比べて、違いを見つけよう。	[sound:s-2598_二つのグラフを比べて、違いを見つけよう。.mp3] <br> ふたつのグラフをくらべて、ちがいをみつけよう。 <br>Let's compare the two graphs and find the differences.
[sound:s-2598_二つのグラフを比べて、違いを見つけよう。.mp3]	<b>比べ</b> <br> 二つのグラフを比べて、違いを見つけよう。<br> ふたつのグラフをくらべて、ちがいをみつけよう <br>Let's compare the two graphs and find the differences.
優勢	[sound:k-2599_優勢.mp3]<br>ゆうせい <br> superiority, superior power, predominance, preponderance
superiority, superior power, predominance, preponderance	<b>優勢<b> <br> ゆうせい <br>[sound:k-2599_優勢.mp3]
[sound:k-2599_優勢.mp3]	superiority, superior power, predominance, preponderance<br> <b>優勢</b> <br> (ゆうせい)
<b>比</b> <br> 数学の授業で比の問題を解いた。	[sound:s-2599_数学の授業で比の問題を解いた。.mp3] <br> すうがくのじゅぎょうでひのもんだいをといた。 <br>Solved problems on ratios in math class.
[sound:s-2599_数学の授業で比の問題を解いた。.mp3]	<b>比</b> <br> 数学の授業で比の問題を解いた。<br> すうがくのじゅぎょうでひのもんだいをといた <br>Solved problems on ratios in math class.
削減	[sound:k-2600_削減.mp3]<br>さくげん <br> cut, reduction, curtailment
cut, reduction, curtailment	<b>削減<b> <br> さくげん <br>[sound:k-2600_削減.mp3]
[sound:k-2600_削減.mp3]	cut, reduction, curtailment<br> <b>削減</b> <br> (さくげん)
<b>比重</b> <br> この問題の解決には時間の比重を考える必要がある。	[sound:s-2600_この問題の解決には時間の比重を考える必要がある。.mp3] <br> このもんだいのかいけつにはじかんのひじゅうをかんがえるひつようがある。 <br>We need to consider the time allocation for solving this problem.
[sound:s-2600_この問題の解決には時間の比重を考える必要がある。.mp3]	<b>比重</b> <br> この問題の解決には時間の比重を考える必要がある。<br> このもんだいのかいけつにはじかんのひじゅうをかんがえるひつようがある <br>We need to consider the time allocation for solving this problem.
減税	[sound:k-2601_減税.mp3]<br>げんぜい <br> tax reduction
tax reduction	<b>減税<b> <br> げんぜい <br>[sound:k-2601_減税.mp3]
[sound:k-2601_減税.mp3]	tax reduction<br> <b>減税</b> <br> (げんぜい)
<b>恵比寿</b> <br> 恵比寿神社で初詣をする。	[sound:s-2601_恵比寿神社で初詣をする。.mp3] <br> えびすじんじゃではつもうでをする。 <br>Visit Ebisu Shrine for New Year's.
[sound:s-2601_恵比寿神社で初詣をする。.mp3]	<b>恵比寿</b> <br> 恵比寿神社で初詣をする。<br> えびすじんじゃではつもうでをする <br>Visit Ebisu Shrine for New Year's.
減少	[sound:k-2602_減少.mp3]<br>げんしょう <br> decrease, reduction, decline
decrease, reduction, decline	<b>減少<b> <br> げんしょう <br>[sound:k-2602_減少.mp3]
[sound:k-2602_減少.mp3]	decrease, reduction, decline<br> <b>減少</b> <br> (げんしょう)
<b>対比</b> <br> 両者の違いを対比して説明する。	[sound:s-2602_両者の違いを対比して説明する。.mp3] <br> りょうしゃのちがいをたいひしてせつめいする。 <br>Explain the differences between the two sides in comparison.
[sound:s-2602_両者の違いを対比して説明する。.mp3]	<b>対比</b> <br> 両者の違いを対比して説明する。<br> りょうしゃのちがいをたいひしてせつめいする <br>Explain the differences between the two sides in comparison.
減益	[sound:k-2603_減益.mp3]<br>げんえき <br> decrease in profits
decrease in profits	<b>減益<b> <br> げんえき <br>[sound:k-2603_減益.mp3]
[sound:k-2603_減益.mp3]	decrease in profits<br> <b>減益</b> <br> (げんえき)
<b>反比例</b> <br> 温度と気圧は反比例の関係にある。	[sound:s-2603_温度と気圧は反比例の関係にある。.mp3] <br> おんどときあつははんぴれいのかんけいにある。 <br>Temperature and pressure are inversely proportional.
[sound:s-2603_温度と気圧は反比例の関係にある。.mp3]	<b>反比例</b> <br> 温度と気圧は反比例の関係にある。<br> おんどときあつははんぴれいのかんけいにある <br>Temperature and pressure are inversely proportional.
減速	[sound:k-2604_減速.mp3]<br>げんそく <br> deceleration
deceleration	<b>減速<b> <br> げんそく <br>[sound:k-2604_減速.mp3]
[sound:k-2604_減速.mp3]	deceleration<br> <b>減速</b> <br> (げんそく)
<b>難</b> <br> その問題は難しそうだ。	[sound:s-2604_その問題は難しそうだ。.mp3] <br> そのもんだいはむずかしそうだ。 <br>That problem looks difficult.
[sound:s-2604_その問題は難しそうだ。.mp3]	<b>難</b> <br> その問題は難しそうだ。<br> そのもんだいはむずかしそうだ <br>That problem looks difficult.
軽減	[sound:k-2605_軽減.mp3]<br>けいげん <br> abatement, reduction
abatement, reduction	<b>軽減<b> <br> けいげん <br>[sound:k-2605_軽減.mp3]
[sound:k-2605_軽減.mp3]	abatement, reduction<br> <b>軽減</b> <br> (けいげん)
<b>難しい</b> <br> この問題は難しいので、時間がかかるかもしれません。	[sound:s-2605_この問題は難しいので、時間がかかるかもしれません。.mp3] <br> このもんだいはむずかしいので、じかんがかかるかもしれません。 <br>"This problem is difficult, so it might take some time."
[sound:s-2605_この問題は難しいので、時間がかかるかもしれません。.mp3]	<b>難しい</b> <br> この問題は難しいので、時間がかかるかもしれません。<br> このもんだいはむずかしいので、じかんがかかるかもしれません <br>This problem is difficult, so it might take some time.
減収	[sound:k-2606_減収.mp3]<br>げんしゅう <br> fall, decrease (in income)
fall, decrease (in income)	<b>減収<b> <br> げんしゅう <br>[sound:k-2606_減収.mp3]
[sound:k-2606_減収.mp3]	fall, decrease<br> <b>in income) (減収</b> <br> (げんしゅう)
<b>難民</b> <br> 戦争で多くの人々が難民になった。	[sound:s-2606_戦争で多くの人々が難民になった。.mp3] <br> せんそうでおおくのひとびとがなんみんになった。 <br>Many people became refugees due to the war.
[sound:s-2606_戦争で多くの人々が難民になった。.mp3]	<b>難民</b> <br> 戦争で多くの人々が難民になった。<br> せんそうでおおくのひとびとがなんみんになった <br>Many people became refugees due to the war.
減反	[sound:k-2607_減反.mp3]<br>げんたん <br> reduction (of crop size), reduction of acreage (under cultivation)
reduction (of crop size), reduction of acreage (under cultivation)	<b>減反<b> <br> げんたん <br>[sound:k-2607_減反.mp3]
[sound:k-2607_減反.mp3]	reduction<br> <b>of crop size), reduction of acreage (under cultivation) (減反</b> <br> (げんたん)
<b>困難</b> <br> そのプロジェクトは多くの困難に直面している。	[sound:s-2607_そのプロジェクトは多くの困難に直面している。.mp3] <br> そのプロジェクトはおおくのこんなんにちょくめんしている。 <br>The project is facing many difficulties.
[sound:s-2607_そのプロジェクトは多くの困難に直面している。.mp3]	<b>困難</b> <br> そのプロジェクトは多くの困難に直面している。<br> そのプロジェクトはおおくのこんなんにちょくめんしている <br>The project is facing many difficulties.
減額	[sound:k-2608_減額.mp3]<br>げんがく <br> reduction, diminution, abatement
reduction, diminution, abatement	<b>減額<b> <br> げんがく <br>[sound:k-2608_減額.mp3]
[sound:k-2608_減額.mp3]	reduction, diminution, abatement<br> <b>減額</b> <br> (げんがく)
<b>避難</b> <br> 自然災害の際には避難する必要がある。	[sound:s-2608_自然災害の際には避難する必要がある。.mp3] <br> しぜんさいがいのさいにはひなんするひつようがある。 <br>It's necessary to evacuate in case of a natural disaster.
[sound:s-2608_自然災害の際には避難する必要がある。.mp3]	<b>避難</b> <br> 自然災害の際には避難する必要がある。<br> しぜんさいがいのさいにはひなんするひつようがある <br>It's necessary to evacuate in case of a natural disaster.
減産	[sound:k-2609_減産.mp3]<br>げんさん <br> reduction in production
reduction in production	<b>減産<b> <br> げんさん <br>[sound:k-2609_減産.mp3]
[sound:k-2609_減産.mp3]	reduction in production<br> <b>減産</b> <br> (げんさん)
<b>非難</b> <br> 彼の行動には多くの非難が集まった。	[sound:s-2609_彼の行動には多くの非難が集まった。.mp3] <br> かれのこうどうにはおおくのひなんがあつまった。 <br>His actions gathered a lot of criticism.
[sound:s-2609_彼の行動には多くの非難が集まった。.mp3]	<b>非難</b> <br> 彼の行動には多くの非難が集まった。<br> かれのこうどうにはおおくのひなんがあつまった <br>His actions gathered a lot of criticism.
台	[sound:k-2610_台.mp3]<br>だい <br> stand, rack, table; support; belt; counter for machines, incl. vehicles; setting (e.g. in jewellery)
stand, rack, table; support; belt; counter for machines, incl. vehicles; setting (e.g. in jewellery)	<b>台<b> <br> だい <br>[sound:k-2610_台.mp3]
[sound:k-2610_台.mp3]	stand, rack, table; support; belt; counter for machines, incl. vehicles; setting<br> <b>e.g. in jewellery) (台</b> <br> (だい)
<b>難色</b> <br> 上司は提案に対して難色を示した。	[sound:s-2610_上司は提案に対して難色を示した。.mp3] <br> じょうしはていあんにたいしてなんしょくをしめした。 <br>The boss showed hesitation towards the proposal.
[sound:s-2610_上司は提案に対して難色を示した。.mp3]	<b>難色</b> <br> 上司は提案に対して難色を示した。<br> じょうしはていあんにたいしてなんしょくをしめした <br>The boss showed hesitation towards the proposal.
台湾	[sound:k-2611_台湾.mp3]<br>たいわん <br> Taiwan
Taiwan	<b>台湾<b> <br> たいわん <br>[sound:k-2611_台湾.mp3]
[sound:k-2611_台湾.mp3]	Taiwan<br> <b>台湾</b> <br> (たいわん)
<b>避難民</b> <br> 戦争により、多くの避難民が生まれた。	[sound:s-2611_戦争により、多くの避難民が生まれた。.mp3] <br> せんそうにより、おおくのひなんみんがうまれた。 <br>Many refugees were born due to the war.
[sound:s-2611_戦争により、多くの避難民が生まれた。.mp3]	<b>避難民</b> <br> 戦争により、多くの避難民が生まれた。<br> せんそうにより、おおくのひなんみんがうまれた <br>Many refugees were born due to the war.
舞台	[sound:k-2612_舞台.mp3]<br>ぶたい <br> stage (theatre, theater); scene or setting (e.g. of novel, play, etc.)
stage (theatre, theater); scene or setting (e.g. of novel, play, etc.)	<b>舞台<b> <br> ぶたい <br>[sound:k-2612_舞台.mp3]
[sound:k-2612_舞台.mp3]	stage<br> <b>theatre, theater); scene or setting (e.g. of novel, play, etc.) (舞台</b> <br> (ぶたい)
<b>難問</b> <br> この数学の問題は本当に難問だ。	[sound:s-2612_この数学の問題は本当に難問だ。.mp3] <br> このすうがくのもんだいはほんとうになんもんだ。 <br>This math problem is really challenging.
[sound:s-2612_この数学の問題は本当に難問だ。.mp3]	<b>難問</b> <br> この数学の問題は本当に難問だ。<br> このすうがくのもんだいはほんとうになんもんだ <br>This math problem is really challenging.
台風	[sound:k-2613_台風.mp3]<br>たいふう <br> typhoon, hurricane
typhoon, hurricane	<b>台風<b> <br> たいふう <br>[sound:k-2613_台風.mp3]
[sound:k-2613_台風.mp3]	typhoon, hurricane<br> <b>台風</b> <br> (たいふう)
<b>難航</b> <br> 交渉は難航している。	[sound:s-2613_交渉は難航している。.mp3] <br> こうしょうはなんこうしている。 <br>Negotiations are difficult.
[sound:s-2613_交渉は難航している。.mp3]	<b>難航</b> <br> 交渉は難航している。<br> こうしょうはなんこうしている <br>Negotiations are difficult.
台所	[sound:k-2614_台所.mp3]<br>だいどころ, だいどこ <br> kitchen
kitchen	<b>台所<b> <br> だいどころ, だいどこ <br>[sound:k-2614_台所.mp3]
[sound:k-2614_台所.mp3]	kitchen<br> <b>台所</b> <br> (だいどころ, だいどこ)
<b>防衛</b> <br> 彼は国の防衛に貢献しています。	[sound:s-2614_彼は国の防衛に貢献しています。.mp3] <br>  かれはくにのぼうえいにこうけんしています。 <br> He is contributing to the defense of the country.
[sound:s-2614_彼は国の防衛に貢献しています。.mp3]	<b>防衛</b> <br> 彼は国の防衛に貢献しています。<br>  かれはくにのぼうえいにこうけんしています <br> He is contributing to the defense of the country.
大台	[sound:k-2615_大台.mp3]<br>おおだい <br> (stock) 100-yen unit, high level (of stock prices)
(stock) 100-yen unit, high level (of stock prices)	<b>大台<b> <br> おおだい <br>[sound:k-2615_大台.mp3]
[sound:k-2615_大台.mp3]	(stock) 100-yen unit, high level<br> <b>of stock prices) (大台</b> <br> (おおだい)
<b>国防</b> <br> 国防政策は重要です。	[sound:s-2615_国防政策は重要です。.mp3] <br>  こくぼうせいさくはじゅうようです。 <br> National defense policy is important.
[sound:s-2615_国防政策は重要です。.mp3]	<b>国防</b> <br> 国防政策は重要です。<br>  こくぼうせいさくはじゅうようです <br> National defense policy is important.
台頭	[sound:k-2616_台頭.mp3]<br>たいとう <br> rise of, appearance of, (in the) forefront, prominence
rise of, appearance of, (in the) forefront, prominence	<b>台頭<b> <br> たいとう <br>[sound:k-2616_台頭.mp3]
[sound:k-2616_台頭.mp3]	rise of, appearance of,<br> <b>in the) forefront, prominence (台頭</b> <br> (たいとう)
<b>防止</b> <br> 予防は病気の拡大を防止します。	[sound:s-2616_予防は病気の拡大を防止します。.mp3] <br>  よぼうはびょうきのかくだいをぼうしさします。 <br> Prevention prevents the spread of diseases.
[sound:s-2616_予防は病気の拡大を防止します。.mp3]	<b>防止</b> <br> 予防は病気の拡大を防止します。<br>  よぼうはびょうきのかくだいをぼうしさします <br> Prevention prevents the spread of diseases.
台本	[sound:k-2617_台本.mp3]<br>だいほん <br> script, libretto, scenario
script, libretto, scenario	<b>台本<b> <br> だいほん <br>[sound:k-2617_台本.mp3]
[sound:k-2617_台本.mp3]	script, libretto, scenario<br> <b>台本</b> <br> (だいほん)
<b>防衛庁</b> <br> 防衛庁は国の安全を守っています。	[sound:s-2617_防衛庁は国の安全を守っています。.mp3] <br>  ぼうえいちょうはくにのあんぜんをまもっています。 <br> The Defense Agency is protecting the safety of the country.
[sound:s-2617_防衛庁は国の安全を守っています。.mp3]	<b>防衛庁</b> <br> 防衛庁は国の安全を守っています。<br>  ぼうえいちょうはくにのあんぜんをまもっています <br> The Defense Agency is protecting the safety of the country.
土台	[sound:k-2618_土台.mp3]<br>どだい <br> foundation, base, basis
foundation, base, basis	<b>土台<b> <br> どだい <br>[sound:k-2618_土台.mp3]
[sound:k-2618_土台.mp3]	foundation, base, basis<br> <b>土台</b> <br> (どだい)
<b>予防</b> <br> 予防接種は疾病を予防します。	[sound:s-2618_予防接種は疾病を予防します。.mp3] <br>  よぼうせっしゅはしっぺいをよぼうします。 <br> Vaccination prevents diseases.
[sound:s-2618_予防接種は疾病を予防します。.mp3]	<b>予防</b> <br> 予防接種は疾病を予防します。<br>  よぼうせっしゅはしっぺいをよぼうします <br> Vaccination prevents diseases.
屋台	[sound:k-2619_屋台.mp3]<br>やたい <br> cart, esp. food cart; (festival) float
cart, esp. food cart; (festival) float	<b>屋台<b> <br> やたい <br>[sound:k-2619_屋台.mp3]
[sound:k-2619_屋台.mp3]	cart, esp. food cart;<br> <b>festival) float (屋台</b> <br> (やたい)
<b>攻防</b> <br> 野球の試合は攻防が続いています。	[sound:s-2619_野球の試合は攻防が続いています。.mp3] <br>  やきゅうのしあいはこうぼうがつづいています。 <br> The baseball game continues with offense and defense.
[sound:s-2619_野球の試合は攻防が続いています。.mp3]	<b>攻防</b> <br> 野球の試合は攻防が続いています。<br>  やきゅうのしあいはこうぼうがつづいています <br> The baseball game continues with offense and defense.
広い	[sound:k-2620_広い.mp3]<br>ひろい <br> spacious, vast, wide
spacious, vast, wide	<b>広い<b> <br> ひろい <br>[sound:k-2620_広い.mp3]
[sound:k-2620_広い.mp3]	spacious, vast, wide<br> <b>広い</b> <br> (ひろい)
<b>消防</b> <br> 消防士は火災を鎮圧しています。	[sound:s-2620_消防士は火災を鎮圧しています。.mp3] <br>  しょうぼうしはかさいをちんあつしています。 <br> Firefighters are suppressing the fire.
[sound:s-2620_消防士は火災を鎮圧しています。.mp3]	<b>消防</b> <br> 消防士は火災を鎮圧しています。<br>  しょうぼうしはかさいをちんあつしています <br> Firefighters are suppressing the fire.
広がり	[sound:k-2621_広がり.mp3]<br>ひろがり <br> spread, span
spread, span	<b>広がり<b> <br> ひろがり <br>[sound:k-2621_広がり.mp3]
[sound:k-2621_広がり.mp3]	spread, span<br> <b>広がり</b> <br> (ひろがり)
<b>防災</b> <br> 防災対策は地震から人々を守ります。	[sound:s-2621_防災対策は地震から人々を守ります。.mp3] <br>  ぼうさいたいさくはじしんからひとびとをまもります。 <br> Disaster prevention measures protect people from earthquakes.
[sound:s-2621_防災対策は地震から人々を守ります。.mp3]	<b>防災</b> <br> 防災対策は地震から人々を守ります。<br>  ぼうさいたいさくはじしんからひとびとをまもります <br> Disaster prevention measures protect people from earthquakes.
広告	[sound:k-2622_広告.mp3]<br>こうこく <br> advertisement
advertisement	<b>広告<b> <br> こうこく <br>[sound:k-2622_広告.mp3]
[sound:k-2622_広告.mp3]	advertisement<br> <b>広告</b> <br> (こうこく)
<b>防御</b> <br> 防御力が強化されました。	[sound:s-2622_防御力が強化されました。.mp3] <br>  ぼうぎょりょくがきょうかされました。 <br> Defensive power has been reinforced.
[sound:s-2622_防御力が強化されました。.mp3]	<b>防御</b> <br> 防御力が強化されました。<br>  ぼうぎょりょくがきょうかされました <br> Defensive power has been reinforced.
広げる	[sound:k-2623_広げる.mp3]<br>ひろげる <br> to spread, to extend, to expand, to enlarge, to widen, to broaden, to unfold, to open, to unroll
to spread, to extend, to expand, to enlarge, to widen, to broaden, to unfold, to open, to unroll	<b>広げる<b> <br> ひろげる <br>[sound:k-2623_広げる.mp3]
[sound:k-2623_広げる.mp3]	to spread, to extend, to expand, to enlarge, to widen, to broaden, to unfold, to open, to unroll<br> <b>広げる</b> <br> (ひろげる)
<b>防護</b> <br> 警察は市民を防護する役割を果たしています。	[sound:s-2623_警察は市民を防護する役割を果たしています。.mp3] <br> けいさつはしみんをぼうごするやくわりをはたしています。 <br>The police are fulfilling the role of protecting citizens.
[sound:s-2623_警察は市民を防護する役割を果たしています。.mp3]	<b>防護</b> <br> 警察は市民を防護する役割を果たしています。<br> けいさつはしみんをぼうごするやくわりをはたしています <br>The police are fulfilling the role of protecting citizens.
広がった枝	[sound:k-2624_広がった枝.mp3]<br>ひろがったえだ <br> spreading branches
spreading branches	<b>広がった枝<b> <br> ひろがったえだ <br>[sound:k-2624_広がった枝.mp3]
[sound:k-2624_広がった枝.mp3]	spreading branches<br> <b>広がった枝</b> <br> (ひろがったえだ)
<b>候補</b> <br> 彼は新しいリーダーの候補です。	[sound:s-2624_彼は新しいリーダーの候補です。.mp3] <br> かれはあたらしいりーだーのこうほです。 <br>He is a candidate for the new leader.
[sound:s-2624_彼は新しいリーダーの候補です。.mp3]	<b>候補</b> <br> 彼は新しいリーダーの候補です。<br> かれはあたらしいりーだーのこうほです <br>He is a candidate for the new leader.
広さ	[sound:k-2625_広さ.mp3]<br>ひろさ <br> extent
extent	<b>広さ<b> <br> ひろさ <br>[sound:k-2625_広さ.mp3]
[sound:k-2625_広さ.mp3]	extent<br> <b>広さ</b> <br> (ひろさ)
<b>補助</b> <br> 学校で補助教材を使います。	[sound:s-2625_学校で補助教材を使います。.mp3] <br> がっこうでほじょきょうざいをつかいます。 <br>We use supplementary teaching materials at school.
[sound:s-2625_学校で補助教材を使います。.mp3]	<b>補助</b> <br> 学校で補助教材を使います。<br> がっこうでほじょきょうざいをつかいます <br>We use supplementary teaching materials at school.
広報	[sound:k-2626_広報.mp3]<br>こうほう <br> PR, public relations, publicity, information
PR, public relations, publicity, information	<b>広報<b> <br> こうほう <br>[sound:k-2626_広報.mp3]
[sound:k-2626_広報.mp3]	PR, public relations, publicity, information<br> <b>広報</b> <br> (こうほう)
<b>補償</b> <br> 補償金が支払われました。	[sound:s-2626_補償金が支払われました。.mp3] <br> ほしょうきんがしはらわれました。 <br>Compensation money has been paid.
[sound:s-2626_補償金が支払われました。.mp3]	<b>補償</b> <br> 補償金が支払われました。<br> ほしょうきんがしはらわれました <br>Compensation money has been paid.
広場	[sound:k-2627_広場.mp3]<br>ひろば <br> plaza
plaza	<b>広場<b> <br> ひろば <br>[sound:k-2627_広場.mp3]
[sound:k-2627_広場.mp3]	plaza<br> <b>広場</b> <br> (ひろば)
<b>立候補</b> <br> 彼は市長選挙に立候補しました。	[sound:s-2627_彼は市長選挙に立候補しました。.mp3] <br> かれはしちょうせんきょにりっこうほしました。 <br>He ran for mayor in the election.
[sound:s-2627_彼は市長選挙に立候補しました。.mp3]	<b>立候補</b> <br> 彼は市長選挙に立候補しました。<br> かれはしちょうせんきょにりっこうほしました <br>He ran for mayor in the election.
幅広い	[sound:k-2628_幅広い.mp3]<br>はばひろい <br> extensive, wide, broad
extensive, wide, broad	<b>幅広い<b> <br> はばひろい <br>[sound:k-2628_幅広い.mp3]
[sound:k-2628_幅広い.mp3]	extensive, wide, broad<br> <b>幅広い</b> <br> (はばひろい)
<b>補正予算</b> <br> 予算の補正が必要です。	[sound:s-2628_予算の補正が必要です。.mp3] <br> よさんのほせいがひつようです。 <br>Budget adjustment is necessary.
[sound:s-2628_予算の補正が必要です。.mp3]	<b>補正予算</b> <br> 予算の補正が必要です。<br> よさんのほせいがひつようです <br>Budget adjustment is necessary.
広大	[sound:k-2629_広大.mp3]<br>こうだい <br> huge, very large, vast, extensive, magnificent, grand
huge, very large, vast, extensive, magnificent, grand	<b>広大<b> <br> こうだい <br>[sound:k-2629_広大.mp3]
[sound:k-2629_広大.mp3]	huge, very large, vast, extensive, magnificent, grand<br> <b>広大</b> <br> (こうだい)
<b>補佐</b> <br> 彼は上司の補佐をしています。	[sound:s-2629_彼は上司の補佐をしています。.mp3] <br> かれはじょうしのほさをしています。 <br>He is assisting his boss.
[sound:s-2629_彼は上司の補佐をしています。.mp3]	<b>補佐</b> <br> 彼は上司の補佐をしています。<br> かれはじょうしのほさをしています <br>He is assisting his boss.
内容	[sound:k-2630_内容.mp3]<br>ないよう <br> subject, contents, matter, substance, detail, import
subject, contents, matter, substance, detail, import	<b>内容<b> <br> ないよう <br>[sound:k-2630_内容.mp3]
[sound:k-2630_内容.mp3]	subject, contents, matter, substance, detail, import<br> <b>内容</b> <br> (ないよう)
<b>補給</b> <br> 軍隊は補給物資を運んでいます。	[sound:s-2630_軍隊は補給物資を運んでいます。.mp3] <br> ぐんたいはほきゅうぶっしをはこんでいます。 <br>The army is transporting supplies.
[sound:s-2630_軍隊は補給物資を運んでいます。.mp3]	<b>補給</b> <br> 軍隊は補給物資を運んでいます。<br> ぐんたいはほきゅうぶっしをはこんでいます <br>The army is transporting supplies.
容疑者	[sound:k-2631_容疑者.mp3]<br>ようぎしゃ <br> suspect (person)
suspect (person)	<b>容疑者<b> <br> ようぎしゃ <br>[sound:k-2631_容疑者.mp3]
[sound:k-2631_容疑者.mp3]	suspect<br> <b>person) (容疑者</b> <br> (ようぎしゃ)
<b>補強</b> <br> 家の補強工事が行われました。	[sound:s-2631_家の補強工事が行われました。.mp3] <br> いえのほきょうこうじがおこなわれました。 <br>Reinforcement work on the house was carried out.
[sound:s-2631_家の補強工事が行われました。.mp3]	<b>補強</b> <br> 家の補強工事が行われました。<br> いえのほきょうこうじがおこなわれました <br>Reinforcement work on the house was carried out.
容疑	[sound:k-2632_容疑.mp3]<br>ようぎ <br> suspect, charge
suspect, charge	<b>容疑<b> <br> ようぎ <br>[sound:k-2632_容疑.mp3]
[sound:k-2632_容疑.mp3]	suspect, charge<br> <b>容疑</b> <br> (ようぎ)
<b>補正</b> <br> 彼はテストの補正を行います。	[sound:s-2632_彼はテストの補正を行います。.mp3] <br> かれはてすとのほせいをおこないます。 <br>He conducts corrections on the test.
[sound:s-2632_彼はテストの補正を行います。.mp3]	<b>補正</b> <br> 彼はテストの補正を行います。<br> かれはてすとのほせいをおこないます <br>He conducts corrections on the test.
容易	[sound:k-2633_容易.mp3]<br>ようい <br> easy, simple, plain
easy, simple, plain	<b>容易<b> <br> ようい <br>[sound:k-2633_容易.mp3]
[sound:k-2633_容易.mp3]	easy, simple, plain<br> <b>容易</b> <br> (ようい)
<b>補欠</b> <br> 彼は試合の補欠選手です。	[sound:s-2633_彼は試合の補欠選手です。.mp3] <br> かれはしあいのほけんせんしゅです。 <br>He is a substitute player for the game.
[sound:s-2633_彼は試合の補欠選手です。.mp3]	<b>補欠</b> <br> 彼は試合の補欠選手です。<br> かれはしあいのほけんせんしゅです <br>He is a substitute player for the game.
容認	[sound:k-2634_容認.mp3]<br>ようにん <br> approval
approval	<b>容認<b> <br> ようにん <br>[sound:k-2634_容認.mp3]
[sound:k-2634_容認.mp3]	approval<br> <b>容認</b> <br> (ようにん)
<b>車</b> <br> 彼は新しい車を買いました。	[sound:s-2634_彼は新しい車を買いました。.mp3] <br> かれはあたらしいくるまをかいました。 <br>He bought a new car.
[sound:s-2634_彼は新しい車を買いました。.mp3]	<b>車</b> <br> 彼は新しい車を買いました。<br> かれはあたらしいくるまをかいました <br>He bought a new car.
容器	[sound:k-2635_容器.mp3]<br>ようき <br> container, vessel
container, vessel	<b>容器<b> <br> ようき <br>[sound:k-2635_容器.mp3]
[sound:k-2635_容器.mp3]	container, vessel<br> <b>容器</b> <br> (ようき)
<b>自動車</b> <br> 自動車の安全性が向上しました。	[sound:s-2635_自動車の安全性が向上しました。.mp3] <br> じどうしゃのあんぜんせいがこうじょうしました。 <br>The safety of automobiles has improved.
[sound:s-2635_自動車の安全性が向上しました。.mp3]	<b>自動車</b> <br> 自動車の安全性が向上しました。<br> じどうしゃのあんぜんせいがこうじょうしました <br>The safety of automobiles has improved.
収容	[sound:k-2636_収容.mp3]<br>しゅうよう <br> accommodation, reception, housing; seating; custody; admission; entering (in a dictionary)
accommodation, reception, housing; seating; custody; admission; entering (in a dictionary)	<b>収容<b> <br> しゅうよう <br>[sound:k-2636_収容.mp3]
[sound:k-2636_収容.mp3]	accommodation, reception, housing; seating; custody; admission; entering<br> <b>in a dictionary) (収容</b> <br> (しゅうよう)
<b>下車</b> <br> 次の駅で下車します。	[sound:s-2636_次の駅で下車します。.mp3] <br> つぎのえきでげしゃします。 <br>I will get off at the next station.
[sound:s-2636_次の駅で下車します。.mp3]	<b>下車</b> <br> 次の駅で下車します。<br> つぎのえきでげしゃします <br>I will get off at the next station.
収容所	[sound:k-2637_収容所.mp3]<br>しゅうようじょ <br> home, asylum, camp
home, asylum, camp	<b>収容所<b> <br> しゅうようじょ <br>[sound:k-2637_収容所.mp3]
[sound:k-2637_収容所.mp3]	home, asylum, camp<br> <b>収容所</b> <br> (しゅうようじょ)
<b>乗用車</b> <br> 乗用車を運転するのは楽しいです。	[sound:s-2637_乗用車を運転するのは楽しいです。.mp3] <br> じょうようしゃをうんてんするのはたのしいです。 <br>Driving a passenger car is enjoyable.
[sound:s-2637_乗用車を運転するのは楽しいです。.mp3]	<b>乗用車</b> <br> 乗用車を運転するのは楽しいです。<br> じょうようしゃをうんてんするのはたのしいです <br>Driving a passenger car is enjoyable.
全容	[sound:k-2638_全容.mp3]<br>ぜんよう <br> full portrait, whole aspect, full story
full portrait, whole aspect, full story	<b>全容<b> <br> ぜんよう <br>[sound:k-2638_全容.mp3]
[sound:k-2638_全容.mp3]	full portrait, whole aspect, full story<br> <b>全容</b> <br> (ぜんよう)
<b>自転車</b> <br> 彼は自転車で学校に通っています。	[sound:s-2638_彼は自転車で学校に通っています。.mp3] <br> かれはじてんしゃでがっこうにかよっています。 <br>He commutes to school by bicycle.
[sound:s-2638_彼は自転車で学校に通っています。.mp3]	<b>自転車</b> <br> 彼は自転車で学校に通っています。<br> かれはじてんしゃでがっこうにかよっています <br>He commutes to school by bicycle.
容量	[sound:k-2639_容量.mp3]<br>ようりょう <br> capacity, electrical capacitance
capacity, electrical capacitance	<b>容量<b> <br> ようりょう <br>[sound:k-2639_容量.mp3]
[sound:k-2639_容量.mp3]	capacity, electrical capacitance<br> <b>容量</b> <br> (ようりょう)
<b>車両</b> <br> 電車の車両数が増えました。	[sound:s-2639_電車の車両数が増えました。.mp3] <br> でんしゃのしゃりょうすうがふえました。 <br>The number of train cars has increased.
[sound:s-2639_電車の車両数が増えました。.mp3]	<b>車両</b> <br> 電車の車両数が増えました。<br> でんしゃのしゃりょうすうがふえました <br>The number of train cars has increased.
必ず	[sound:k-2640_必ず.mp3]<br>かならず <br> necessarily, certainly, without fail, positively, invariably
necessarily, certainly, without fail, positively, invariably	<b>必ず<b> <br> かならず <br>[sound:k-2640_必ず.mp3]
[sound:k-2640_必ず.mp3]	necessarily, certainly, without fail, positively, invariably<br> <b>必ず</b> <br> (かならず)
<b>電車</b> <br> 電車が遅れています。	[sound:s-2640_電車が遅れています。.mp3] <br> でんしゃがおくれています。 <br>The train is running late.
[sound:s-2640_電車が遅れています。.mp3]	<b>電車</b> <br> 電車が遅れています。<br> でんしゃがおくれています <br>The train is running late.
必ずしも	[sound:k-2641_必ずしも.mp3]<br>かならずしも <br> (not) always, (not) necessarily, (not) all, (not) entirely
(not) always, (not) necessarily, (not) all, (not) entirely	<b>必ずしも<b> <br> かならずしも <br>[sound:k-2641_必ずしも.mp3]
[sound:k-2641_必ずしも.mp3]	(not) always,<br> <b>not) necessarily, (not) all, (not) entirely (必ずしも</b> <br> (かならずしも)
<b>列車</b> <br> その列車は満員です。	[sound:s-2641_その列車は満員です。.mp3] <br> そのれっしゃはまんいんです。 <br>The train is crowded.
[sound:s-2641_その列車は満員です。.mp3]	<b>列車</b> <br> その列車は満員です。<br> そのれっしゃはまんいんです <br>The train is crowded.
必要	[sound:k-2642_必要.mp3]<br>ひつよう <br> necessary, needed, essential, indispensable; necessity, need, requirement
necessary, needed, essential, indispensable; necessity, need, requirement	<b>必要<b> <br> ひつよう <br>[sound:k-2642_必要.mp3]
[sound:k-2642_必要.mp3]	necessary, needed, essential, indispensable; necessity, need, requirement<br> <b>必要</b> <br> (ひつよう)
<b>駐車場</b> <br> ホテルには無料の駐車場があります。	[sound:s-2642_ホテルには無料の駐車場があります。.mp3] <br> ほてるにはむりょうのちゅうしゃじょうがあります。 <br>The hotel has a free parking lot.
[sound:s-2642_ホテルには無料の駐車場があります。.mp3]	<b>駐車場</b> <br> ホテルには無料の駐車場があります。<br> ほてるにはむりょうのちゅうしゃじょうがあります <br>The hotel has a free parking lot.
必要性	[sound:k-2643_必要性.mp3]<br>ひつようせい <br> necessity
necessity	<b>必要性<b> <br> ひつようせい <br>[sound:k-2643_必要性.mp3]
[sound:k-2643_必要性.mp3]	necessity<br> <b>必要性</b> <br> (ひつようせい)
<b>戦車</b> <br> 戦車が戦場に展開されました。	[sound:s-2643_戦車が戦場に展開されました。.mp3] <br> せんしゃがせんじょうにてんかいされました。 <br>Tanks were deployed to the battlefield.
[sound:s-2643_戦車が戦場に展開されました。.mp3]	<b>戦車</b> <br> 戦車が戦場に展開されました。<br> せんしゃがせんじょうにてんかいされました <br>Tanks were deployed to the battlefield.
必死	[sound:k-2644_必死.mp3]<br>ひっし <br> frantic, desperate; inevitable death; brinkmate (inevitable checkmate) (shogi)
frantic, desperate; inevitable death; brinkmate (inevitable checkmate) (shogi)	<b>必死<b> <br> ひっし <br>[sound:k-2644_必死.mp3]
[sound:k-2644_必死.mp3]	frantic, desperate; inevitable death; brinkmate<br> <b>inevitable checkmate) (shogi) (必死</b> <br> (ひっし)
<b>優勝</b> <br> 彼はテニスの大会で優勝しました。	[sound:s-2644_彼はテニスの大会で優勝しました。.mp3] <br> かれはてにすのたいかいでゆうしょうしました。 <br>He won the tennis tournament.
[sound:s-2644_彼はテニスの大会で優勝しました。.mp3]	<b>優勝</b> <br> 彼はテニスの大会で優勝しました。<br> かれはてにすのたいかいでゆうしょうしました <br>He won the tennis tournament.
必着	[sound:k-2645_必着.mp3]<br>ひっちゃく <br> must arrive, must be received
must arrive, must be received	<b>必着<b> <br> ひっちゃく <br>[sound:k-2645_必着.mp3]
[sound:k-2645_必着.mp3]	must arrive, must be received<br> <b>必着</b> <br> (ひっちゃく)
<b>俳優</b> <br> 彼は有名な俳優です。	[sound:s-2645_彼は有名な俳優です。.mp3] <br> かれはゆうめいなはいゆうです。 <br>He is a famous actor.
[sound:s-2645_彼は有名な俳優です。.mp3]	<b>俳優</b> <br> 彼は有名な俳優です。<br> かれはゆうめいなはいゆうです <br>He is a famous actor.
必需	[sound:k-2646_必需.mp3]<br>ひつじゅ <br> necessary
necessary	<b>必需<b> <br> ひつじゅ <br>[sound:k-2646_必需.mp3]
[sound:k-2646_必需.mp3]	necessary<br> <b>必需</b> <br> (ひつじゅ)
<b>優先</b> <br> 安全を優先しなければなりません。	[sound:s-2646_安全を優先しなければなりません。.mp3] <br> あんぜんをゆうせんしなければなりません。 <br>Safety must be given priority.
[sound:s-2646_安全を優先しなければなりません。.mp3]	<b>優先</b> <br> 安全を優先しなければなりません。<br> あんぜんをゆうせんしなければなりません <br>Safety must be given priority.
不必要	[sound:k-2647_不必要.mp3]<br>ふひつよう <br> unnecessary, undesired
unnecessary, undesired	<b>不必要<b> <br> ふひつよう <br>[sound:k-2647_不必要.mp3]
[sound:k-2647_不必要.mp3]	unnecessary, undesired<br> <b>不必要</b> <br> (ふひつよう)
<b>女優</b> <br> 彼女は優れた女優です。	[sound:s-2647_彼女は優れた女優です。.mp3] <br> かのじょはすぐれたじょゆうです。 <br>She is an excellent actress.
[sound:s-2647_彼女は優れた女優です。.mp3]	<b>女優</b> <br> 彼女は優れた女優です。<br> かのじょはすぐれたじょゆうです <br>She is an excellent actress.
必勝	[sound:k-2648_必勝.mp3]<br>ひっしょう <br> certain victory
certain victory	<b>必勝<b> <br> ひっしょう <br>[sound:k-2648_必勝.mp3]
[sound:k-2648_必勝.mp3]	certain victory<br> <b>必勝</b> <br> (ひっしょう)
<b>優秀</b> <br> 彼は優秀な成績を収めました。	[sound:s-2648_彼は優秀な成績を収めました。.mp3] <br> かれはゆうしゅうなせいせきをおさめました。 <br>He achieved excellent grades.
[sound:s-2648_彼は優秀な成績を収めました。.mp3]	<b>優秀</b> <br> 彼は優秀な成績を収めました。<br> かれはゆうしゅうなせいせきをおさめました <br>He achieved excellent grades.
必然的	[sound:k-2649_必然的.mp3]<br>ひつぜんてき <br> inevitable, necessary
inevitable, necessary	<b>必然的<b> <br> ひつぜんてき <br>[sound:k-2649_必然的.mp3]
[sound:k-2649_必然的.mp3]	inevitable, necessary<br> <b>必然的</b> <br> (ひつぜんてき)
<b>優遇</b> <br> その会社は新入社員を優遇します。	[sound:s-2649_その会社は新入社員を優遇します。.mp3] <br> そのかいしゃはしんにゅうしゃいんをゆうぐうします。 <br>The company gives preferential treatment to new employees.
[sound:s-2649_その会社は新入社員を優遇します。.mp3]	<b>優遇</b> <br> その会社は新入社員を優遇します。<br> そのかいしゃはしんにゅうしゃいんをゆうぐうします <br>The company gives preferential treatment to new employees.
応じる	[sound:k-2650_応じる.mp3]<br>おうじる <br> to respond, to satisfy, to accept, to comply with, to apply for
to respond, to satisfy, to accept, to comply with, to apply for	<b>応じる<b> <br> おうじる <br>[sound:k-2650_応じる.mp3]
[sound:k-2650_応じる.mp3]	to respond, to satisfy, to accept, to comply with, to apply for<br> <b>応じる</b> <br> (おうじる)
<b>優しい</b> <br> 彼は優しい笑顔で迎えてくれました。	[sound:s-2650_彼は優しい笑顔で迎えてくれました。.mp3] <br> かれはやさしいえがおでむかえてくれました。 <br>He welcomed me with a gentle smile.
[sound:s-2650_彼は優しい笑顔で迎えてくれました。.mp3]	<b>優しい</b> <br> 彼は優しい笑顔で迎えてくれました。<br> かれはやさしいえがおでむかえてくれました <br>He welcomed me with a gentle smile.
対応	[sound:k-2651_対応.mp3]<br>たいおう <br> interaction, correspondence, coping with, dealing with, support
interaction, correspondence, coping with, dealing with, support	<b>対応<b> <br> たいおう <br>[sound:k-2651_対応.mp3]
[sound:k-2651_対応.mp3]	interaction, correspondence, coping with, dealing with, support<br> <b>対応</b> <br> (たいおう)
<b>優位</b> <br> その企業は市場で優位を保っています。	[sound:s-2651_その企業は市場で優位を保っています。.mp3] <br> そのきぎょうはしじょうでゆういをたもっています。 <br>The company maintains a dominant position in the market.
[sound:s-2651_その企業は市場で優位を保っています。.mp3]	<b>優位</b> <br> その企業は市場で優位を保っています。<br> そのきぎょうはしじょうでゆういをたもっています <br>The company maintains a dominant position in the market.
応える	[sound:k-2652_応える.mp3]<br>こたえる <br> to respond, to live up to, to reward; to take its toll, to strike home
to respond, to live up to, to reward; to take its toll, to strike home	<b>応える<b> <br> こたえる <br>[sound:k-2652_応える.mp3]
[sound:k-2652_応える.mp3]	to respond, to live up to, to reward; to take its toll, to strike home<br> <b>応える</b> <br> (こたえる)
<b>優良</b> <br> この製品は優良な品質を持っています。	[sound:s-2652_この製品は優良な品質を持っています。.mp3] <br> このせいひんはゆうりょうなひんしつをもっています。 <br>This product has excellent quality.
[sound:s-2652_この製品は優良な品質を持っています。.mp3]	<b>優良</b> <br> この製品は優良な品質を持っています。<br> このせいひんはゆうりょうなひんしつをもっています <br>This product has excellent quality.
応援	[sound:k-2653_応援.mp3]<br>おうえん <br> aid, assistance, help, reinforcement, rooting, barracking, support, cheering
aid, assistance, help, reinforcement, rooting, barracking, support, cheering	<b>応援<b> <br> おうえん <br>[sound:k-2653_応援.mp3]
[sound:k-2653_応援.mp3]	aid, assistance, help, reinforcement, rooting, barracking, support, cheering<br> <b>応援</b> <br> (おうえん)
<b>優勢</b> <br> 彼は試合で優勢です。	[sound:s-2653_彼は試合で優勢です。.mp3] <br> かれはしあいでゆうせいです。 <br>He is dominant in the game.
[sound:s-2653_彼は試合で優勢です。.mp3]	<b>優勢</b> <br> 彼は試合で優勢です。<br> かれはしあいでゆうせいです <br>He is dominant in the game.
応募	[sound:k-2654_応募.mp3]<br>おうぼ <br> subscription, application
subscription, application	<b>応募<b> <br> おうぼ <br>[sound:k-2654_応募.mp3]
[sound:k-2654_応募.mp3]	subscription, application<br> <b>応募</b> <br> (おうぼ)
<b>夫</b> <br> 私の夫は医者です。	[sound:s-2654_私の夫は医者です。.mp3] <br> わたしのおっとはいしゃです。 <br>My husband is a doctor.
[sound:s-2654_私の夫は医者です。.mp3]	<b>夫</b> <br> 私の夫は医者です。<br> わたしのおっとはいしゃです <br>My husband is a doctor.
反応	[sound:k-2655_反応.mp3]<br>はんのう <br> reaction, response
reaction, response	<b>反応<b> <br> はんのう <br>[sound:k-2655_反応.mp3]
[sound:k-2655_反応.mp3]	reaction, response<br> <b>反応</b> <br> (はんのう)
<b>夫人</b> <br> 夫人は華やかなドレスを着ています。	[sound:s-2655_夫人は華やかなドレスを着ています。.mp3] <br> ふじんははなやかなどれすをきています。 <br>The lady is wearing a glamorous dress.
[sound:s-2655_夫人は華やかなドレスを着ています。.mp3]	<b>夫人</b> <br> 夫人は華やかなドレスを着ています。<br> ふじんははなやかなどれすをきています <br>The lady is wearing a glamorous dress.
一応	[sound:k-2656_一応.mp3]<br>いちおう <br> once, tentatively, in outline, for the time being, just in case
once, tentatively, in outline, for the time being, just in case	<b>一応<b> <br> いちおう <br>[sound:k-2656_一応.mp3]
[sound:k-2656_一応.mp3]	once, tentatively, in outline, for the time being, just in case<br> <b>一応</b> <br> (いちおう)
<b>夫婦</b> <br> 彼らは仲の良い夫婦です。	[sound:s-2656_彼らは仲の良い夫婦です。.mp3] <br> かれらはなかのいいふうふです。 <br>They are a happily married couple.
[sound:s-2656_彼らは仲の良い夫婦です。.mp3]	<b>夫婦</b> <br> 彼らは仲の良い夫婦です。<br> かれらはなかのいいふうふです <br>They are a happily married couple.
応用	[sound:k-2657_応用.mp3]<br>おうよう <br> application, put to practical use
application, put to practical use	<b>応用<b> <br> おうよう <br>[sound:k-2657_応用.mp3]
[sound:k-2657_応用.mp3]	application, put to practical use<br> <b>応用</b> <br> (おうよう)
<b>夫妻</b> <br> 彼らは夫妻で一緒に旅行しています。	[sound:s-2657_彼らは夫妻で一緒に旅行しています。.mp3] <br> かれらはふさいでいっしょにりょこうしています。 <br>They are traveling together as a married couple.
[sound:s-2657_彼らは夫妻で一緒に旅行しています。.mp3]	<b>夫妻</b> <br> 彼らは夫妻で一緒に旅行しています。<br> かれらはふさいでいっしょにりょこうしています <br>They are traveling together as a married couple.
適応	[sound:k-2658_適応.mp3]<br>てきおう <br> adaptation, accommodation, conformity
adaptation, accommodation, conformity	<b>適応<b> <br> てきおう <br>[sound:k-2658_適応.mp3]
[sound:k-2658_適応.mp3]	adaptation, accommodation, conformity<br> <b>適応</b> <br> (てきおう)
<b>工夫</b> <br> 彼は料理に工夫を凝らします。	[sound:s-2658_彼は料理に工夫を凝らします。.mp3] <br> かれはりょうりにくふうをこらします。 <br>He puts effort into cooking.
[sound:s-2658_彼は料理に工夫を凝らします。.mp3]	<b>工夫</b> <br> 彼は料理に工夫を凝らします。<br> かれはりょうりにくふうをこらします <br>He puts effort into cooking.
応答	[sound:k-2659_応答.mp3]<br>おうとう <br> reply, answer, response
reply, answer, response	<b>応答<b> <br> おうとう <br>[sound:k-2659_応答.mp3]
[sound:k-2659_応答.mp3]	reply, answer, response<br> <b>応答</b> <br> (おうとう)
<b>大丈夫</b> <br> 彼は大丈夫だと言いました。	[sound:s-2659_彼は大丈夫だと言いました。.mp3] <br> かれはだいじょうぶだといいました。 <br>He said he's okay.
[sound:s-2659_彼は大丈夫だと言いました。.mp3]	<b>大丈夫</b> <br> 彼は大丈夫だと言いました。<br> かれはだいじょうぶだといいました <br>He said he's okay.
演説	[sound:k-2660_演説.mp3]<br>えんぜつ <br> speech, address
speech, address	<b>演説<b> <br> えんぜつ <br>[sound:k-2660_演説.mp3]
[sound:k-2660_演説.mp3]	speech, address<br> <b>演説</b> <br> (えんぜつ)
<b>丈夫</b> <br> 彼は丈夫な体をしています。	[sound:s-2660_彼は丈夫な体をしています。.mp3] <br> かれはじょうぶなからだをしています。 <br>He has a strong body.
[sound:s-2660_彼は丈夫な体をしています。.mp3]	<b>丈夫</b> <br> 彼は丈夫な体をしています。<br> かれはじょうぶなからだをしています <br>He has a strong body.
公演	[sound:k-2661_公演.mp3]<br>こうえん <br> public performance; sumo exhibition in a foreign country
public performance; sumo exhibition in a foreign country	<b>公演<b> <br> こうえん <br>[sound:k-2661_公演.mp3]
[sound:k-2661_公演.mp3]	public performance; sumo exhibition in a foreign country<br> <b>公演</b> <br> (こうえん)
<b>義太夫</b> <br> 義太夫は伝統的な日本の芸能です。	[sound:s-2661_義太夫は伝統的な日本の芸能です。.mp3] <br> ぎだゆうはでんとうてきなにほんのげいのうです。 <br>Gidayu is a traditional Japanese performing art.
[sound:s-2661_義太夫は伝統的な日本の芸能です。.mp3]	<b>義太夫</b> <br> 義太夫は伝統的な日本の芸能です。<br> ぎだゆうはでんとうてきなにほんのげいのうです <br>Gidayu is a traditional Japanese performing art.
講演	[sound:k-2662_講演.mp3]<br>こうえん <br> lecture, address, speech
lecture, address, speech	<b>講演<b> <br> こうえん <br>[sound:k-2662_講演.mp3]
[sound:k-2662_講演.mp3]	lecture, address, speech<br> <b>講演</b> <br> (こうえん)
<b>老夫婦</b> <br> あの老夫婦はとても仲良しです。	[sound:s-2662_あの老夫婦はとても仲良しです。.mp3] <br> あのろうふうふはとてもなかよしです。 <br>That elderly couple is very close.
[sound:s-2662_あの老夫婦はとても仲良しです。.mp3]	<b>老夫婦</b> <br> あの老夫婦はとても仲良しです。<br> あのろうふうふはとてもなかよしです <br>That elderly couple is very close.
演出	[sound:k-2663_演出.mp3]<br>えんしゅつ <br> production (e.g. play), direction
production (e.g. play), direction	<b>演出<b> <br> えんしゅつ <br>[sound:k-2663_演出.mp3]
[sound:k-2663_演出.mp3]	production<br> <b>e.g. play), direction (演出</b> <br> (えんしゅつ)
<b>亡夫</b> <br> 彼女は亡き夫を想いながら生活しています。	[sound:s-2663_彼女は亡き夫を想いながら生活しています。.mp3] <br> かのじょはなきおっとをおもいながらせいかつしています。 <br>She lives while remembering her late husband.
[sound:s-2663_彼女は亡き夫を想いながら生活しています。.mp3]	<b>亡夫</b> <br> 彼女は亡き夫を想いながら生活しています。<br> かのじょはなきおっとをおもいながらせいかつしています <br>She lives while remembering her late husband.
出演	[sound:k-2664_出演.mp3]<br>しゅつえん <br> performance, stage appearance; to act (in a play)
performance, stage appearance; to act (in a play)	<b>出演<b> <br> しゅつえん <br>[sound:k-2664_出演.mp3]
[sound:k-2664_出演.mp3]	performance, stage appearance; to act<br> <b>in a play) (出演</b> <br> (しゅつえん)
<b>研究</b> <br> 私は心理学の研究をしています。	[sound:s-2664_私は心理学の研究をしています。.mp3] <br> わたしはしんりがくのけんきゅうをしています。 <br>I am conducting research in psychology.
[sound:s-2664_私は心理学の研究をしています。.mp3]	<b>研究</b> <br> 私は心理学の研究をしています。<br> わたしはしんりがくのけんきゅうをしています <br>I am conducting research in psychology.
演奏	[sound:k-2665_演奏.mp3]<br>えんそう <br> musical performance
musical performance	<b>演奏<b> <br> えんそう <br>[sound:k-2665_演奏.mp3]
[sound:k-2665_演奏.mp3]	musical performance<br> <b>演奏</b> <br> (えんそう)
<b>研究所</b> <br> この研究所は新しい技術を開発しています。	[sound:s-2665_この研究所は新しい技術を開発しています。.mp3] <br> このけんきゅうしょはあたらしいぎじゅつをかいはつしています。 <br>This research institute is developing new technologies.
[sound:s-2665_この研究所は新しい技術を開発しています。.mp3]	<b>研究所</b> <br> この研究所は新しい技術を開発しています。<br> このけんきゅうしょはあたらしいぎじゅつをかいはつしています <br>This research institute is developing new technologies.
演劇	[sound:k-2666_演劇.mp3]<br>えんげき <br> play (theatrical)
play (theatrical)	<b>演劇<b> <br> えんげき <br>[sound:k-2666_演劇.mp3]
[sound:k-2666_演劇.mp3]	play<br> <b>theatrical) (演劇</b> <br> (えんげき)
<b>研修</b> <br> 入社したばかりの社員は研修を受けます。	[sound:s-2666_入社したばかりの社員は研修を受けます。.mp3] <br> にゅうしゃしたばかりのしゃいんはけんしゅうをうけます。 <br>Newly hired employees undergo training.
[sound:s-2666_入社したばかりの社員は研修を受けます。.mp3]	<b>研修</b> <br> 入社したばかりの社員は研修を受けます。<br> にゅうしゃしたばかりのしゃいんはけんしゅうをうけます <br>Newly hired employees undergo training.
演技	[sound:k-2667_演技.mp3]<br>えんぎ <br> acting, performance
acting, performance	<b>演技<b> <br> えんぎ <br>[sound:k-2667_演技.mp3]
[sound:k-2667_演技.mp3]	acting, performance<br> <b>演技</b> <br> (えんぎ)
<b>研究者</b> <br> 彼は優秀な研究者です。	[sound:s-2667_彼は優秀な研究者です。.mp3] <br> かれはゆうしゅうなけんきゅうしゃです。 <br>He is an excellent researcher.
[sound:s-2667_彼は優秀な研究者です。.mp3]	<b>研究者</b> <br> 彼は優秀な研究者です。<br> かれはゆうしゅうなけんきゅうしゃです <br>He is an excellent researcher.
演習	[sound:k-2668_演習.mp3]<br>えんしゅう <br> practice, practise, exercises, manoeuvres, maneuvers, practicum
practice, practise, exercises, manoeuvres, maneuvers, practicum	<b>演習<b> <br> えんしゅう <br>[sound:k-2668_演習.mp3]
[sound:k-2668_演習.mp3]	practice, practise, exercises, manoeuvres, maneuvers, practicum<br> <b>演習</b> <br> (えんしゅう)
<b>研究員</b> <br> この研究所には多くの研究員がいます。	[sound:s-2668_この研究所には多くの研究員がいます。.mp3] <br> このけんきゅうしょにはおおくのけんきゅういんがいます。 <br>There are many researchers at this research institute.
[sound:s-2668_この研究所には多くの研究員がいます。.mp3]	<b>研究員</b> <br> この研究所には多くの研究員がいます。<br> このけんきゅうしょにはおおくのけんきゅういんがいます <br>There are many researchers at this research institute.
主演	[sound:k-2669_主演.mp3]<br>しゅえん <br> starring, playing the leading part
starring, playing the leading part	<b>主演<b> <br> しゅえん <br>[sound:k-2669_主演.mp3]
[sound:k-2669_主演.mp3]	starring, playing the leading part<br> <b>主演</b> <br> (しゅえん)
<b>保護</b> <br> この動物園は動物たちの保護を重視しています。	[sound:s-2669_この動物園は動物たちの保護を重視しています。.mp3] <br> このどうぶつえんはどうぶつたちのほごをじゅうししています。 <br>This zoo prioritizes the protection of animals.
[sound:s-2669_この動物園は動物たちの保護を重視しています。.mp3]	<b>保護</b> <br> この動物園は動物たちの保護を重視しています。<br> このどうぶつえんはどうぶつたちのほごをじゅうししています <br>This zoo prioritizes the protection of animals.
電話	[sound:k-2670_電話.mp3]<br>でんわ <br> telephone
telephone	<b>電話<b> <br> でんわ <br>[sound:k-2670_電話.mp3]
[sound:k-2670_電話.mp3]	telephone<br> <b>電話</b> <br> (でんわ)
<b>弁護士</b> <br> 弁護士は被告人を代表して法廷で弁護します。	[sound:s-2670_弁護士は被告人を代表して法廷で弁護します。.mp3] <br> べんごしはひこくにんをだいひょうしてほうていでべんごします。 <br>The lawyer defends the defendant in court.
[sound:s-2670_弁護士は被告人を代表して法廷で弁護します。.mp3]	<b>弁護士</b> <br> 弁護士は被告人を代表して法廷で弁護します。<br> べんごしはひこくにんをだいひょうしてほうていでべんごします <br>The lawyer defends the defendant in court.
電気	[sound:k-2671_電気.mp3]<br>でんき <br> electricity; (electric) light
electricity; (electric) light	<b>電気<b> <br> でんき <br>[sound:k-2671_電気.mp3]
[sound:k-2671_電気.mp3]	electricity;<br> <b>electric) light (電気</b> <br> (でんき)
<b>看護婦</b> <br> その看護婦は患者たちの世話をとても丁寧にしています。	[sound:s-2671_その看護婦は患者たちの世話をとても丁寧にしています。.mp3] <br> そのかんごふはかんじゃたちのせわをとてもていねいにしています。 <br>The nurse takes care of the patients very attentively.
[sound:s-2671_その看護婦は患者たちの世話をとても丁寧にしています。.mp3]	<b>看護婦</b> <br> その看護婦は患者たちの世話をとても丁寧にしています。<br> そのかんごふはかんじゃたちのせわをとてもていねいにしています <br>The nurse takes care of the patients very attentively.
電力	[sound:k-2672_電力.mp3]<br>でんりょく <br> electric power
electric power	<b>電力<b> <br> でんりょく <br>[sound:k-2672_電力.mp3]
[sound:k-2672_電力.mp3]	electric power<br> <b>電力</b> <br> (でんりょく)
<b>介護</b> <br> 私は祖父の介護をしています。	[sound:s-2672_私は祖父の介護をしています。.mp3] <br> わたしはそふのかいごをしています。 <br>I am taking care of my grandfather.
[sound:s-2672_私は祖父の介護をしています。.mp3]	<b>介護</b> <br> 私は祖父の介護をしています。<br> わたしはそふのかいごをしています <br>I am taking care of my grandfather.
電子	[sound:k-2673_電子.mp3]<br>でんし <br> electron; (esp. as a prefix) electronic, electronics
electron; (esp. as a prefix) electronic, electronics	<b>電子<b> <br> でんし <br>[sound:k-2673_電子.mp3]
[sound:k-2673_電子.mp3]	electron;<br> <b>esp. as a prefix) electronic, electronics (電子</b> <br> (でんし)
<b>看護</b> <br> 看護師は病院で患者の健康を見守ります。	[sound:s-2673_看護師は病院で患者の健康を見守ります。.mp3] <br> かんごしはびょういんでかんじゃのけんこうをみまもります。 <br>Nurses watch over the health of patients at the hospital.
[sound:s-2673_看護師は病院で患者の健康を見守ります。.mp3]	<b>看護</b> <br> 看護師は病院で患者の健康を見守ります。<br> かんごしはびょういんでかんじゃのけんこうをみまもります <br>Nurses watch over the health of patients at the hospital.
電車	[sound:k-2674_電車.mp3]<br>でんしゃ <br> (electric) train
(electric) train	<b>電車<b> <br> でんしゃ <br>[sound:k-2674_電車.mp3]
[sound:k-2674_電車.mp3]	(electric) train<br> <b>電車</b> <br> (でんしゃ)
<b>弁護</b> <br> 弁護士はクライアントの権利を弁護する責任があります。	[sound:s-2674_弁護士はクライアントの権利を弁護する責任があります。.mp3] <br> べんごしはくらいあんとのけんりをべんごするせきにんがあります。 <br>Lawyers have a responsibility to defend the rights of their clients.
[sound:s-2674_弁護士はクライアントの権利を弁護する責任があります。.mp3]	<b>弁護</b> <br> 弁護士はクライアントの権利を弁護する責任があります。<br> べんごしはくらいあんとのけんりをべんごするせきにんがあります <br>Lawyers have a responsibility to defend the rights of their clients.
家電	[sound:k-2675_家電.mp3]<br>かでん <br> consumer electronics
consumer electronics	<b>家電<b> <br> かでん <br>[sound:k-2675_家電.mp3]
[sound:k-2675_家電.mp3]	consumer electronics<br> <b>家電</b> <br> (かでん)
<b>護憲</b> <br> 彼は憲法を護るために尽力しています。	[sound:s-2675_彼は憲法を護るために尽力しています。.mp3] <br> かれはけんぽうをまもるためにじんりょくしています。 <br>He is making every effort to protect the constitution.
[sound:s-2675_彼は憲法を護るために尽力しています。.mp3]	<b>護憲</b> <br> 彼は憲法を護るために尽力しています。<br> かれはけんぽうをまもるためにじんりょくしています <br>He is making every effort to protect the constitution.
電機	[sound:k-2676_電機.mp3]<br>でんき <br> electrical machinery, appliances
electrical machinery, appliances	<b>電機<b> <br> でんき <br>[sound:k-2676_電機.mp3]
[sound:k-2676_電機.mp3]	electrical machinery, appliances<br> <b>電機</b> <br> (でんき)
<b>防護</b> <br> この服は紫外線から肌を防護してくれます。	[sound:s-2676_この服は紫外線から肌を防護してくれます。.mp3] <br> このふくはしがいせんからはだをぼうごしてくれます。 <br>This clothing protects the skin from ultraviolet rays.
[sound:s-2676_この服は紫外線から肌を防護してくれます。.mp3]	<b>防護</b> <br> この服は紫外線から肌を防護してくれます。<br> このふくはしがいせんからはだをぼうごしてくれます <br>This clothing protects the skin from ultraviolet rays.
電波	[sound:k-2677_電波.mp3]<br>でんぱ <br> electro-magnetic wave, radio wave; nonsense
electro-magnetic wave, radio wave; nonsense	<b>電波<b> <br> でんぱ <br>[sound:k-2677_電波.mp3]
[sound:k-2677_電波.mp3]	electro-magnetic wave, radio wave; nonsense<br> <b>電波</b> <br> (でんぱ)
<b>援護</b> <br> その団体は地域の子供たちを援護する活動を行っています。	[sound:s-2677_その団体は地域の子供たちを援護する活動を行っています。.mp3] <br> そのだんたいはちいきのこどもたちをえんごするかつどうをおこなっています。 <br>The organization is conducting activities to support the children in the community.
[sound:s-2677_その団体は地域の子供たちを援護する活動を行っています。.mp3]	<b>援護</b> <br> その団体は地域の子供たちを援護する活動を行っています。<br> そのだんたいはちいきのこどもたちをえんごするかつどうをおこなっています <br>The organization is conducting activities to support the children in the community.
発電	[sound:k-2678_発電.mp3]<br>はつでん <br> generation (e.g. power)
generation (e.g. power)	<b>発電<b> <br> はつでん <br>[sound:k-2678_発電.mp3]
[sound:k-2678_発電.mp3]	generation<br> <b>e.g. power) (発電</b> <br> (はつでん)
<b>擁護</b> <br> 彼は友人を擁護するために立ち上がった。	[sound:s-2678_彼は友人を擁護するために立ち上がった。.mp3] <br> かれはゆうじんをようごするためにたちあがった。 <br>He stood up to defend his friend.
[sound:s-2678_彼は友人を擁護するために立ち上がった。.mp3]	<b>擁護</b> <br> 彼は友人を擁護するために立ち上がった。<br> かれはゆうじんをようごするためにたちあがった <br>He stood up to defend his friend.
発電所	[sound:k-2679_発電所.mp3]<br>はつでんしょ <br> power plant, power station
power plant, power station	<b>発電所<b> <br> はつでんしょ <br>[sound:k-2679_発電所.mp3]
[sound:k-2679_発電所.mp3]	power plant, power station<br> <b>発電所</b> <br> (はつでんしょ)
<b>展開</b> <br> その企業は新しい市場への展開を計画しています。	[sound:s-2679_その企業は新しい市場への展開を計画しています。.mp3] <br> そのきぎょうはあたらしいしじょうへのてんかいをけいかくしています。 <br>The company is planning to expand into new markets.
[sound:s-2679_その企業は新しい市場への展開を計画しています。.mp3]	<b>展開</b> <br> その企業は新しい市場への展開を計画しています。<br> そのきぎょうはあたらしいしじょうへのてんかいをけいかくしています <br>The company is planning to expand into new markets.
歳出	[sound:k-2680_歳出.mp3]<br>さいしゅつ <br> annual expenditure
annual expenditure	<b>歳出<b> <br> さいしゅつ <br>[sound:k-2680_歳出.mp3]
[sound:k-2680_歳出.mp3]	annual expenditure<br> <b>歳出</b> <br> (さいしゅつ)
<b>発展</b> <br> 教育は個人の能力の発展を支援することが重要です。	[sound:s-2680_教育は個人の能力の発展を支援することが重要です。.mp3] <br> きょういくはこじんののうりょくのはってんをしえんすることがじゅうようです。 <br>Education is important for supporting the development of individual abilities.
[sound:s-2680_教育は個人の能力の発展を支援することが重要です。.mp3]	<b>発展</b> <br> 教育は個人の能力の発展を支援することが重要です。<br> きょういくはこじんののうりょくのはってんをしえんすることがじゅうようです <br>Education is important for supporting the development of individual abilities.
歳入	[sound:k-2681_歳入.mp3]<br>さいにゅう <br> annual revenue or income
annual revenue or income	<b>歳入<b> <br> さいにゅう <br>[sound:k-2681_歳入.mp3]
[sound:k-2681_歳入.mp3]	annual revenue or income<br> <b>歳入</b> <br> (さいにゅう)
<b>進展</b> <br> このプロジェクトは予想よりも速い進展を遂げています。	[sound:s-2681_このプロジェクトは予想よりも速い進展を遂げています。.mp3] <br> このぷろじぇくとはよそうよりもはやいしんてんをとげています。 <br>This project is making faster progress than expected.
[sound:s-2681_このプロジェクトは予想よりも速い進展を遂げています。.mp3]	<b>進展</b> <br> このプロジェクトは予想よりも速い進展を遂げています。<br> このぷろじぇくとはよそうよりもはやいしんてんをとげています <br>This project is making faster progress than expected.
歳	[sound:k-2682_歳.mp3]<br>さい <br> -years-old; ability, gift, talent, aptitude, genius
-years-old; ability, gift, talent, aptitude, genius	<b>歳<b> <br> さい <br>[sound:k-2682_歳.mp3]
[sound:k-2682_歳.mp3]	-years-old; ability, gift, talent, aptitude, genius<br> <b>歳</b> <br> (さい)
<b>展示</b> <br> 美術館では有名な画家の作品が展示されています。	[sound:s-2682_美術館では有名な画家の作品が展示されています。.mp3] <br> びじゅつかんではゆうめいながかのさくひんがてんじされています。 <br>The museum is exhibiting works by famous painters.
[sound:s-2682_美術館では有名な画家の作品が展示されています。.mp3]	<b>展示</b> <br> 美術館では有名な画家の作品が展示されています。<br> びじゅつかんではゆうめいながかのさくひんがてんじされています <br>The museum is exhibiting works by famous painters.
歳月	[sound:k-2683_歳月.mp3]<br>さいげつ, としつき <br> time, years
time, years	<b>歳月<b> <br> さいげつ, としつき <br>[sound:k-2683_歳月.mp3]
[sound:k-2683_歳月.mp3]	time, years<br> <b>歳月</b> <br> (さいげつ, としつき)
<b>展望</b> <br> 彼は将来の展望について楽観的です。	[sound:s-2683_彼は将来の展望について楽観的です。.mp3] <br> かれはしょうらいのてんぼうについてらっかんてきです。 <br>He is optimistic about the prospects for the future.
[sound:s-2683_彼は将来の展望について楽観的です。.mp3]	<b>展望</b> <br> 彼は将来の展望について楽観的です。<br> かれはしょうらいのてんぼうについてらっかんてきです <br>He is optimistic about the prospects for the future.
千歳	[sound:k-2684_千歳.mp3]<br>ちとせ, せんねん <br> millennium, one thousand years
millennium, one thousand years	<b>千歳<b> <br> ちとせ, せんねん <br>[sound:k-2684_千歳.mp3]
[sound:k-2684_千歳.mp3]	millennium, one thousand years<br> <b>千歳</b> <br> (ちとせ, せんねん)
<b>展覧会</b> <br> 今週末、地元のアーティストたちによる展覧会が開催されます。	[sound:s-2684_今週末、地元のアーティストたちによる展覧会が開催されます。.mp3] <br> こんしゅうまつ、じもとのあーてぃすとたちによるてんらんかいがかいさいされます。 <br>A local art exhibition by artists will be held this weekend.
[sound:s-2684_今週末、地元のアーティストたちによる展覧会が開催されます。.mp3]	<b>展覧会</b> <br> 今週末、地元のアーティストたちによる展覧会が開催されます。<br> こんしゅうまつ、じもとのあーてぃすとたちによるてんらんかいがかいさいされます <br>A local art exhibition by artists will be held this weekend.
歳暮	[sound:k-2685_歳暮.mp3]<br>せいぼ <br> end of the year, year-end gift
end of the year, year-end gift	<b>歳暮<b> <br> せいぼ <br>[sound:k-2685_歳暮.mp3]
[sound:k-2685_歳暮.mp3]	end of the year, year-end gift<br> <b>歳暮</b> <br> (せいぼ)
<b>個展</b> <br> その画家は最近個展を開催しました。	[sound:s-2685_その画家は最近個展を開催しました。.mp3] <br> そのがかはさいきんこてんをかいさいしました。 <br>The painter recently held a solo exhibition.
[sound:s-2685_その画家は最近個展を開催しました。.mp3]	<b>個展</b> <br> その画家は最近個展を開催しました。<br> そのがかはさいきんこてんをかいさいしました <br>The painter recently held a solo exhibition.
万歳	[sound:k-2686_万歳.mp3]<br>ばんざい, ばんぜい <br> crying "banzai" (or raising one's hands in the banzai gesture); something worthy of celebration; giving up; long time; eternal life (and prosperity); banzai (a celebratory cheer), hurrah (hooray, hurray)
crying "banzai" (or raising one's hands in the banzai gesture); something worthy of celebration; giving up; long time; eternal life (and prosperity); banzai (a celebratory cheer), hurrah (hooray, hurray)	<b>万歳<b> <br> ばんざい, ばんぜい <br>[sound:k-2686_万歳.mp3]
[sound:k-2686_万歳.mp3]	crying "banzai"<br> <b>or raising one's hands in the banzai gesture); something worthy of celebration; giving up; long time; eternal life (and prosperity); banzai (a celebratory cheer), hurrah (hooray, hurray) (万歳</b> <br> (ばんざい, ばんぜい)
<b>展示会</b> <br> この地域では毎年、農産物の展示会が開かれます。	[sound:s-2686_この地域では毎年、農産物の展示会が開かれます。.mp3] <br> このちいきではまいとし、のうさんぶつのてんじかいがひらかれます。 <br>"In this area, an agricultural exhibition is held every year."
[sound:s-2686_この地域では毎年、農産物の展示会が開かれます。.mp3]	<b>展示会</b> <br> この地域では毎年、農産物の展示会が開かれます。<br> このちいきではまいとし、のうさんぶつのてんじかいがひらかれます <br>In this area, an agricultural exhibition is held every year.
歳費	[sound:k-2687_歳費.mp3]<br>さいひ <br> annual expenditure
annual expenditure	<b>歳費<b> <br> さいひ <br>[sound:k-2687_歳費.mp3]
[sound:k-2687_歳費.mp3]	annual expenditure<br> <b>歳費</b> <br> (さいひ)
<b>出展</b> <br> その作家はパリの美術館で作品を出展しています。	[sound:s-2687_その作家はパリの美術館で作品を出展しています。.mp3] <br> そのさっかはパリのびじゅつかんでさくひんをしゅってんしています。 <br>The artist is exhibiting works at a museum in Paris.
[sound:s-2687_その作家はパリの美術館で作品を出展しています。.mp3]	<b>出展</b> <br> その作家はパリの美術館で作品を出展しています。<br> そのさっかはパリのびじゅつかんでさくひんをしゅってんしています <br>The artist is exhibiting works at a museum in Paris.
歳末	[sound:k-2688_歳末.mp3]<br>さいまつ <br> year end
year end	<b>歳末<b> <br> さいまつ <br>[sound:k-2688_歳末.mp3]
[sound:k-2688_歳末.mp3]	year end<br> <b>歳末</b> <br> (さいまつ)
<b>美術展</b> <br> 私たちは週末に友達と美術展を訪れました。	[sound:s-2688_私たちは週末に友達と美術展を訪れました。.mp3] <br> わたしたちはしゅうまつにともだちとびじゅつてんをおとずれました。 <br>We visited an art exhibition with friends over the weekend.
[sound:s-2688_私たちは週末に友達と美術展を訪れました。.mp3]	<b>美術展</b> <br> 私たちは週末に友達と美術展を訪れました。<br> わたしたちはしゅうまつにともだちとびじゅつてんをおとずれました <br>We visited an art exhibition with friends over the weekend.
歳時記	[sound:k-2689_歳時記.mp3]<br>さいじき <br> almanac of seasonal words (for haiku poets)
almanac of seasonal words (for haiku poets)	<b>歳時記<b> <br> さいじき <br>[sound:k-2689_歳時記.mp3]
[sound:k-2689_歳時記.mp3]	almanac of seasonal words<br> <b>for haiku poets) (歳時記</b> <br> (さいじき)
<b>状態</b> <br> 彼の健康状態は良くなっています。	[sound:s-2689_彼の健康状態は良くなっています。.mp3] <br> かれのけんこうじょうたいはよくなっています。 <br>His health condition is improving.
[sound:s-2689_彼の健康状態は良くなっています。.mp3]	<b>状態</b> <br> 彼の健康状態は良くなっています。<br> かれのけんこうじょうたいはよくなっています <br>His health condition is improving.
住	[sound:k-2690_住.mp3]<br>じゅう <br> dwelling, living
dwelling, living	<b>住<b> <br> じゅう <br>[sound:k-2690_住.mp3]
[sound:k-2690_住.mp3]	dwelling, living<br> <b>住</b> <br> (じゅう)
<b>事態</b> <br> この事態に対処するためには迅速な行動が必要です。	[sound:s-2690_この事態に対処するためには迅速な行動が必要です。.mp3] <br> このじたいにたいしょするためにはじんそくなこうどうがひつようです。 <br>Swift action is necessary to deal with this situation.
[sound:s-2690_この事態に対処するためには迅速な行動が必要です。.mp3]	<b>事態</b> <br> この事態に対処するためには迅速な行動が必要です。<br> このじたいにたいしょするためにはじんそくなこうどうがひつようです <br>Swift action is necessary to deal with this situation.
住宅	[sound:k-2691_住宅.mp3]<br>じゅうたく <br> residence, housing, residential building
residence, housing, residential building	<b>住宅<b> <br> じゅうたく <br>[sound:k-2691_住宅.mp3]
[sound:k-2691_住宅.mp3]	residence, housing, residential building<br> <b>住宅</b> <br> (じゅうたく)
<b>実態</b> <br> その組織の実態を知るためには調査が必要です。	[sound:s-2691_その組織の実態を知るためには調査が必要です。.mp3] <br> そのそしきのじったいをしるためにはちょうさがひつようです。 <br>Investigation is necessary to understand the true nature of the organization.
[sound:s-2691_その組織の実態を知るためには調査が必要です。.mp3]	<b>実態</b> <br> その組織の実態を知るためには調査が必要です。<br> そのそしきのじったいをしるためにはちょうさがひつようです <br>Investigation is necessary to understand the true nature of the organization.
住民	[sound:k-2692_住民.mp3]<br>じゅうみん <br> citizens, inhabitants, residents, population
citizens, inhabitants, residents, population	<b>住民<b> <br> じゅうみん <br>[sound:k-2692_住民.mp3]
[sound:k-2692_住民.mp3]	citizens, inhabitants, residents, population<br> <b>住民</b> <br> (じゅうみん)
<b>態度</b> <br> 彼の態度が問題を引き起こしています。	[sound:s-2692_彼の態度が問題を引き起こしています。.mp3] <br> かれのたいどがもんだいをひきおこしています。 <br>His attitude is causing problems.
[sound:s-2692_彼の態度が問題を引き起こしています。.mp3]	<b>態度</b> <br> 彼の態度が問題を引き起こしています。<br> かれのたいどがもんだいをひきおこしています <br>His attitude is causing problems.
住所	[sound:k-2693_住所.mp3]<br>じゅうしょ <br> address (e.g. of house), residence, domicile
address (e.g. of house), residence, domicile	<b>住所<b> <br> じゅうしょ <br>[sound:k-2693_住所.mp3]
[sound:k-2693_住所.mp3]	address<br> <b>e.g. of house), residence, domicile (住所</b> <br> (じゅうしょ)
<b>態</b> <br> 彼女の態は落ち着いています。	[sound:s-2693_彼女の態は落ち着いています。.mp3] <br> かのじょのたいはおちついています。 <br>Her demeanor is calm.
[sound:s-2693_彼女の態は落ち着いています。.mp3]	<b>態</b> <br> 彼女の態は落ち着いています。<br> かのじょのたいはおちついています <br>Her demeanor is calm.
在住	[sound:k-2694_在住.mp3]<br>ざいじゅう <br> resident
resident	<b>在住<b> <br> ざいじゅう <br>[sound:k-2694_在住.mp3]
[sound:k-2694_在住.mp3]	resident<br> <b>在住</b> <br> (ざいじゅう)
<b>態勢</b> <br> その国は台風に備えて万全の態勢を整えています。	[sound:s-2694_その国は台風に備えて万全の態勢を整えています。.mp3] <br> そのくにはたいふうにそなえてばんぜんのたいせいをととのえています。 <br>The country is fully prepared for the typhoon.
[sound:s-2694_その国は台風に備えて万全の態勢を整えています。.mp3]	<b>態勢</b> <br> その国は台風に備えて万全の態勢を整えています。<br> そのくにはたいふうにそなえてばんぜんのたいせいをととのえています <br>The country is fully prepared for the typhoon.
居住	[sound:k-2695_居住.mp3]<br>きょじゅう <br> residence
residence	<b>居住<b> <br> きょじゅう <br>[sound:k-2695_居住.mp3]
[sound:k-2695_居住.mp3]	residence<br> <b>居住</b> <br> (きょじゅう)
<b>形態</b> <br> 彼らの組織は独特の形態を持っています。	[sound:s-2695_彼らの組織は独特の形態を持っています。.mp3] <br> かれらのそしきはどくとくのけいたいをもっています。 <br>Their organization has a unique form.
[sound:s-2695_彼らの組織は独特の形態を持っています。.mp3]	<b>形態</b> <br> 彼らの組織は独特の形態を持っています。<br> かれらのそしきはどくとくのけいたいをもっています <br>Their organization has a unique form.
住み心地	[sound:k-2696_住み心地.mp3]<br>すみごこち <br> comfort (in living place)
comfort (in living place)	<b>住み心地<b> <br> すみごこち <br>[sound:k-2696_住み心地.mp3]
[sound:k-2696_住み心地.mp3]	comfort<br> <b>in living place) (住み心地</b> <br> (すみごこち)
<b>実態調査</b> <br> 政府は不正行為の実態調査を行っています。	[sound:s-2696_政府は不正行為の実態調査を行っています。.mp3] <br> せいふはふせいこういのじったいちょうさをおこなっています。 <br>The government is conducting an investigation into the actual situation of misconduct.
[sound:s-2696_政府は不正行為の実態調査を行っています。.mp3]	<b>実態調査</b> <br> 政府は不正行為の実態調査を行っています。<br> せいふはふせいこういのじったいちょうさをおこなっています <br>The government is conducting an investigation into the actual situation of misconduct.
先住	[sound:k-2697_先住.mp3]<br>せんじゅう <br> previous priest or resident
previous priest or resident	<b>先住<b> <br> せんじゅう <br>[sound:k-2697_先住.mp3]
[sound:k-2697_先住.mp3]	previous priest or resident<br> <b>先住</b> <br> (せんじゅう)
<b>生態系</b> <br> この地域の生態系は多様性に富んでいます。	[sound:s-2697_この地域の生態系は多様性に富んでいます。.mp3] <br> このちいきのせいたいけいはたようせいにとんでいます。 <br>The ecosystem of this region is rich in biodiversity.
[sound:s-2697_この地域の生態系は多様性に富んでいます。.mp3]	<b>生態系</b> <br> この地域の生態系は多様性に富んでいます。<br> このちいきのせいたいけいはたようせいにとんでいます <br>The ecosystem of this region is rich in biodiversity.
住宅地	[sound:k-2698_住宅地.mp3]<br>じゅうたくち <br> housing district, residential district
housing district, residential district	<b>住宅地<b> <br> じゅうたくち <br>[sound:k-2698_住宅地.mp3]
[sound:k-2698_住宅地.mp3]	housing district, residential district<br> <b>住宅地</b> <br> (じゅうたくち)
<b>生態</b> <br> この研究は生態系の変化についてです。	[sound:s-2698_この研究は生態系の変化についてです。.mp3] <br> このけんきゅうはせいたいけいのへんかについてです。 <br>This research is about changes in the ecosystem.
[sound:s-2698_この研究は生態系の変化についてです。.mp3]	<b>生態</b> <br> この研究は生態系の変化についてです。<br> このけんきゅうはせいたいけいのへんかについてです <br>This research is about changes in the ecosystem.
住友	[sound:k-2699_住友.mp3]<br>すみとも <br> Sumitomo (company)
Sumitomo (company)	<b>住友<b> <br> すみとも <br>[sound:k-2699_住友.mp3]
[sound:k-2699_住友.mp3]	Sumitomo<br> <b>company) (住友</b> <br> (すみとも)
<b>指導</b> <br> 彼はチームを成功に導く優れたリーダーです。	[sound:s-2699_彼はチームを成功に導く優れたリーダーです。.mp3] <br> かれはチームをせいこうにみちびくすぐれたりーだーです。 <br>He is an excellent leader who guides the team to success.
[sound:s-2699_彼はチームを成功に導く優れたリーダーです。.mp3]	<b>指導</b> <br> 彼はチームを成功に導く優れたリーダーです。<br> かれはチームをせいこうにみちびくすぐれたりーだーです <br>He is an excellent leader who guides the team to success.
争い	[sound:k-2700_争い.mp3]<br>あらそい <br> dispute, strife, quarrel, dissension, conflict, rivalry, contest
dispute, strife, quarrel, dissension, conflict, rivalry, contest	<b>争い<b> <br> あらそい <br>[sound:k-2700_争い.mp3]
[sound:k-2700_争い.mp3]	dispute, strife, quarrel, dissension, conflict, rivalry, contest<br> <b>争い</b> <br> (あらそい)
<b>導入</b> <br> 新しい技術の導入により、生産性が向上しました。	[sound:s-2700_新しい技術の導入により、生産性が向上しました。.mp3] <br> あたらしいぎじゅつのどうにゅうにより、せいさんせいがこうじょうしました。 <br>The introduction of new technology has led to improved productivity.
[sound:s-2700_新しい技術の導入により、生産性が向上しました。.mp3]	<b>導入</b> <br> 新しい技術の導入により、生産性が向上しました。<br> あたらしいぎじゅつのどうにゅうにより、せいさんせいがこうじょうしました <br>The introduction of new technology has led to improved productivity.
戦争	[sound:k-2701_戦争.mp3]<br>せんそう <br> war
war	<b>戦争<b> <br> せんそう <br>[sound:k-2701_戦争.mp3]
[sound:k-2701_戦争.mp3]	war<br> <b>戦争</b> <br> (せんそう)
<b>主導</b> <br> 彼はそのプロジェクトの主導権を握っています。	[sound:s-2701_彼はそのプロジェクトの主導権を握っています。.mp3] <br> かれはそのぷろじぇくとのしゅどうけんをにぎっています。 <br>He holds the initiative in the project.
[sound:s-2701_彼はそのプロジェクトの主導権を握っています。.mp3]	<b>主導</b> <br> 彼はそのプロジェクトの主導権を握っています。<br> かれはそのぷろじぇくとのしゅどうけんをにぎっています <br>He holds the initiative in the project.
競争	[sound:k-2702_競争.mp3]<br>きょうそう <br> competition, contest; to compete
competition, contest; to compete	<b>競争<b> <br> きょうそう <br>[sound:k-2702_競争.mp3]
[sound:k-2702_競争.mp3]	competition, contest; to compete<br> <b>競争</b> <br> (きょうそう)
<b>半導体</b> <br> スマートフォンやコンピューターには半導体が使われています。	[sound:s-2702_スマートフォンやコンピューターには半導体が使われています。.mp3] <br> すまーとふぉんやこんぴゅーたーにははんどうたいがつかわれています。 <br>Semiconductors are used in smartphones and computers.
[sound:s-2702_スマートフォンやコンピューターには半導体が使われています。.mp3]	<b>半導体</b> <br> スマートフォンやコンピューターには半導体が使われています。<br> すまーとふぉんやこんぴゅーたーにははんどうたいがつかわれています <br>Semiconductors are used in smartphones and computers.
紛争	[sound:k-2703_紛争.mp3]<br>ふんそう <br> dispute, trouble, strife
dispute, trouble, strife	<b>紛争<b> <br> ふんそう <br>[sound:k-2703_紛争.mp3]
[sound:k-2703_紛争.mp3]	dispute, trouble, strife<br> <b>紛争</b> <br> (ふんそう)
<b>主導権</b> <br> この問題で主導権を握ることが重要です。	[sound:s-2703_この問題で主導権を握ることが重要です。.mp3] <br> このもんだいでしゅどうけんをにぎることがじゅうようです。 <br>It's important to take the initiative in this issue.
[sound:s-2703_この問題で主導権を握ることが重要です。.mp3]	<b>主導権</b> <br> この問題で主導権を握ることが重要です。<br> このもんだいでしゅどうけんをにぎることがじゅうようです <br>It's important to take the initiative in this issue.
闘争	[sound:k-2704_闘争.mp3]<br>とうそう <br> strife, conflict
strife, conflict	<b>闘争<b> <br> とうそう <br>[sound:k-2704_闘争.mp3]
[sound:k-2704_闘争.mp3]	strife, conflict<br> <b>闘争</b> <br> (とうそう)
<b>誘導</b> <br> 案内板が私たちを目的地に誘導してくれます。	[sound:s-2704_案内板が私たちを目的地に誘導してくれます。.mp3] <br> あんないばんがわたしたちをもくてきちにゆうどうしてくれます。 <br>Signboards guide us to our destination.
[sound:s-2704_案内板が私たちを目的地に誘導してくれます。.mp3]	<b>誘導</b> <br> 案内板が私たちを目的地に誘導してくれます。<br> あんないばんがわたしたちをもくてきちにゆうどうしてくれます <br>Signboards guide us to our destination.
抗争	[sound:k-2705_抗争.mp3]<br>こうそう <br> dispute, resistance
dispute, resistance	<b>抗争<b> <br> こうそう <br>[sound:k-2705_抗争.mp3]
[sound:k-2705_抗争.mp3]	dispute, resistance<br> <b>抗争</b> <br> (こうそう)
<b>超電導</b> <br> 超電導は電気の効率を高めます。	[sound:s-2705_超電導は電気の効率を高めます。.mp3] <br> ちょうでんどうはでんきのこうりつをたかめます。 <br>Superconductivity enhances the efficiency of electricity.
[sound:s-2705_超電導は電気の効率を高めます。.mp3]	<b>超電導</b> <br> 超電導は電気の効率を高めます。<br> ちょうでんどうはでんきのこうりつをたかめます <br>Superconductivity enhances the efficiency of electricity.
争点	[sound:k-2706_争点.mp3]<br>そうてん <br> point at issue
point at issue	<b>争点<b> <br> そうてん <br>[sound:k-2706_争点.mp3]
[sound:k-2706_争点.mp3]	point at issue<br> <b>争点</b> <br> (そうてん)
<b>学習指導要領</b> <br> 学校では、学習指導要領に基づいて教育が行われます。	[sound:s-2706_学校では、学習指導要領に基づいて教育が行われます。.mp3] <br> がっこうでは、がくしゅうしどうようりょうにもとづいてきょういくがおこなわれます。 <br>Education in schools is conducted based on the curriculum guidelines.
[sound:s-2706_学校では、学習指導要領に基づいて教育が行われます。.mp3]	<b>学習指導要領</b> <br> 学校では、学習指導要領に基づいて教育が行われます。<br> がっこうでは、がくしゅうしどうようりょうにもとづいてきょういくがおこなわれます <br>Education in schools is conducted based on the curriculum guidelines.
論争	[sound:k-2707_論争.mp3]<br>ろんそう <br> controversy, dispute
controversy, dispute	<b>論争<b> <br> ろんそう <br>[sound:k-2707_論争.mp3]
[sound:k-2707_論争.mp3]	controversy, dispute<br> <b>論争</b> <br> (ろんそう)
<b>盲導犬</b> <br> 盲導犬は視覚障害者の移動を支援します。	[sound:s-2707_盲導犬は視覚障害者の移動を支援します。.mp3] <br> もうどうけんはしかくしょうがいしゃのいどうをしえんします。 <br>Guide dogs assist visually impaired individuals in navigation.
[sound:s-2707_盲導犬は視覚障害者の移動を支援します。.mp3]	<b>盲導犬</b> <br> 盲導犬は視覚障害者の移動を支援します。<br> もうどうけんはしかくしょうがいしゃのいどうをしえんします <br>Guide dogs assist visually impaired individuals in navigation.
争う	[sound:k-2708_争う.mp3]<br>あらそう <br> to compete, to contest, to contend; to quarrel, to argue, to dispute, to be at variance, to oppose; (usu. in negative form) to deny (e.g. evidence)
to compete, to contest, to contend; to quarrel, to argue, to dispute, to be at variance, to oppose; (usu. in negative form) to deny (e.g. evidence)	<b>争う<b> <br> あらそう <br>[sound:k-2708_争う.mp3]
[sound:k-2708_争う.mp3]	to compete, to contest, to contend; to quarrel, to argue, to dispute, to be at variance, to oppose;<br> <b>usu. in negative form) to deny (e.g. evidence) (争う</b> <br> (あらそう)
<b>先導</b> <br> この企業は新しい技術の先導者です。	[sound:s-2708_この企業は新しい技術の先導者です。.mp3] <br> このきぎょうはあたらしいぎじゅつのせんどうしゃです。 <br>This company is a leader in new technology.
[sound:s-2708_この企業は新しい技術の先導者です。.mp3]	<b>先導</b> <br> この企業は新しい技術の先導者です。<br> このきぎょうはあたらしいぎじゅつのせんどうしゃです <br>This company is a leader in new technology.
太平洋戦争	[sound:k-2709_太平洋戦争.mp3]<br>たいへいようせんそう <br> the Pacific War
the Pacific War	<b>太平洋戦争<b> <br> たいへいようせんそう <br>[sound:k-2709_太平洋戦争.mp3]
[sound:k-2709_太平洋戦争.mp3]	the Pacific War<br> <b>太平洋戦争</b> <br> (たいへいようせんそう)
<b>北朝鮮</b> <br> 北朝鮮の核開発は国際的な懸念の焦点です。	[sound:s-2709_北朝鮮の核開発は国際的な懸念の焦点です。.mp3] <br> きたちょうせんのかくかいはつはこくさいてきなけねんのしょうてんです。 <br>North Korea's nuclear development is the focus of international concern.
[sound:s-2709_北朝鮮の核開発は国際的な懸念の焦点です。.mp3]	<b>北朝鮮</b> <br> 北朝鮮の核開発は国際的な懸念の焦点です。<br> きたちょうせんのかくかいはつはこくさいてきなけねんのしょうてんです <br>North Korea's nuclear development is the focus of international concern.
会談	[sound:k-2710_会談.mp3]<br>かいだん <br> conversation, conference, discussion, interview
conversation, conference, discussion, interview	<b>会談<b> <br> かいだん <br>[sound:k-2710_会談.mp3]
[sound:k-2710_会談.mp3]	conversation, conference, discussion, interview<br> <b>会談</b> <br> (かいだん)
<b>鮮やか</b> <br> その花火は鮮やかな色で空を彩りました。	[sound:s-2710_その花火は鮮やかな色で空を彩りました。.mp3] <br> そのはなびはあざやかないろでそらをいろどりました。 <br>The fireworks painted the sky with vibrant colors.
[sound:s-2710_その花火は鮮やかな色で空を彩りました。.mp3]	<b>鮮やか</b> <br> その花火は鮮やかな色で空を彩りました。<br> そのはなびはあざやかないろでそらをいろどりました <br>The fireworks painted the sky with vibrant colors.
相談	[sound:k-2711_相談.mp3]<br>そうだん <br> consultation, discussion
consultation, discussion	<b>相談<b> <br> そうだん <br>[sound:k-2711_相談.mp3]
[sound:k-2711_相談.mp3]	consultation, discussion<br> <b>相談</b> <br> (そうだん)
<b>朝鮮</b> <br> 古代の朝鮮半島は歴史的な遺跡が多く残っています。	[sound:s-2711_古代の朝鮮半島は歴史的な遺跡が多く残っています。.mp3] <br> こだいのちょうせんはんとうはれきしてきないせきがおおくのこっています。 <br>The ancient Korean Peninsula has many historical relics remaining.
[sound:s-2711_古代の朝鮮半島は歴史的な遺跡が多く残っています。.mp3]	<b>朝鮮</b> <br> 古代の朝鮮半島は歴史的な遺跡が多く残っています。<br> こだいのちょうせんはんとうはれきしてきないせきがおおくのこっています <br>The ancient Korean Peninsula has many historical relics remaining.
懇談	[sound:k-2712_懇談.mp3]<br>こんだん <br> informal talk
informal talk	<b>懇談<b> <br> こんだん <br>[sound:k-2712_懇談.mp3]
[sound:k-2712_懇談.mp3]	informal talk<br> <b>懇談</b> <br> (こんだん)
<b>朝鮮民主主義人民共和国</b> <br> 朝鮮民主主義人民共和国は東アジアに位置する国です。	[sound:s-2712_朝鮮民主主義人民共和国は東アジアに位置する国です。.mp3] <br> ちょうせんみんしゅしゅぎじんみんきょうわこくはひがしアジアにいちするくにです。 <br>The Democratic People's Republic of Korea is a country located in East Asia.
[sound:s-2712_朝鮮民主主義人民共和国は東アジアに位置する国です。.mp3]	<b>朝鮮民主主義人民共和国</b> <br> 朝鮮民主主義人民共和国は東アジアに位置する国です。<br> ちょうせんみんしゅしゅぎじんみんきょうわこくはひがしアジアにいちするくにです <br>The Democratic People's Republic of Korea is a country located in East Asia.
談合	[sound:k-2713_談合.mp3]<br>だんごう <br> consultation, discussion, conference; collusion, bid-rigging
consultation, discussion, conference; collusion, bid-rigging	<b>談合<b> <br> だんごう <br>[sound:k-2713_談合.mp3]
[sound:k-2713_談合.mp3]	consultation, discussion, conference; collusion, bid-rigging<br> <b>談合</b> <br> (だんごう)
<b>朝鮮半島</b> <br> 朝鮮半島は中国と韓国に隣接しています。	[sound:s-2713_朝鮮半島は中国と韓国に隣接しています。.mp3] <br> ちょうせんはんとうはちゅうごくとかんこくにりんせつしています。 <br>The Korean Peninsula is adjacent to China and South Korea.
[sound:s-2713_朝鮮半島は中国と韓国に隣接しています。.mp3]	<b>朝鮮半島</b> <br> 朝鮮半島は中国と韓国に隣接しています。<br> ちょうせんはんとうはちゅうごくとかんこくにりんせつしています <br>The Korean Peninsula is adjacent to China and South Korea.
相談役	[sound:k-2714_相談役.mp3]<br>そうだんやく <br> counselor, counsellor, adviser, advisor
counselor, counsellor, adviser, advisor	<b>相談役<b> <br> そうだんやく <br>[sound:k-2714_相談役.mp3]
[sound:k-2714_相談役.mp3]	counselor, counsellor, adviser, advisor<br> <b>相談役</b> <br> (そうだんやく)
<b>鮮明</b> <br> 彼の記憶は鮮明に事件を覚えています。	[sound:s-2714_彼の記憶は鮮明に事件を覚えています。.mp3] <br> かれのきおくはせんめいにじけんをおぼえています。 <br>His memory vividly recalls the incident.
[sound:s-2714_彼の記憶は鮮明に事件を覚えています。.mp3]	<b>鮮明</b> <br> 彼の記憶は鮮明に事件を覚えています。<br> かれのきおくはせんめいにじけんをおぼえています <br>His memory vividly recalls the incident.
談話	[sound:k-2715_談話.mp3]<br>だんわ <br> a talk, conversation
a talk, conversation	<b>談話<b> <br> だんわ <br>[sound:k-2715_談話.mp3]
[sound:k-2715_談話.mp3]	a talk, conversation<br> <b>談話</b> <br> (だんわ)
<b>新鮮</b> <br> 新鮮な野菜を使ってサラダを作りましょう。	[sound:s-2715_新鮮な野菜を使ってサラダを作りましょう。.mp3] <br> しんせんなやさいをつかってさらだをつくりましょう。 <br>Let's make a salad using fresh vegetables.
[sound:s-2715_新鮮な野菜を使ってサラダを作りましょう。.mp3]	<b>新鮮</b> <br> 新鮮な野菜を使ってサラダを作りましょう。<br> しんせんなやさいをつかってさらだをつくりましょう <br>Let's make a salad using fresh vegetables.
冗談	[sound:k-2716_冗談.mp3]<br>じょうだん <br> jest, joke
jest, joke	<b>冗談<b> <br> じょうだん <br>[sound:k-2716_冗談.mp3]
[sound:k-2716_冗談.mp3]	jest, joke<br> <b>冗談</b> <br> (じょうだん)
<b>生鮮</b> <br> スーパーマーケットでは生鮮食品が豊富に揃っています。	[sound:s-2716_スーパーマーケットでは生鮮食品が豊富に揃っています。.mp3] <br> すーぱーまーけっとではせいせんしょくひんがほうふにそろっています。 <br>Supermarkets offer a wide variety of fresh food.
[sound:s-2716_スーパーマーケットでは生鮮食品が豊富に揃っています。.mp3]	<b>生鮮</b> <br> スーパーマーケットでは生鮮食品が豊富に揃っています。<br> すーぱーまーけっとではせいせんしょくひんがほうふにそろっています <br>Supermarkets offer a wide variety of fresh food.
商談	[sound:k-2717_商談.mp3]<br>しょうだん <br> business discussion, negotiation
business discussion, negotiation	<b>商談<b> <br> しょうだん <br>[sound:k-2717_商談.mp3]
[sound:k-2717_商談.mp3]	business discussion, negotiation<br> <b>商談</b> <br> (しょうだん)
<b>鮮度</b> <br> 鮮度の良い魚を選ぶと料理が美味しくなります。	[sound:s-2717_鮮度の良い魚を選ぶと料理が美味しくなります。.mp3] <br> せんどのよいさかなをえらぶとりょうりがおいしくなります。 <br>Choosing fresh fish enhances the taste of the dish.
[sound:s-2717_鮮度の良い魚を選ぶと料理が美味しくなります。.mp3]	<b>鮮度</b> <br> 鮮度の良い魚を選ぶと料理が美味しくなります。<br> せんどのよいさかなをえらぶとりょうりがおいしくなります <br>Choosing fresh fish enhances the taste of the dish.
対談	[sound:k-2718_対談.mp3]<br>たいだん <br> talk, dialogue, conversation
talk, dialogue, conversation	<b>対談<b> <br> たいだん <br>[sound:k-2718_対談.mp3]
[sound:k-2718_対談.mp3]	talk, dialogue, conversation<br> <b>対談</b> <br> (たいだん)
<b>新鮮さ</b> <br> その果物の新鮮さがその品質を示しています。	[sound:s-2718_その果物の新鮮さがその品質を示しています。.mp3] <br> そのくだもののしんせんさがそのひんしつをしめしています。 <br>The freshness of the fruit indicates its quality.
[sound:s-2718_その果物の新鮮さがその品質を示しています。.mp3]	<b>新鮮さ</b> <br> その果物の新鮮さがその品質を示しています。<br> そのくだもののしんせんさがそのひんしつをしめしています <br>The freshness of the fruit indicates its quality.
座談会	[sound:k-2719_座談会.mp3]<br>ざだんかい <br> symposium, round-table discussion
symposium, round-table discussion	<b>座談会<b> <br> ざだんかい <br>[sound:k-2719_座談会.mp3]
[sound:k-2719_座談会.mp3]	symposium, round-table discussion<br> <b>座談会</b> <br> (ざだんかい)
<b>準備</b> <br> 旅行の準備は整いましたか？	[sound:s-2719_旅行の準備は整いましたか？.mp3] <br> りょこうのじゅんびはととのいましたか？ <br>Are the preparations for the trip ready?
[sound:s-2719_旅行の準備は整いましたか？.mp3]	(<b>準備</b>) 旅行の準備は整いましたか？	りょこうのじゅんびはととのいましたか？ <br>Are the preparations for the trip ready?
能	[sound:k-2720_能.mp3]<br>のう <br> talent, gift, function; noh (theatre)
talent, gift, function; noh (theatre)	<b>能<b> <br> のう <br>[sound:k-2720_能.mp3]
[sound:k-2720_能.mp3]	talent, gift, function; noh<br> <b>theatre) (能</b> <br> (のう)
<b>整備</b> <br> 自動車を定期的に整備することは安全に運転するために重要です。	[sound:s-2720_自動車を定期的に整備することは安全に運転するために重要です。.mp3] <br> じどうしゃをていきてきにせいびすることはあんぜんにうんてんするためにじゅうようです。 <br>Regular maintenance of the car is important for safe driving.
[sound:s-2720_自動車を定期的に整備することは安全に運転するために重要です。.mp3]	<b>整備</b> <br> 自動車を定期的に整備することは安全に運転するために重要です。<br> じどうしゃをていきてきにせいびすることはあんぜんにうんてんするためにじゅうようです <br>Regular maintenance of the car is important for safe driving.
可能	[sound:k-2721_可能.mp3]<br>かのう <br> possible, practicable, feasible
possible, practicable, feasible	<b>可能<b> <br> かのう <br>[sound:k-2721_可能.mp3]
[sound:k-2721_可能.mp3]	possible, practicable, feasible<br> <b>可能</b> <br> (かのう)
<b>設備</b> <br> この施設は最新の設備を備えています。	[sound:s-2721_この施設は最新の設備を備えています。.mp3] <br> このしせつはさいしんのせつびをそなえています。 <br>This facility is equipped with state-of-the-art facilities.
[sound:s-2721_この施設は最新の設備を備えています。.mp3]	<b>設備</b> <br> この施設は最新の設備を備えています。<br> このしせつはさいしんのせつびをそなえています <br>This facility is equipped with state-of-the-art facilities.
可能性	[sound:k-2722_可能性.mp3]<br>かのうせい <br> potentiality, likelihood, possibility, availability
potentiality, likelihood, possibility, availability	<b>可能性<b> <br> かのうせい <br>[sound:k-2722_可能性.mp3]
[sound:k-2722_可能性.mp3]	potentiality, likelihood, possibility, availability<br> <b>可能性</b> <br> (かのうせい)
<b>備える</b> <br> 台風に備えて非常食を備えておきます。	[sound:s-2722_台風に備えて非常食を備えておきます。.mp3] <br> たいふうにそなえてひじょうしょくをそなえておきます。 <br>I'll stock up on emergency food in preparation for the typhoon.
[sound:s-2722_台風に備えて非常食を備えておきます。.mp3]	<b>備える</b> <br> 台風に備えて非常食を備えておきます。<br> たいふうにそなえてひじょうしょくをそなえておきます <br>I'll stock up on emergency food in preparation for the typhoon.
機能	[sound:k-2723_機能.mp3]<br>きのう <br> function, facility, faculty, feature
function, facility, faculty, feature	<b>機能<b> <br> きのう <br>[sound:k-2723_機能.mp3]
[sound:k-2723_機能.mp3]	function, facility, faculty, feature<br> <b>機能</b> <br> (きのう)
<b>警備</b> <br> 大統領の警備は非常に厳重です。	[sound:s-2723_大統領の警備は非常に厳重です。.mp3] <br> だいとうりょうのけいびはひじょうにげんじゅうです。 <br>The security for the president is extremely tight.
[sound:s-2723_大統領の警備は非常に厳重です。.mp3]	<b>警備</b> <br> 大統領の警備は非常に厳重です。<br> だいとうりょうのけいびはひじょうにげんじゅうです <br>The security for the president is extremely tight.
能力	[sound:k-2724_能力.mp3]<br>のうりょく <br> ability, faculty
ability, faculty	<b>能力<b> <br> のうりょく <br>[sound:k-2724_能力.mp3]
[sound:k-2724_能力.mp3]	ability, faculty<br> <b>能力</b> <br> (のうりょく)
<b>守備</b> <br> そのチームは優れた守備力を持っています。	[sound:s-2724_そのチームは優れた守備力を持っています。.mp3] <br> そのチームはすぐれたしゅびりょくをもっています。 <br>That team has excellent defensive capabilities.
[sound:s-2724_そのチームは優れた守備力を持っています。.mp3]	<b>守備</b> <br> そのチームは優れた守備力を持っています。<br> そのチームはすぐれたしゅびりょくをもっています <br>That team has excellent defensive capabilities.
芸能	[sound:k-2725_芸能.mp3]<br>げいのう <br> public entertainment, accomplishments, attainments
public entertainment, accomplishments, attainments	<b>芸能<b> <br> げいのう <br>[sound:k-2725_芸能.mp3]
[sound:k-2725_芸能.mp3]	public entertainment, accomplishments, attainments<br> <b>芸能</b> <br> (げいのう)
<b>予備</b> <br> 会議のための予備資料を用意しています。	[sound:s-2725_会議のための予備資料を用意しています。.mp3] <br> かいぎのためのよびしりょうをよういしています。 <br>I'm preparing backup materials for the meeting.
[sound:s-2725_会議のための予備資料を用意しています。.mp3]	<b>予備</b> <br> 会議のための予備資料を用意しています。<br> かいぎのためのよびしりょうをよういしています <br>I'm preparing backup materials for the meeting.
不可能	[sound:k-2726_不可能.mp3]<br>ふかのう <br> impossible
impossible	<b>不可能<b> <br> ふかのう <br>[sound:k-2726_不可能.mp3]
[sound:k-2726_不可能.mp3]	impossible<br> <b>不可能</b> <br> (ふかのう)
<b>装備</b> <br> 彼は山登りのために最新の装備を購入しました。	[sound:s-2726_彼は山登りのために最新の装備を購入しました。.mp3] <br> かれはやまのぼりのためにさいしんのそうびをこうにゅうしました。 <br>He bought the latest equipment for mountain climbing.
[sound:s-2726_彼は山登りのために最新の装備を購入しました。.mp3]	<b>装備</b> <br> 彼は山登りのために最新の装備を購入しました。<br> かれはやまのぼりのためにさいしんのそうびをこうにゅうしました <br>He bought the latest equipment for mountain climbing.
放射能	[sound:k-2727_放射能.mp3]<br>ほうしゃのう <br> radioactivity
radioactivity	<b>放射能<b> <br> ほうしゃのう <br>[sound:k-2727_放射能.mp3]
[sound:k-2727_放射能.mp3]	radioactivity<br> <b>放射能</b> <br> (ほうしゃのう)
<b>軍備</b> <br> 両国の軍備拡張は国際社会の安定に影響を与えます。	[sound:s-2727_両国の軍備拡張は国際社会の安定に影響を与えます。.mp3] <br> りょうこくのぐんびかくちょうはこくさいしゃかいのあんていにえいきょうをあたえます。 <br>The expansion of both countries' military capabilities affects the stability of the international community.
[sound:s-2727_両国の軍備拡張は国際社会の安定に影響を与えます。.mp3]	<b>軍備</b> <br> 両国の軍備拡張は国際社会の安定に影響を与えます。<br> りょうこくのぐんびかくちょうはこくさいしゃかいのあんていにえいきょうをあたえます <br>The expansion of both countries' military capabilities affects the stability of the international community.
才能	[sound:k-2728_才能.mp3]<br>さいのう <br> talent, ability
talent, ability	<b>才能<b> <br> さいのう <br>[sound:k-2728_才能.mp3]
[sound:k-2728_才能.mp3]	talent, ability<br> <b>才能</b> <br> (さいのう)
<b>備蓄</b> <br> 災害時に備蓄した食料品が役立ちます。	[sound:s-2728_災害時に備蓄した食料品が役立ちます。.mp3] <br> さいがいじにびちくしたしょくりょうひんがやくだちます。 <br>Stored food supplies come in handy during disasters.
[sound:s-2728_災害時に備蓄した食料品が役立ちます。.mp3]	<b>備蓄</b> <br> 災害時に備蓄した食料品が役立ちます。<br> さいがいじにびちくしたしょくりょうひんがやくだちます <br>Stored food supplies come in handy during disasters.
性能	[sound:k-2729_性能.mp3]<br>せいのう <br> ability, performance, efficiency
ability, performance, efficiency	<b>性能<b> <br> せいのう <br>[sound:k-2729_性能.mp3]
[sound:k-2729_性能.mp3]	ability, performance, efficiency<br> <b>性能</b> <br> (せいのう)
<b>宅</b> <br> 彼は自分の宅で静かな夜を過ごした。	[sound:s-2729_彼は自分の宅で静かな夜を過ごした。.mp3] <br> かれはじぶんのたくでしずかなよるをすごした。 <br>He spent a quiet night at his home.
[sound:s-2729_彼は自分の宅で静かな夜を過ごした。.mp3]	<b>宅</b> <br> 彼は自分の宅で静かな夜を過ごした。<br> かれはじぶんのたくでしずかなよるをすごした <br>He spent a quiet night at his home.
無料	[sound:k-2730_無料.mp3]<br>むりょう <br> free, no charge
free, no charge	<b>無料<b> <br> むりょう <br>[sound:k-2730_無料.mp3]
[sound:k-2730_無料.mp3]	free, no charge<br> <b>無料</b> <br> (むりょう)
<b>自宅</b> <br> 彼女は自宅で家族と夕食を楽しんだ。	[sound:s-2730_彼女は自宅で家族と夕食を楽しんだ。.mp3] <br> かのじょはじたくでかぞくとゆうしょくをたのしんだ。 <br>She enjoyed dinner with her family at home.
[sound:s-2730_彼女は自宅で家族と夕食を楽しんだ。.mp3]	<b>自宅</b> <br> 彼女は自宅で家族と夕食を楽しんだ。<br> かのじょはじたくでかぞくとゆうしょくをたのしんだ <br>She enjoyed dinner with her family at home.
無職	[sound:k-2731_無職.mp3]<br>むしょく <br> without an occupation
without an occupation	<b>無職<b> <br> むしょく <br>[sound:k-2731_無職.mp3]
[sound:k-2731_無職.mp3]	without an occupation<br> <b>無職</b> <br> (むしょく)
<b>住宅</b> <br> この地域には新しい住宅が建設されています。	[sound:s-2731_この地域には新しい住宅が建設されています。.mp3] <br> このちいきにはあたらしいじゅうたくがけんせつされています。 <br>New housing is being constructed in this area.
[sound:s-2731_この地域には新しい住宅が建設されています。.mp3]	<b>住宅</b> <br> この地域には新しい住宅が建設されています。<br> このちいきにはあたらしいじゅうたくがけんせつされています <br>New housing is being constructed in this area.
無所属	[sound:k-2732_無所属.mp3]<br>むしょぞく <br> independent
independent	<b>無所属<b> <br> むしょぞく <br>[sound:k-2732_無所属.mp3]
[sound:k-2732_無所属.mp3]	independent<br> <b>無所属</b> <br> (むしょぞく)
<b>在宅</b> <br> リモートワークにより、多くの人々が在宅勤務をしています。	[sound:s-2732_リモートワークにより、多くの人々が在宅勤務をしています。.mp3] <br> りもーとわーくにより、おおくのひとびとがざいたくきんむをしています。 <br>"Due to remote work, many people are working from home."
[sound:s-2732_リモートワークにより、多くの人々が在宅勤務をしています。.mp3]	<b>在宅</b> <br> リモートワークにより、多くの人々が在宅勤務をしています。<br> りもーとわーくにより、おおくのひとびとがざいたくきんむをしています <br>Due to remote work, many people are working from home.
無罪	[sound:k-2733_無罪.mp3]<br>むざい <br> innocence
innocence	<b>無罪<b> <br> むざい <br>[sound:k-2733_無罪.mp3]
[sound:k-2733_無罪.mp3]	innocence<br> <b>無罪</b> <br> (むざい)
<b>家宅</b> <br> 彼の家宅は都心から離れた静かな場所にあります。	[sound:s-2733_彼の家宅は都心から離れた静かな場所にあります。.mp3] <br> かれのかたくはとしんからはなれたしずかなばしょにあります。 <br>His residence is located in a quiet place away from the city center.
[sound:s-2733_彼の家宅は都心から離れた静かな場所にあります。.mp3]	<b>家宅</b> <br> 彼の家宅は都心から離れた静かな場所にあります。<br> かれのかたくはとしんからはなれたしずかなばしょにあります <br>His residence is located in a quiet place away from the city center.
無理	[sound:k-2734_無理.mp3]<br>むり <br> unreasonable, impossible, overdoing
unreasonable, impossible, overdoing	<b>無理<b> <br> むり <br>[sound:k-2734_無理.mp3]
[sound:k-2734_無理.mp3]	unreasonable, impossible, overdoing<br> <b>無理</b> <br> (むり)
<b>住宅地</b> <br> この地域は住宅地として人気があります。	[sound:s-2734_この地域は住宅地として人気があります。.mp3] <br> このちいきはじゅうたくちとしてにんきがあります。 <br>This area is popular as a residential area.
[sound:s-2734_この地域は住宅地として人気があります。.mp3]	<b>住宅地</b> <br> この地域は住宅地として人気があります。<br> このちいきはじゅうたくちとしてにんきがあります <br>This area is popular as a residential area.
無線	[sound:k-2735_無線.mp3]<br>むせん <br> wireless, radio
wireless, radio	<b>無線<b> <br> むせん <br>[sound:k-2735_無線.mp3]
[sound:k-2735_無線.mp3]	wireless, radio<br> <b>無線</b> <br> (むせん)
<b>宅地</b> <br> 新しい宅地開発が計画されています。	[sound:s-2735_新しい宅地開発が計画されています。.mp3] <br> あたらしいたくちかいはつがけいかくされています。 <br>New residential development is being planned.
[sound:s-2735_新しい宅地開発が計画されています。.mp3]	<b>宅地</b> <br> 新しい宅地開発が計画されています。<br> あたらしいたくちかいはつがけいかくされています <br>New residential development is being planned.
無効	[sound:k-2736_無効.mp3]<br>むこう <br> invalid, no effect, unavailable, illegal
invalid, no effect, unavailable, illegal	<b>無効<b> <br> むこう <br>[sound:k-2736_無効.mp3]
[sound:k-2736_無効.mp3]	invalid, no effect, unavailable, illegal<br> <b>無効</b> <br> (むこう)
<b>帰宅</b> <br> 長い一日の後、彼は遅く帰宅しました。	[sound:s-2736_長い一日の後、彼は遅く帰宅しました。.mp3] <br> ながいいちにちのあと、かれはおそくきたくしました。 <br>"After a long day, he returned home late."
[sound:s-2736_長い一日の後、彼は遅く帰宅しました。.mp3]	<b>帰宅</b> <br> 長い一日の後、彼は遅く帰宅しました。<br> ながいいちにちのあと、かれはおそくきたくしました <br>After a long day, he returned home late.
無償	[sound:k-2737_無償.mp3]<br>むしょう <br> no compensation, free of charge
no compensation, free of charge	<b>無償<b> <br> むしょう <br>[sound:k-2737_無償.mp3]
[sound:k-2737_無償.mp3]	no compensation, free of charge<br> <b>無償</b> <br> (むしょう)
<b>宅配</b> <br> インターネットでの宅配サービスが便利です。	[sound:s-2737_インターネットでの宅配サービスが便利です。.mp3] <br> いんたーねっとでのたくはいサービスがべんりです。 <br>Home delivery services on the internet are convenient.
[sound:s-2737_インターネットでの宅配サービスが便利です。.mp3]	<b>宅配</b> <br> インターネットでの宅配サービスが便利です。<br> いんたーねっとでのたくはいサービスがべんりです <br>Home delivery services on the internet are convenient.
有無	[sound:k-2738_有無.mp3]<br>うむ, ゆうむ <br> existence or nonexistence, presence or absence; consent or refusal, yes or no; flag indicator, presence or absence marker
existence or nonexistence, presence or absence; consent or refusal, yes or no; flag indicator, presence or absence marker	<b>有無<b> <br> うむ, ゆうむ <br>[sound:k-2738_有無.mp3]
[sound:k-2738_有無.mp3]	existence or nonexistence, presence or absence; consent or refusal, yes or no; flag indicator, presence or absence marker<br> <b>有無</b> <br> (うむ, ゆうむ)
<b>住宅街</b> <br> 彼女は静かな住宅街で暮らしています。	[sound:s-2738_彼女は静かな住宅街で暮らしています。.mp3] <br> かのじょはしずかなじゅうたくがいでくらしています。 <br>She lives in a quiet residential area.
[sound:s-2738_彼女は静かな住宅街で暮らしています。.mp3]	<b>住宅街</b> <br> 彼女は静かな住宅街で暮らしています。<br> かのじょはしずかなじゅうたくがいでくらしています <br>She lives in a quiet residential area.
無死	[sound:k-2739_無死.mp3]<br>むし <br> baseball with no outs
baseball with no outs	<b>無死<b> <br> むし <br>[sound:k-2739_無死.mp3]
[sound:k-2739_無死.mp3]	baseball with no outs<br> <b>無死</b> <br> (むし)
<b>障害</b> <br> 障害があっても、夢を追いかけることはできます。	[sound:s-2739_障害があっても、夢を追いかけることはできます。.mp3] <br> しょうがいがあっても、ゆめをおいかけることはできます。 <br>"Even with disabilities, you can still pursue your dreams."
[sound:s-2739_障害があっても、夢を追いかけることはできます。.mp3]	<b>障害</b> <br> 障害があっても、夢を追いかけることはできます。<br> しょうがいがあっても、ゆめをおいかけることはできます <br>Even with disabilities, you can still pursue your dreams.
再び	[sound:k-2740_再び.mp3]<br>ふたたび <br> again, once more, a second time
again, once more, a second time	<b>再び<b> <br> ふたたび <br>[sound:k-2740_再び.mp3]
[sound:k-2740_再び.mp3]	again, once more, a second time<br> <b>再び</b> <br> (ふたたび)
<b>被害</b> <br> その地域は大雨の被害を受けました。	[sound:s-2740_その地域は大雨の被害を受けました。.mp3] <br> そのちいきはおおあめのひがいをうけました。 <br>The area suffered damage from heavy rain.
[sound:s-2740_その地域は大雨の被害を受けました。.mp3]	<b>被害</b> <br> その地域は大雨の被害を受けました。<br> そのちいきはおおあめのひがいをうけました <br>The area suffered damage from heavy rain.
再開	[sound:k-2741_再開.mp3]<br>さいかい <br> reopening, resumption, restarting
reopening, resumption, restarting	<b>再開<b> <br> さいかい <br>[sound:k-2741_再開.mp3]
[sound:k-2741_再開.mp3]	reopening, resumption, restarting<br> <b>再開</b> <br> (さいかい)
<b>災害</b> <br> 災害が起こった時、迅速な対応が必要です。	[sound:s-2741_災害が起こった時、迅速な対応が必要です。.mp3] <br> さいがいがおこったとき、じんそくなたいおうがひつようです。 <br>Rapid response is necessary when a disaster occurs.
[sound:s-2741_災害が起こった時、迅速な対応が必要です。.mp3]	<b>災害</b> <br> 災害が起こった時、迅速な対応が必要です。<br> さいがいがおこったとき、じんそくなたいおうがひつようです <br>Rapid response is necessary when a disaster occurs.
再建	[sound:k-2742_再建.mp3]<br>さいけん <br> rebuilding, reconstruction, rehabilitation
rebuilding, reconstruction, rehabilitation	<b>再建<b> <br> さいけん <br>[sound:k-2742_再建.mp3]
[sound:k-2742_再建.mp3]	rebuilding, reconstruction, rehabilitation<br> <b>再建</b> <br> (さいけん)
<b>損害</b> <br> 事故で車に損害が生じました。	[sound:s-2742_事故で車に損害が生じました。.mp3] <br> じこでくるまにそんがいがしょうじました。 <br>The car suffered damage in the accident.
[sound:s-2742_事故で車に損害が生じました。.mp3]	<b>損害</b> <br> 事故で車に損害が生じました。<br> じこでくるまにそんがいがしょうじました <br>The car suffered damage in the accident.
再編	[sound:k-2743_再編.mp3]<br>さいへん <br> reorganization, reorganisation, reshuffle
reorganization, reorganisation, reshuffle	<b>再編<b> <br> さいへん <br>[sound:k-2743_再編.mp3]
[sound:k-2743_再編.mp3]	reorganization, reorganisation, reshuffle<br> <b>再編</b> <br> (さいへん)
<b>障害者</b> <br> この施設は障害者のためのバリアフリー設計です。	[sound:s-2743_この施設は障害者のためのバリアフリー設計です。.mp3] <br> このしせつはしょうがいしゃのためのばりあふりーせっけいです。 <br>This facility is designed to be barrier-free for people with disabilities.
[sound:s-2743_この施設は障害者のためのバリアフリー設計です。.mp3]	<b>障害者</b> <br> この施設は障害者のためのバリアフリー設計です。<br> このしせつはしょうがいしゃのためのばりあふりーせっけいです <br>This facility is designed to be barrier-free for people with disabilities.
再生	[sound:k-2744_再生.mp3]<br>さいせい <br> playback, regeneration, resuscitation, return to life, rebirth, reincarnation, refresh, narrow escape, reclamation, regrowth
playback, regeneration, resuscitation, return to life, rebirth, reincarnation, refresh, narrow escape, reclamation, regrowth	<b>再生<b> <br> さいせい <br>[sound:k-2744_再生.mp3]
[sound:k-2744_再生.mp3]	playback, regeneration, resuscitation, return to life, rebirth, reincarnation, refresh, narrow escape, reclamation, regrowth<br> <b>再生</b> <br> (さいせい)
<b>公害</b> <br> 工場の排水が地域の公害問題となっています。	[sound:s-2744_工場の排水が地域の公害問題となっています。.mp3] <br> こうじょうのはいすいがちいきのこうがいもんだいとなっています。 <br>Factory wastewater has become an environmental pollution problem in the area.
[sound:s-2744_工場の排水が地域の公害問題となっています。.mp3]	<b>公害</b> <br> 工場の排水が地域の公害問題となっています。<br> こうじょうのはいすいがちいきのこうがいもんだいとなっています <br>Factory wastewater has become an environmental pollution problem in the area.
再三	[sound:k-2745_再三.mp3]<br>さいさん <br> again and again, repeatedly
again and again, repeatedly	<b>再三<b> <br> さいさん <br>[sound:k-2745_再三.mp3]
[sound:k-2745_再三.mp3]	again and again, repeatedly<br> <b>再三</b> <br> (さいさん)
<b>被害者</b> <br> 被害者支援のための基金が設立されました。	[sound:s-2745_被害者支援のための基金が設立されました。.mp3] <br> ひがいしゃしえんのためのききんがせつりつされました。 <br>A fund for the support of victims has been established.
[sound:s-2745_被害者支援のための基金が設立されました。.mp3]	<b>被害者</b> <br> 被害者支援のための基金が設立されました。<br> ひがいしゃしえんのためのききんがせつりつされました <br>A fund for the support of victims has been established.
再発	[sound:k-2746_再発.mp3]<br>さいはつ <br> return, relapse, reoccurrence
return, relapse, reoccurrence	<b>再発<b> <br> さいはつ <br>[sound:k-2746_再発.mp3]
[sound:k-2746_再発.mp3]	return, relapse, reoccurrence<br> <b>再発</b> <br> (さいはつ)
<b>侵害</b> <br> 私有地への侵害は法律で禁じられています。	[sound:s-2746_私有地への侵害は法律で禁じられています。.mp3] <br> しゆうちへのしんがいはほうりつできんじられています。 <br>Trespassing onto private property is prohibited by law.
[sound:s-2746_私有地への侵害は法律で禁じられています。.mp3]	<b>侵害</b> <br> 私有地への侵害は法律で禁じられています。<br> しゆうちへのしんがいはほうりつできんじられています <br>Trespassing onto private property is prohibited by law.
再選	[sound:k-2747_再選.mp3]<br>さいせん <br> re-election
re-election	<b>再選<b> <br> さいせん <br>[sound:k-2747_再選.mp3]
[sound:k-2747_再選.mp3]	re-election<br> <b>再選</b> <br> (さいせん)
<b>害</b> <br> 環境への害を最小限に抑えることが重要です。	[sound:s-2747_環境への害を最小限に抑えることが重要です。.mp3] <br> かんきょうへのがいをさいしょうげんにおさえることがじゅうようです。 <br>It's important to minimize harm to the environment.
[sound:s-2747_環境への害を最小限に抑えることが重要です。.mp3]	<b>害</b> <br> 環境への害を最小限に抑えることが重要です。<br> かんきょうへのがいをさいしょうげんにおさえることがじゅうようです <br>It's important to minimize harm to the environment.
再検討	[sound:k-2748_再検討.mp3]<br>さいけんとう <br> re-examination, review, reappraisal
re-examination, review, reappraisal	<b>再検討<b> <br> さいけんとう <br>[sound:k-2748_再検討.mp3]
[sound:k-2748_再検討.mp3]	re-examination, review, reappraisal<br> <b>再検討</b> <br> (さいけんとう)
<b>殺害</b> <br> 犯人は無実の人を殺害しました。	[sound:s-2748_犯人は無実の人を殺害しました。.mp3] <br> はんにんはむじつのひとをさつがいしました。 <br>The criminal killed an innocent person.
[sound:s-2748_犯人は無実の人を殺害しました。.mp3]	<b>殺害</b> <br> 犯人は無実の人を殺害しました。<br> はんにんはむじつのひとをさつがいしました <br>The criminal killed an innocent person.
再度	[sound:k-2749_再度.mp3]<br>さいど <br> twice, again, second time
twice, again, second time	<b>再度<b> <br> さいど <br>[sound:k-2749_再度.mp3]
[sound:k-2749_再度.mp3]	twice, again, second time<br> <b>再度</b> <br> (さいど)
<b>支配</b> <br> その国の支配者は厳しい政策を実行しています。	[sound:s-2749_その国の支配者は厳しい政策を実行しています。.mp3] <br> そのくにのしはいしゃはきびしいせいさくをじっこうしています。 <br>The ruler of that country is implementing strict policies.
[sound:s-2749_その国の支配者は厳しい政策を実行しています。.mp3]	<b>支配</b> <br> その国の支配者は厳しい政策を実行しています。<br> そのくにのしはいしゃはきびしいせいさくをじっこうしています <br>The ruler of that country is implementing strict policies.
上位	[sound:k-2750_上位.mp3]<br>じょうい <br> superior (rank not class); higher order (e.g. byte); host computer (of connected device)
superior (rank not class); higher order (e.g. byte); host computer (of connected device)	<b>上位<b> <br> じょうい <br>[sound:k-2750_上位.mp3]
[sound:k-2750_上位.mp3]	superior<br> <b>rank not class); higher order (e.g. byte); host computer (of connected device) (上位</b> <br> (じょうい)
<b>心配</b> <br> 彼の安全が心配です。	[sound:s-2750_彼の安全が心配です。.mp3] <br> かれのあんぜんがしんぱいです。 <br>I'm worried about his safety.
[sound:s-2750_彼の安全が心配です。.mp3]	<b>心配</b> <br> 彼の安全が心配です。<br> かれのあんぜんがしんぱいです <br>I'm worried about his safety.
単位	[sound:k-2751_単位.mp3]<br>たんい <br> unit, denomination; credit (in school)
unit, denomination; credit (in school)	<b>単位<b> <br> たんい <br>[sound:k-2751_単位.mp3]
[sound:k-2751_単位.mp3]	unit, denomination; credit<br> <b>in school) (単位</b> <br> (たんい)
<b>配分</b> <br> 利益は全株主に配分されます。	[sound:s-2751_利益は全株主に配分されます。.mp3] <br> りえきはぜんかぶぬしにはいぶんされます。 <br>Profits are distributed among all shareholders.
[sound:s-2751_利益は全株主に配分されます。.mp3]	<b>配分</b> <br> 利益は全株主に配分されます。<br> りえきはぜんかぶぬしにはいぶんされます <br>Profits are distributed among all shareholders.
地位	[sound:k-2752_地位.mp3]<br>ちい <br> (social) position, status
(social) position, status	<b>地位<b> <br> ちい <br>[sound:k-2752_地位.mp3]
[sound:k-2752_地位.mp3]	(social) position, status<br> <b>地位</b> <br> (ちい)
<b>配慮</b> <br> 彼は他人の感情に配慮することができます。	[sound:s-2752_彼は他人の感情に配慮することができます。.mp3] <br> かれはたにんのかんじょうにはいりょすることができます。 <br>He can consider other people's feelings.
[sound:s-2752_彼は他人の感情に配慮することができます。.mp3]	<b>配慮</b> <br> 彼は他人の感情に配慮することができます。<br> かれはたにんのかんじょうにはいりょすることができます <br>He can consider other people's feelings.
首位	[sound:k-2753_首位.mp3]<br>しゅい <br> first place, head position, leading position
first place, head position, leading position	<b>首位<b> <br> しゅい <br>[sound:k-2753_首位.mp3]
[sound:k-2753_首位.mp3]	first place, head position, leading position<br> <b>首位</b> <br> (しゅい)
<b>配当</b> <br> この株は毎年配当を支払います。	[sound:s-2753_この株は毎年配当を支払います。.mp3] <br> このかぶはまいねんはいとうをしはらいます。 <br>This stock pays dividends every year.
[sound:s-2753_この株は毎年配当を支払います。.mp3]	<b>配当</b> <br> この株は毎年配当を支払います。<br> このかぶはまいねんはいとうをしはらいます <br>This stock pays dividends every year.
一位	[sound:k-2754_一位.mp3]<br>いちい, イチイ <br> first place, first rank, unit's position; Japanese yew (Taxus cuspidata)
first place, first rank, unit's position; Japanese yew (Taxus cuspidata)	<b>一位<b> <br> いちい, イチイ <br>[sound:k-2754_一位.mp3]
[sound:k-2754_一位.mp3]	first place, first rank, unit's position; Japanese yew<br> <b>Taxus cuspidata) (一位</b> <br> (いちい, イチイ)
<b>気配</b> <br> 森の中に獣の気配が漂っている。	[sound:s-2754_森の中に獣の気配が漂っている。.mp3] <br> もりのなかにけもののけはいがただよっている。 <br>There is a scent of animals drifting in the forest.
[sound:s-2754_森の中に獣の気配が漂っている。.mp3]	<b>気配</b> <br> 森の中に獣の気配が漂っている。<br> もりのなかにけもののけはいがただよっている <br>There is a scent of animals drifting in the forest.
位置	[sound:k-2755_位置.mp3]<br>いち <br> place, situation, position, location
place, situation, position, location	<b>位置<b> <br> いち <br>[sound:k-2755_位置.mp3]
[sound:k-2755_位置.mp3]	place, situation, position, location<br> <b>位置</b> <br> (いち)
<b>配置</b> <br> 机と椅子を部屋の中に適切に配置しました。	[sound:s-2755_机と椅子を部屋の中に適切に配置しました。.mp3] <br> つくえといすをへやのなかにてきせつにはいちしました。 <br>I arranged the desk and chair properly in the room.
[sound:s-2755_机と椅子を部屋の中に適切に配置しました。.mp3]	<b>配置</b> <br> 机と椅子を部屋の中に適切に配置しました。<br> つくえといすをへやのなかにてきせつにはいちしました <br>I arranged the desk and chair properly in the room.
順位	[sound:k-2756_順位.mp3]<br>じゅんい <br> order, rank, position (e.g. in a race), precedence
order, rank, position (e.g. in a race), precedence	<b>順位<b> <br> じゅんい <br>[sound:k-2756_順位.mp3]
[sound:k-2756_順位.mp3]	order, rank, position<br> <b>e.g. in a race), precedence (順位</b> <br> (じゅんい)
<b>配る</b> <br> リーダーはタスクをチームメンバーに均等に配ります。	[sound:s-2756_リーダーはタスクをチームメンバーに均等に配ります。.mp3] <br> りーだーはたすくをちーむめんばーにきんとうにくばります。 <br>The leader distributes tasks evenly among team members.
[sound:s-2756_リーダーはタスクをチームメンバーに均等に配ります。.mp3]	<b>配る</b> <br> リーダーはタスクをチームメンバーに均等に配ります。<br> りーだーはたすくをちーむめんばーにきんとうにくばります <br>The leader distributes tasks evenly among team members.
下位	[sound:k-2757_下位.mp3]<br>かい <br> low rank, subordinate, lower order (e.g. byte), low-end
low rank, subordinate, lower order (e.g. byte), low-end	<b>下位<b> <br> かい <br>[sound:k-2757_下位.mp3]
[sound:k-2757_下位.mp3]	low rank, subordinate, lower order<br> <b>e.g. byte), low-end (下位</b> <br> (かい)
<b>配給</b> <br> 災害地域には食料や水が配給されました。	[sound:s-2757_災害地域には食料や水が配給されました。.mp3] <br> さいがいちいきにはしょくりょうやみずがはいきゅうされました。 <br>Food and water were distributed to the disaster area.
[sound:s-2757_災害地域には食料や水が配給されました。.mp3]	<b>配給</b> <br> 災害地域には食料や水が配給されました。<br> さいがいちいきにはしょくりょうやみずがはいきゅうされました <br>Food and water were distributed to the disaster area.
本位	[sound:k-2758_本位.mp3]<br>ほんい <br> standard, basis, principle
standard, basis, principle	<b>本位<b> <br> ほんい <br>[sound:k-2758_本位.mp3]
[sound:k-2758_本位.mp3]	standard, basis, principle<br> <b>本位</b> <br> (ほんい)
<b>宅配</b> <br> インターネット注文した商品が宅配されました。	[sound:s-2758_インターネット注文した商品が宅配されました。.mp3] <br> いんたーねっとちゅうもんしたしょうひんがたくはいされました。 <br>The goods ordered online were delivered to the home.
[sound:s-2758_インターネット注文した商品が宅配されました。.mp3]	<b>宅配</b> <br> インターネット注文した商品が宅配されました。<br> いんたーねっとちゅうもんしたしょうひんがたくはいされました <br>The goods ordered online were delivered to the home.
優位	[sound:k-2759_優位.mp3]<br>ゆうい <br> predominance, ascendancy, superiority
predominance, ascendancy, superiority	<b>優位<b> <br> ゆうい <br>[sound:k-2759_優位.mp3]
[sound:k-2759_優位.mp3]	predominance, ascendancy, superiority<br> <b>優位</b> <br> (ゆうい)
<b>副社長</b> <br> 彼は会社の副社長として重要な役割を果たしています。	[sound:s-2759_彼は会社の副社長として重要な役割を果たしています。.mp3] <br> かれはかいしゃのふくしゃちょうとしてじゅうようなやくわりをはたしています。 <br>He plays an important role as the vice president of the company.
[sound:s-2759_彼は会社の副社長として重要な役割を果たしています。.mp3]	<b>副社長</b> <br> 彼は会社の副社長として重要な役割を果たしています。<br> かれはかいしゃのふくしゃちょうとしてじゅうようなやくわりをはたしています <br>He plays an important role as the vice president of the company.
措置	[sound:k-2760_措置.mp3]<br>そち <br> measure, step
measure, step	<b>措置<b> <br> そち <br>[sound:k-2760_措置.mp3]
[sound:k-2760_措置.mp3]	measure, step<br> <b>措置</b> <br> (そち)
<b>副作用</b> <br> この薬には副作用があるかもしれません。	[sound:s-2760_この薬には副作用があるかもしれません。.mp3] <br> このくすりにはふくさようがあるかもしれません。 <br>This medicine may have side effects.
[sound:s-2760_この薬には副作用があるかもしれません。.mp3]	<b>副作用</b> <br> この薬には副作用があるかもしれません。<br> このくすりにはふくさようがあるかもしれません <br>This medicine may have side effects.
設置	[sound:k-2761_設置.mp3]<br>せっち <br> establishment, institution
establishment, institution	<b>設置<b> <br> せっち <br>[sound:k-2761_設置.mp3]
[sound:k-2761_設置.mp3]	establishment, institution<br> <b>設置</b> <br> (せっち)
<b>副知事</b> <br> 市の副知事は市長の補佐をします。	[sound:s-2761_市の副知事は市長の補佐をします。.mp3] <br> しのふくちじはしちょうのほさをします。 <br>The deputy mayor assists the mayor.
[sound:s-2761_市の副知事は市長の補佐をします。.mp3]	<b>副知事</b> <br> 市の副知事は市長の補佐をします。<br> しのふくちじはしちょうのほさをします <br>The deputy mayor assists the mayor.
装置	[sound:k-2762_装置.mp3]<br>そうち <br> equipment, installation, apparatus, device
equipment, installation, apparatus, device	<b>装置<b> <br> そうち <br>[sound:k-2762_装置.mp3]
[sound:k-2762_装置.mp3]	equipment, installation, apparatus, device<br> <b>装置</b> <br> (そうち)
<b>副賞</b> <br> 彼女は映画祭で最優秀女優賞を受賞しました。	[sound:s-2762_彼女は映画祭で最優秀女優賞を受賞しました。.mp3] <br> かのじょはえいがさいでさいゆうしゅうじょゆうしょうをじゅしょうしました。 <br>She won the Best Actress Award at the film festival.
[sound:s-2762_彼女は映画祭で最優秀女優賞を受賞しました。.mp3]	<b>副賞</b> <br> 彼女は映画祭で最優秀女優賞を受賞しました。<br> かのじょはえいがさいでさいゆうしゅうじょゆうしょうをじゅしょうしました <br>She won the Best Actress Award at the film festival.
位置	[sound:k-2763_位置.mp3]<br>いち <br> place, situation, position, location
place, situation, position, location	<b>位置<b> <br> いち <br>[sound:k-2763_位置.mp3]
[sound:k-2763_位置.mp3]	place, situation, position, location<br> <b>位置</b> <br> (いち)
<b>副題</b> <br> この本の副題は「夢の探求」です。	[sound:s-2763_この本の副題は「夢の探求」です。.mp3] <br> このほんのふくだいは「ゆめのたんきゅう」です。 <br>"The subtitle of this book is ""The Pursuit of Dreams."""
[sound:s-2763_この本の副題は「夢の探求」です。.mp3]	<b>副題</b> <br> この本の副題は「夢の探求」です。<br> このほんのふくだいは「ゆめのたんきゅう」です <br>The subtitle of this book is "The Pursuit of Dreams."
配置	[sound:k-2764_配置.mp3]<br>はいち <br> arrangement (of resources), deployment, stationing, posting, disposition
arrangement (of resources), deployment, stationing, posting, disposition	<b>配置<b> <br> はいち <br>[sound:k-2764_配置.mp3]
[sound:k-2764_配置.mp3]	arrangement<br> <b>of resources), deployment, stationing, posting, disposition (配置</b> <br> (はいち)
<b>副産物</b> <br> 工場の生産過程で副産物が発生します。	[sound:s-2764_工場の生産過程で副産物が発生します。.mp3] <br> こうじょうのせいさんかていでふくさんぶつがはっせいします。 <br>Byproducts are generated during the manufacturing process in the factory.
[sound:s-2764_工場の生産過程で副産物が発生します。.mp3]	<b>副産物</b> <br> 工場の生産過程で副産物が発生します。<br> こうじょうのせいさんかていでふくさんぶつがはっせいします <br>Byproducts are generated during the manufacturing process in the factory.
拘置	[sound:k-2765_拘置.mp3]<br>こうち <br> detention, confinement, arrest
detention, confinement, arrest	<b>拘置<b> <br> こうち <br>[sound:k-2765_拘置.mp3]
[sound:k-2765_拘置.mp3]	detention, confinement, arrest<br> <b>拘置</b> <br> (こうち)
<b>副葬品</b> <br> 古代エジプトの墓には副葬品が多く納められていました。	[sound:s-2765_古代エジプトの墓には副葬品が多く納められていました。.mp3] <br> こだいえじぷとのはかにはふくそうひんがおおくおさめられていました。 <br>Many burial goods were placed in the tombs of ancient Egypt.
[sound:s-2765_古代エジプトの墓には副葬品が多く納められていました。.mp3]	<b>副葬品</b> <br> 古代エジプトの墓には副葬品が多く納められていました。<br> こだいえじぷとのはかにはふくそうひんがおおくおさめられていました <br>Many burial goods were placed in the tombs of ancient Egypt.
処置	[sound:k-2766_処置.mp3]<br>しょち <br> treatment, measure, step
treatment, measure, step	<b>処置<b> <br> しょち <br>[sound:k-2766_処置.mp3]
[sound:k-2766_処置.mp3]	treatment, measure, step<br> <b>処置</b> <br> (しょち)
<b>副業</b> <br> 彼は週末に副業で追加の収入を得ています。	[sound:s-2766_彼は週末に副業で追加の収入を得ています。.mp3] <br> かれはしゅうまつにふくぎょうでついかのしゅうにゅうをえています。 <br>He earns additional income from a side job on weekends.
[sound:s-2766_彼は週末に副業で追加の収入を得ています。.mp3]	<b>副業</b> <br> 彼は週末に副業で追加の収入を得ています。<br> かれはしゅうまつにふくぎょうでついかのしゅうにゅうをえています <br>He earns additional income from a side job on weekends.
拘置所	[sound:k-2767_拘置所.mp3]<br>こうちしょ <br> prison, detention house
prison, detention house	<b>拘置所<b> <br> こうちしょ <br>[sound:k-2767_拘置所.mp3]
[sound:k-2767_拘置所.mp3]	prison, detention house<br> <b>拘置所</b> <br> (こうちしょ)
<b>副将</b> <br> 彼は軍で副将の地位に昇進しました。	[sound:s-2767_彼は軍で副将の地位に昇進しました。.mp3] <br> かれはぐんでふくしょうのちいにしょうしんしました。 <br>He was promoted to the rank of vice general in the army.
[sound:s-2767_彼は軍で副将の地位に昇進しました。.mp3]	<b>副将</b> <br> 彼は軍で副将の地位に昇進しました。<br> かれはぐんでふくしょうのちいにしょうしんしました <br>He was promoted to the rank of vice general in the army.
据え置き	[sound:k-2768_据え置き.mp3]<br>すえおき <br> deferment (e.g. of savings), leaving (a thing) as it stands
deferment (e.g. of savings), leaving (a thing) as it stands	<b>据え置き<b> <br> すえおき <br>[sound:k-2768_据え置き.mp3]
[sound:k-2768_据え置き.mp3]	deferment<br> <b>e.g. of savings), leaving (a thing) as it stands (据え置き</b> <br> (すえおき)
<b>副読本</b> <br> その教科書には副読本として付属のCDがあります。	[sound:s-2768_その教科書には副読本として付属のCDがあります。.mp3] <br> そのきょうかほんにはふくどくほんとしてふぞくのCDがあります。 <br>The textbook comes with a supplementary CD as a companion reader.
[sound:s-2768_その教科書には副読本として付属のCDがあります。.mp3]	<b>副読本</b> <br> その教科書には副読本として付属のCDがあります。<br> そのきょうかほんにはふくどくほんとしてふぞくのCDがあります <br>The textbook comes with a supplementary CD as a companion reader.
位置付け	[sound:k-2769_位置付け.mp3]<br>いちづけ, いちつけ <br> placement, fixed position, mapping out, location
placement, fixed position, mapping out, location	<b>位置付け<b> <br> いちづけ, いちつけ <br>[sound:k-2769_位置付け.mp3]
[sound:k-2769_位置付け.mp3]	placement, fixed position, mapping out, location<br> <b>位置付け</b> <br> (いちづけ, いちつけ)
<b>予算</b> <br> 会社の来年の予算はまだ決まっていません。	[sound:s-2769_会社の来年の予算はまだ決まっていません。.mp3] <br> かいしゃのらいねんのよさんはまだきまっていません。 <br>The company's budget for next year has not been decided yet.
[sound:s-2769_会社の来年の予算はまだ決まっていません。.mp3]	<b>予算</b> <br> 会社の来年の予算はまだ決まっていません。<br> かいしゃのらいねんのよさんはまだきまっていません <br>The company's budget for next year has not been decided yet.
企業	[sound:k-2770_企業.mp3]<br>きぎょう <br> enterprise, undertaking, corporation, business
enterprise, undertaking, corporation, business	<b>企業<b> <br> きぎょう <br>[sound:k-2770_企業.mp3]
[sound:k-2770_企業.mp3]	enterprise, undertaking, corporation, business<br> <b>企業</b> <br> (きぎょう)
<b>決算</b> <br> 会社の決算報告書が公開されました。	[sound:s-2770_会社の決算報告書が公開されました。.mp3] <br> かいしゃのけっさんほうこくしょがこうかいされました。 <br>The company's financial statements have been published.
[sound:s-2770_会社の決算報告書が公開されました。.mp3]	<b>決算</b> <br> 会社の決算報告書が公開されました。<br> かいしゃのけっさんほうこくしょがこうかいされました <br>The company's financial statements have been published.
企画	[sound:k-2771_企画.mp3]<br>きかく <br> planning, project, plan, design
planning, project, plan, design	<b>企画<b> <br> きかく <br>[sound:k-2771_企画.mp3]
[sound:k-2771_企画.mp3]	planning, project, plan, design<br> <b>企画</b> <br> (きかく)
<b>通算</b> <br> 彼の通算成績は非常に優れています。	[sound:s-2771_彼の通算成績は非常に優れています。.mp3] <br> かれのつうさんせいせきはひじょうにすぐれています。 <br>His overall performance is exceptionally good.
[sound:s-2771_彼の通算成績は非常に優れています。.mp3]	<b>通算</b> <br> 彼の通算成績は非常に優れています。<br> かれのつうさんせいせきはひじょうにすぐれています <br>His overall performance is exceptionally good.
中小企業	[sound:k-2772_中小企業.mp3]<br>ちゅうしょうきぎょう <br> small to medium enterprises, smaller companies
small to medium enterprises, smaller companies	<b>中小企業<b> <br> ちゅうしょうきぎょう <br>[sound:k-2772_中小企業.mp3]
[sound:k-2772_中小企業.mp3]	small to medium enterprises, smaller companies<br> <b>中小企業</b> <br> (ちゅうしょうきぎょう)
<b>計算</b> <br> 数学の計算問題が難しいです。	[sound:s-2772_数学の計算問題が難しいです。.mp3] <br> すうがくのけいさんもんだいがむずかしいです。 <br>Math calculation problems are difficult.
[sound:s-2772_数学の計算問題が難しいです。.mp3]	<b>計算</b> <br> 数学の計算問題が難しいです。<br> すうがくのけいさんもんだいがむずかしいです <br>Math calculation problems are difficult.
大企業	[sound:k-2773_大企業.mp3]<br>だいきぎょう <br> large company, enterprise
large company, enterprise	<b>大企業<b> <br> だいきぎょう <br>[sound:k-2773_大企業.mp3]
[sound:k-2773_大企業.mp3]	large company, enterprise<br> <b>大企業</b> <br> (だいきぎょう)
<b>補正予算</b> <br> 今年の補正予算案が提出されました。	[sound:s-2773_今年の補正予算案が提出されました。.mp3] <br> ことしのほせいよさんあんがていしゅつされました。 <br>This year's supplementary budget proposal has been submitted.
[sound:s-2773_今年の補正予算案が提出されました。.mp3]	<b>補正予算</b> <br> 今年の補正予算案が提出されました。<br> ことしのほせいよさんあんがていしゅつされました <br>This year's supplementary budget proposal has been submitted.
経企庁	[sound:k-2774_経企庁.mp3]<br>けいきちょう <br> Economic Planning Agency
Economic Planning Agency	<b>経企庁<b> <br> けいきちょう <br>[sound:k-2774_経企庁.mp3]
[sound:k-2774_経企庁.mp3]	Economic Planning Agency<br> <b>経企庁</b> <br> (けいきちょう)
<b>公算</b> <br> 彼の成功は皆が公算していたことではありませんでした。	[sound:s-2774_彼の成功は皆が公算していたことではありませんでした。.mp3] <br> かれのせいこうはみながこうさんしていたことではありませんでした。 <br>His success was not something everyone had anticipated.
[sound:s-2774_彼の成功は皆が公算していたことではありませんでした。.mp3]	<b>公算</b> <br> 彼の成功は皆が公算していたことではありませんでした。<br> かれのせいこうはみながこうさんしていたことではありませんでした <br>His success was not something everyone had anticipated.
経済企画庁	[sound:k-2775_経済企画庁.mp3]<br>けいざいきかくちょう <br> Economic Planning Agency
Economic Planning Agency	<b>経済企画庁<b> <br> けいざいきかくちょう <br>[sound:k-2775_経済企画庁.mp3]
[sound:k-2775_経済企画庁.mp3]	Economic Planning Agency<br> <b>経済企画庁</b> <br> (けいざいきかくちょう)
<b>概算</b> <br> 予算の概算を行った後で、詳細な検討を行います。	[sound:s-2775_予算の概算を行った後で、詳細な検討を行います。.mp3] <br> よさんのがいさんをおこなったあとで、しょうさいなけんとうをおこないます。 <br>"After making a rough estimate of the budget, we will conduct a detailed review."
[sound:s-2775_予算の概算を行った後で、詳細な検討を行います。.mp3]	<b>概算</b> <br> 予算の概算を行った後で、詳細な検討を行います。<br> よさんのがいさんをおこなったあとで、しょうさいなけんとうをおこないます <br>After making a rough estimate of the budget, we will conduct a detailed review.
企業家	[sound:k-2776_企業家.mp3]<br>きぎょうか <br> industrialist, entrepreneur
industrialist, entrepreneur	<b>企業家<b> <br> きぎょうか <br>[sound:k-2776_企業家.mp3]
[sound:k-2776_企業家.mp3]	industrialist, entrepreneur<br> <b>企業家</b> <br> (きぎょうか)
<b>試算</b> <br> 新プロジェクトの収益を試算してみましょう。	[sound:s-2776_新プロジェクトの収益を試算してみましょう。.mp3] <br> しんぷろじぇくとのしゅうえきをしさんしてみましょう。 <br>Let's estimate the revenue of the new project.
[sound:s-2776_新プロジェクトの収益を試算してみましょう。.mp3]	<b>試算</b> <br> 新プロジェクトの収益を試算してみましょう。<br> しんぷろじぇくとのしゅうえきをしさんしてみましょう <br>Let's estimate the revenue of the new project.
企画室	[sound:k-2777_企画室.mp3]<br>きかくしつ <br> planning office
planning office	<b>企画室<b> <br> きかくしつ <br>[sound:k-2777_企画室.mp3]
[sound:k-2777_企画室.mp3]	planning office<br> <b>企画室</b> <br> (きかくしつ)
<b>採算</b> <br> このビジネスが採算が合わない場合、継続することは難しいかもしれません。	[sound:s-2777_このビジネスが採算が合わない場合、継続することは難しいかもしれません。.mp3] <br> このびじねすがさいさんがあわないばあい、けいぞくすることはむずかしいかもしれません。 <br>"If this business doesn't turn a profit, it may be difficult to continue."
[sound:s-2777_このビジネスが採算が合わない場合、継続することは難しいかもしれません。.mp3]	<b>採算</b> <br> このビジネスが採算が合わない場合、継続することは難しいかもしれません。<br> このびじねすがさいさんがあわないばあい、けいぞくすることはむずかしいかもしれません <br>If this business doesn't turn a profit, it may be difficult to continue.
私企業	[sound:k-2778_私企業.mp3]<br>しきぎょう <br> private enterprise
private enterprise	<b>私企業<b> <br> しきぎょう <br>[sound:k-2778_私企業.mp3]
[sound:k-2778_私企業.mp3]	private enterprise<br> <b>私企業</b> <br> (しきぎょう)
<b>清算</b> <br> 会社の清算手続きが完了しました。	[sound:s-2778_会社の清算手続きが完了しました。.mp3] <br> かいしゃのせいさんてつづきがかんりょうしました。 <br>The company's liquidation process has been completed.
[sound:s-2778_会社の清算手続きが完了しました。.mp3]	<b>清算</b> <br> 会社の清算手続きが完了しました。<br> かいしゃのせいさんてつづきがかんりょうしました <br>The company's liquidation process has been completed.
中小企業庁	[sound:k-2779_中小企業庁.mp3]<br>ちゅうしょうきぎょうちょう <br> (Japanese) Small and Medium Enterprise Agency
(Japanese) Small and Medium Enterprise Agency	<b>中小企業庁<b> <br> ちゅうしょうきぎょうちょう <br>[sound:k-2779_中小企業庁.mp3]
[sound:k-2779_中小企業庁.mp3]	(Japanese) Small and Medium Enterprise Agency<br> <b>中小企業庁</b> <br> (ちゅうしょうきぎょうちょう)
<b>監視</b> <br> セキュリティカメラが店内を監視しています。	[sound:s-2779_セキュリティカメラが店内を監視しています。.mp3] <br> せきゅりてぃかめらがてんないをかんししています。 <br>Security cameras are monitoring the store.
[sound:s-2779_セキュリティカメラが店内を監視しています。.mp3]	<b>監視</b> <br> セキュリティカメラが店内を監視しています。<br> せきゅりてぃかめらがてんないをかんししています <br>Security cameras are monitoring the store.
写真	[sound:k-2780_写真.mp3]<br>しゃしん <br> photograph, photo; movie
photograph, photo; movie	<b>写真<b> <br> しゃしん <br>[sound:k-2780_写真.mp3]
[sound:k-2780_写真.mp3]	photograph, photo; movie<br> <b>写真</b> <br> (しゃしん)
<b>警視庁</b> <br> 東京都の警視庁は治安維持に努めています。	[sound:s-2780_東京都の警視庁は治安維持に努めています。.mp3] <br> とうきょうとのけいしちょうはちあんいじにつとめています。 <br>The Tokyo Metropolitan Police Department is working to maintain public order.
[sound:s-2780_東京都の警視庁は治安維持に努めています。.mp3]	<b>警視庁</b> <br> 東京都の警視庁は治安維持に努めています。<br> とうきょうとのけいしちょうはちあんいじにつとめています <br>The Tokyo Metropolitan Police Department is working to maintain public order.
真の	[sound:k-2781_真の.mp3]<br>しんの <br> true, real, genuine, proper, utter
true, real, genuine, proper, utter	<b>真の<b> <br> しんの <br>[sound:k-2781_真の.mp3]
[sound:k-2781_真の.mp3]	true, real, genuine, proper, utter<br> <b>真の</b> <br> (しんの)
<b>視点</b> <br> 問題を別の視点から考えてみましょう。	[sound:s-2781_問題を別の視点から考えてみましょう。.mp3] <br> もんだいをべつのしてんからかんがえてみましょう。 <br>Let's consider the problem from a different perspective.
[sound:s-2781_問題を別の視点から考えてみましょう。.mp3]	<b>視点</b> <br> 問題を別の視点から考えてみましょう。<br> もんだいをべつのしてんからかんがえてみましょう <br>Let's consider the problem from a different perspective.
真相	[sound:k-2782_真相.mp3]<br>しんそう <br> truth, real situation
truth, real situation	<b>真相<b> <br> しんそう <br>[sound:k-2782_真相.mp3]
[sound:k-2782_真相.mp3]	truth, real situation<br> <b>真相</b> <br> (しんそう)
<b>重視</b> <br> この企画では顧客の意見を重視しています。	[sound:s-2782_この企画では顧客の意見を重視しています。.mp3] <br> このきかくではこきゃくのいけんをじゅうししています。 <br>This plan gives importance to the opinions of customers.
[sound:s-2782_この企画では顧客の意見を重視しています。.mp3]	<b>重視</b> <br> この企画では顧客の意見を重視しています。<br> このきかくではこきゃくのいけんをじゅうししています <br>This plan gives importance to the opinions of customers.
真実	[sound:k-2783_真実.mp3]<br>しんじつ, さな, さね <br> truth, reality
truth, reality	<b>真実<b> <br> しんじつ, さな, さね <br>[sound:k-2783_真実.mp3]
[sound:k-2783_真実.mp3]	truth, reality<br> <b>真実</b> <br> (しんじつ, さな, さね)
<b>視聴率</b> <br> その番組は高い視聴率を誇っています。	[sound:s-2783_その番組は高い視聴率を誇っています。.mp3] <br> そのばんぐみはたかいしちょうりつをほこっています。 <br>That program boasts high viewer ratings.
[sound:s-2783_その番組は高い視聴率を誇っています。.mp3]	<b>視聴率</b> <br> その番組は高い視聴率を誇っています。<br> そのばんぐみはたかいしちょうりつをほこっています <br>That program boasts high viewer ratings.
真ん中	[sound:k-2784_真ん中.mp3]<br>まんなか, まなか <br> middle, centre, center, mid-way
middle, centre, center, mid-way	<b>真ん中<b> <br> まんなか, まなか <br>[sound:k-2784_真ん中.mp3]
[sound:k-2784_真ん中.mp3]	middle, centre, center, mid-way<br> <b>真ん中</b> <br> (まんなか, まなか)
<b>視野</b> <br> 彼は将来の展望を広い視野で考えています。	[sound:s-2784_彼は将来の展望を広い視野で考えています。.mp3] <br> かれはしょうらいのてんぼうをひろいしやでかんがえています。 <br>He is considering future prospects with a broad perspective.
[sound:s-2784_彼は将来の展望を広い視野で考えています。.mp3]	<b>視野</b> <br> 彼は将来の展望を広い視野で考えています。<br> かれはしょうらいのてんぼうをひろいしやでかんがえています <br>He is considering future prospects with a broad perspective.
真意	[sound:k-2785_真意.mp3]<br>しんい <br> real intention, true motive, true meaning
real intention, true motive, true meaning	<b>真意<b> <br> しんい <br>[sound:k-2785_真意.mp3]
[sound:k-2785_真意.mp3]	real intention, true motive, true meaning<br> <b>真意</b> <br> (しんい)
<b>視察</b> <br> 経営者が工場を視察しました。	[sound:s-2785_経営者が工場を視察しました。.mp3] <br> けいえいしゃがこうじょうをしさつしました。 <br>The manager inspected the factory.
[sound:s-2785_経営者が工場を視察しました。.mp3]	<b>視察</b> <br> 経営者が工場を視察しました。<br> けいえいしゃがこうじょうをしさつしました <br>The manager inspected the factory.
写真集	[sound:k-2786_写真集.mp3]<br>しゃしんしゅう <br> collection of photographs, photoalbum
collection of photographs, photoalbum	<b>写真集<b> <br> しゃしんしゅう <br>[sound:k-2786_写真集.mp3]
[sound:k-2786_写真集.mp3]	collection of photographs, photoalbum<br> <b>写真集</b> <br> (しゃしんしゅう)
<b>視聴者</b> <br> テレビ番組の視聴者が増えています。	[sound:s-2786_テレビ番組の視聴者が増えています。.mp3] <br> てれびばんぐみのしちょうしゃがふえています。 <br>The viewership of the TV program is increasing.
[sound:s-2786_テレビ番組の視聴者が増えています。.mp3]	<b>視聴者</b> <br> テレビ番組の視聴者が増えています。<br> てれびばんぐみのしちょうしゃがふえています <br>The viewership of the TV program is increasing.
真理	[sound:k-2787_真理.mp3]<br>しんり <br> truth
truth	<b>真理<b> <br> しんり <br>[sound:k-2787_真理.mp3]
[sound:k-2787_真理.mp3]	truth<br> <b>真理</b> <br> (しんり)
<b>視線</b> <br> 彼の視線が私に向けられている。	[sound:s-2787_彼の視線が私に向けられている。.mp3] <br> かれのしせんがわたしにむけられている。 <br>His gaze is directed towards me.
[sound:s-2787_彼の視線が私に向けられている。.mp3]	<b>視線</b> <br> 彼の視線が私に向けられている。<br> かれのしせんがわたしにむけられている <br>His gaze is directed towards me.
真っ暗	[sound:k-2788_真っ暗.mp3]<br>まっくら <br> total darkness, pitch dark; bleak future, poor prospects
total darkness, pitch dark; bleak future, poor prospects	<b>真っ暗<b> <br> まっくら <br>[sound:k-2788_真っ暗.mp3]
[sound:k-2788_真っ暗.mp3]	total darkness, pitch dark; bleak future, poor prospects<br> <b>真っ暗</b> <br> (まっくら)
<b>視覚</b> <br> 絵画は私たちの視覚を刺激します。	[sound:s-2788_絵画は私たちの視覚を刺激します。.mp3] <br> かいがはわたしたちのしかくをしげきします。 <br>Paintings stimulate our visual senses.
[sound:s-2788_絵画は私たちの視覚を刺激します。.mp3]	<b>視覚</b> <br> 絵画は私たちの視覚を刺激します。<br> かいがはわたしたちのしかくをしげきします <br>Paintings stimulate our visual senses.
真珠湾	[sound:k-2789_真珠湾.mp3]<br>しんじゅわん <br> Pearl Harbor
Pearl Harbor	<b>真珠湾<b> <br> しんじゅわん <br>[sound:k-2789_真珠湾.mp3]
[sound:k-2789_真珠湾.mp3]	Pearl Harbor<br> <b>真珠湾</b> <br> (しんじゅわん)
<b>条件</b> <br> 成功するためには、厳しい条件を受け入れなければなりません。	[sound:s-2789_成功するためには、厳しい条件を受け入れなければなりません。.mp3] <br> せいこうするためには、きびしいじょうけんをうけいれなければなりません。 <br>"To succeed, one must accept tough conditions."
[sound:s-2789_成功するためには、厳しい条件を受け入れなければなりません。.mp3]	<b>条件</b> <br> 成功するためには、厳しい条件を受け入れなければなりません。<br> せいこうするためには、きびしいじょうけんをうけいれなければなりません <br>To succeed, one must accept tough conditions.
流れ	[sound:k-2790_流れ.mp3]<br>ながれ <br> stream, current, flow
stream, current, flow	<b>流れ<b> <br> ながれ <br>[sound:k-2790_流れ.mp3]
[sound:k-2790_流れ.mp3]	stream, current, flow<br> <b>流れ</b> <br> (ながれ)
<b>条約</b> <br> 両国間で新しい貿易条約が締結されました。	[sound:s-2790_両国間で新しい貿易条約が締結されました。.mp3] <br> りょうこくかんであたらしいぼうえきじょうやくがていけつされました。 <br>A new trade treaty was signed between the two countries.
[sound:s-2790_両国間で新しい貿易条約が締結されました。.mp3]	<b>条約</b> <br> 両国間で新しい貿易条約が締結されました。<br> りょうこくかんであたらしいぼうえきじょうやくがていけつされました <br>A new trade treaty was signed between the two countries.
交流	[sound:k-2791_交流.mp3]<br>こうりゅう <br> intercourse, (cultural) exchange, intermingling; alternating current, AC
intercourse, (cultural) exchange, intermingling; alternating current, AC	<b>交流<b> <br> こうりゅう <br>[sound:k-2791_交流.mp3]
[sound:k-2791_交流.mp3]	intercourse,<br> <b>cultural) exchange, intermingling; alternating current, AC (交流</b> <br> (こうりゅう)
<b>条項</b> <br> 契約書の重要な条項を確認してください。	[sound:s-2791_契約書の重要な条項を確認してください。.mp3] <br> けいやくしょのじゅうようなじょうこうをかくにんしてください。 <br>Please review the important clauses of the contract.
[sound:s-2791_契約書の重要な条項を確認してください。.mp3]	<b>条項</b> <br> 契約書の重要な条項を確認してください。<br> けいやくしょのじゅうようなじょうこうをかくにんしてください <br>Please review the important clauses of the contract.
流す	[sound:k-2792_流す.mp3]<br>ながす <br> to drain, to pour, to spill, to shed (blood, tears); to wash away; to distribute (e.g. electricity over wires, music over a PA system, etc.), to circulate, to broadcast, to beam; to cruise (e.g. taxi); to float, to set adrift
to drain, to pour, to spill, to shed (blood, tears); to wash away; to distribute (e.g. electricity over wires, music over a PA system, etc.), to circulate, to broadcast, to beam; to cruise (e.g. taxi); to float, to set adrift	<b>流す<b> <br> ながす <br>[sound:k-2792_流す.mp3]
[sound:k-2792_流す.mp3]	to drain, to pour, to spill, to shed<br> <b>blood, tears); to wash away; to distribute (e.g. electricity over wires, music over a PA system, etc.), to circulate, to broadcast, to beam; to cruise (e.g. taxi); to float, to set adrift (流す</b> <br> (ながす)
<b>条例</b> <br> その都市では、深夜の騒音を制限する条例があります。	[sound:s-2792_その都市では、深夜の騒音を制限する条例があります。.mp3] <br> そのとしでは、しんやのそうおんをせいげんするじょうれいがあります。 <br>"In that city, there is an ordinance to restrict late-night noise."
[sound:s-2792_その都市では、深夜の騒音を制限する条例があります。.mp3]	<b>条例</b> <br> その都市では、深夜の騒音を制限する条例があります。<br> そのとしでは、しんやのそうおんをせいげんするじょうれいがあります <br>In that city, there is an ordinance to restrict late-night noise.
流通	[sound:k-2793_流通.mp3]<br>りゅうつう <br> circulation of money or goods, flow of water or air, distribution; negotiable (e.g. shares)
circulation of money or goods, flow of water or air, distribution; negotiable (e.g. shares)	<b>流通<b> <br> りゅうつう <br>[sound:k-2793_流通.mp3]
[sound:k-2793_流通.mp3]	circulation of money or goods, flow of water or air, distribution; negotiable<br> <b>e.g. shares) (流通</b> <br> (りゅうつう)
<b>条件付き</b> <br> この契約は条件付きで有効です。	[sound:s-2793_この契約は条件付きで有効です。.mp3] <br> このけいやくはじょうけんつきでゆうこうです。 <br>This contract is valid under certain conditions.
[sound:s-2793_この契約は条件付きで有効です。.mp3]	<b>条件付き</b> <br> この契約は条件付きで有効です。<br> このけいやくはじょうけんつきでゆうこうです <br>This contract is valid under certain conditions.
主流	[sound:k-2794_主流.mp3]<br>しゅりゅう <br> main current (stream), mainline, mainstream
main current (stream), mainline, mainstream	<b>主流<b> <br> しゅりゅう <br>[sound:k-2794_主流.mp3]
[sound:k-2794_主流.mp3]	main current<br> <b>stream), mainline, mainstream (主流</b> <br> (しゅりゅう)
<b>無条件</b> <br> 愛は無条件で人々を包み込みます。	[sound:s-2794_愛は無条件で人々を包み込みます。.mp3] <br> あいはむじょうけんでひとびとをつつみこみます。 <br>Love embraces people unconditionally.
[sound:s-2794_愛は無条件で人々を包み込みます。.mp3]	<b>無条件</b> <br> 愛は無条件で人々を包み込みます。<br> あいはむじょうけんでひとびとをつつみこみます <br>Love embraces people unconditionally.
流出	[sound:k-2795_流出.mp3]<br>りゅうしゅつ <br> discharge, outward flow, efflux, effluence; leak of (private) information or pictures
discharge, outward flow, efflux, effluence; leak of (private) information or pictures	<b>流出<b> <br> りゅうしゅつ <br>[sound:k-2795_流出.mp3]
[sound:k-2795_流出.mp3]	discharge, outward flow, efflux, effluence; leak of<br> <b>private) information or pictures (流出</b> <br> (りゅうしゅつ)
<b>労働条件</b> <br> その企業は良い労働条件を提供しています。	[sound:s-2795_その企業は良い労働条件を提供しています。.mp3] <br> そのきぎょうはよいろうどうじょうけんをていきょうしています。 <br>The company provides good working conditions.
[sound:s-2795_その企業は良い労働条件を提供しています。.mp3]	<b>労働条件</b> <br> その企業は良い労働条件を提供しています。<br> そのきぎょうはよいろうどうじょうけんをていきょうしています <br>The company provides good working conditions.
流行	[sound:k-2796_流行.mp3]<br>りゅうこう, はやり <br> fashion, fad, vogue, craze
fashion, fad, vogue, craze	<b>流行<b> <br> りゅうこう, はやり <br>[sound:k-2796_流行.mp3]
[sound:k-2796_流行.mp3]	fashion, fad, vogue, craze<br> <b>流行</b> <br> (りゅうこう, はやり)
<b>条文</b> <br> 法律の条文を理解するのは難しいことです。	[sound:s-2796_法律の条文を理解するのは難しいことです。.mp3] <br> ほうりつのじょうぶんをりかいするのはむずかしいことです。 <br>Understanding legal texts is difficult.
[sound:s-2796_法律の条文を理解するのは難しいことです。.mp3]	<b>条文</b> <br> 法律の条文を理解するのは難しいことです。<br> ほうりつのじょうぶんをりかいするのはむずかしいことです <br>Understanding legal texts is difficult.
一流	[sound:k-2797_一流.mp3]<br>いちりゅう <br> first-class, top grade, school (of art), foremost, top-notch, unique
first-class, top grade, school (of art), foremost, top-notch, unique	<b>一流<b> <br> いちりゅう <br>[sound:k-2797_一流.mp3]
[sound:k-2797_一流.mp3]	first-class, top grade, school<br> <b>of art), foremost, top-notch, unique (一流</b> <br> (いちりゅう)
<b>信条</b> <br> 彼は自分の信条に忠実です。	[sound:s-2797_彼は自分の信条に忠実です。.mp3] <br> かれはじぶんのしんじょうにちゅうじつです。 <br>He is faithful to his beliefs.
[sound:s-2797_彼は自分の信条に忠実です。.mp3]	<b>信条</b> <br> 彼は自分の信条に忠実です。<br> かれはじぶんのしんじょうにちゅうじつです <br>He is faithful to his beliefs.
流動	[sound:k-2798_流動.mp3]<br>りゅうどう <br> flow
flow	<b>流動<b> <br> りゅうどう <br>[sound:k-2798_流動.mp3]
[sound:k-2798_流動.mp3]	flow<br> <b>流動</b> <br> (りゅうどう)
<b>一条</b> <br> 彼の提案は一条のみで否定されました。	[sound:s-2798_彼の提案は一条のみで否定されました。.mp3] <br> かれのていあんはいちじょうのみでひていされました。 <br>His proposal was rejected on a single point.
[sound:s-2798_彼の提案は一条のみで否定されました。.mp3]	<b>一条</b> <br> 彼の提案は一条のみで否定されました。<br> かれのていあんはいちじょうのみでひていされました <br>His proposal was rejected on a single point.
火砕流	[sound:k-2799_火砕流.mp3]<br>かさいりゅう <br> pyroclastic flow (type of volcanic eruption), stone wind
pyroclastic flow (type of volcanic eruption), stone wind	<b>火砕流<b> <br> かさいりゅう <br>[sound:k-2799_火砕流.mp3]
[sound:k-2799_火砕流.mp3]	pyroclastic flow<br> <b>type of volcanic eruption), stone wind (火砕流</b> <br> (かさいりゅう)
<b>幹</b> <br> この木の幹は太くて丈夫です。	[sound:s-2799_この木の幹は太くて丈夫です。.mp3] <br> このきのみきはふとくてじょうぶです。 <br>The trunk of this tree is thick and strong.
[sound:s-2799_この木の幹は太くて丈夫です。.mp3]	<b>幹</b> <br> この木の幹は太くて丈夫です。<br> このきのみきはふとくてじょうぶです <br>The trunk of this tree is thick and strong.
価格	[sound:k-2800_価格.mp3]<br>かかく <br> price, value, cost
price, value, cost	<b>価格<b> <br> かかく <br>[sound:k-2800_価格.mp3]
[sound:k-2800_価格.mp3]	price, value, cost<br> <b>価格</b> <br> (かかく)
<b>幹事</b> <br> イベントの幹事はスケジュールを管理します。	[sound:s-2800_イベントの幹事はスケジュールを管理します。.mp3] <br> いべんとのかんじはすけじゅーるをかんりします。 <br>The organizer of the event manages the schedule.
[sound:s-2800_イベントの幹事はスケジュールを管理します。.mp3]	<b>幹事</b> <br> イベントの幹事はスケジュールを管理します。<br> いべんとのかんじはすけじゅーるをかんりします <br>The organizer of the event manages the schedule.
格差	[sound:k-2801_格差.mp3]<br>かくさ <br> qualitative difference, disparity
qualitative difference, disparity	<b>格差<b> <br> かくさ <br>[sound:k-2801_格差.mp3]
[sound:k-2801_格差.mp3]	qualitative difference, disparity<br> <b>格差</b> <br> (かくさ)
<b>幹部</b> <br> その会社の幹部は次の戦略を検討しています。	[sound:s-2801_その会社の幹部は次の戦略を検討しています。.mp3] <br> そのかいしゃのかんぶはつぎのせんりゃくをけんとうしています。 <br>The executives of the company are considering the next strategy.
[sound:s-2801_その会社の幹部は次の戦略を検討しています。.mp3]	<b>幹部</b> <br> その会社の幹部は次の戦略を検討しています。<br> そのかいしゃのかんぶはつぎのせんりゃくをけんとうしています <br>The executives of the company are considering the next strategy.
資格	[sound:k-2802_資格.mp3]<br>しかく <br> qualifications, requirements, capabilities
qualifications, requirements, capabilities	<b>資格<b> <br> しかく <br>[sound:k-2802_資格.mp3]
[sound:k-2802_資格.mp3]	qualifications, requirements, capabilities<br> <b>資格</b> <br> (しかく)
<b>新幹線</b> <br> 新幹線での移動は快適です。	[sound:s-2802_新幹線での移動は快適です。.mp3] <br> しんかんせんでのいどうはかいてきです。 <br>Traveling by Shinkansen is comfortable.
[sound:s-2802_新幹線での移動は快適です。.mp3]	<b>新幹線</b> <br> 新幹線での移動は快適です。<br> しんかんせんでのいどうはかいてきです <br>Traveling by Shinkansen is comfortable.
性格	[sound:k-2803_性格.mp3]<br>せいかく <br> character, personality
character, personality	<b>性格<b> <br> せいかく <br>[sound:k-2803_性格.mp3]
[sound:k-2803_性格.mp3]	character, personality<br> <b>性格</b> <br> (せいかく)
<b>根幹</b> <br> この計画の根幹は地域の発展にあります。	[sound:s-2803_この計画の根幹は地域の発展にあります。.mp3] <br> このけいかくのこんかんはちいきのはってんにあります。 <br>The essence of this plan lies in the development of the region.
[sound:s-2803_この計画の根幹は地域の発展にあります。.mp3]	<b>根幹</b> <br> この計画の根幹は地域の発展にあります。<br> このけいかくのこんかんはちいきのはってんにあります <br>The essence of this plan lies in the development of the region.
本格	[sound:k-2804_本格.mp3]<br>ほんかく <br> original method or procedure; serious, orthodox, classical, genuine
original method or procedure; serious, orthodox, classical, genuine	<b>本格<b> <br> ほんかく <br>[sound:k-2804_本格.mp3]
[sound:k-2804_本格.mp3]	original method or procedure; serious, orthodox, classical, genuine<br> <b>本格</b> <br> (ほんかく)
<b>幹線</b> <br> この道路は都市間を結ぶ幹線道路です。	[sound:s-2804_この道路は都市間を結ぶ幹線道路です。.mp3] <br> このどうろはとしけんをむすぶかんせんどうろです。 <br>This road is a main artery connecting cities.
[sound:s-2804_この道路は都市間を結ぶ幹線道路です。.mp3]	<b>幹線</b> <br> この道路は都市間を結ぶ幹線道路です。<br> このどうろはとしけんをむすぶかんせんどうろです <br>This road is a main artery connecting cities.
本格的	[sound:k-2805_本格的.mp3]<br>ほんかくてき <br> full-blown, regular, genuine, earnest, normal, typical, fundamental, real
full-blown, regular, genuine, earnest, normal, typical, fundamental, real	<b>本格的<b> <br> ほんかくてき <br>[sound:k-2805_本格的.mp3]
[sound:k-2805_本格的.mp3]	full-blown, regular, genuine, earnest, normal, typical, fundamental, real<br> <b>本格的</b> <br> (ほんかくてき)
<b>主幹</b> <br> この会議の主幹は彼女です。	[sound:s-2805_この会議の主幹は彼女です。.mp3] <br> このかいぎのしゅかんはかのじょです。 <br>She is the main organizer of this meeting.
[sound:s-2805_この会議の主幹は彼女です。.mp3]	<b>主幹</b> <br> この会議の主幹は彼女です。<br> このかいぎのしゅかんはかのじょです <br>She is the main organizer of this meeting.
格好	[sound:k-2806_格好.mp3]<br>かっこう, カッコ <br> shape, form, posture, appearance, manner; suitability, moderateness (in price)
shape, form, posture, appearance, manner; suitability, moderateness (in price)	<b>格好<b> <br> かっこう, カッコ <br>[sound:k-2806_格好.mp3]
[sound:k-2806_格好.mp3]	shape, form, posture, appearance, manner; suitability, moderateness<br> <b>in price) (格好</b> <br> (かっこう, カッコ)
<b>基幹</b> <br> インフラの整備は都市の基幹を支えます。	[sound:s-2806_インフラの整備は都市の基幹を支えます。.mp3] <br> いんふらのせいびはとしきこうかんをささえます。 <br>Infrastructure development supports the backbone of cities.
[sound:s-2806_インフラの整備は都市の基幹を支えます。.mp3]	<b>基幹</b> <br> インフラの整備は都市の基幹を支えます。<br> いんふらのせいびはとしきこうかんをささえます <br>Infrastructure development supports the backbone of cities.
合格	[sound:k-2807_合格.mp3]<br>ごうかく <br> success, passing (e.g. exam), eligibility
success, passing (e.g. exam), eligibility	<b>合格<b> <br> ごうかく <br>[sound:k-2807_合格.mp3]
[sound:k-2807_合格.mp3]	success, passing<br> <b>e.g. exam), eligibility (合格</b> <br> (ごうかく)
<b>幹事会</b> <br> 今日の幹事会で次のイベントの計画を立てます。	[sound:s-2807_今日の幹事会で次のイベントの計画を立てます。.mp3] <br> きょうのかんじかいでつぎのいべんとのけいかくをたてます。 <br>Today's planning committee will plan the next event.
[sound:s-2807_今日の幹事会で次のイベントの計画を立てます。.mp3]	<b>幹事会</b> <br> 今日の幹事会で次のイベントの計画を立てます。<br> きょうのかんじかいでつぎのいべんとのけいかくをたてます <br>Today's planning committee will plan the next event.
本格化	[sound:k-2808_本格化.mp3]<br>ほんかくか <br> regularization, regularisation, getting up speed, proceeding at full tilt
regularization, regularisation, getting up speed, proceeding at full tilt	<b>本格化<b> <br> ほんかくか <br>[sound:k-2808_本格化.mp3]
[sound:k-2808_本格化.mp3]	regularization, regularisation, getting up speed, proceeding at full tilt<br> <b>本格化</b> <br> (ほんかくか)
<b>独自</b> <br> その企業は独自の技術を持っています。	[sound:s-2808_その企業は独自の技術を持っています。.mp3] <br> そのきぎょうはどくじのぎじゅつをもっています。 <br>The company has its own unique technology.
[sound:s-2808_その企業は独自の技術を持っています。.mp3]	<b>独自</b> <br> その企業は独自の技術を持っています。<br> そのきぎょうはどくじのぎじゅつをもっています <br>The company has its own unique technology.
規格	[sound:k-2809_規格.mp3]<br>きかく <br> standard, norm
standard, norm	<b>規格<b> <br> きかく <br>[sound:k-2809_規格.mp3]
[sound:k-2809_規格.mp3]	standard, norm<br> <b>規格</b> <br> (きかく)
<b>独立</b> <br> 彼女は独立心が強い人です。	[sound:s-2809_彼女は独立心が強い人です。.mp3] <br> かのじょはどくりつしんがつよいひとです。 <br>She is a person with a strong sense of independence.
[sound:s-2809_彼女は独立心が強い人です。.mp3]	<b>独立</b> <br> 彼女は独立心が強い人です。<br> かのじょはどくりつしんがつよいひとです <br>She is a person with a strong sense of independence.
有	[sound:k-2810_有.mp3]<br>ゆう <br> existence; possession, having; limited company
existence; possession, having; limited company	<b>有<b> <br> ゆう <br>[sound:k-2810_有.mp3]
[sound:k-2810_有.mp3]	existence; possession, having; limited company<br> <b>有</b> <br> (ゆう)
<b>単独</b> <br> 彼は単独でそのプロジェクトを完成させました。	[sound:s-2810_彼は単独でそのプロジェクトを完成させました。.mp3] <br> かれはたんどくでそのぷろじぇくとをかんせいさせました。 <br>He completed the project alone.
[sound:s-2810_彼は単独でそのプロジェクトを完成させました。.mp3]	<b>単独</b> <br> 彼は単独でそのプロジェクトを完成させました。<br> かれはたんどくでそのぷろじぇくとをかんせいさせました <br>He completed the project alone.
有効	[sound:k-2811_有効.mp3]<br>ゆうこう <br> validity, legality, availability, effectiveness
validity, legality, availability, effectiveness	<b>有効<b> <br> ゆうこう <br>[sound:k-2811_有効.mp3]
[sound:k-2811_有効.mp3]	validity, legality, availability, effectiveness<br> <b>有効</b> <br> (ゆうこう)
<b>独特</b> <br> この料理には独特の風味があります。	[sound:s-2811_この料理には独特の風味があります。.mp3] <br> このりょうりにはどくとくのふうみがあります。 <br>This dish has a unique flavor.
[sound:s-2811_この料理には独特の風味があります。.mp3]	<b>独特</b> <br> この料理には独特の風味があります。<br> このりょうりにはどくとくのふうみがあります <br>This dish has a unique flavor.
有力	[sound:k-2812_有力.mp3]<br>ゆうりょく <br> influential, prominent; strong, likely, plausible, potent
influential, prominent; strong, likely, plausible, potent	<b>有力<b> <br> ゆうりょく <br>[sound:k-2812_有力.mp3]
[sound:k-2812_有力.mp3]	influential, prominent; strong, likely, plausible, potent<br> <b>有力</b> <br> (ゆうりょく)
<b>独立国</b> <br> 彼らは独立国としての地位を宣言しました。	[sound:s-2812_彼らは独立国としての地位を宣言しました。.mp3] <br> かれらはどくりつこくとしてのちいをせんげんしました。 <br>They declared their status as an independent country.
[sound:s-2812_彼らは独立国としての地位を宣言しました。.mp3]	<b>独立国</b> <br> 彼らは独立国としての地位を宣言しました。<br> かれらはどくりつこくとしてのちいをせんげんしました <br>They declared their status as an independent country.
有権者	[sound:k-2813_有権者.mp3]<br>ゆうけんしゃ <br> voter, constituent, (electoral) franchise-holder, (the) electorate, eligible voters
voter, constituent, (electoral) franchise-holder, (the) electorate, eligible voters	<b>有権者<b> <br> ゆうけんしゃ <br>[sound:k-2813_有権者.mp3]
[sound:k-2813_有権者.mp3]	voter, constituent,<br> <b>electoral) franchise-holder, (the) electorate, eligible voters (有権者</b> <br> (ゆうけんしゃ)
<b>東独</b> <br> 東ドイツは西ドイツとは別の国でした。	[sound:s-2813_東ドイツは西ドイツとは別の国でした。.mp3] <br> ひがしドイツはにしドイツとはべつのくにでした。 <br>East Germany was a separate country from West Germany.
[sound:s-2813_東ドイツは西ドイツとは別の国でした。.mp3]	<b>東独</b> <br> 東ドイツは西ドイツとは別の国でした。<br> ひがしドイツはにしドイツとはべつのくにでした <br>East Germany was a separate country from West Germany.
有名	[sound:k-2814_有名.mp3]<br>ゆうめい <br> famous; fame
famous; fame	<b>有名<b> <br> ゆうめい <br>[sound:k-2814_有名.mp3]
[sound:k-2814_有名.mp3]	famous; fame<br> <b>有名</b> <br> (ゆうめい)
<b>独裁</b> <br> この国では独裁政治が行われています。	[sound:s-2814_この国では独裁政治が行われています。.mp3] <br> このくにではどくさいせいじがおこなわれています。 <br>This country is under a dictatorship.
[sound:s-2814_この国では独裁政治が行われています。.mp3]	<b>独裁</b> <br> この国では独裁政治が行われています。<br> このくにではどくさいせいじがおこなわれています <br>This country is under a dictatorship.
保有	[sound:k-2815_保有.mp3]<br>ほゆう <br> possession, retention, maintenance
possession, retention, maintenance	<b>保有<b> <br> ほゆう <br>[sound:k-2815_保有.mp3]
[sound:k-2815_保有.mp3]	possession, retention, maintenance<br> <b>保有</b> <br> (ほゆう)
<b>独占</b> <br> その企業は市場で独占的な地位を占めています。	[sound:s-2815_その企業は市場で独占的な地位を占めています。.mp3] <br> そのきぎょうはしじょうでどくせんてきなちいをしめています。 <br>The company holds a monopolistic position in the market.
[sound:s-2815_その企業は市場で独占的な地位を占めています。.mp3]	<b>独占</b> <br> その企業は市場で独占的な地位を占めています。<br> そのきぎょうはしじょうでどくせんてきなちいをしめています <br>The company holds a monopolistic position in the market.
有利	[sound:k-2816_有利.mp3]<br>ゆうり <br> advantageous, better, profitable, lucrative
advantageous, better, profitable, lucrative	<b>有利<b> <br> ゆうり <br>[sound:k-2816_有利.mp3]
[sound:k-2816_有利.mp3]	advantageous, better, profitable, lucrative<br> <b>有利</b> <br> (ゆうり)
<b>独禁法</b> <br> 独禁法は市場における競争を規制します。	[sound:s-2816_独禁法は市場における競争を規制します。.mp3] <br> どっきんほうはしじょうにおけるきょうそうをきせいします。 <br>Antitrust laws regulate competition in the market.
[sound:s-2816_独禁法は市場における競争を規制します。.mp3]	<b>独禁法</b> <br> 独禁法は市場における競争を規制します。<br> どっきんほうはしじょうにおけるきょうそうをきせいします <br>Antitrust laws regulate competition in the market.
所有	[sound:k-2817_所有.mp3]<br>しょゆう <br> one's possessions, ownership
one's possessions, ownership	<b>所有<b> <br> しょゆう <br>[sound:k-2817_所有.mp3]
[sound:k-2817_所有.mp3]	one's possessions, ownership<br> <b>所有</b> <br> (しょゆう)
<b>独身</b> <br> 彼はまだ独身です。	[sound:s-2817_彼はまだ独身です。.mp3] <br> かれはまだどくしんです。 <br>He is still single.
[sound:s-2817_彼はまだ独身です。.mp3]	<b>独身</b> <br> 彼はまだ独身です。<br> かれはまだどくしんです <br>He is still single.
