<b>真理</b> <br> 彼は哲学的な真理を探求しています。	[sound:s-1972_彼は哲学的な真理を探求しています。.mp3] <br> He is searching for philosophical truths. <br>
[sound:s-1972_彼は哲学的な真理を探求しています。.mp3]	(<b>真理</b>) 彼は哲学的な真理を探求しています。He is searching for philosophical truths. <br>
公認	[sound:k-1973_公認.mp3]<br>こうにん <br> official recognition, authorization, authorisation, licence, license, accreditation
official recognition, authorization, authorisation, licence, license, accreditation	<b>公認<b> <br> こうにん <br>[sound:k-1973_公認.mp3]
[sound:k-1973_公認.mp3]	official recognition, authorization, authorisation, licence, license, accreditation<br> <b>公認</b> <br> (こうにん)
<b>真っ暗</b> <br> 夜は真っ暗でした。	[sound:s-1973_夜は真っ暗でした。.mp3] <br> It was pitch black at night. <br>
[sound:s-1973_夜は真っ暗でした。.mp3]	(<b>真っ暗</b>) 夜は真っ暗でした。It was pitch black at night. <br>
認定	[sound:k-1974_認定.mp3]<br>にんてい <br> authorization, authorisation, acknowledgment, acknowledgement, certification, recognition
authorization, authorisation, acknowledgment, acknowledgement, certification, recognition	<b>認定<b> <br> にんてい <br>[sound:k-1974_認定.mp3]
[sound:k-1974_認定.mp3]	authorization, authorisation, acknowledgment, acknowledgement, certification, recognition<br> <b>認定</b> <br> (にんてい)
<b>真珠湾</b> <br> 真珠湾攻撃はアメリカを巻き込んだ。	[sound:s-1974_真珠湾攻撃はアメリカを巻き込んだ。.mp3] <br> The attack on Pearl Harbor involved the United States. <br>
[sound:s-1974_真珠湾攻撃はアメリカを巻き込んだ。.mp3]	(<b>真珠湾</b>) 真珠湾攻撃はアメリカを巻き込んだ。The attack on Pearl Harbor involved the United States. <br>
認可	[sound:k-1975_認可.mp3]<br>にんか <br> approval, license, licence, permission
approval, license, licence, permission	<b>認可<b> <br> にんか <br>[sound:k-1975_認可.mp3]
[sound:k-1975_認可.mp3]	approval, license, licence, permission<br> <b>認可</b> <br> (にんか)
<b>流れ</b> <br> 川の流れが速いです。	[sound:s-1975_川の流れが速いです。.mp3] <br> The river current is fast. <br>
[sound:s-1975_川の流れが速いです。.mp3]	(<b>流れ</b>) 川の流れが速いです。The river current is fast. <br>
容認	[sound:k-1976_容認.mp3]<br>ようにん <br> approval
approval	<b>容認<b> <br> ようにん <br>[sound:k-1976_容認.mp3]
[sound:k-1976_容認.mp3]	approval<br> <b>容認</b> <br> (ようにん)
<b>交流</b> <br> 異文化間での交流は貴重です。	[sound:s-1976_異文化間での交流は貴重です。.mp3] <br> Cultural exchange is valuable. <br>
[sound:s-1976_異文化間での交流は貴重です。.mp3]	(<b>交流</b>) 異文化間での交流は貴重です。Cultural exchange is valuable. <br>
認知	[sound:k-1977_認知.mp3]<br>にんち <br> acknowledgement, acknowledgment, recognition
acknowledgement, acknowledgment, recognition	<b>認知<b> <br> にんち <br>[sound:k-1977_認知.mp3]
[sound:k-1977_認知.mp3]	acknowledgement, acknowledgment, recognition<br> <b>認知</b> <br> (にんち)
<b>流す</b> <br> 河川に水を流します。	[sound:s-1977_河川に水を流します。.mp3] <br> We let water flow into the river. <br>
[sound:s-1977_河川に水を流します。.mp3]	(<b>流す</b>) 河川に水を流します。We let water flow into the river. <br>
認証	[sound:k-1978_認証.mp3]<br>にんしょう <br> certification, attestation, authentication, confirmation; Imperial attestation
certification, attestation, authentication, confirmation; Imperial attestation	<b>認証<b> <br> にんしょう <br>[sound:k-1978_認証.mp3]
[sound:k-1978_認証.mp3]	certification, attestation, authentication, confirmation; Imperial attestation<br> <b>認証</b> <br> (にんしょう)
<b>流通</b> <br> 商品の流通が滞っています。	[sound:s-1978_商品の流通が滞っています。.mp3] <br> The distribution of goods is stagnant. <br>
[sound:s-1978_商品の流通が滞っています。.mp3]	(<b>流通</b>) 商品の流通が滞っています。The distribution of goods is stagnant. <br>
認め	[sound:k-1979_認め.mp3]<br>みとめ <br> approval, final seal (of approval)
approval, final seal (of approval)	<b>認め<b> <br> みとめ <br>[sound:k-1979_認め.mp3]
[sound:k-1979_認め.mp3]	approval, final seal<br> <b>of approval) (認め</b> <br> (みとめ)
<b>主流</b> <br> その考え方は社会の主流になりつつあります。	[sound:s-1979_その考え方は社会の主流になりつつあります。.mp3] <br> That way of thinking is becoming mainstream in society. <br>
[sound:s-1979_その考え方は社会の主流になりつつあります。.mp3]	(<b>主流</b>) その考え方は社会の主流になりつつあります。That way of thinking is becoming mainstream in society. <br>
画	[sound:k-1980_画.mp3]<br>かく <br> stroke (of a kanji, etc.)
stroke (of a kanji, etc.)	<b>画<b> <br> かく <br>[sound:k-1980_画.mp3]
[sound:k-1980_画.mp3]	stroke<br> <b>of a kanji, etc.) (画</b> <br> (かく)
<b>流出</b> <br> 機密情報がインターネットに流出しました。	[sound:s-1980_機密情報がインターネットに流出しました。.mp3] <br> Confidential information leaked onto the internet. <br>
[sound:s-1980_機密情報がインターネットに流出しました。.mp3]	(<b>流出</b>) 機密情報がインターネットに流出しました。Confidential information leaked onto the internet. <br>
映画	[sound:k-1981_映画.mp3]<br>えいが <br> movie, film
movie, film	<b>映画<b> <br> えいが <br>[sound:k-1981_映画.mp3]
[sound:k-1981_映画.mp3]	movie, film<br> <b>映画</b> <br> (えいが)
<b>流行</b> <br> この春はその服が流行っています。	[sound:s-1981_この春はその服が流行っています。.mp3] <br> That clothing is in fashion this spring. <br>
[sound:s-1981_この春はその服が流行っています。.mp3]	(<b>流行</b>) この春はその服が流行っています。That clothing is in fashion this spring. <br>
計画	[sound:k-1982_計画.mp3]<br>けいかく <br> plan, project, schedule, scheme, program, programme
plan, project, schedule, scheme, program, programme	<b>計画<b> <br> けいかく <br>[sound:k-1982_計画.mp3]
[sound:k-1982_計画.mp3]	plan, project, schedule, scheme, program, programme<br> <b>計画</b> <br> (けいかく)
<b>一流</b> <br> 彼は一流の料理人です。	[sound:s-1982_彼は一流の料理人です。.mp3] <br> He is a first-class chef. <br>
[sound:s-1982_彼は一流の料理人です。.mp3]	(<b>一流</b>) 彼は一流の料理人です。He is a first-class chef. <br>
企画	[sound:k-1983_企画.mp3]<br>きかく <br> planning, project, plan, design
planning, project, plan, design	<b>企画<b> <br> きかく <br>[sound:k-1983_企画.mp3]
[sound:k-1983_企画.mp3]	planning, project, plan, design<br> <b>企画</b> <br> (きかく)
<b>流動</b> <br> 会議ではアイデアが自由に流動しました。	[sound:s-1983_会議ではアイデアが自由に流動しました。.mp3] <br> Ideas flowed freely in the meeting. <br>
[sound:s-1983_会議ではアイデアが自由に流動しました。.mp3]	(<b>流動</b>) 会議ではアイデアが自由に流動しました。Ideas flowed freely in the meeting. <br>
絵画	[sound:k-1984_絵画.mp3]<br>かいが <br> picture, painting
picture, painting	<b>絵画<b> <br> かいが <br>[sound:k-1984_絵画.mp3]
[sound:k-1984_絵画.mp3]	picture, painting<br> <b>絵画</b> <br> (かいが)
<b>火砕流</b> <br> 火砕流が山を覆い尽くしました。	[sound:s-1984_火砕流が山を覆い尽くしました。.mp3] <br> The pyroclastic flow covered the mountain completely. <br>
[sound:s-1984_火砕流が山を覆い尽くしました。.mp3]	(<b>火砕流</b>) 火砕流が山を覆い尽くしました。The pyroclastic flow covered the mountain completely. <br>
画面	[sound:k-1985_画面.mp3]<br>がめん <br> terminal screen, scene, picture, the field (in TV), photo
terminal screen, scene, picture, the field (in TV), photo	<b>画面<b> <br> がめん <br>[sound:k-1985_画面.mp3]
[sound:k-1985_画面.mp3]	terminal screen, scene, picture, the field<br> <b>in TV), photo (画面</b> <br> (がめん)
<b>価格</b> <br> この製品の価格は高すぎます。	[sound:s-1985_この製品の価格は高すぎます。.mp3] <br> The price of this product is too high. <br>
[sound:s-1985_この製品の価格は高すぎます。.mp3]	(<b>価格</b>) この製品の価格は高すぎます。The price of this product is too high. <br>
画家	[sound:k-1986_画家.mp3]<br>がか <br> painter, artist
painter, artist	<b>画家<b> <br> がか <br>[sound:k-1986_画家.mp3]
[sound:k-1986_画家.mp3]	painter, artist<br> <b>画家</b> <br> (がか)
<b>格差</b> <br> その国では富の格差が大きいです。	[sound:s-1986_その国では富の格差が大きいです。.mp3] <br> There is a large wealth gap in that country. <br>
[sound:s-1986_その国では富の格差が大きいです。.mp3]	(<b>格差</b>) その国では富の格差が大きいです。There is a large wealth gap in that country. <br>
漫画	[sound:k-1987_漫画.mp3]<br>まんが <br> comic, cartoon
comic, cartoon	<b>漫画<b> <br> まんが <br>[sound:k-1987_漫画.mp3]
[sound:k-1987_漫画.mp3]	comic, cartoon<br> <b>漫画</b> <br> (まんが)
<b>資格</b> <br> その資格を取得するために勉強しています。	[sound:s-1987_その資格を取得するために勉強しています。.mp3] <br> I am studying to obtain that qualification. <br>
[sound:s-1987_その資格を取得するために勉強しています。.mp3]	(<b>資格</b>) その資格を取得するために勉強しています。I am studying to obtain that qualification. <br>
画像	[sound:k-1988_画像.mp3]<br>がぞう <br> image, picture, portrait
image, picture, portrait	<b>画像<b> <br> がぞう <br>[sound:k-1988_画像.mp3]
[sound:k-1988_画像.mp3]	image, picture, portrait<br> <b>画像</b> <br> (がぞう)
<b>性格</b> <br> 彼女の性格は明るいです。	[sound:s-1988_彼女の性格は明るいです。.mp3] <br> Her personality is cheerful. <br>
[sound:s-1988_彼女の性格は明るいです。.mp3]	(<b>性格</b>) 彼女の性格は明るいです。Her personality is cheerful. <br>
経済企画庁	[sound:k-1989_経済企画庁.mp3]<br>けいざいきかくちょう <br> Economic Planning Agency
Economic Planning Agency	<b>経済企画庁<b> <br> けいざいきかくちょう <br>[sound:k-1989_経済企画庁.mp3]
[sound:k-1989_経済企画庁.mp3]	Economic Planning Agency<br> <b>経済企画庁</b> <br> (けいざいきかくちょう)
<b>本格</b> <br> 彼は本格的な料理が得意です。	[sound:s-1989_彼は本格的な料理が得意です。.mp3] <br> He is skilled in authentic cooking. <br>
[sound:s-1989_彼は本格的な料理が得意です。.mp3]	(<b>本格</b>) 彼は本格的な料理が得意です。He is skilled in authentic cooking. <br>
海	[sound:k-1990_海.mp3]<br>うみ, み, わた, わだ <br> sea, beach
sea, beach	<b>海<b> <br> うみ, み, わた, わだ <br>[sound:k-1990_海.mp3]
[sound:k-1990_海.mp3]	sea, beach<br> <b>海</b> <br> (うみ, み, わた, わだ)
<b>本格的</b> <br> このレストランは本格的なフランス料理を提供しています。	[sound:s-1990_このレストランは本格的なフランス料理を提供しています。.mp3] <br> This restaurant offers authentic French cuisine. <br>
[sound:s-1990_このレストランは本格的なフランス料理を提供しています。.mp3]	(<b>本格的</b>) このレストランは本格的なフランス料理を提供しています。This restaurant offers authentic French cuisine. <br>
海外	[sound:k-1991_海外.mp3]<br>かいがい <br> foreign, abroad, overseas
foreign, abroad, overseas	<b>海外<b> <br> かいがい <br>[sound:k-1991_海外.mp3]
[sound:k-1991_海外.mp3]	foreign, abroad, overseas<br> <b>海外</b> <br> (かいがい)
<b>格好</b> <br> 彼は格好いいスーツを着ている。	[sound:s-1991_彼は格好いいスーツを着ている。.mp3] <br> He is wearing a handsome suit. <br>
[sound:s-1991_彼は格好いいスーツを着ている。.mp3]	(<b>格好</b>) 彼は格好いいスーツを着ている。He is wearing a handsome suit. <br>
北海道	[sound:k-1992_北海道.mp3]<br>ほっかいどう <br> Hokkaido (northernmost of the four main islands of Japan)
Hokkaido (northernmost of the four main islands of Japan)	<b>北海道<b> <br> ほっかいどう <br>[sound:k-1992_北海道.mp3]
[sound:k-1992_北海道.mp3]	Hokkaido<br> <b>northernmost of the four main islands of Japan) (北海道</b> <br> (ほっかいどう)
<b>合格</b> <br> 彼は試験に合格しました。	[sound:s-1992_彼は試験に合格しました。.mp3] <br> He passed the exam. <br>
[sound:s-1992_彼は試験に合格しました。.mp3]	(<b>合格</b>) 彼は試験に合格しました。He passed the exam. <br>
東海	[sound:k-1993_東海.mp3]<br>とうかい <br> region south of Tokyo on Pacific Ocean side of Japan, eastern sea
region south of Tokyo on Pacific Ocean side of Japan, eastern sea	<b>東海<b> <br> とうかい <br>[sound:k-1993_東海.mp3]
[sound:k-1993_東海.mp3]	region south of Tokyo on Pacific Ocean side of Japan, eastern sea<br> <b>東海</b> <br> (とうかい)
<b>本格化</b> <br> そのプロジェクトは本格化されました。	[sound:s-1993_そのプロジェクトは本格化されました。.mp3] <br> The project has been formalized. <br>
[sound:s-1993_そのプロジェクトは本格化されました。.mp3]	(<b>本格化</b>) そのプロジェクトは本格化されました。The project has been formalized. <br>
海軍	[sound:k-1994_海軍.mp3]<br>かいぐん <br> navy
navy	<b>海軍<b> <br> かいぐん <br>[sound:k-1994_海軍.mp3]
[sound:k-1994_海軍.mp3]	navy<br> <b>海軍</b> <br> (かいぐん)
<b>規格</b> <br> 製品の規格を満たしていますか？	[sound:s-1994_製品の規格を満たしていますか？.mp3] <br> Does the product meet the specifications? <br>
[sound:s-1994_製品の規格を満たしていますか？.mp3]	(<b>規格</b>) 製品の規格を満たしていますか？	Does the product meet the specifications? <br>
海上	[sound:k-1995_海上.mp3]<br>かいじょう <br> (by, at, on) sea, maritime, marine
(by, at, on) sea, maritime, marine	<b>海上<b> <br> かいじょう <br>[sound:k-1995_海上.mp3]
[sound:k-1995_海上.mp3]	(by, at, on) sea, maritime, marine<br> <b>海上</b> <br> (かいじょう)
<b>有</b> <br> 彼は有能なリーダーです。	[sound:s-1995_彼は有能なリーダーです。.mp3] <br> He is a capable leader. <br>
[sound:s-1995_彼は有能なリーダーです。.mp3]	(<b>有</b>) 彼は有能なリーダーです。He is a capable leader. <br>
海岸	[sound:k-1996_海岸.mp3]<br>かいがん <br> coast, beach
coast, beach	<b>海岸<b> <br> かいがん <br>[sound:k-1996_海岸.mp3]
[sound:k-1996_海岸.mp3]	coast, beach<br> <b>海岸</b> <br> (かいがん)
<b>有効</b> <br> このチケットは有効期限があります。	[sound:s-1996_このチケットは有効期限があります。.mp3] <br> This ticket is valid for a limited time. <br>
[sound:s-1996_このチケットは有効期限があります。.mp3]	(<b>有効</b>) このチケットは有効期限があります。This ticket is valid for a limited time. <br>
海洋	[sound:k-1997_海洋.mp3]<br>かいよう <br> ocean
ocean	<b>海洋<b> <br> かいよう <br>[sound:k-1997_海洋.mp3]
[sound:k-1997_海洋.mp3]	ocean<br> <b>海洋</b> <br> (かいよう)
<b>有力</b> <br> 彼は有力な候補者です。	[sound:s-1997_彼は有力な候補者です。.mp3] <br> He is a strong candidate. <br>
[sound:s-1997_彼は有力な候補者です。.mp3]	(<b>有力</b>) 彼は有力な候補者です。He is a strong candidate. <br>
掃海	[sound:k-1998_掃海.mp3]<br>そうかい <br> sweeping the sea for mines, dragging for mines
sweeping the sea for mines, dragging for mines	<b>掃海<b> <br> そうかい <br>[sound:k-1998_掃海.mp3]
[sound:k-1998_掃海.mp3]	sweeping the sea for mines, dragging for mines<br> <b>掃海</b> <br> (そうかい)
<b>有権者</b> <br> 有権者の投票率が高かった。	[sound:s-1998_有権者の投票率が高かった。.mp3] <br> The voter turnout was high. <br>
[sound:s-1998_有権者の投票率が高かった。.mp3]	(<b>有権者</b>) 有権者の投票率が高かった。The voter turnout was high. <br>
日本海	[sound:k-1999_日本海.mp3]<br>にほんかい, にっぽんかい <br> Sea of Japan
Sea of Japan	<b>日本海<b> <br> にほんかい, にっぽんかい <br>[sound:k-1999_日本海.mp3]
[sound:k-1999_日本海.mp3]	Sea of Japan<br> <b>日本海</b> <br> (にほんかい, にっぽんかい)
<b>有名</b> <br> 彼は有名な俳優です。	[sound:s-1999_彼は有名な俳優です。.mp3] <br> He is a famous actor. <br>
[sound:s-1999_彼は有名な俳優です。.mp3]	(<b>有名</b>) 彼は有名な俳優です。He is a famous actor. <br>
参院	[sound:k-2000_参院.mp3]<br>さんいん <br> House of Councillors
House of Councillors	<b>参院<b> <br> さんいん <br>[sound:k-2000_参院.mp3]
[sound:k-2000_参院.mp3]	House of Councillors<br> <b>参院</b> <br> (さんいん)
<b>保有</b> <br> その会社は多くの特許を保有しています。	[sound:s-2000_その会社は多くの特許を保有しています。.mp3] <br> The company holds many patents. <br>
[sound:s-2000_その会社は多くの特許を保有しています。.mp3]	(<b>保有</b>) その会社は多くの特許を保有しています。The company holds many patents. <br>
参加	[sound:k-2001_参加.mp3]<br>さんか <br> participation
participation	<b>参加<b> <br> さんか <br>[sound:k-2001_参加.mp3]
[sound:k-2001_参加.mp3]	participation<br> <b>参加</b> <br> (さんか)
<b>有利</b> <br> 彼らは競争で有利な地位にあります。	[sound:s-2001_彼らは競争で有利な地位にあります。.mp3] <br> They have an advantageous position in the competition. <br>
[sound:s-2001_彼らは競争で有利な地位にあります。.mp3]	(<b>有利</b>) 彼らは競争で有利な地位にあります。They have an advantageous position in the competition. <br>
参加者	[sound:k-2002_参加者.mp3]<br>さんかしゃ <br> participant, entrant
participant, entrant	<b>参加者<b> <br> さんかしゃ <br>[sound:k-2002_参加者.mp3]
[sound:k-2002_参加者.mp3]	participant, entrant<br> <b>参加者</b> <br> (さんかしゃ)
<b>所有</b> <br> この土地の所有権は彼にあります。	[sound:s-2002_この土地の所有権は彼にあります。.mp3] <br> He owns the land. <br>
[sound:s-2002_この土地の所有権は彼にあります。.mp3]	(<b>所有</b>) この土地の所有権は彼にあります。He owns the land. <br>
参考	[sound:k-2003_参考.mp3]<br>さんこう <br> reference, consultation
reference, consultation	<b>参考<b> <br> さんこう <br>[sound:k-2003_参考.mp3]
[sound:k-2003_参考.mp3]	reference, consultation<br> <b>参考</b> <br> (さんこう)
<b>有罪</b> <br> 彼は有罪とされました。	[sound:s-2003_彼は有罪とされました。.mp3] <br> He was found guilty. <br>
[sound:s-2003_彼は有罪とされました。.mp3]	(<b>有罪</b>) 彼は有罪とされました。He was found guilty. <br>
参入	[sound:k-2004_参入.mp3]<br>さんにゅう <br> coming, visiting, going
coming, visiting, going	<b>参入<b> <br> さんにゅう <br>[sound:k-2004_参入.mp3]
[sound:k-2004_参入.mp3]	coming, visiting, going<br> <b>参入</b> <br> (さんにゅう)
<b>有価証券</b> <br> 彼は有価証券を投資しています。	[sound:s-2004_彼は有価証券を投資しています。.mp3] <br> He invests in securities. <br>
[sound:s-2004_彼は有価証券を投資しています。.mp3]	(<b>有価証券</b>) 彼は有価証券を投資しています。He invests in securities. <br>
参議院	[sound:k-2005_参議院.mp3]<br>さんぎいん <br> House of Councillors
House of Councillors	<b>参議院<b> <br> さんぎいん <br>[sound:k-2005_参議院.mp3]
[sound:k-2005_参議院.mp3]	House of Councillors<br> <b>参議院</b> <br> (さんぎいん)
<b>疑い</b> <br> 彼に犯行の疑いがかかっています。	[sound:s-2005_彼に犯行の疑いがかかっています。.mp3] <br> He is suspected of the crime. <br>
[sound:s-2005_彼に犯行の疑いがかかっています。.mp3]	(<b>疑い</b>) 彼に犯行の疑いがかかっています。He is suspected of the crime. <br>
参拝	[sound:k-2006_参拝.mp3]<br>さんぱい <br> visit to a shrine or temple, paying homage at a shrine or temple
visit to a shrine or temple, paying homage at a shrine or temple	<b>参拝<b> <br> さんぱい <br>[sound:k-2006_参拝.mp3]
[sound:k-2006_参拝.mp3]	visit to a shrine or temple, paying homage at a shrine or temple<br> <b>参拝</b> <br> (さんぱい)
<b>容疑者</b> <br> 警察は容疑者を逮捕しました。	[sound:s-2006_警察は容疑者を逮捕しました。.mp3] <br> The police arrested the suspect. <br>
[sound:s-2006_警察は容疑者を逮捕しました。.mp3]	(<b>容疑者</b>) 警察は容疑者を逮捕しました。The police arrested the suspect. <br>
参謀	[sound:k-2007_参謀.mp3]<br>さんぼう <br> staff officer, participating in planning
staff officer, participating in planning	<b>参謀<b> <br> さんぼう <br>[sound:k-2007_参謀.mp3]
[sound:k-2007_参謀.mp3]	staff officer, participating in planning<br> <b>参謀</b> <br> (さんぼう)
<b>疑問</b> <br> 私には彼の行動について疑問があります。	[sound:s-2007_私には彼の行動について疑問があります。.mp3] <br> I have doubts about his actions. <br>
[sound:s-2007_私には彼の行動について疑問があります。.mp3]	(<b>疑問</b>) 私には彼の行動について疑問があります。I have doubts about his actions. <br>
参照	[sound:k-2008_参照.mp3]<br>さんしょう <br> reference, bibliographical reference, consultation, browsing (e.g. when selecting a file to upload on a computer), checking out
reference, bibliographical reference, consultation, browsing (e.g. when selecting a file to upload on a computer), checking out	<b>参照<b> <br> さんしょう <br>[sound:k-2008_参照.mp3]
[sound:k-2008_参照.mp3]	reference, bibliographical reference, consultation, browsing<br> <b>e.g. when selecting a file to upload on a computer), checking out (参照</b> <br> (さんしょう)
<b>疑惑</b> <br> 彼には汚職の疑惑がかかっています。	[sound:s-2008_彼には汚職の疑惑がかかっています。.mp3] <br> He is under suspicion of corruption. <br>
[sound:s-2008_彼には汚職の疑惑がかかっています。.mp3]	(<b>疑惑</b>) 彼には汚職の疑惑がかかっています。He is under suspicion of corruption. <br>
参事官	[sound:k-2009_参事官.mp3]<br>さんじかん <br> councillor, councilor
councillor, councilor	<b>参事官<b> <br> さんじかん <br>[sound:k-2009_参事官.mp3]
[sound:k-2009_参事官.mp3]	councillor, councilor<br> <b>参事官</b> <br> (さんじかん)
<b>容疑</b> <br> 彼は殺人容疑で逮捕されました。	[sound:s-2009_彼は殺人容疑で逮捕されました。.mp3] <br> He was arrested on suspicion of murder. <br>
[sound:s-2009_彼は殺人容疑で逮捕されました。.mp3]	(<b>容疑</b>) 彼は殺人容疑で逮捕されました。He was arrested on suspicion of murder. <br>
販売	[sound:k-2010_販売.mp3]<br>はんばい <br> sales, selling, marketing
sales, selling, marketing	<b>販売<b> <br> はんばい <br>[sound:k-2010_販売.mp3]
[sound:k-2010_販売.mp3]	sales, selling, marketing<br> <b>販売</b> <br> (はんばい)
<b>質疑</b> <br> 議長は質疑応答の時間を設けました。	[sound:s-2010_議長は質疑応答の時間を設けました。.mp3] <br> The chairman set aside time for questions and answers. <br>
[sound:s-2010_議長は質疑応答の時間を設けました。.mp3]	(<b>質疑</b>) 議長は質疑応答の時間を設けました。The chairman set aside time for questions and answers. <br>
売り	[sound:k-2011_売り.mp3]<br>うり <br> sale, selling; selling point, gimmick
sale, selling; selling point, gimmick	<b>売り<b> <br> うり <br>[sound:k-2011_売り.mp3]
[sound:k-2011_売り.mp3]	sale, selling; selling point, gimmick<br> <b>売り</b> <br> (うり)
<b>疑う</b> <br> 彼の言葉には疑いがある。	[sound:s-2011_彼の言葉には疑いがある。.mp3] <br> There is doubt in his words. <br>
[sound:s-2011_彼の言葉には疑いがある。.mp3]	(<b>疑う</b>) 彼の言葉には疑いがある。There is doubt in his words. <br>
売る	[sound:k-2012_売る.mp3]<br>うる <br> to sell
to sell	<b>売る<b> <br> うる <br>[sound:k-2012_売る.mp3]
[sound:k-2012_売る.mp3]	to sell<br> <b>売る</b> <br> (うる)
<b>疑念</b> <br> 彼は計画について疑念を抱いている。	[sound:s-2012_彼は計画について疑念を抱いている。.mp3] <br> He harbors doubts about the plan. <br>
[sound:s-2012_彼は計画について疑念を抱いている。.mp3]	(<b>疑念</b>) 彼は計画について疑念を抱いている。He harbors doubts about the plan. <br>
売買	[sound:k-2013_売買.mp3]<br>ばいばい <br> trade, buying and selling
trade, buying and selling	<b>売買<b> <br> ばいばい <br>[sound:k-2013_売買.mp3]
[sound:k-2013_売買.mp3]	trade, buying and selling<br> <b>売買</b> <br> (ばいばい)
<b>懐疑</b> <br> 彼は常に懐疑的な考えを持っている。	[sound:s-2013_彼は常に懐疑的な考えを持っている。.mp3] <br> He always has a skeptical mindset. <br>
[sound:s-2013_彼は常に懐疑的な考えを持っている。.mp3]	(<b>懐疑</b>) 彼は常に懐疑的な考えを持っている。He always has a skeptical mindset. <br>
発売	[sound:k-2014_発売.mp3]<br>はつばい <br> sale, offering for sale, release (for sale), launch (product)
sale, offering for sale, release (for sale), launch (product)	<b>発売<b> <br> はつばい <br>[sound:k-2014_発売.mp3]
[sound:k-2014_発売.mp3]	sale, offering for sale, release<br> <b>for sale), launch (product) (発売</b> <br> (はつばい)
<b>疑わしい</b> <br> その計画の成功について疑わしい点がある。	[sound:s-2014_その計画の成功について疑わしい点がある。.mp3] <br> There are questionable aspects to the success of that plan. <br>
[sound:s-2014_その計画の成功について疑わしい点がある。.mp3]	(<b>疑わしい</b>) その計画の成功について疑わしい点がある。There are questionable aspects to the success of that plan. <br>
売り上げ	[sound:k-2015_売り上げ.mp3]<br>うりあげ <br> amount sold, proceeds
amount sold, proceeds	<b>売り上げ<b> <br> うりあげ <br>[sound:k-2015_売り上げ.mp3]
[sound:k-2015_売り上げ.mp3]	amount sold, proceeds<br> <b>売り上げ</b> <br> (うりあげ)
<b>口</b> <br> 口から出た言葉は大切にしなければなりません。	[sound:s-2015_口から出た言葉は大切にしなければなりません。.mp3] <br> Words spoken must be chosen carefully. <br>
[sound:s-2015_口から出た言葉は大切にしなければなりません。.mp3]	(<b>口</b>) 口から出た言葉は大切にしなければなりません。Words spoken must be chosen carefully. <br>
売却	[sound:k-2016_売却.mp3]<br>ばいきゃく <br> sale, disposal by sale
sale, disposal by sale	<b>売却<b> <br> ばいきゃく <br>[sound:k-2016_売却.mp3]
[sound:k-2016_売却.mp3]	sale, disposal by sale<br> <b>売却</b> <br> (ばいきゃく)
<b>人口</b> <br> その都市の人口は急速に増加しています。	[sound:s-2016_その都市の人口は急速に増加しています。.mp3] <br> The population of the city is rapidly increasing. <br>
[sound:s-2016_その都市の人口は急速に増加しています。.mp3]	(<b>人口</b>) その都市の人口は急速に増加しています。The population of the city is rapidly increasing. <br>
売上高	[sound:k-2017_売上高.mp3]<br>うりあげだか <br> sales, amount sold, proceeds
sales, amount sold, proceeds	<b>売上高<b> <br> うりあげだか <br>[sound:k-2017_売上高.mp3]
[sound:k-2017_売上高.mp3]	sales, amount sold, proceeds<br> <b>売上高</b> <br> (うりあげだか)
<b>窓口</b> <br> 銀行の窓口で手続きをします。	[sound:s-2017_銀行の窓口で手続きをします。.mp3] <br> I do my transactions at the bank counter. <br>
[sound:s-2017_銀行の窓口で手続きをします。.mp3]	(<b>窓口</b>) 銀行の窓口で手続きをします。I do my transactions at the bank counter. <br>
商売	[sound:k-2018_商売.mp3]<br>しょうばい <br> trade, business, commerce, transaction, occupation
trade, business, commerce, transaction, occupation	<b>商売<b> <br> しょうばい <br>[sound:k-2018_商売.mp3]
[sound:k-2018_商売.mp3]	trade, business, commerce, transaction, occupation<br> <b>商売</b> <br> (しょうばい)
<b>口座</b> <br> 銀行に新しい口座を開設しました。	[sound:s-2018_銀行に新しい口座を開設しました。.mp3] <br> I opened a new bank account. <br>
[sound:s-2018_銀行に新しい口座を開設しました。.mp3]	(<b>口座</b>) 銀行に新しい口座を開設しました。I opened a new bank account. <br>
売り場	[sound:k-2019_売り場.mp3]<br>うりば <br> place where things are sold, point of sale, POS, sales floor, counter (in shop)
place where things are sold, point of sale, POS, sales floor, counter (in shop)	<b>売り場<b> <br> うりば <br>[sound:k-2019_売り場.mp3]
[sound:k-2019_売り場.mp3]	place where things are sold, point of sale, POS, sales floor, counter<br> <b>in shop) (売り場</b> <br> (うりば)
<b>入り口</b> <br> パーティーの入り口に警備員が立っている。	[sound:s-2019_パーティーの入り口に警備員が立っている。.mp3] <br> A security guard is standing at the entrance of the party. <br>
[sound:s-2019_パーティーの入り口に警備員が立っている。.mp3]	(<b>入り口</b>) パーティーの入り口に警備員が立っている。A security guard is standing at the entrance of the party. <br>
利	[sound:k-2020_利.mp3]<br>り <br> advantage, benefit, profit, interest
advantage, benefit, profit, interest	<b>利<b> <br> り <br>[sound:k-2020_利.mp3]
[sound:k-2020_利.mp3]	advantage, benefit, profit, interest<br> <b>利</b> <br> (り)
<b>大口</b> <br> 彼は大口の顧客を持っています。	[sound:s-2020_彼は大口の顧客を持っています。.mp3] <br> He has major clients. <br>
[sound:s-2020_彼は大口の顧客を持っています。.mp3]	(<b>大口</b>) 彼は大口の顧客を持っています。He has major clients. <br>
金利	[sound:k-2021_金利.mp3]<br>きんり <br> interest rates
interest rates	<b>金利<b> <br> きんり <br>[sound:k-2021_金利.mp3]
[sound:k-2021_金利.mp3]	interest rates<br> <b>金利</b> <br> (きんり)
<b>口調</b> <br> 彼の口調はとても丁寧です。	[sound:s-2021_彼の口調はとても丁寧です。.mp3] <br> His tone of voice is very polite. <br>
[sound:s-2021_彼の口調はとても丁寧です。.mp3]	(<b>口調</b>) 彼の口調はとても丁寧です。His tone of voice is very polite. <br>
権利	[sound:k-2022_権利.mp3]<br>けんり <br> right, privilege
right, privilege	<b>権利<b> <br> けんり <br>[sound:k-2022_権利.mp3]
[sound:k-2022_権利.mp3]	right, privilege<br> <b>権利</b> <br> (けんり)
<b>出口</b> <br> 火事の時は出口に向かってください。	[sound:s-2022_火事の時は出口に向かってください。.mp3] <br> Please head towards the exit in case of fire. <br>
[sound:s-2022_火事の時は出口に向かってください。.mp3]	(<b>出口</b>) 火事の時は出口に向かってください。Please head towards the exit in case of fire. <br>
勝利	[sound:k-2023_勝利.mp3]<br>しょうり <br> victory, triumph, conquest, success, win
victory, triumph, conquest, success, win	<b>勝利<b> <br> しょうり <br>[sound:k-2023_勝利.mp3]
[sound:k-2023_勝利.mp3]	victory, triumph, conquest, success, win<br> <b>勝利</b> <br> (しょうり)
<b>川口</b> <br> 川口さんは駅の近くに住んでいます。	[sound:s-2023_川口さんは駅の近くに住んでいます。.mp3] <br> Kawaguchi-san lives near the station. <br>
[sound:s-2023_川口さんは駅の近くに住んでいます。.mp3]	(<b>川口</b>) 川口さんは駅の近くに住んでいます。Kawaguchi-san lives near the station. <br>
利益	[sound:k-2024_利益.mp3]<br>りえき, りやく <br> profit, gains; benefit, advantage, interest (of the public, etc.); grace (of God, Buddha, etc.) (esp. as attained through rightful actions, prayer, adherence to one's faith, etc.), blessing, miracle
profit, gains; benefit, advantage, interest (of the public, etc.); grace (of God, Buddha, etc.) (esp. as attained through rightful actions, prayer, adherence to one's faith, etc.), blessing, miracle	<b>利益<b> <br> りえき, りやく <br>[sound:k-2024_利益.mp3]
[sound:k-2024_利益.mp3]	profit, gains; benefit, advantage, interest<br> <b>of the public, etc.); grace (of God, Buddha, etc.) (esp. as attained through rightful actions, prayer, adherence to one's faith, etc.), blessing, miracle (利益</b> <br> (りえき, りやく)
<b>手口</b> <br> 犯人の手口は巧妙だった。	[sound:s-2024_犯人の手口は巧妙だった。.mp3] <br> The criminal's modus operandi was clever. <br>
[sound:s-2024_犯人の手口は巧妙だった。.mp3]	(<b>手口</b>) 犯人の手口は巧妙だった。The criminal's modus operandi was clever. <br>
利用	[sound:k-2025_利用.mp3]<br>りよう <br> use, utilization, utilisation, application
use, utilization, utilisation, application	<b>利用<b> <br> りよう <br>[sound:k-2025_利用.mp3]
[sound:k-2025_利用.mp3]	use, utilization, utilisation, application<br> <b>利用</b> <br> (りよう)
<b>過ぎ</b> <br> 時間が過ぎるのが早いです。	[sound:s-2025_時間が過ぎるのが早いです。.mp3] <br> Time passes quickly. <br>
[sound:s-2025_時間が過ぎるのが早いです。.mp3]	(<b>過ぎ</b>) 時間が過ぎるのが早いです。Time passes quickly. <br>
利用者	[sound:k-2026_利用者.mp3]<br>りようしゃ <br> user, end-user, consumer
user, end-user, consumer	<b>利用者<b> <br> りようしゃ <br>[sound:k-2026_利用者.mp3]
[sound:k-2026_利用者.mp3]	user, end-user, consumer<br> <b>利用者</b> <br> (りようしゃ)
<b>過去</b> <br> 過去の出来事を振り返る。	[sound:s-2026_過去の出来事を振り返る。.mp3] <br> Reflecting on past events. <br>
[sound:s-2026_過去の出来事を振り返る。.mp3]	(<b>過去</b>) 過去の出来事を振り返る。Reflecting on past events. <br>
有利	[sound:k-2027_有利.mp3]<br>ゆうり <br> advantageous, better, profitable, lucrative
advantageous, better, profitable, lucrative	<b>有利<b> <br> ゆうり <br>[sound:k-2027_有利.mp3]
[sound:k-2027_有利.mp3]	advantageous, better, profitable, lucrative<br> <b>有利</b> <br> (ゆうり)
<b>過程</b> <br> プロジェクトの過程を見直す。	[sound:s-2027_プロジェクトの過程を見直す。.mp3] <br> Reviewing the process of the project. <br>
[sound:s-2027_プロジェクトの過程を見直す。.mp3]	(<b>過程</b>) プロジェクトの過程を見直す。Reviewing the process of the project. <br>
経常利益	[sound:k-2028_経常利益.mp3]<br>けいじょうりえき <br> current profits, ordinary profit, income before income taxes
current profits, ordinary profit, income before income taxes	<b>経常利益<b> <br> けいじょうりえき <br>[sound:k-2028_経常利益.mp3]
[sound:k-2028_経常利益.mp3]	current profits, ordinary profit, income before income taxes<br> <b>経常利益</b> <br> (けいじょうりえき)
<b>過半数</b> <br> 選挙では過半数を獲得する必要がある。	[sound:s-2028_選挙では過半数を獲得する必要がある。.mp3] <br> You need to win a majority in elections. <br>
[sound:s-2028_選挙では過半数を獲得する必要がある。.mp3]	(<b>過半数</b>) 選挙では過半数を獲得する必要がある。You need to win a majority in elections. <br>
利下げ	[sound:k-2029_利下げ.mp3]<br>りさげ <br> decrease in interest rates
decrease in interest rates	<b>利下げ<b> <br> りさげ <br>[sound:k-2029_利下げ.mp3]
[sound:k-2029_利下げ.mp3]	decrease in interest rates<br> <b>利下げ</b> <br> (りさげ)
<b>過激</b> <br> 彼の言動は過激すぎる。	[sound:s-2029_彼の言動は過激すぎる。.mp3] <br> His actions are too extreme. <br>
[sound:s-2029_彼の言動は過激すぎる。.mp3]	(<b>過激</b>) 彼の言動は過激すぎる。His actions are too extreme. <br>
組	[sound:k-2030_組.mp3]<br>くみ <br> set (of items); group (of people), class (of students), company (esp. construction), family (i.e. mafia), team; typesetting, composition
set (of items); group (of people), class (of students), company (esp. construction), family (i.e. mafia), team; typesetting, composition	<b>組<b> <br> くみ <br>[sound:k-2030_組.mp3]
[sound:k-2030_組.mp3]	set<br> <b>of items); group (of people), class (of students), company (esp. construction), family (i.e. mafia), team; typesetting, composition (組</b> <br> (くみ)
<b>経過</b> <br> 任務の経過を報告します。	[sound:s-2030_任務の経過を報告します。.mp3] <br> Reporting on the progress of the mission. <br>
[sound:s-2030_任務の経過を報告します。.mp3]	(<b>経過</b>) 任務の経過を報告します。Reporting on the progress of the mission. <br>
組織	[sound:k-2031_組織.mp3]<br>そしき <br> organization, organisation; structure, construction; tissue; system
organization, organisation; structure, construction; tissue; system	<b>組織<b> <br> そしき <br>[sound:k-2031_組織.mp3]
[sound:k-2031_組織.mp3]	organization, organisation; structure, construction; tissue; system<br> <b>組織</b> <br> (そしき)
<b>通過</b> <br> 列車がトンネルを通過しました。	[sound:s-2031_列車がトンネルを通過しました。.mp3] <br> The train passed through the tunnel. <br>
[sound:s-2031_列車がトンネルを通過しました。.mp3]	(<b>通過</b>) 列車がトンネルを通過しました。The train passed through the tunnel. <br>
番組	[sound:k-2032_番組.mp3]<br>ばんぐみ <br> program (e.g. TV), programme
program (e.g. TV), programme	<b>番組<b> <br> ばんぐみ <br>[sound:k-2032_番組.mp3]
[sound:k-2032_番組.mp3]	program<br> <b>e.g. TV), programme (番組</b> <br> (ばんぐみ)
<b>過失</b> <br> 交通事故の過失が争われた。	[sound:s-2032_交通事故の過失が争われた。.mp3] <br> Fault for the traffic accident was disputed. <br>
[sound:s-2032_交通事故の過失が争われた。.mp3]	(<b>過失</b>) 交通事故の過失が争われた。Fault for the traffic accident was disputed. <br>
組合	[sound:k-2033_組合.mp3]<br>くみあい <br> association, union
association, union	<b>組合<b> <br> くみあい <br>[sound:k-2033_組合.mp3]
[sound:k-2033_組合.mp3]	association, union<br> <b>組合</b> <br> (くみあい)
<b>過剰</b> <br> 運動を過剰にすると怪我をする危険性がある。	[sound:s-2033_運動を過剰にすると怪我をする危険性がある。.mp3] <br> There's a risk of injury if you overexercise. <br>
[sound:s-2033_運動を過剰にすると怪我をする危険性がある。.mp3]	(<b>過剰</b>) 運動を過剰にすると怪我をする危険性がある。There's a risk of injury if you overexercise. <br>
労組	[sound:k-2034_労組.mp3]<br>ろうそ, ろうくみ <br> labor union, labour union
labor union, labour union	<b>労組<b> <br> ろうそ, ろうくみ <br>[sound:k-2034_労組.mp3]
[sound:k-2034_労組.mp3]	labor union, labour union<br> <b>労組</b> <br> (ろうそ, ろうくみ)
<b>過ち</b> <br> 彼は過ちを認めた。	[sound:s-2034_彼は過ちを認めた。.mp3] <br> He admitted his mistake. <br>
[sound:s-2034_彼は過ちを認めた。.mp3]	(<b>過ち</b>) 彼は過ちを認めた。He admitted his mistake. <br>
仕組み	[sound:k-2035_仕組み.mp3]<br>しくみ <br> structure, construction, arrangement, contrivance; plan, plot, contrivance
structure, construction, arrangement, contrivance; plan, plot, contrivance	<b>仕組み<b> <br> しくみ <br>[sound:k-2035_仕組み.mp3]
[sound:k-2035_仕組み.mp3]	structure, construction, arrangement, contrivance; plan, plot, contrivance<br> <b>仕組み</b> <br> (しくみ)
<b>局</b> <br> その問題は地域の局に報告されました。	[sound:s-2035_その問題は地域の局に報告されました。.mp3] <br> The issue was reported to the local authorities. <br>
[sound:s-2035_その問題は地域の局に報告されました。.mp3]	(<b>局</b>) その問題は地域の局に報告されました。The issue was reported to the local authorities. <br>
枠組み	[sound:k-2036_枠組み.mp3]<br>わくぐみ <br> frame, framework
frame, framework	<b>枠組み<b> <br> わくぐみ <br>[sound:k-2036_枠組み.mp3]
[sound:k-2036_枠組み.mp3]	frame, framework<br> <b>枠組み</b> <br> (わくぐみ)
<b>事務局</b> <br> 会議の事務局が会議の進行を管理します。	[sound:s-2036_会議の事務局が会議の進行を管理します。.mp3] <br> The secretariat of the meeting manages the proceedings. <br>
[sound:s-2036_会議の事務局が会議の進行を管理します。.mp3]	(<b>事務局</b>) 会議の事務局が会議の進行を管理します。The secretariat of the meeting manages the proceedings. <br>
取り組み	[sound:k-2037_取り組み.mp3]<br>とりくみ <br> bout (in sports, etc.), match; effort, initiative, dealing with, grappling with, wrestling with
bout (in sports, etc.), match; effort, initiative, dealing with, grappling with, wrestling with	<b>取り組み<b> <br> とりくみ <br>[sound:k-2037_取り組み.mp3]
[sound:k-2037_取り組み.mp3]	bout<br> <b>in sports, etc.), match; effort, initiative, dealing with, grappling with, wrestling with (取り組み</b> <br> (とりくみ)
<b>当局</b> <br> 当局は事件を調査中です。	[sound:s-2037_当局は事件を調査中です。.mp3] <br> The authorities are investigating the case. <br>
[sound:s-2037_当局は事件を調査中です。.mp3]	(<b>当局</b>) 当局は事件を調査中です。The authorities are investigating the case. <br>
労働組合	[sound:k-2038_労働組合.mp3]<br>ろうどうくみあい <br> labor union, labour union
labor union, labour union	<b>労働組合<b> <br> ろうどうくみあい <br>[sound:k-2038_労働組合.mp3]
[sound:k-2038_労働組合.mp3]	labor union, labour union<br> <b>労働組合</b> <br> (ろうどうくみあい)
<b>局長</b> <br> 彼は地元の郵便局の局長です。	[sound:s-2038_彼は地元の郵便局の局長です。.mp3] <br> He is the director of the local post office. <br>
[sound:s-2038_彼は地元の郵便局の局長です。.mp3]	(<b>局長</b>) 彼は地元の郵便局の局長です。He is the director of the local post office. <br>
組長	[sound:k-2039_組長.mp3]<br>くみちょう <br> boss (yakuza)
boss (yakuza)	<b>組長<b> <br> くみちょう <br>[sound:k-2039_組長.mp3]
[sound:k-2039_組長.mp3]	boss<br> <b>yakuza) (組長</b> <br> (くみちょう)
<b>結局</b> <br> 結局、彼は私たちの提案を受け入れました。	"[sound:s-2039_結局、彼は私たちの提案を受け入れました。.mp3] <br> ""In the end, he accepted our proposal.""" <br>
[sound:s-2039_結局、彼は私たちの提案を受け入れました。.mp3]	(<b>結局</b>) 結局、彼は私たちの提案を受け入れました。In the end, he accepted our proposal. <br>
知る	[sound:k-2040_知る.mp3]<br>しる <br> to know, to understand, to be acquainted with, to feel
to know, to understand, to be acquainted with, to feel	<b>知る<b> <br> しる <br>[sound:k-2040_知る.mp3]
[sound:k-2040_知る.mp3]	to know, to understand, to be acquainted with, to feel<br> <b>知る</b> <br> (しる)
<b>支局</b> <br> その新聞社には全国各地に支局があります。	[sound:s-2040_その新聞社には全国各地に支局があります。.mp3] <br> The newspaper company has branch offices all over the country. <br>
[sound:s-2040_その新聞社には全国各地に支局があります。.mp3]	(<b>支局</b>) その新聞社には全国各地に支局があります。The newspaper company has branch offices all over the country. <br>
知事	[sound:k-2041_知事.mp3]<br>ちじ <br> prefectural governor
prefectural governor	<b>知事<b> <br> ちじ <br>[sound:k-2041_知事.mp3]
[sound:k-2041_知事.mp3]	prefectural governor<br> <b>知事</b> <br> (ちじ)
<b>政局</b> <br> 最近の政局は混乱しています。	[sound:s-2041_最近の政局は混乱しています。.mp3] <br> Recent political affairs have been chaotic. <br>
[sound:s-2041_最近の政局は混乱しています。.mp3]	(<b>政局</b>) 最近の政局は混乱しています。Recent political affairs have been chaotic. <br>
知らん顔	[sound:k-2042_知らん顔.mp3]<br>しらんかお <br> unconcerned air, indifference, feigned ignorance, pretending not to recognize (somebody)
unconcerned air, indifference, feigned ignorance, pretending not to recognize (somebody)	<b>知らん顔<b> <br> しらんかお <br>[sound:k-2042_知らん顔.mp3]
[sound:k-2042_知らん顔.mp3]	unconcerned air, indifference, feigned ignorance, pretending not to recognize<br> <b>somebody) (知らん顔</b> <br> (しらんかお)
<b>局面</b> <br> 我々は新しい局面に直面しています。	[sound:s-2042_我々は新しい局面に直面しています。.mp3] <br> We are facing a new phase. <br>
[sound:s-2042_我々は新しい局面に直面しています。.mp3]	(<b>局面</b>) 我々は新しい局面に直面しています。We are facing a new phase. <br>
県知事	[sound:k-2043_県知事.mp3]<br>けんちじ <br> prefectural governor
prefectural governor	<b>県知事<b> <br> けんちじ <br>[sound:k-2043_県知事.mp3]
[sound:k-2043_県知事.mp3]	prefectural governor<br> <b>県知事</b> <br> (けんちじ)
<b>郵便局</b> <br> 郵便局で手紙を送ります。	[sound:s-2043_郵便局で手紙を送ります。.mp3] <br> I'll send the letter at the post office. <br>
[sound:s-2043_郵便局で手紙を送ります。.mp3]	(<b>郵便局</b>) 郵便局で手紙を送ります。I'll send the letter at the post office. <br>
知識	[sound:k-2044_知識.mp3]<br>ちしき <br> knowledge, information
knowledge, information	<b>知識<b> <br> ちしき <br>[sound:k-2044_知識.mp3]
[sound:k-2044_知識.mp3]	knowledge, information<br> <b>知識</b> <br> (ちしき)
<b>対局</b> <br> 彼は対局中に不注意をしてしまいました。	[sound:s-2044_彼は対局中に不注意をしてしまいました。.mp3] <br> He made a careless move during the game. <br>
[sound:s-2044_彼は対局中に不注意をしてしまいました。.mp3]	(<b>対局</b>) 彼は対局中に不注意をしてしまいました。He made a careless move during the game. <br>
知人	[sound:k-2045_知人.mp3]<br>ちじん <br> friend, acquaintance
friend, acquaintance	<b>知人<b> <br> ちじん <br>[sound:k-2045_知人.mp3]
[sound:k-2045_知人.mp3]	friend, acquaintance<br> <b>知人</b> <br> (ちじん)
<b>少し</b> <br> 私は少し疲れています。	[sound:s-2045_私は少し疲れています。.mp3] <br> I am a little tired. <br>
[sound:s-2045_私は少し疲れています。.mp3]	(<b>少し</b>) 私は少し疲れています。I am a little tired. <br>
知恵	[sound:k-2046_知恵.mp3]<br>ちえ <br> wisdom, wit, sagacity, sense, intelligence; prajna (insight leading to enlightenmen)
wisdom, wit, sagacity, sense, intelligence; prajna (insight leading to enlightenmen)	<b>知恵<b> <br> ちえ <br>[sound:k-2046_知恵.mp3]
[sound:k-2046_知恵.mp3]	wisdom, wit, sagacity, sense, intelligence; prajna<br> <b>insight leading to enlightenmen) (知恵</b> <br> (ちえ)
<b>少なくとも</b> <br> 少なくとも3時間は必要です。	[sound:s-2046_少なくとも3時間は必要です。.mp3] <br> At least three hours are necessary. <br>
[sound:s-2046_少なくとも3時間は必要です。.mp3]	(<b>少なくとも</b>) 少なくとも3時間は必要です。At least three hours are necessary. <br>
知的	[sound:k-2047_知的.mp3]<br>ちてき <br> intellectual
intellectual	<b>知的<b> <br> ちてき <br>[sound:k-2047_知的.mp3]
[sound:k-2047_知的.mp3]	intellectual<br> <b>知的</b> <br> (ちてき)
<b>少年</b> <br> その少年は公園で遊んでいます。	[sound:s-2047_その少年は公園で遊んでいます。.mp3] <br> The boy is playing in the park. <br>
[sound:s-2047_その少年は公園で遊んでいます。.mp3]	(<b>少年</b>) その少年は公園で遊んでいます。The boy is playing in the park. <br>
通知	[sound:k-2048_通知.mp3]<br>つうち <br> notice, notification, report, posting
notice, notification, report, posting	<b>通知<b> <br> つうち <br>[sound:k-2048_通知.mp3]
[sound:k-2048_通知.mp3]	notice, notification, report, posting<br> <b>通知</b> <br> (つうち)
<b>減少</b> <br> 資源の減少が問題となっています。	[sound:s-2048_資源の減少が問題となっています。.mp3] <br> The decrease in resources is a problem. <br>
[sound:s-2048_資源の減少が問題となっています。.mp3]	(<b>減少</b>) 資源の減少が問題となっています。The decrease in resources is a problem. <br>
副知事	[sound:k-2049_副知事.mp3]<br>ふくちじ <br> lieutenant governor
lieutenant governor	<b>副知事<b> <br> ふくちじ <br>[sound:k-2049_副知事.mp3]
[sound:k-2049_副知事.mp3]	lieutenant governor<br> <b>副知事</b> <br> (ふくちじ)
<b>少数</b> <br> 少数意見も尊重されるべきです。	[sound:s-2049_少数意見も尊重されるべきです。.mp3] <br> Minority opinions should also be respected. <br>
[sound:s-2049_少数意見も尊重されるべきです。.mp3]	(<b>少数</b>) 少数意見も尊重されるべきです。Minority opinions should also be respected. <br>
法案	[sound:k-2050_法案.mp3]<br>ほうあん <br> bill (law)
bill (law)	<b>法案<b> <br> ほうあん <br>[sound:k-2050_法案.mp3]
[sound:k-2050_法案.mp3]	bill<br> <b>law) (法案</b> <br> (ほうあん)
<b>少女</b> <br> 公園で少女たちが楽しそうに遊んでいる。	[sound:s-2050_公園で少女たちが楽しそうに遊んでいる。.mp3] <br> The girls are playing happily in the park. <br>
[sound:s-2050_公園で少女たちが楽しそうに遊んでいる。.mp3]	(<b>少女</b>) 公園で少女たちが楽しそうに遊んでいる。The girls are playing happily in the park. <br>
提案	[sound:k-2051_提案.mp3]<br>ていあん <br> proposal, proposition, suggestion
proposal, proposition, suggestion	<b>提案<b> <br> ていあん <br>[sound:k-2051_提案.mp3]
[sound:k-2051_提案.mp3]	proposal, proposition, suggestion<br> <b>提案</b> <br> (ていあん)
<b>青少年</b> <br> 青少年の犯罪が増加しています。	[sound:s-2051_青少年の犯罪が増加しています。.mp3] <br> Juvenile crime is increasing. <br>
[sound:s-2051_青少年の犯罪が増加しています。.mp3]	(<b>青少年</b>) 青少年の犯罪が増加しています。Juvenile crime is increasing. <br>
廃案	[sound:k-2052_廃案.mp3]<br>はいあん <br> rejected bill (project)
rejected bill (project)	<b>廃案<b> <br> はいあん <br>[sound:k-2052_廃案.mp3]
[sound:k-2052_廃案.mp3]	rejected bill<br> <b>project) (廃案</b> <br> (はいあん)
<b>多少</b> <br> 彼は多少の経験を持っています。	[sound:s-2052_彼は多少の経験を持っています。.mp3] <br> He has some experience. <br>
[sound:s-2052_彼は多少の経験を持っています。.mp3]	(<b>多少</b>) 彼は多少の経験を持っています。He has some experience. <br>
懸案	[sound:k-2053_懸案.mp3]<br>けんあん <br> pending question, pending problem
pending question, pending problem	<b>懸案<b> <br> けんあん <br>[sound:k-2053_懸案.mp3]
[sound:k-2053_懸案.mp3]	pending question, pending problem<br> <b>懸案</b> <br> (けんあん)
<b>少ない</b> <br> 今日は仕事が少ないです。	[sound:s-2053_今日は仕事が少ないです。.mp3] <br> There is little work today. <br>
[sound:s-2053_今日は仕事が少ないです。.mp3]	(<b>少ない</b>) 今日は仕事が少ないです。There is little work today. <br>
原案	[sound:k-2054_原案.mp3]<br>げんあん <br> original plan, original bill, motion, draft, draught
original plan, original bill, motion, draft, draught	<b>原案<b> <br> げんあん <br>[sound:k-2054_原案.mp3]
[sound:k-2054_原案.mp3]	original plan, original bill, motion, draft, draught<br> <b>原案</b> <br> (げんあん)
<b>少なからず</b> <br> 彼女はこの件について少なからず知識がある。	[sound:s-2054_彼女はこの件について少なからず知識がある。.mp3] <br> She has some knowledge about this matter. <br>
[sound:s-2054_彼女はこの件について少なからず知識がある。.mp3]	(<b>少なからず</b>) 彼女はこの件について少なからず知識がある。She has some knowledge about this matter. <br>
案内	[sound:k-2055_案内.mp3]<br>あんない <br> information, guidance, leading; to guide, to show (around), to conduct
information, guidance, leading; to guide, to show (around), to conduct	<b>案内<b> <br> あんない <br>[sound:k-2055_案内.mp3]
[sound:k-2055_案内.mp3]	information, guidance, leading; to guide, to show<br> <b>around), to conduct (案内</b> <br> (あんない)
<b>放る</b> <br> ゴミを海に放るべきではありません。	[sound:s-2055_ゴミを海に放るべきではありません。.mp3] <br> You shouldn't throw garbage into the sea. <br>
[sound:s-2055_ゴミを海に放るべきではありません。.mp3]	(<b>放る</b>) ゴミを海に放るべきではありません。You shouldn't throw garbage into the sea. <br>
草案	[sound:k-2056_草案.mp3]<br>そうあん <br> draft, draught
draft, draught	<b>草案<b> <br> そうあん <br>[sound:k-2056_草案.mp3]
[sound:k-2056_草案.mp3]	draft, draught<br> <b>草案</b> <br> (そうあん)
<b>放送</b> <br> テレビでライブ放送が行われました。	[sound:s-2056_テレビでライブ放送が行われました。.mp3] <br> A live broadcast was aired on TV. <br>
[sound:s-2056_テレビでライブ放送が行われました。.mp3]	(<b>放送</b>) テレビでライブ放送が行われました。A live broadcast was aired on TV. <br>
案件	[sound:k-2057_案件.mp3]<br>あんけん <br> matter in question, subject
matter in question, subject	<b>案件<b> <br> あんけん <br>[sound:k-2057_案件.mp3]
[sound:k-2057_案件.mp3]	matter in question, subject<br> <b>案件</b> <br> (あんけん)
<b>開放</b> <br> 公園は一般に開放されています。	[sound:s-2057_公園は一般に開放されています。.mp3] <br> The park is generally open to the public. <br>
[sound:s-2057_公園は一般に開放されています。.mp3]	(<b>開放</b>) 公園は一般に開放されています。The park is generally open to the public. <br>
試案	[sound:k-2058_試案.mp3]<br>しあん <br> tentative
tentative	<b>試案<b> <br> しあん <br>[sound:k-2058_試案.mp3]
[sound:k-2058_試案.mp3]	tentative<br> <b>試案</b> <br> (しあん)
<b>解放</b> <br> 囚人が解放されました。	[sound:s-2058_囚人が解放されました。.mp3] <br> The prisoner was released. <br>
[sound:s-2058_囚人が解放されました。.mp3]	(<b>解放</b>) 囚人が解放されました。The prisoner was released. <br>
立案	[sound:k-2059_立案.mp3]<br>りつあん <br> draft, draught, (rough) design
draft, draught, (rough) design	<b>立案<b> <br> りつあん <br>[sound:k-2059_立案.mp3]
[sound:k-2059_立案.mp3]	draft, draught,<br> <b>rough) design (立案</b> <br> (りつあん)
<b>民放</b> <br> 民放のテレビ局で新しい番組が始まります。	[sound:s-2059_民放のテレビ局で新しい番組が始まります。.mp3] <br> A new program will start on private television channels. <br>
[sound:s-2059_民放のテレビ局で新しい番組が始まります。.mp3]	(<b>民放</b>) 民放のテレビ局で新しい番組が始まります。A new program will start on private television channels. <br>
道	[sound:k-2060_道.mp3]<br>みち <br> road, street, way, path, course, route, lane; distance, ways (e.g. "a long ways"); the way (of proper conduct, etc.), one's way, morals; teachings (esp. Confucian or Buddhist), dogma; field (of medicine, etc.), subject; way, method, means
road, street, way, path, course, route, lane; distance, ways (e.g. "a long ways"); the way (of proper conduct, etc.), one's way, morals; teachings (esp. Confucian or Buddhist), dogma; field (of medicine, etc.), subject; way, method, means	<b>道<b> <br> みち <br>[sound:k-2060_道.mp3]
[sound:k-2060_道.mp3]	road, street, way, path, course, route, lane; distance, ways<br> <b>e.g. "a long ways"); the way (of proper conduct, etc.), one's way, morals; teachings (esp. Confucian or Buddhist), dogma; field (of medicine, etc.), subject; way, method, means (道</b> <br> (みち)
<b>追放</b> <br> 彼は組織から追放された。	[sound:s-2060_彼は組織から追放された。.mp3] <br> He was expelled from the organization. <br>
[sound:s-2060_彼は組織から追放された。.mp3]	(<b>追放</b>) 彼は組織から追放された。He was expelled from the organization. <br>
報道	[sound:k-2061_報道.mp3]<br>ほうどう <br> information, report, journalism
information, report, journalism	<b>報道<b> <br> ほうどう <br>[sound:k-2061_報道.mp3]
[sound:k-2061_報道.mp3]	information, report, journalism<br> <b>報道</b> <br> (ほうどう)
<b>放射性</b> <br> 放射性物質が健康に悪影響を与える可能性があります。	[sound:s-2061_放射性物質が健康に悪影響を与える可能性があります。.mp3] <br> Radioactive substances may have adverse effects on health. <br>
[sound:s-2061_放射性物質が健康に悪影響を与える可能性があります。.mp3]	(<b>放射性</b>) 放射性物質が健康に悪影響を与える可能性があります。Radioactive substances may have adverse effects on health. <br>
北海道	[sound:k-2062_北海道.mp3]<br>ほっかいどう <br> Hokkaido (northernmost of the four main islands of Japan)
Hokkaido (northernmost of the four main islands of Japan)	<b>北海道<b> <br> ほっかいどう <br>[sound:k-2062_北海道.mp3]
[sound:k-2062_北海道.mp3]	Hokkaido<br> <b>northernmost of the four main islands of Japan) (北海道</b> <br> (ほっかいどう)
<b>放射線</b> <br> 放射線の影響を受けることがあります。	[sound:s-2062_放射線の影響を受けることがあります。.mp3] <br> You may be exposed to radiation. <br>
[sound:s-2062_放射線の影響を受けることがあります。.mp3]	(<b>放射線</b>) 放射線の影響を受けることがあります。You may be exposed to radiation. <br>
道路	[sound:k-2063_道路.mp3]<br>どうろ <br> road, highway
road, highway	<b>道路<b> <br> どうろ <br>[sound:k-2063_道路.mp3]
[sound:k-2063_道路.mp3]	road, highway<br> <b>道路</b> <br> (どうろ)
<b>放射能</b> <br> 福島の事故で放射能が漏れ出した。	[sound:s-2063_福島の事故で放射能が漏れ出した。.mp3] <br> Radiation leaked out in the Fukushima accident. <br>
[sound:s-2063_福島の事故で放射能が漏れ出した。.mp3]	(<b>放射能</b>) 福島の事故で放射能が漏れ出した。Radiation leaked out in the Fukushima accident. <br>
鉄道	[sound:k-2064_鉄道.mp3]<br>てつどう <br> railroad
railroad	<b>鉄道<b> <br> てつどう <br>[sound:k-2064_鉄道.mp3]
[sound:k-2064_鉄道.mp3]	railroad<br> <b>鉄道</b> <br> (てつどう)
<b>放映</b> <br> ドラマがテレビで放映されます。	[sound:s-2064_ドラマがテレビで放映されます。.mp3] <br> The drama will be broadcasted on TV. <br>
[sound:s-2064_ドラマがテレビで放映されます。.mp3]	(<b>放映</b>) ドラマがテレビで放映されます。The drama will be broadcasted on TV. <br>
都道府県	[sound:k-2065_都道府県.mp3]<br>とどうふけん <br> administrative divisions of Japan: Tokyo-to, Hokkai-do, Osaka-fu, Kyoto-fu and remaining prefectures
administrative divisions of Japan: Tokyo-to, Hokkai-do, Osaka-fu, Kyoto-fu and remaining prefectures	<b>都道府県<b> <br> とどうふけん <br>[sound:k-2065_都道府県.mp3]
[sound:k-2065_都道府県.mp3]	administrative divisions of Japan: Tokyo-to, Hokkai-do, Osaka-fu, Kyoto-fu and remaining prefectures<br> <b>都道府県</b> <br> (とどうふけん)
<b>関税</b> <br> 関税が上がりました。	[sound:s-2065_関税が上がりました。.mp3] <br> The tariff has been raised. <br>
[sound:s-2065_関税が上がりました。.mp3]	(<b>関税</b>) 関税が上がりました。The tariff has been raised. <br>
軌道	[sound:k-2066_軌道.mp3]<br>きどう <br> orbit, trajectory; railroad track
orbit, trajectory; railroad track	<b>軌道<b> <br> きどう <br>[sound:k-2066_軌道.mp3]
[sound:k-2066_軌道.mp3]	orbit, trajectory; railroad track<br> <b>軌道</b> <br> (きどう)
<b>減税</b> <br> 政府は所得税を減税しました。	[sound:s-2066_政府は所得税を減税しました。.mp3] <br> The government reduced income tax. <br>
[sound:s-2066_政府は所得税を減税しました。.mp3]	(<b>減税</b>) 政府は所得税を減税しました。The government reduced income tax. <br>
柔道	[sound:k-2067_柔道.mp3]<br>じゅうどう <br> judo
judo	<b>柔道<b> <br> じゅうどう <br>[sound:k-2067_柔道.mp3]
[sound:k-2067_柔道.mp3]	judo<br> <b>柔道</b> <br> (じゅうどう)
<b>消費税</b> <br> 消費税率が上がりました。	[sound:s-2067_消費税率が上がりました。.mp3] <br> The consumption tax rate has increased. <br>
[sound:s-2067_消費税率が上がりました。.mp3]	(<b>消費税</b>) 消費税率が上がりました。The consumption tax rate has increased. <br>
報道陣	[sound:k-2068_報道陣.mp3]<br>ほうどうじん <br> press corps
press corps	<b>報道陣<b> <br> ほうどうじん <br>[sound:k-2068_報道陣.mp3]
[sound:k-2068_報道陣.mp3]	press corps<br> <b>報道陣</b> <br> (ほうどうじん)
<b>税制</b> <br> 国の税制が変更されました。	[sound:s-2068_国の税制が変更されました。.mp3] <br> The country's tax system has been changed. <br>
[sound:s-2068_国の税制が変更されました。.mp3]	(<b>税制</b>) 国の税制が変更されました。The country's tax system has been changed. <br>
高速道路	[sound:k-2069_高速道路.mp3]<br>こうそくどうろ <br> highway, freeway, expressway, motorway
highway, freeway, expressway, motorway	<b>高速道路<b> <br> こうそくどうろ <br>[sound:k-2069_高速道路.mp3]
[sound:k-2069_高速道路.mp3]	highway, freeway, expressway, motorway<br> <b>高速道路</b> <br> (こうそくどうろ)
<b>課税</b> <br> 収入に対して課税されます。	[sound:s-2069_収入に対して課税されます。.mp3] <br> Income is subject to taxation. <br>
[sound:s-2069_収入に対して課税されます。.mp3]	(<b>課税</b>) 収入に対して課税されます。Income is subject to taxation. <br>
信	[sound:k-2070_信.mp3]<br>しん <br> honesty, fidelity; trust, reliance; (religious) faith; counter for received messages
honesty, fidelity; trust, reliance; (religious) faith; counter for received messages	<b>信<b> <br> しん <br>[sound:k-2070_信.mp3]
[sound:k-2070_信.mp3]	honesty, fidelity; trust, reliance;<br> <b>religious) faith; counter for received messages (信</b> <br> (しん)
<b>所得税</b> <br> 彼は年に一度所得税を払います。	[sound:s-2070_彼は年に一度所得税を払います。.mp3] <br> He pays income tax once a year. <br>
[sound:s-2070_彼は年に一度所得税を払います。.mp3]	(<b>所得税</b>) 彼は年に一度所得税を払います。He pays income tax once a year. <br>
通信	[sound:k-2071_通信.mp3]<br>つうしん <br> correspondence, communication, transmission, news, signal
correspondence, communication, transmission, news, signal	<b>通信<b> <br> つうしん <br>[sound:k-2071_通信.mp3]
[sound:k-2071_通信.mp3]	correspondence, communication, transmission, news, signal<br> <b>通信</b> <br> (つうしん)
<b>税率</b> <br> 高い税率が経済に影響を与えることがあります。	[sound:s-2071_高い税率が経済に影響を与えることがあります。.mp3] <br> High tax rates can affect the economy. <br>
[sound:s-2071_高い税率が経済に影響を与えることがあります。.mp3]	(<b>税率</b>) 高い税率が経済に影響を与えることがあります。High tax rates can affect the economy. <br>
自信	[sound:k-2072_自信.mp3]<br>じしん <br> self-confidence
self-confidence	<b>自信<b> <br> じしん <br>[sound:k-2072_自信.mp3]
[sound:k-2072_自信.mp3]	self-confidence<br> <b>自信</b> <br> (じしん)
<b>増税</b> <br> 消費税の増税が議論されています。	[sound:s-2072_消費税の増税が議論されています。.mp3] <br> An increase in consumption tax is being discussed. <br>
[sound:s-2072_消費税の増税が議論されています。.mp3]	(<b>増税</b>) 消費税の増税が議論されています。An increase in consumption tax is being discussed. <br>
信用	[sound:k-2073_信用.mp3]<br>しんよう <br> confidence, dependence, credit, faith, reliance, belief, credence
confidence, dependence, credit, faith, reliance, belief, credence	<b>信用<b> <br> しんよう <br>[sound:k-2073_信用.mp3]
[sound:k-2073_信用.mp3]	confidence, dependence, credit, faith, reliance, belief, credence<br> <b>信用</b> <br> (しんよう)
<b>税金</b> <br> 納税者は毎年税金を払わなければなりません。	[sound:s-2073_納税者は毎年税金を払わなければなりません。.mp3] <br> Taxpayers must pay taxes every year. <br>
[sound:s-2073_納税者は毎年税金を払わなければなりません。.mp3]	(<b>税金</b>) 納税者は毎年税金を払わなければなりません。Taxpayers must pay taxes every year. <br>
信頼	[sound:k-2074_信頼.mp3]<br>しんらい <br> reliance, trust, faith, confidence
reliance, trust, faith, confidence	<b>信頼<b> <br> しんらい <br>[sound:k-2074_信頼.mp3]
[sound:k-2074_信頼.mp3]	reliance, trust, faith, confidence<br> <b>信頼</b> <br> (しんらい)
<b>税収</b> <br> 政府の税収が予想を上回りました。	[sound:s-2074_政府の税収が予想を上回りました。.mp3] <br> Government tax revenue exceeded expectations. <br>
[sound:s-2074_政府の税収が予想を上回りました。.mp3]	(<b>税収</b>) 政府の税収が予想を上回りました。Government tax revenue exceeded expectations. <br>
不信	[sound:k-2075_不信.mp3]<br>ふしん <br> unfaithfulness, insincerity, perfidy, mistrust, distrust, discredit
unfaithfulness, insincerity, perfidy, mistrust, distrust, discredit	<b>不信<b> <br> ふしん <br>[sound:k-2075_不信.mp3]
[sound:k-2075_不信.mp3]	unfaithfulness, insincerity, perfidy, mistrust, distrust, discredit<br> <b>不信</b> <br> (ふしん)
<b>検査</b> <br> 製品に品質検査を行います。	[sound:s-2075_製品に品質検査を行います。.mp3] <br> Quality inspection will be conducted on the product. <br>
[sound:s-2075_製品に品質検査を行います。.mp3]	(<b>検査</b>) 製品に品質検査を行います。Quality inspection will be conducted on the product. <br>
信託	[sound:k-2076_信託.mp3]<br>しんたく <br> trust, entrusting
trust, entrusting	<b>信託<b> <br> しんたく <br>[sound:k-2076_信託.mp3]
[sound:k-2076_信託.mp3]	trust, entrusting<br> <b>信託</b> <br> (しんたく)
<b>検察</b> <br> 検察官は犯罪捜査を行います。	[sound:s-2076_検察官は犯罪捜査を行います。.mp3] <br> The prosecutor conducts criminal investigations. <br>
[sound:s-2076_検察官は犯罪捜査を行います。.mp3]	(<b>検察</b>) 検察官は犯罪捜査を行います。The prosecutor conducts criminal investigations. <br>
不信任	[sound:k-2077_不信任.mp3]<br>ふしんにん <br> non-confidence, lack of confidence
non-confidence, lack of confidence	<b>不信任<b> <br> ふしんにん <br>[sound:k-2077_不信任.mp3]
[sound:k-2077_不信任.mp3]	non-confidence, lack of confidence<br> <b>不信任</b> <br> (ふしんにん)
<b>検討</b> <br> その案を検討します。	[sound:s-2077_その案を検討します。.mp3] <br> We will consider that proposal. <br>
[sound:s-2077_その案を検討します。.mp3]	(<b>検討</b>) その案を検討します。We will consider that proposal. <br>
信号	[sound:k-2078_信号.mp3]<br>しんごう <br> traffic lights, signal, semaphore
traffic lights, signal, semaphore	<b>信号<b> <br> しんごう <br>[sound:k-2078_信号.mp3]
[sound:k-2078_信号.mp3]	traffic lights, signal, semaphore<br> <b>信号</b> <br> (しんごう)
<b>地検</b> <br> 彼は地検に勤務しています。	[sound:s-2078_彼は地検に勤務しています。.mp3] <br> He works at the district prosecutor's office. <br>
[sound:s-2078_彼は地検に勤務しています。.mp3]	(<b>地検</b>) 彼は地検に勤務しています。He works at the district prosecutor's office. <br>
受信	[sound:k-2079_受信.mp3]<br>じゅしん <br> reception (e.g. radio), receipt
reception (e.g. radio), receipt	<b>受信<b> <br> じゅしん <br>[sound:k-2079_受信.mp3]
[sound:k-2079_受信.mp3]	reception<br> <b>e.g. radio), receipt (受信</b> <br> (じゅしん)
<b>検事</b> <br> 彼は有名な検事です。	[sound:s-2079_彼は有名な検事です。.mp3] <br> He is a famous prosecutor. <br>
[sound:s-2079_彼は有名な検事です。.mp3]	(<b>検事</b>) 彼は有名な検事です。He is a famous prosecutor. <br>
政策	[sound:k-2080_政策.mp3]<br>せいさく <br> political measures, policy
political measures, policy	<b>政策<b> <br> せいさく <br>[sound:k-2080_政策.mp3]
[sound:k-2080_政策.mp3]	political measures, policy<br> <b>政策</b> <br> (せいさく)
<b>検定</b> <br> その製品は安全性の検定を通過しました。	[sound:s-2080_その製品は安全性の検定を通過しました。.mp3] <br> The product passed the safety inspection. <br>
[sound:s-2080_その製品は安全性の検定を通過しました。.mp3]	(<b>検定</b>) その製品は安全性の検定を通過しました。The product passed the safety inspection. <br>
対策	[sound:k-2081_対策.mp3]<br>たいさく <br> counter-plan, counter-measure
counter-plan, counter-measure	<b>対策<b> <br> たいさく <br>[sound:k-2081_対策.mp3]
[sound:k-2081_対策.mp3]	counter-plan, counter-measure<br> <b>対策</b> <br> (たいさく)
<b>点検</b> <br> 車両の点検を定期的に行います。	[sound:s-2081_車両の点検を定期的に行います。.mp3] <br> Regular inspections of vehicles are conducted. <br>
[sound:s-2081_車両の点検を定期的に行います。.mp3]	(<b>点検</b>) 車両の点検を定期的に行います。Regular inspections of vehicles are conducted. <br>
策	[sound:k-2082_策.mp3]<br>さく <br> plan, policy
plan, policy	<b>策<b> <br> さく <br>[sound:k-2082_策.mp3]
[sound:k-2082_策.mp3]	plan, policy<br> <b>策</b> <br> (さく)
<b>検証</b> <br> その説の正確性を検証します。	[sound:s-2082_その説の正確性を検証します。.mp3] <br> We will verify the accuracy of that theory. <br>
[sound:s-2082_その説の正確性を検証します。.mp3]	(<b>検証</b>) その説の正確性を検証します。We will verify the accuracy of that theory. <br>
策定	[sound:k-2083_策定.mp3]<br>さくてい <br> decision, settling on
decision, settling on	<b>策定<b> <br> さくてい <br>[sound:k-2083_策定.mp3]
[sound:k-2083_策定.mp3]	decision, settling on<br> <b>策定</b> <br> (さくてい)
<b>検診</b> <br> 健康診断の検診を受ける。	[sound:s-2083_健康診断の検診を受ける。.mp3] <br> Undergo a health check-up. <br>
[sound:s-2083_健康診断の検診を受ける。.mp3]	(<b>検診</b>) 健康診断の検診を受ける。Undergo a health check-up. <br>
施策	[sound:k-2084_施策.mp3]<br>しさく <br> policy, measure
policy, measure	<b>施策<b> <br> しさく <br>[sound:k-2084_施策.mp3]
[sound:k-2084_施策.mp3]	policy, measure<br> <b>施策</b> <br> (しさく)
<b>藤</b> <br> 藤の花が美しいです。	[sound:s-2084_藤の花が美しいです。.mp3] <br>  ふじのはながうつくしいです。 <br> The wisteria flowers are beautiful.
[sound:s-2084_藤の花が美しいです。.mp3]	<b>藤</b> <br> 藤の花が美しいです。<br>  ふじのはながうつくしいです <br> The wisteria flowers are beautiful.
方策	[sound:k-2085_方策.mp3]<br>ほうさく <br> plan, policy
plan, policy	<b>方策<b> <br> ほうさく <br>[sound:k-2085_方策.mp3]
[sound:k-2085_方策.mp3]	plan, policy<br> <b>方策</b> <br> (ほうさく)
<b>葛藤</b> <br> 彼らの間には葛藤がある。	[sound:s-2085_彼らの間には葛藤がある。.mp3] <br>  かれらのあいだにはかっとうがある。 <br> There is conflict between them.
[sound:s-2085_彼らの間には葛藤がある。.mp3]	<b>葛藤</b> <br> 彼らの間には葛藤がある。<br>  かれらのあいだにはかっとうがある <br> There is conflict between them.
失策	[sound:k-2086_失策.mp3]<br>しっさく <br> blunder, slip, error
blunder, slip, error	<b>失策<b> <br> しっさく <br>[sound:k-2086_失策.mp3]
[sound:k-2086_失策.mp3]	blunder, slip, error<br> <b>失策</b> <br> (しっさく)
<b>藤色</b> <br> 彼女のドレスは藤色です。	[sound:s-2086_彼女のドレスは藤色です。.mp3] <br>  かのじょのどれすはふじいろです。 <br> Her dress is wisteria-colored.
[sound:s-2086_彼女のドレスは藤色です。.mp3]	<b>藤色</b> <br> 彼女のドレスは藤色です。<br>  かのじょのどれすはふじいろです <br> Her dress is wisteria-colored.
得策	[sound:k-2087_得策.mp3]<br>とくさく <br> profitable plan, good plan
profitable plan, good plan	<b>得策<b> <br> とくさく <br>[sound:k-2087_得策.mp3]
[sound:k-2087_得策.mp3]	profitable plan, good plan<br> <b>得策</b> <br> (とくさく)
<b>藤棚</b> <br> 庭に藤棚を作りたいです。	[sound:s-2087_庭に藤棚を作りたいです。.mp3] <br>  にわにふじだなをつくりたいです。 <br> I want to build a wisteria trellis in the garden.
[sound:s-2087_庭に藤棚を作りたいです。.mp3]	<b>藤棚</b> <br> 庭に藤棚を作りたいです。<br>  にわにふじだなをつくりたいです <br> I want to build a wisteria trellis in the garden.
苦肉の策	[sound:k-2088_苦肉の策.mp3]<br>くにくのさく <br> last resort, desperate measure taken under pressure of necessity
last resort, desperate measure taken under pressure of necessity	<b>苦肉の策<b> <br> くにくのさく <br>[sound:k-2088_苦肉の策.mp3]
[sound:k-2088_苦肉の策.mp3]	last resort, desperate measure taken under pressure of necessity<br> <b>苦肉の策</b> <br> (くにくのさく)
<b>藤蔓</b> <br> 藤蔓が壁を覆っている。	[sound:s-2088_藤蔓が壁を覆っている。.mp3] <br>  ふじづるがかべをおおっている。 <br> The wisteria vine is covering the wall.
[sound:s-2088_藤蔓が壁を覆っている。.mp3]	<b>藤蔓</b> <br> 藤蔓が壁を覆っている。<br>  ふじづるがかべをおおっている <br> The wisteria vine is covering the wall.
国策	[sound:k-2089_国策.mp3]<br>こくさく <br> national policy
national policy	<b>国策<b> <br> こくさく <br>[sound:k-2089_国策.mp3]
[sound:k-2089_国策.mp3]	national policy<br> <b>国策</b> <br> (こくさく)
<b>藤氏</b> <br> 藤氏は古代の氏族です。	[sound:s-2089_藤氏は古代の氏族です。.mp3] <br>  とうじはこだいのしぞくです。 <br> The Fuji clan is an ancient lineage.
[sound:s-2089_藤氏は古代の氏族です。.mp3]	<b>藤氏</b> <br> 藤氏は古代の氏族です。<br>  とうじはこだいのしぞくです <br> The Fuji clan is an ancient lineage.
集める	[sound:k-2090_集める.mp3]<br>あつめる <br> to collect, to assemble, to gather
to collect, to assemble, to gather	<b>集める<b> <br> あつめる <br>[sound:k-2090_集める.mp3]
[sound:k-2090_集める.mp3]	to collect, to assemble, to gather<br> <b>集める</b> <br> (あつめる)
<b>藤本</b> <br> 私の友人の名前は藤本です。	[sound:s-2090_私の友人の名前は藤本です。.mp3] <br>  わたしのゆうじんのなまえはふじもとです。 <br> My friend's name is Fujimoto.
[sound:s-2090_私の友人の名前は藤本です。.mp3]	<b>藤本</b> <br> 私の友人の名前は藤本です。<br>  わたしのゆうじんのなまえはふじもとです <br> My friend's name is Fujimoto.
集会	[sound:k-2091_集会.mp3]<br>しゅうかい <br> meeting, assembly
meeting, assembly	<b>集会<b> <br> しゅうかい <br>[sound:k-2091_集会.mp3]
[sound:k-2091_集会.mp3]	meeting, assembly<br> <b>集会</b> <br> (しゅうかい)
<b>上り藤</b> <br> 庭に上り藤を植えました。	[sound:s-2091_庭に上り藤を植えました。.mp3] <br>  にわにのぼりふじをうえました。 <br> We planted climbing wisteria in the garden.
[sound:s-2091_庭に上り藤を植えました。.mp3]	<b>上り藤</b> <br> 庭に上り藤を植えました。<br>  にわにのぼりふじをうえました <br> We planted climbing wisteria in the garden.
集団	[sound:k-2092_集団.mp3]<br>しゅうだん <br> group, mass
group, mass	<b>集団<b> <br> しゅうだん <br>[sound:k-2092_集団.mp3]
[sound:k-2092_集団.mp3]	group, mass<br> <b>集団</b> <br> (しゅうだん)
<b>藤原氏の出</b> <br> 藤原氏の出は古代に遡る。	[sound:s-2092_藤原氏の出は古代に遡る。.mp3] <br>  ふじわらしのではこだいにさかのぼる。 <br> The origin of the Fujiwara clan dates back to ancient times.
[sound:s-2092_藤原氏の出は古代に遡る。.mp3]	<b>藤原氏の出</b> <br> 藤原氏の出は古代に遡る。<br>  ふじわらしのではこだいにさかのぼる <br> The origin of the Fujiwara clan dates back to ancient times.
編集	[sound:k-2093_編集.mp3]<br>へんしゅう <br> editing, compilation, editorial (e.g. committee)
editing, compilation, editorial (e.g. committee)	<b>編集<b> <br> へんしゅう <br>[sound:k-2093_編集.mp3]
[sound:k-2093_編集.mp3]	editing, compilation, editorial<br> <b>e.g. committee) (編集</b> <br> (へんしゅう)
<b>藤袴</b> <br> 彼は藤袴を着ている。	[sound:s-2093_彼は藤袴を着ている。.mp3] <br> かれはふじばかまをきている。 <br>He is wearing wisteria-colored trousers.
[sound:s-2093_彼は藤袴を着ている。.mp3]	<b>藤袴</b> <br> 彼は藤袴を着ている。<br> かれはふじばかまをきている <br>He is wearing wisteria-colored trousers.
集中	[sound:k-2094_集中.mp3]<br>しゅうちゅう <br> concentration, convergence, centralization, integration, gathering together
concentration, convergence, centralization, integration, gathering together	<b>集中<b> <br> しゅうちゅう <br>[sound:k-2094_集中.mp3]
[sound:k-2094_集中.mp3]	concentration, convergence, centralization, integration, gathering together<br> <b>集中</b> <br> (しゅうちゅう)
<b>町</b> <br> この町は静かです。	[sound:s-2094_この町は静かです。.mp3] <br> このまちはしずかです。 <br>This town is quiet.
[sound:s-2094_この町は静かです。.mp3]	<b>町</b> <br> この町は静かです。<br> このまちはしずかです <br>This town is quiet.
募集	[sound:k-2095_募集.mp3]<br>ぼしゅう <br> recruiting, taking applications
recruiting, taking applications	<b>募集<b> <br> ぼしゅう <br>[sound:k-2095_募集.mp3]
[sound:k-2095_募集.mp3]	recruiting, taking applications<br> <b>募集</b> <br> (ぼしゅう)
<b>市町村</b> <br> この地域には多くの市町村があります。	[sound:s-2095_この地域には多くの市町村があります。.mp3] <br> このちいきにはおおくのしちょうそんがあります。 <br>There are many municipalities in this area.
[sound:s-2095_この地域には多くの市町村があります。.mp3]	<b>市町村</b> <br> この地域には多くの市町村があります。<br> このちいきにはおおくのしちょうそんがあります <br>There are many municipalities in this area.
集まり	[sound:k-2096_集まり.mp3]<br>あつまり <br> gathering, meeting, assembly, collection
gathering, meeting, assembly, collection	<b>集まり<b> <br> あつまり <br>[sound:k-2096_集まり.mp3]
[sound:k-2096_集まり.mp3]	gathering, meeting, assembly, collection<br> <b>集まり</b> <br> (あつまり)
<b>同町</b> <br> 彼女は私の同町出身です。	[sound:s-2096_彼女は私の同町出身です。.mp3] <br> かのじょはわたしのどうまちしゅっしんです。 <br>She is from the same town as me.
[sound:s-2096_彼女は私の同町出身です。.mp3]	<b>同町</b> <br> 彼女は私の同町出身です。<br> かのじょはわたしのどうまちしゅっしんです <br>She is from the same town as me.
収集	[sound:k-2097_収集.mp3]<br>しゅうしゅう <br> gathering up, collection, accumulation
gathering up, collection, accumulation	<b>収集<b> <br> しゅうしゅう <br>[sound:k-2097_収集.mp3]
[sound:k-2097_収集.mp3]	gathering up, collection, accumulation<br> <b>収集</b> <br> (しゅうしゅう)
<b>町長</b> <br> 町長は地元の人々に人気があります。	[sound:s-2097_町長は地元の人々に人気があります。.mp3] <br> ちょうちょうはじもとのひとびとににんきがあります。 <br>The mayor is popular among the local people.
[sound:s-2097_町長は地元の人々に人気があります。.mp3]	<b>町長</b> <br> 町長は地元の人々に人気があります。<br> ちょうちょうはじもとのひとびとににんきがあります <br>The mayor is popular among the local people.
集	[sound:k-2098_集.mp3]<br>しゅう <br> collection, compilation
collection, compilation	<b>集<b> <br> しゅう <br>[sound:k-2098_集.mp3]
[sound:k-2098_集.mp3]	collection, compilation<br> <b>集</b> <br> (しゅう)
<b>町内</b> <br> 町内の環境を改善する計画が進行中です。	[sound:s-2098_町内の環境を改善する計画が進行中です。.mp3] <br> ちょうないのかんきょうをかいぜんするけいかくがしんこうちゅうです。 <br>Plans to improve the town's environment are underway.
[sound:s-2098_町内の環境を改善する計画が進行中です。.mp3]	<b>町内</b> <br> 町内の環境を改善する計画が進行中です。<br> ちょうないのかんきょうをかいぜんするけいかくがしんこうちゅうです <br>Plans to improve the town's environment are underway.
特集	[sound:k-2099_特集.mp3]<br>とくしゅう <br> feature (e.g. newspaper), special edition, report
feature (e.g. newspaper), special edition, report	<b>特集<b> <br> とくしゅう <br>[sound:k-2099_特集.mp3]
[sound:k-2099_特集.mp3]	feature<br> <b>e.g. newspaper), special edition, report (特集</b> <br> (とくしゅう)
<b>下町</b> <br> 下町の雰囲気が好きです。	[sound:s-2099_下町の雰囲気が好きです。.mp3] <br> したまちのふんいきがすきです。 <br>I like the atmosphere of the downtown area.
[sound:s-2099_下町の雰囲気が好きです。.mp3]	<b>下町</b> <br> 下町の雰囲気が好きです。<br> したまちのふんいきがすきです <br>I like the atmosphere of the downtown area.
在る	[sound:k-2100_在る.mp3]<br>ある <br> to be (usu. of inanimate objects), to exist, to live; to have; to be located; to be equipped with; to happen, to come about
to be (usu. of inanimate objects), to exist, to live; to have; to be located; to be equipped with; to happen, to come about	<b>在る<b> <br> ある <br>[sound:k-2100_在る.mp3]
[sound:k-2100_在る.mp3]	to be<br> <b>usu. of inanimate objects), to exist, to live; to have; to be located; to be equipped with; to happen, to come about (在る</b> <br> (ある)
<b>町村</b> <br> 彼の家は小さな町村にあります。	[sound:s-2100_彼の家は小さな町村にあります。.mp3] <br> かれのいえはちいさなちょうそんにあります。 <br>His house is in a small town and village.
[sound:s-2100_彼の家は小さな町村にあります。.mp3]	<b>町村</b> <br> 彼の家は小さな町村にあります。<br> かれのいえはちいさなちょうそんにあります <br>His house is in a small town and village.
現在	[sound:k-2101_現在.mp3]<br>げんざい <br> now, current, present, present time, as of
now, current, present, present time, as of	<b>現在<b> <br> げんざい <br>[sound:k-2101_現在.mp3]
[sound:k-2101_現在.mp3]	now, current, present, present time, as of<br> <b>現在</b> <br> (げんざい)
<b>町民</b> <br> 町民は地域の発展に貢献しています。	[sound:s-2101_町民は地域の発展に貢献しています。.mp3] <br> ちょうみんはちいきのはってんにこうけんしています。 <br>The town residents are contributing to the development of the region.
[sound:s-2101_町民は地域の発展に貢献しています。.mp3]	<b>町民</b> <br> 町民は地域の発展に貢献しています。<br> ちょうみんはちいきのはってんにこうけんしています <br>The town residents are contributing to the development of the region.
存在	[sound:k-2102_存在.mp3]<br>そんざい <br> existence, being
existence, being	<b>存在<b> <br> そんざい <br>[sound:k-2102_存在.mp3]
[sound:k-2102_存在.mp3]	existence, being<br> <b>存在</b> <br> (そんざい)
<b>町並み</b> <br> この町並みは歴史的価値が高いです。	[sound:s-2102_この町並みは歴史的価値が高いです。.mp3] <br> このまちなみはれきしてきかちがたかいです。 <br>The townscape has high historical value.
[sound:s-2102_この町並みは歴史的価値が高いです。.mp3]	<b>町並み</b> <br> この町並みは歴史的価値が高いです。<br> このまちなみはれきしてきかちがたかいです <br>The townscape has high historical value.
在住	[sound:k-2103_在住.mp3]<br>ざいじゅう <br> resident
resident	<b>在住<b> <br> ざいじゅう <br>[sound:k-2103_在住.mp3]
[sound:k-2103_在住.mp3]	resident<br> <b>在住</b> <br> (ざいじゅう)
<b>室町</b> <br> 室町時代には文化が繁栄しました。	[sound:s-2103_室町時代には文化が繁栄しました。.mp3] <br> むろまちじだいにはぶんかがはんえいしました。 <br>Culture flourished during the Muromachi period.
[sound:s-2103_室町時代には文化が繁栄しました。.mp3]	<b>室町</b> <br> 室町時代には文化が繁栄しました。<br> むろまちじだいにはぶんかがはんえいしました <br>Culture flourished during the Muromachi period.
在日	[sound:k-2104_在日.mp3]<br>ざいにち <br> in Japan; people in Japan (esp. Koreans living in Japan, often used as a slur)
in Japan; people in Japan (esp. Koreans living in Japan, often used as a slur)	<b>在日<b> <br> ざいにち <br>[sound:k-2104_在日.mp3]
[sound:k-2104_在日.mp3]	in Japan; people in Japan<br> <b>esp. Koreans living in Japan, often used as a slur) (在日</b> <br> (ざいにち)
<b>常</b> <br> 彼の態度は常ではありません。	[sound:s-2104_彼の態度は常ではありません。.mp3] <br> かれのたいどはつねではありません。 <br>His attitude is not normal.
[sound:s-2104_彼の態度は常ではありません。.mp3]	<b>常</b> <br> 彼の態度は常ではありません。<br> かれのたいどはつねではありません <br>His attitude is not normal.
滞在	[sound:k-2105_滞在.mp3]<br>たいざい <br> stay, sojourn
stay, sojourn	<b>滞在<b> <br> たいざい <br>[sound:k-2105_滞在.mp3]
[sound:k-2105_滞在.mp3]	stay, sojourn<br> <b>滞在</b> <br> (たいざい)
<b>常に</b> <br> 彼女は常に笑顔を見せています。	[sound:s-2105_彼女は常に笑顔を見せています。.mp3] <br> かのじょはつねにえがおをみせています。 <br>She always shows a smile.
[sound:s-2105_彼女は常に笑顔を見せています。.mp3]	<b>常に</b> <br> 彼女は常に笑顔を見せています。<br> かのじょはつねにえがおをみせています <br>She always shows a smile.
在庫	[sound:k-2106_在庫.mp3]<br>ざいこ <br> inventory, stockpile, stock
inventory, stockpile, stock	<b>在庫<b> <br> ざいこ <br>[sound:k-2106_在庫.mp3]
[sound:k-2106_在庫.mp3]	inventory, stockpile, stock<br> <b>在庫</b> <br> (ざいこ)
<b>常務</b> <br> 彼は会社の常務です。	[sound:s-2106_彼は会社の常務です。.mp3] <br> かれはかいしゃのじょうむです。 <br>He is the managing director of the company.
[sound:s-2106_彼は会社の常務です。.mp3]	<b>常務</b> <br> 彼は会社の常務です。<br> かれはかいしゃのじょうむです <br>He is the managing director of the company.
在りし日	[sound:k-2107_在りし日.mp3]<br>ありしひ <br> days of yore, the olden days; during one's lifetime
days of yore, the olden days; during one's lifetime	<b>在りし日<b> <br> ありしひ <br>[sound:k-2107_在りし日.mp3]
[sound:k-2107_在りし日.mp3]	days of yore, the olden days; during one's lifetime<br> <b>在りし日</b> <br> (ありしひ)
<b>正常</b> <br> 事態は正常に戻りました。	[sound:s-2107_事態は正常に戻りました。.mp3] <br> じたいはせいじょうにもどりました。 <br>The situation has returned to normalcy.
[sound:s-2107_事態は正常に戻りました。.mp3]	<b>正常</b> <br> 事態は正常に戻りました。<br> じたいはせいじょうにもどりました <br>The situation has returned to normalcy.
在宅	[sound:k-2108_在宅.mp3]<br>ざいたく <br> being in, being at home
being in, being at home	<b>在宅<b> <br> ざいたく <br>[sound:k-2108_在宅.mp3]
[sound:k-2108_在宅.mp3]	being in, being at home<br> <b>在宅</b> <br> (ざいたく)
<b>通常</b> <br> 通常の手順に従ってください。	[sound:s-2108_通常の手順に従ってください。.mp3] <br> つうじょうのてじゅんにしたがってください。 <br>Please follow the usual procedure.
[sound:s-2108_通常の手順に従ってください。.mp3]	<b>通常</b> <br> 通常の手順に従ってください。<br> つうじょうのてじゅんにしたがってください <br>Please follow the usual procedure.
不在	[sound:k-2109_不在.mp3]<br>ふざい <br> absence
absence	<b>不在<b> <br> ふざい <br>[sound:k-2109_不在.mp3]
[sound:k-2109_不在.mp3]	absence<br> <b>不在</b> <br> (ふざい)
<b>非常</b> <br> 非常時には冷静に行動してください。	[sound:s-2109_非常時には冷静に行動してください。.mp3] <br> ひじょうじにはれいせいにこうどうしてください。 <br>Please act calmly in an emergency.
[sound:s-2109_非常時には冷静に行動してください。.mp3]	<b>非常</b> <br> 非常時には冷静に行動してください。<br> ひじょうじにはれいせいにこうどうしてください <br>Please act calmly in an emergency.
件	[sound:k-2110_件.mp3]<br>けん <br> matter, case, item
matter, case, item	<b>件<b> <br> けん <br>[sound:k-2110_件.mp3]
[sound:k-2110_件.mp3]	matter, case, item<br> <b>件</b> <br> (けん)
<b>常任</b> <br> 彼は常任理事として任命されました。	[sound:s-2110_彼は常任理事として任命されました。.mp3] <br> かれはじょうにんりじとしてにんめいされました。 <br>He was appointed as a permanent director.
[sound:s-2110_彼は常任理事として任命されました。.mp3]	<b>常任</b> <br> 彼は常任理事として任命されました。<br> かれはじょうにんりじとしてにんめいされました <br>He was appointed as a permanent director.
事件	[sound:k-2111_事件.mp3]<br>じけん <br> event, affair, incident, case, plot, trouble, scandal
event, affair, incident, case, plot, trouble, scandal	<b>事件<b> <br> じけん <br>[sound:k-2111_事件.mp3]
[sound:k-2111_事件.mp3]	event, affair, incident, case, plot, trouble, scandal<br> <b>事件</b> <br> (じけん)
<b>日常</b> <br> 彼の日常はとても忙しいです。	[sound:s-2111_彼の日常はとても忙しいです。.mp3] <br> かれのにちじょうはとてもいそがしいです。 <br>His daily life is very busy.
[sound:s-2111_彼の日常はとても忙しいです。.mp3]	<b>日常</b> <br> 彼の日常はとても忙しいです。<br> かれのにちじょうはとてもいそがしいです <br>His daily life is very busy.
条件	[sound:k-2112_条件.mp3]<br>じょうけん <br> condition(s), term(s), requirement(s)
condition(s), term(s), requirement(s)	<b>条件<b> <br> じょうけん <br>[sound:k-2112_条件.mp3]
[sound:k-2112_条件.mp3]	condition(s), term(s), requirement(s)<br> <b>条件</b> <br> (じょうけん)
<b>経常</b> <br> 経常利益が増加しています。	[sound:s-2112_経常利益が増加しています。.mp3] <br> けいじょうりえきがぞうかしています。 <br>Ordinary profits are increasing.
[sound:s-2112_経常利益が増加しています。.mp3]	<b>経常</b> <br> 経常利益が増加しています。<br> けいじょうりえきがぞうかしています <br>Ordinary profits are increasing.
件数	[sound:k-2113_件数.mp3]<br>けんすう <br> number (of things)
number (of things)	<b>件数<b> <br> けんすう <br>[sound:k-2113_件数.mp3]
[sound:k-2113_件数.mp3]	number<br> <b>of things) (件数</b> <br> (けんすう)
<b>異常</b> <br> 機械の動作に異常があります。	[sound:s-2113_機械の動作に異常があります。.mp3] <br> きかいのどうさにいじょうがあります。 <br>There is something abnormal with the operation of the machine.
[sound:s-2113_機械の動作に異常があります。.mp3]	<b>異常</b> <br> 機械の動作に異常があります。<br> きかいのどうさにいじょうがあります <br>There is something abnormal with the operation of the machine.
人件費	[sound:k-2114_人件費.mp3]<br>じんけんひ <br> personnel expenses, labor cost, labour cost; indirect labour costs, indirect labor costs
personnel expenses, labor cost, labour cost; indirect labour costs, indirect labor costs	<b>人件費<b> <br> じんけんひ <br>[sound:k-2114_人件費.mp3]
[sound:k-2114_人件費.mp3]	personnel expenses, labor cost, labour cost; indirect labour costs, indirect labor costs<br> <b>人件費</b> <br> (じんけんひ)
<b>学校</b> <br> 彼は学校に遅れています。	[sound:s-2114_彼は学校に遅れています。.mp3] <br> かれはがっこうにおくれています。 <br>He is late for school.
[sound:s-2114_彼は学校に遅れています。.mp3]	<b>学校</b> <br> 彼は学校に遅れています。<br> かれはがっこうにおくれています <br>He is late for school.
本件	[sound:k-2115_本件.mp3]<br>ほんけん <br> this matter or case
this matter or case	<b>本件<b> <br> ほんけん <br>[sound:k-2115_本件.mp3]
[sound:k-2115_本件.mp3]	this matter or case<br> <b>本件</b> <br> (ほんけん)
<b>高校</b> <br> 私は高校時代を楽しみました。	[sound:s-2115_私は高校時代を楽しみました。.mp3] <br> わたしはこうこうじだいをたのしみました。 <br>I enjoyed my high school days.
[sound:s-2115_私は高校時代を楽しみました。.mp3]	<b>高校</b> <br> 私は高校時代を楽しみました。<br> わたしはこうこうじだいをたのしみました <br>I enjoyed my high school days.
条件付き	[sound:k-2116_条件付き.mp3]<br>じょうけんつき <br> conditionally, with conditions attached
conditionally, with conditions attached	<b>条件付き<b> <br> じょうけんつき <br>[sound:k-2116_条件付き.mp3]
[sound:k-2116_条件付き.mp3]	conditionally, with conditions attached<br> <b>条件付き</b> <br> (じょうけんつき)
<b>校長</b> <br> 校長先生は厳格です。	[sound:s-2116_校長先生は厳格です。.mp3] <br> こうちょうせんせいはげんかくです。 <br>The principal is strict.
[sound:s-2116_校長先生は厳格です。.mp3]	<b>校長</b> <br> 校長先生は厳格です。<br> こうちょうせんせいはげんかくです <br>The principal is strict.
物件	[sound:k-2117_物件.mp3]<br>ぶっけん <br> article, thing
article, thing	<b>物件<b> <br> ぶっけん <br>[sound:k-2117_物件.mp3]
[sound:k-2117_物件.mp3]	article, thing<br> <b>物件</b> <br> (ぶっけん)
<b>高校生</b> <br> 彼は高校生のときに友達とバンドを組んでいました。	[sound:s-2117_彼は高校生のときに友達とバンドを組んでいました。.mp3] <br> かれはこうこうせいのときにともだちとばんどをくんでいました。 <br>He formed a band with his friends when he was a high school student.
[sound:s-2117_彼は高校生のときに友達とバンドを組んでいました。.mp3]	<b>高校生</b> <br> 彼は高校生のときに友達とバンドを組んでいました。<br> かれはこうこうせいのときにともだちとばんどをくんでいました <br>He formed a band with his friends when he was a high school student.
要件	[sound:k-2118_要件.mp3]<br>ようけん <br> requirement, important matter
requirement, important matter	<b>要件<b> <br> ようけん <br>[sound:k-2118_要件.mp3]
[sound:k-2118_要件.mp3]	requirement, important matter<br> <b>要件</b> <br> (ようけん)
<b>小学校</b> <br> 私の子供たちは小学校に通っています。	[sound:s-2118_私の子供たちは小学校に通っています。.mp3] <br> わたしのこどもたちはしょうがっこうにかよっています。 <br>My children go to elementary school.
[sound:s-2118_私の子供たちは小学校に通っています。.mp3]	<b>小学校</b> <br> 私の子供たちは小学校に通っています。<br> わたしのこどもたちはしょうがっこうにかよっています <br>My children go to elementary school.
案件	[sound:k-2119_案件.mp3]<br>あんけん <br> matter in question, subject
matter in question, subject	<b>案件<b> <br> あんけん <br>[sound:k-2119_案件.mp3]
[sound:k-2119_案件.mp3]	matter in question, subject<br> <b>案件</b> <br> (あんけん)
<b>中学校</b> <br> 彼は中学校の時にサッカーに熱中していました。	[sound:s-2119_彼は中学校の時にサッカーに熱中していました。.mp3] <br>  かれはちゅうがっこうのときにさっかーにねっちゅうしていました。 <br> He was passionate about soccer during middle school.
[sound:s-2119_彼は中学校の時にサッカーに熱中していました。.mp3]	<b>中学校</b> <br> 彼は中学校の時にサッカーに熱中していました。<br>  かれはちゅうがっこうのときにさっかーにねっちゅうしていました <br> He was passionate about soccer during middle school.
団体	[sound:k-2120_団体.mp3]<br>だんたい <br> organization, organisation, association
organization, organisation, association	<b>団体<b> <br> だんたい <br>[sound:k-2120_団体.mp3]
[sound:k-2120_団体.mp3]	organization, organisation, association<br> <b>団体</b> <br> (だんたい)
<b>登校</b> <br> 彼は毎日遅れずに登校しています。	[sound:s-2120_彼は毎日遅れずに登校しています。.mp3] <br>  かれはまいにちおくれずにとうこうしています。 <br> He attends school every day without being late.
[sound:s-2120_彼は毎日遅れずに登校しています。.mp3]	<b>登校</b> <br> 彼は毎日遅れずに登校しています。<br>  かれはまいにちおくれずにとうこうしています <br> He attends school every day without being late.
集団	[sound:k-2121_集団.mp3]<br>しゅうだん <br> group, mass
group, mass	<b>集団<b> <br> しゅうだん <br>[sound:k-2121_集団.mp3]
[sound:k-2121_集団.mp3]	group, mass<br> <b>集団</b> <br> (しゅうだん)
<b>校舎</b> <br> 新しい校舎が完成しました。	[sound:s-2121_新しい校舎が完成しました。.mp3] <br>  あたらしいこうしゃがかんせいしました。 <br> The new school building has been completed.
[sound:s-2121_新しい校舎が完成しました。.mp3]	<b>校舎</b> <br> 新しい校舎が完成しました。<br>  あたらしいこうしゃがかんせいしました <br> The new school building has been completed.
暴力団	[sound:k-2122_暴力団.mp3]<br>ぼうりょくだん <br> gangster organization (organisation), crime syndicate, yakuza (Japanese mafia), band of thugs, group of hoodlums
gangster organization (organisation), crime syndicate, yakuza (Japanese mafia), band of thugs, group of hoodlums	<b>暴力団<b> <br> ぼうりょくだん <br>[sound:k-2122_暴力団.mp3]
[sound:k-2122_暴力団.mp3]	gangster organization<br> <b>organisation), crime syndicate, yakuza (Japanese mafia), band of thugs, group of hoodlums (暴力団</b> <br> (ぼうりょくだん)
<b>同校</b> <br> 彼と私は同校の卒業生です。	[sound:s-2122_彼と私は同校の卒業生です。.mp3] <br>  かれとわたしはどうこうのそつぎょうせいです。 <br> He and I are graduates of the same school.
[sound:s-2122_彼と私は同校の卒業生です。.mp3]	<b>同校</b> <br> 彼と私は同校の卒業生です。<br>  かれとわたしはどうこうのそつぎょうせいです <br> He and I are graduates of the same school.
経団連	[sound:k-2123_経団連.mp3]<br>けいだんれん <br> Federation of Economic Organizations (Organisation)
Federation of Economic Organizations (Organisation)	<b>経団連<b> <br> けいだんれん <br>[sound:k-2123_経団連.mp3]
[sound:k-2123_経団連.mp3]	Federation of Economic Organizations<br> <b>Organisation) (経団連</b> <br> (けいだんれん)
<b>専門学校</b> <br> 彼女は専門学校で美術を学んでいます。	[sound:s-2123_彼女は専門学校で美術を学んでいます。.mp3] <br>  かのじょはせんもんがっこうでびじゅつをまなんでいます。 <br> She is studying art at a vocational school.
[sound:s-2123_彼女は専門学校で美術を学んでいます。.mp3]	<b>専門学校</b> <br> 彼女は専門学校で美術を学んでいます。<br>  かのじょはせんもんがっこうでびじゅつをまなんでいます <br> She is studying art at a vocational school.
球団	[sound:k-2124_球団.mp3]<br>きゅうだん <br> baseball team
baseball team	<b>球団<b> <br> きゅうだん <br>[sound:k-2124_球団.mp3]
[sound:k-2124_球団.mp3]	baseball team<br> <b>球団</b> <br> (きゅうだん)
<b>資料</b> <br> この資料を参考にしてください。	[sound:s-2124_この資料を参考にしてください。.mp3] <br>  このしりょうをさんこうにしてください。 <br> Please refer to this material.
[sound:s-2124_この資料を参考にしてください。.mp3]	<b>資料</b> <br> この資料を参考にしてください。<br>  このしりょうをさんこうにしてください <br> Please refer to this material.
財団	[sound:k-2125_財団.mp3]<br>ざいだん <br> foundation
foundation	<b>財団<b> <br> ざいだん <br>[sound:k-2125_財団.mp3]
[sound:k-2125_財団.mp3]	foundation<br> <b>財団</b> <br> (ざいだん)
<b>無料</b> <br> このアプリは無料でダウンロードできます。	[sound:s-2125_このアプリは無料でダウンロードできます。.mp3] <br>  このあぷりはむりょうでだうんろーどできます。 <br> This app can be downloaded for free.
[sound:s-2125_このアプリは無料でダウンロードできます。.mp3]	<b>無料</b> <br> このアプリは無料でダウンロードできます。<br>  このあぷりはむりょうでだうんろーどできます <br> This app can be downloaded for free.
団長	[sound:k-2126_団長.mp3]<br>だんちょう <br> leader of a delegation (body, party)
leader of a delegation (body, party)	<b>団長<b> <br> だんちょう <br>[sound:k-2126_団長.mp3]
[sound:k-2126_団長.mp3]	leader of a delegation<br> <b>body, party) (団長</b> <br> (だんちょう)
<b>料金</b> <br> サービスには追加料金がかかりますか？	[sound:s-2126_サービスには追加料金がかかりますか？.mp3] <br>  さーびすにはついかりょうきんがかかりますか？ <br> Is there an additional charge for the service?
[sound:s-2126_サービスには追加料金がかかりますか？.mp3]	(<b>料金</b>) サービスには追加料金がかかりますか？	 さーびすにはついかりょうきんがかかりますか？ <br> Is there an additional charge for the service?
劇団	[sound:k-2127_劇団.mp3]<br>げきだん <br> troupe, theatrical company
troupe, theatrical company	<b>劇団<b> <br> げきだん <br>[sound:k-2127_劇団.mp3]
[sound:k-2127_劇団.mp3]	troupe, theatrical company<br> <b>劇団</b> <br> (げきだん)
<b>料理</b> <br> 彼女は料理が得意です。	[sound:s-2127_彼女は料理が得意です。.mp3] <br>  かのじょはりょうりがとくいです。 <br> She is good at cooking.
[sound:s-2127_彼女は料理が得意です。.mp3]	<b>料理</b> <br> 彼女は料理が得意です。<br>  かのじょはりょうりがとくいです <br> She is good at cooking.
財団法人	[sound:k-2128_財団法人.mp3]<br>ざいだんほうじん <br> incorporated foundation, juridical foundation
incorporated foundation, juridical foundation	<b>財団法人<b> <br> ざいだんほうじん <br>[sound:k-2128_財団法人.mp3]
[sound:k-2128_財団法人.mp3]	incorporated foundation, juridical foundation<br> <b>財団法人</b> <br> (ざいだんほうじん)
<b>材料</b> <br> この料理に必要な材料を買いに行きます。	[sound:s-2128_この料理に必要な材料を買いに行きます。.mp3] <br>  このりょうりにひつようなざいりょうをかいにいきます。 <br> I'm going to buy the necessary ingredients for this dish.
[sound:s-2128_この料理に必要な材料を買いに行きます。.mp3]	<b>材料</b> <br> この料理に必要な材料を買いに行きます。<br>  このりょうりにひつようなざいりょうをかいにいきます <br> I'm going to buy the necessary ingredients for this dish.
公団	[sound:k-2129_公団.mp3]<br>こうだん <br> public corporation
public corporation	<b>公団<b> <br> こうだん <br>[sound:k-2129_公団.mp3]
[sound:k-2129_公団.mp3]	public corporation<br> <b>公団</b> <br> (こうだん)
<b>燃料</b> <br> この車はガソリンを燃料として使います。	[sound:s-2129_この車はガソリンを燃料として使います。.mp3] <br>  このくるまはがそりんをねんりょうとしてつかいます。 <br> This car uses gasoline as fuel.
[sound:s-2129_この車はガソリンを燃料として使います。.mp3]	<b>燃料</b> <br> この車はガソリンを燃料として使います。<br>  このくるまはがそりんをねんりょうとしてつかいます <br> This car uses gasoline as fuel.
別に	[sound:k-2130_別に.mp3]<br>べつに <br> (not) particularly, nothing; separately, apart
(not) particularly, nothing; separately, apart	<b>別に<b> <br> べつに <br>[sound:k-2130_別に.mp3]
[sound:k-2130_別に.mp3]	(not) particularly, nothing; separately, apart<br> <b>別に</b> <br> (べつに)
<b>食料</b> <br> 非常時には十分な食料を備えておく必要があります。	[sound:s-2130_非常時には十分な食料を備えておく必要があります。.mp3] <br>  ひじょうじにはじゅうぶんなしょくりょうをそなえておくひつようがあります。 <br>" In an emergency, it's necessary to have enough provisions."
[sound:s-2130_非常時には十分な食料を備えておく必要があります。.mp3]	<b>食料</b> <br> 非常時には十分な食料を備えておく必要があります。<br>  ひじょうじにはじゅうぶんなしょくりょうをそなえておくひつようがあります <br> In an emergency, it's necessary to have enough provisions.
告別	[sound:k-2131_告別.mp3]<br>こくべつ <br> farewell, leave-taking
farewell, leave-taking	<b>告別<b> <br> こくべつ <br>[sound:k-2131_告別.mp3]
[sound:k-2131_告別.mp3]	farewell, leave-taking<br> <b>告別</b> <br> (こくべつ)
<b>手数料</b> <br> このサービスには手数料がかかります。	[sound:s-2131_このサービスには手数料がかかります。.mp3] <br>  このさーびすにはてすうりょうがかかります。 <br> There is a handling fee for this service.
[sound:s-2131_このサービスには手数料がかかります。.mp3]	<b>手数料</b> <br> このサービスには手数料がかかります。<br>  このさーびすにはてすうりょうがかかります <br> There is a handling fee for this service.
特別	[sound:k-2132_特別.mp3]<br>とくべつ <br> special
special	<b>特別<b> <br> とくべつ <br>[sound:k-2132_特別.mp3]
[sound:k-2132_特別.mp3]	special<br> <b>特別</b> <br> (とくべつ)
<b>給料</b> <br> 彼の給料は月々安定しています。	[sound:s-2132_彼の給料は月々安定しています。.mp3] <br>  かれのきゅうりょうはつきごとあんていしています。 <br> His salary is stable every month.
[sound:s-2132_彼の給料は月々安定しています。.mp3]	<b>給料</b> <br> 彼の給料は月々安定しています。<br>  かれのきゅうりょうはつきごとあんていしています <br> His salary is stable every month.
個別	[sound:k-2133_個別.mp3]<br>こべつ <br> particular case, discrete, individual, separate
particular case, discrete, individual, separate	<b>個別<b> <br> こべつ <br>[sound:k-2133_個別.mp3]
[sound:k-2133_個別.mp3]	particular case, discrete, individual, separate<br> <b>個別</b> <br> (こべつ)
<b>飲料</b> <br> この自動販売機には各種飲料があります。	[sound:s-2133_この自動販売機には各種飲料があります。.mp3] <br>  このじどうはんばいきにはかくしゅいんりょうがあります。 <br> This vending machine has various beverages.
[sound:s-2133_この自動販売機には各種飲料があります。.mp3]	<b>飲料</b> <br> この自動販売機には各種飲料があります。<br>  このじどうはんばいきにはかくしゅいんりょうがあります <br> This vending machine has various beverages.
差別	[sound:k-2134_差別.mp3]<br>さべつ <br> discrimination, distinction, differentiation
discrimination, distinction, differentiation	<b>差別<b> <br> さべつ <br>[sound:k-2134_差別.mp3]
[sound:k-2134_差別.mp3]	discrimination, distinction, differentiation<br> <b>差別</b> <br> (さべつ)
<b>沢</b> <br> 森の中にはたくさんの沢があります。	[sound:s-2134_森の中にはたくさんの沢があります。.mp3] <br>  もりのなかにはたくさんのたくわんがあります。 <br> There are many marshes in the forest.
[sound:s-2134_森の中にはたくさんの沢があります。.mp3]	<b>沢</b> <br> 森の中にはたくさんの沢があります。<br>  もりのなかにはたくさんのたくわんがあります <br> There are many marshes in the forest.
別れ	[sound:k-2135_別れ.mp3]<br>わかれ <br> parting, separation, farewell, (lateral) branch, fork, offshoot, division, section
parting, separation, farewell, (lateral) branch, fork, offshoot, division, section	<b>別れ<b> <br> わかれ <br>[sound:k-2135_別れ.mp3]
[sound:k-2135_別れ.mp3]	parting, separation, farewell,<br> <b>lateral) branch, fork, offshoot, division, section (別れ</b> <br> (わかれ)
<b>光沢</b> <br> この素材は光沢が美しいです。	[sound:s-2135_この素材は光沢が美しいです。.mp3] <br>  このそざいはこうたくがうつくしいです。 <br> This material has a beautiful sheen.
[sound:s-2135_この素材は光沢が美しいです。.mp3]	<b>光沢</b> <br> この素材は光沢が美しいです。<br>  このそざいはこうたくがうつくしいです <br> This material has a beautiful sheen.
別荘	[sound:k-2136_別荘.mp3]<br>べっそう <br> holiday house, villa
holiday house, villa	<b>別荘<b> <br> べっそう <br>[sound:k-2136_別荘.mp3]
[sound:k-2136_別荘.mp3]	holiday house, villa<br> <b>別荘</b> <br> (べっそう)
<b>沢辺</b> <br> そのキャンプ場は沢辺にあります。	[sound:s-2136_そのキャンプ場は沢辺にあります。.mp3] <br>  そのきゃんぷじょうはたくべにあります。 <br> The campsite is located on the edge of a swamp.
[sound:s-2136_そのキャンプ場は沢辺にあります。.mp3]	<b>沢辺</b> <br> そのキャンプ場は沢辺にあります。<br>  そのきゃんぷじょうはたくべにあります <br> The campsite is located on the edge of a swamp.
別表	[sound:k-2137_別表.mp3]<br>べっぴょう <br> annexed (statistical) table
annexed (statistical) table	<b>別表<b> <br> べっぴょう <br>[sound:k-2137_別表.mp3]
[sound:k-2137_別表.mp3]	annexed<br> <b>statistical) table (別表</b> <br> (べっぴょう)
<b>潤沢</b> <br> 彼の収入は潤沢です。	[sound:s-2137_彼の収入は潤沢です。.mp3] <br>  かれのしゅうにゅうはじゅんたくです。 <br> His income is abundant.
[sound:s-2137_彼の収入は潤沢です。.mp3]	<b>潤沢</b> <br> 彼の収入は潤沢です。<br>  かれのしゅうにゅうはじゅんたくです <br> His income is abundant.
性別	[sound:k-2138_性別.mp3]<br>せいべつ <br> distinction by sex, sex, gender
distinction by sex, sex, gender	<b>性別<b> <br> せいべつ <br>[sound:k-2138_性別.mp3]
[sound:k-2138_性別.mp3]	distinction by sex, sex, gender<br> <b>性別</b> <br> (せいべつ)
<b>沢地</b> <br> この地域には広大な沢地が広がっています。	[sound:s-2138_この地域には広大な沢地が広がっています。.mp3] <br>  このちいきにはこうだいなたくちがひろがっています。 <br> Vast marshy land stretches across this area.
[sound:s-2138_この地域には広大な沢地が広がっています。.mp3]	<b>沢地</b> <br> この地域には広大な沢地が広がっています。<br>  このちいきにはこうだいなたくちがひろがっています <br> Vast marshy land stretches across this area.
区別	[sound:k-2139_区別.mp3]<br>くべつ <br> distinction, differentiation, classification
distinction, differentiation, classification	<b>区別<b> <br> くべつ <br>[sound:k-2139_区別.mp3]
[sound:k-2139_区別.mp3]	distinction, differentiation, classification<br> <b>区別</b> <br> (くべつ)
<b>沢庵</b> <br> 寿司には美味しい沢庵が入っています。	[sound:s-2139_寿司には美味しい沢庵が入っています。.mp3] <br>  すしにはおいしいたくあんがはいっています。 <br> Sushi often contains delicious pickled vegetables.
[sound:s-2139_寿司には美味しい沢庵が入っています。.mp3]	<b>沢庵</b> <br> 寿司には美味しい沢庵が入っています。<br>  すしにはおいしいたくあんがはいっています <br> Sushi often contains delicious pickled vegetables.
人物	[sound:k-2140_人物.mp3]<br>じんぶつ <br> character, personality, person, man, personage, talented man
character, personality, person, man, personage, talented man	<b>人物<b> <br> じんぶつ <br>[sound:k-2140_人物.mp3]
[sound:k-2140_人物.mp3]	character, personality, person, man, personage, talented man<br> <b>人物</b> <br> (じんぶつ)
<b>沢山</b> <br> この店ではたくさんの商品が売られています。	[sound:s-2140_この店ではたくさんの商品が売られています。.mp3] <br>  このみせではたくさんのしょうひんがうられています。 <br> This store sells many products.
[sound:s-2140_この店ではたくさんの商品が売られています。.mp3]	<b>沢山</b> <br> この店ではたくさんの商品が売られています。<br>  このみせではたくさんのしょうひんがうられています <br> This store sells many products.
動物	[sound:k-2141_動物.mp3]<br>どうぶつ <br> animal
animal	<b>動物<b> <br> どうぶつ <br>[sound:k-2141_動物.mp3]
[sound:k-2141_動物.mp3]	animal<br> <b>動物</b> <br> (どうぶつ)
<b>贅沢</b> <br> 彼女は贅沢な生活を楽しんでいます。	[sound:s-2141_彼女は贅沢な生活を楽しんでいます。.mp3] <br>  かのじょはぜいたくなせいかつをたのしんでいます。 <br> She enjoys a luxurious lifestyle.
[sound:s-2141_彼女は贅沢な生活を楽しんでいます。.mp3]	<b>贅沢</b> <br> 彼女は贅沢な生活を楽しんでいます。<br>  かのじょはぜいたくなせいかつをたのしんでいます <br> She enjoys a luxurious lifestyle.
建物	[sound:k-2142_建物.mp3]<br>たてもの <br> building
building	<b>建物<b> <br> たてもの <br>[sound:k-2142_建物.mp3]
[sound:k-2142_建物.mp3]	building<br> <b>建物</b> <br> (たてもの)
<b>沼沢</b> <br> この地域には多くの沼沢地があります。	[sound:s-2142_この地域には多くの沼沢地があります。.mp3] <br>  このちいきにはおおくのしょうたくちがあります。 <br> There are many marshes in this area.
[sound:s-2142_この地域には多くの沼沢地があります。.mp3]	<b>沼沢</b> <br> この地域には多くの沼沢地があります。<br>  このちいきにはおおくのしょうたくちがあります <br> There are many marshes in this area.
物価	[sound:k-2143_物価.mp3]<br>ぶっか <br> prices of commodities, prices (in general), cost-of-living
prices of commodities, prices (in general), cost-of-living	<b>物価<b> <br> ぶっか <br>[sound:k-2143_物価.mp3]
[sound:k-2143_物価.mp3]	prices of commodities, prices<br> <b>in general), cost-of-living (物価</b> <br> (ぶっか)
<b>恩沢</b> <br> 彼女は恩沢を受けたことに感謝しています。	[sound:s-2143_彼女は恩沢を受けたことに感謝しています。.mp3] <br>  かのじょはおんたくをうけたことにかんしゃしています。 <br> She is grateful for the favor she received.
[sound:s-2143_彼女は恩沢を受けたことに感謝しています。.mp3]	<b>恩沢</b> <br> 彼女は恩沢を受けたことに感謝しています。<br>  かのじょはおんたくをうけたことにかんしゃしています <br> She is grateful for the favor she received.
物語	[sound:k-2144_物語.mp3]<br>ものがたり <br> tale, story, legend
tale, story, legend	<b>物語<b> <br> ものがたり <br>[sound:k-2144_物語.mp3]
[sound:k-2144_物語.mp3]	tale, story, legend<br> <b>物語</b> <br> (ものがたり)
<b>裁判</b> <br> 彼は裁判で有罪と判決されました。	[sound:s-2144_彼は裁判で有罪と判決されました。.mp3] <br>  かれはさいばんでゆうざいとはんけつされました。 <br> He was found guilty in the trial.
[sound:s-2144_彼は裁判で有罪と判決されました。.mp3]	<b>裁判</b> <br> 彼は裁判で有罪と判決されました。<br>  かれはさいばんでゆうざいとはんけつされました <br> He was found guilty in the trial.
物質	[sound:k-2145_物質.mp3]<br>ぶっしつ <br> material, substance
material, substance	<b>物質<b> <br> ぶっしつ <br>[sound:k-2145_物質.mp3]
[sound:k-2145_物質.mp3]	material, substance<br> <b>物質</b> <br> (ぶっしつ)
<b>総裁</b> <br> 彼はその会社の総裁です。	[sound:s-2145_彼はその会社の総裁です。.mp3] <br>  かれはそのかいしゃのそうさいです。 <br> He is the president of the company.
[sound:s-2145_彼はその会社の総裁です。.mp3]	<b>総裁</b> <br> 彼はその会社の総裁です。<br>  かれはそのかいしゃのそうさいです <br> He is the president of the company.
植物	[sound:k-2146_植物.mp3]<br>しょくぶつ <br> plant, vegetation
plant, vegetation	<b>植物<b> <br> しょくぶつ <br>[sound:k-2146_植物.mp3]
[sound:k-2146_植物.mp3]	plant, vegetation<br> <b>植物</b> <br> (しょくぶつ)
<b>制裁</b> <br> 国際社会から制裁が課せられました。	[sound:s-2146_国際社会から制裁が課せられました。.mp3] <br>  こくさいしゃかいからせいさいがかせられました。 <br> Sanctions were imposed by the international community.
[sound:s-2146_国際社会から制裁が課せられました。.mp3]	<b>制裁</b> <br> 国際社会から制裁が課せられました。<br>  こくさいしゃかいからせいさいがかせられました <br> Sanctions were imposed by the international community.
生物	[sound:k-2147_生物.mp3]<br>せいぶつ <br> living things, creature
living things, creature	<b>生物<b> <br> せいぶつ <br>[sound:k-2147_生物.mp3]
[sound:k-2147_生物.mp3]	living things, creature<br> <b>生物</b> <br> (せいぶつ)
<b>地裁</b> <br> 事件は地裁で審理されます。	[sound:s-2147_事件は地裁で審理されます。.mp3] <br>  じけんはじさいでしんりされます。 <br> The case will be heard in the district court.
[sound:s-2147_事件は地裁で審理されます。.mp3]	<b>地裁</b> <br> 事件は地裁で審理されます。<br>  じけんはじさいでしんりされます <br> The case will be heard in the district court.
博物館	[sound:k-2148_博物館.mp3]<br>はくぶつかん <br> museum
museum	<b>博物館<b> <br> はくぶつかん <br>[sound:k-2148_博物館.mp3]
[sound:k-2148_博物館.mp3]	museum<br> <b>博物館</b> <br> (はくぶつかん)
<b>最高裁</b> <br> その判決は最高裁で確定されました。	[sound:s-2148_その判決は最高裁で確定されました。.mp3] <br>  そのはんけつはさいこうさいでかくていされました。 <br> The verdict was finalized by the supreme court.
[sound:s-2148_その判決は最高裁で確定されました。.mp3]	<b>最高裁</b> <br> その判決は最高裁で確定されました。<br>  そのはんけつはさいこうさいでかくていされました <br> The verdict was finalized by the supreme court.
物資	[sound:k-2149_物資.mp3]<br>ぶっし <br> goods, materials
goods, materials	<b>物資<b> <br> ぶっし <br>[sound:k-2149_物資.mp3]
[sound:k-2149_物資.mp3]	goods, materials<br> <b>物資</b> <br> (ぶっし)
<b>裁判所</b> <br> 裁判所の前にはたくさんの人が並んでいます。	[sound:s-2149_裁判所の前にはたくさんの人が並んでいます。.mp3] <br>  さいばんしょのまえにはたくさんのひとがならんでいます。 <br> There are many people lined up in front of the courthouse.
[sound:s-2149_裁判所の前にはたくさんの人が並んでいます。.mp3]	<b>裁判所</b> <br> 裁判所の前にはたくさんの人が並んでいます。<br>  さいばんしょのまえにはたくさんのひとがならんでいます <br> There are many people lined up in front of the courthouse.
側	[sound:k-2150_側.mp3]<br>そば, そく, はた <br> near, close, beside, vicinity, proximity, besides, while; third person
near, close, beside, vicinity, proximity, besides, while; third person	<b>側<b> <br> そば, そく, はた <br>[sound:k-2150_側.mp3]
[sound:k-2150_側.mp3]	near, close, beside, vicinity, proximity, besides, while; third person<br> <b>側</b> <br> (そば, そく, はた)
<b>高裁</b> <br> 彼は高裁で勝訴しました。	[sound:s-2150_彼は高裁で勝訴しました。.mp3] <br>  かれはこうさいでしょうそしました。 <br> He won the case in the high court.
[sound:s-2150_彼は高裁で勝訴しました。.mp3]	<b>高裁</b> <br> 彼は高裁で勝訴しました。<br>  かれはこうさいでしょうそしました <br> He won the case in the high court.
西側	[sound:k-2151_西側.mp3]<br>にしがわ <br> west side, west bank
west side, west bank	<b>西側<b> <br> にしがわ <br>[sound:k-2151_西側.mp3]
[sound:k-2151_西側.mp3]	west side, west bank<br> <b>西側</b> <br> (にしがわ)
<b>独裁</b> <br> この国は独裁政治に支配されています。	[sound:s-2151_この国は独裁政治に支配されています。.mp3] <br>  このくにはどくさいせいじにしはいされています。 <br> This country is ruled by a dictatorship.
[sound:s-2151_この国は独裁政治に支配されています。.mp3]	<b>独裁</b> <br> この国は独裁政治に支配されています。<br>  このくにはどくさいせいじにしはいされています <br> This country is ruled by a dictatorship.
側近	[sound:k-2152_側近.mp3]<br>そっきん <br> close associate, close aide, brains-truster
close associate, close aide, brains-truster	<b>側近<b> <br> そっきん <br>[sound:k-2152_側近.mp3]
[sound:k-2152_側近.mp3]	close associate, close aide, brains-truster<br> <b>側近</b> <br> (そっきん)
<b>裁判官</b> <br> 裁判官は公正な判断を下すべきです。	[sound:s-2152_裁判官は公正な判断を下すべきです。.mp3] <br>  さいばんかんはこうせいなはんだんをくだすべきです。 <br> Judges should make fair judgments.
[sound:s-2152_裁判官は公正な判断を下すべきです。.mp3]	<b>裁判官</b> <br> 裁判官は公正な判断を下すべきです。<br>  さいばんかんはこうせいなはんだんをくだすべきです <br> Judges should make fair judgments.
側面	[sound:k-2153_側面.mp3]<br>そくめん <br> side, flank, sidelight, lateral
side, flank, sidelight, lateral	<b>側面<b> <br> そくめん <br>[sound:k-2153_側面.mp3]
[sound:k-2153_側面.mp3]	side, flank, sidelight, lateral<br> <b>側面</b> <br> (そくめん)
<b>裁量</b> <br> 上司には一定の裁量が与えられています。	[sound:s-2153_上司には一定の裁量が与えられています。.mp3] <br>  じょうしにはいっていのさいりょうがあたえられています。 <br> Supervisors have a certain level of discretion.
[sound:s-2153_上司には一定の裁量が与えられています。.mp3]	<b>裁量</b> <br> 上司には一定の裁量が与えられています。<br>  じょうしにはいっていのさいりょうがあたえられています <br> Supervisors have a certain level of discretion.
北側	[sound:k-2154_北側.mp3]<br>きたがわ, ほくそく <br> north side, north bank
north side, north bank	<b>北側<b> <br> きたがわ, ほくそく <br>[sound:k-2154_北側.mp3]
[sound:k-2154_北側.mp3]	north side, north bank<br> <b>北側</b> <br> (きたがわ, ほくそく)
<b>状況</b> <br> 現在の状況を把握していますか？	[sound:s-2154_現在の状況を把握していますか？.mp3] <br>  げんざいのじょうきょうをはあくしていますか？ <br> Do you understand the current situation?
[sound:s-2154_現在の状況を把握していますか？.mp3]	(<b>状況</b>) 現在の状況を把握していますか？	 げんざいのじょうきょうをはあくしていますか？ <br> Do you understand the current situation?
内側	[sound:k-2155_内側.mp3]<br>うちがわ <br> inside, interior, inner part
inside, interior, inner part	<b>内側<b> <br> うちがわ <br>[sound:k-2155_内側.mp3]
[sound:k-2155_内側.mp3]	inside, interior, inner part<br> <b>内側</b> <br> (うちがわ)
<b>状態</b> <br> 彼の健康状態は良好です。	[sound:s-2155_彼の健康状態は良好です。.mp3] <br>  かれのけんこうじょうたいはりょうこうです。 <br> His health condition is good.
[sound:s-2155_彼の健康状態は良好です。.mp3]	<b>状態</b> <br> 彼の健康状態は良好です。<br>  かれのけんこうじょうたいはりょうこうです <br> His health condition is good.
東側	[sound:k-2156_東側.mp3]<br>ひがしがわ, とうそく <br> east side, east bank
east side, east bank	<b>東側<b> <br> ひがしがわ, とうそく <br>[sound:k-2156_東側.mp3]
[sound:k-2156_東側.mp3]	east side, east bank<br> <b>東側</b> <br> (ひがしがわ, とうそく)
<b>現状</b> <br> この問題の現状を調査しています。	[sound:s-2156_この問題の現状を調査しています。.mp3] <br>  このもんだいのげんじょうをちょうさしています。 <br> We are investigating the current state of this issue.
[sound:s-2156_この問題の現状を調査しています。.mp3]	<b>現状</b> <br> この問題の現状を調査しています。<br>  このもんだいのげんじょうをちょうさしています <br> We are investigating the current state of this issue.
南側	[sound:k-2157_南側.mp3]<br>みなみがわ, なんそく <br> south side
south side	<b>南側<b> <br> みなみがわ, なんそく <br>[sound:k-2157_南側.mp3]
[sound:k-2157_南側.mp3]	south side<br> <b>南側</b> <br> (みなみがわ, なんそく)
<b>症状</b> <br> 彼は風邪の症状を訴えています。	[sound:s-2157_彼は風邪の症状を訴えています。.mp3] <br>  かれはかぜのしょうじょうをうっています。 <br> He is complaining of cold symptoms.
[sound:s-2157_彼は風邪の症状を訴えています。.mp3]	<b>症状</b> <br> 彼は風邪の症状を訴えています。<br>  かれはかぜのしょうじょうをうっています <br> He is complaining of cold symptoms.
裏側	[sound:k-2158_裏側.mp3]<br>うらがわ <br> the reverse, other side, lining
the reverse, other side, lining	<b>裏側<b> <br> うらがわ <br>[sound:k-2158_裏側.mp3]
[sound:k-2158_裏側.mp3]	the reverse, other side, lining<br> <b>裏側</b> <br> (うらがわ)
<b>賞状</b> <br> 彼は優秀な成績で賞状を受け取りました。	[sound:s-2158_彼は優秀な成績で賞状を受け取りました。.mp3] <br>  かれはゆうしゅうなせいせきでしょうじょうをうけとりました。 <br> He received a certificate of commendation for outstanding achievements.
[sound:s-2158_彼は優秀な成績で賞状を受け取りました。.mp3]	<b>賞状</b> <br> 彼は優秀な成績で賞状を受け取りました。<br>  かれはゆうしゅうなせいせきでしょうじょうをうけとりました <br> He received a certificate of commendation for outstanding achievements.
外側	[sound:k-2159_外側.mp3]<br>そとがわ, がいそく <br> exterior, outside
exterior, outside	<b>外側<b> <br> そとがわ, がいそく <br>[sound:k-2159_外側.mp3]
[sound:k-2159_外側.mp3]	exterior, outside<br> <b>外側</b> <br> (そとがわ, がいそく)
<b>訴状</b> <br> 弁護士は訴状を準備しています。	[sound:s-2159_弁護士は訴状を準備しています。.mp3] <br>  べんごしはそじょうをじゅんびしています。 <br> The lawyer is preparing the legal complaint.
[sound:s-2159_弁護士は訴状を準備しています。.mp3]	<b>訴状</b> <br> 弁護士は訴状を準備しています。<br>  べんごしはそじょうをじゅんびしています <br> The lawyer is preparing the legal complaint.
責任	[sound:k-2160_責任.mp3]<br>せきにん <br> duty, responsibility; liability, onus
duty, responsibility; liability, onus	<b>責任<b> <br> せきにん <br>[sound:k-2160_責任.mp3]
[sound:k-2160_責任.mp3]	duty, responsibility; liability, onus<br> <b>責任</b> <br> (せきにん)
<b>病状</b> <br> 彼の病状は安定しています。	[sound:s-2160_彼の病状は安定しています。.mp3] <br>  かれのびょうじょうはあんていしています。 <br> His condition of illness is stable.
[sound:s-2160_彼の病状は安定しています。.mp3]	<b>病状</b> <br> 彼の病状は安定しています。<br>  かれのびょうじょうはあんていしています <br> His condition of illness is stable.
辞任	[sound:k-2161_辞任.mp3]<br>じにん <br> to resign; resignation
to resign; resignation	<b>辞任<b> <br> じにん <br>[sound:k-2161_辞任.mp3]
[sound:k-2161_辞任.mp3]	to resign; resignation<br> <b>辞任</b> <br> (じにん)
<b>年賀状</b> <br> 年末にはたくさんの年賀状が届きます。	[sound:s-2161_年末にはたくさんの年賀状が届きます。.mp3] <br>  ねんまつにはたくさんのねんがじょうがとどきます。 <br> Many New Year's greeting cards arrive at the end of the year.
[sound:s-2161_年末にはたくさんの年賀状が届きます。.mp3]	<b>年賀状</b> <br> 年末にはたくさんの年賀状が届きます。<br>  ねんまつにはたくさんのねんがじょうがとどきます <br> Many New Year's greeting cards arrive at the end of the year.
就任	[sound:k-2162_就任.mp3]<br>しゅうにん <br> inauguration, assumption of office
inauguration, assumption of office	<b>就任<b> <br> しゅうにん <br>[sound:k-2162_就任.mp3]
[sound:k-2162_就任.mp3]	inauguration, assumption of office<br> <b>就任</b> <br> (しゅうにん)
<b>形状</b> <br> その建物の形状は独特です。	[sound:s-2162_その建物の形状は独特です。.mp3] <br>  そのたてもののけいじょうはどくとくです。 <br> The shape of the building is unique.
[sound:s-2162_その建物の形状は独特です。.mp3]	<b>形状</b> <br> その建物の形状は独特です。<br>  そのたてもののけいじょうはどくとくです <br> The shape of the building is unique.
常任	[sound:k-2163_常任.mp3]<br>じょうにん <br> standing, regular, permanent
standing, regular, permanent	<b>常任<b> <br> じょうにん <br>[sound:k-2163_常任.mp3]
[sound:k-2163_常任.mp3]	standing, regular, permanent<br> <b>常任</b> <br> (じょうにん)
<b>窮状</b> <br> 彼の窮状を助けるために、多くの人々が協力しています。	[sound:s-2163_彼の窮状を助けるために、多くの人々が協力しています。.mp3] <br>  かれのきゅうじょうをたすけるために、おおくのひとびとがきょうりょくしています。 <br> Many people are cooperating to help him out of his dire situation.
[sound:s-2163_彼の窮状を助けるために、多くの人々が協力しています。.mp3]	<b>窮状</b> <br> 彼の窮状を助けるために、多くの人々が協力しています。<br>  かれのきゅうじょうをたすけるために、おおくのひとびとがきょうりょくしています <br> Many people are cooperating to help him out of his dire situation.
任期	[sound:k-2164_任期.mp3]<br>にんき <br> term of office
term of office	<b>任期<b> <br> にんき <br>[sound:k-2164_任期.mp3]
[sound:k-2164_任期.mp3]	term of office<br> <b>任期</b> <br> (にんき)
<b>工場</b> <br> この地域には自動車工場がたくさんあります。	[sound:s-2164_この地域には自動車工場がたくさんあります。.mp3] <br>  このちいきにはじどうしゃこうじょうがたくさんあります。 <br> There are many car factories in this area.
[sound:s-2164_この地域には自動車工場がたくさんあります。.mp3]	<b>工場</b> <br> この地域には自動車工場がたくさんあります。<br>  このちいきにはじどうしゃこうじょうがたくさんあります <br> There are many car factories in this area.
後任	[sound:k-2165_後任.mp3]<br>こうにん <br> successor
successor	<b>後任<b> <br> こうにん <br>[sound:k-2165_後任.mp3]
[sound:k-2165_後任.mp3]	successor<br> <b>後任</b> <br> (こうにん)
<b>工業</b> <br> この地域は工業が盛んです。	[sound:s-2165_この地域は工業が盛んです。.mp3] <br>  このちいきはこうぎょうがさかんです。 <br> This area is prosperous in industry.
[sound:s-2165_この地域は工業が盛んです。.mp3]	<b>工業</b> <br> この地域は工業が盛んです。<br>  このちいきはこうぎょうがさかんです <br> This area is prosperous in industry.
責任者	[sound:k-2166_責任者.mp3]<br>せきにんしゃ <br> responsible party
responsible party	<b>責任者<b> <br> せきにんしゃ <br>[sound:k-2166_責任者.mp3]
[sound:k-2166_責任者.mp3]	responsible party<br> <b>責任者</b> <br> (せきにんしゃ)
<b>工事</b> <br> 道路工事が明日から始まります。	[sound:s-2166_道路工事が明日から始まります。.mp3] <br>  どうろこうじがあしたからはじまります。 <br> Road construction will start from tomorrow.
[sound:s-2166_道路工事が明日から始まります。.mp3]	<b>工事</b> <br> 道路工事が明日から始まります。<br>  どうろこうじがあしたからはじまります <br> Road construction will start from tomorrow.
任	[sound:k-2167_任.mp3]<br>にん <br> obligation, duty, charge, responsibility
obligation, duty, charge, responsibility	<b>任<b> <br> にん <br>[sound:k-2167_任.mp3]
[sound:k-2167_任.mp3]	obligation, duty, charge, responsibility<br> <b>任</b> <br> (にん)
<b>工作</b> <br> 彼は木工作が得意です。	[sound:s-2167_彼は木工作が得意です。.mp3] <br>  かれはもっこうさくがとくいです。 <br> He is skilled in woodworking.
[sound:s-2167_彼は木工作が得意です。.mp3]	<b>工作</b> <br> 彼は木工作が得意です。<br>  かれはもっこうさくがとくいです <br> He is skilled in woodworking.
主任	[sound:k-2168_主任.mp3]<br>しゅにん <br> person in charge, responsible official
person in charge, responsible official	<b>主任<b> <br> しゅにん <br>[sound:k-2168_主任.mp3]
[sound:k-2168_主任.mp3]	person in charge, responsible official<br> <b>主任</b> <br> (しゅにん)
<b>加工</b> <br> この製品は高度な技術で加工されています。	[sound:s-2168_この製品は高度な技術で加工されています。.mp3] <br>  このせいひんはこうどなぎじゅつでかこうされています。 <br> This product is processed with advanced technology.
[sound:s-2168_この製品は高度な技術で加工されています。.mp3]	<b>加工</b> <br> この製品は高度な技術で加工されています。<br>  このせいひんはこうどなぎじゅつでかこうされています <br> This product is processed with advanced technology.
任務	[sound:k-2169_任務.mp3]<br>にんむ <br> duty, function, office, mission, task
duty, function, office, mission, task	<b>任務<b> <br> にんむ <br>[sound:k-2169_任務.mp3]
[sound:k-2169_任務.mp3]	duty, function, office, mission, task<br> <b>任務</b> <br> (にんむ)
<b>工夫</b> <br> 彼は機械の動作を改善する工夫を凝らしています。	[sound:s-2169_彼は機械の動作を改善する工夫を凝らしています。.mp3] <br>  かれはきかいのどうさをかいぜんするくふうをこらしています。 <br> He is devising ways to improve the operation of the machine.
[sound:s-2169_彼は機械の動作を改善する工夫を凝らしています。.mp3]	<b>工夫</b> <br> 彼は機械の動作を改善する工夫を凝らしています。<br>  かれはきかいのどうさをかいぜんするくふうをこらしています <br> He is devising ways to improve the operation of the machine.
取引	[sound:k-2170_取引.mp3]<br>とりひき <br> transactions, dealings, business
transactions, dealings, business	<b>取引<b> <br> とりひき <br>[sound:k-2170_取引.mp3]
[sound:k-2170_取引.mp3]	transactions, dealings, business<br> <b>取引</b> <br> (とりひき)
<b>人工</b> <br> この湖は人工のダムで作られました。	[sound:s-2170_この湖は人工のダムで作られました。.mp3] <br>  このみずうみはじんこうのだむでつくられました。 <br> This lake was created by an artificial dam.
[sound:s-2170_この湖は人工のダムで作られました。.mp3]	<b>人工</b> <br> この湖は人工のダムで作られました。<br>  このみずうみはじんこうのだむでつくられました <br> This lake was created by an artificial dam.
引き下げ	[sound:k-2171_引き下げ.mp3]<br>ひきさげ <br> reduction, cut
reduction, cut	<b>引き下げ<b> <br> ひきさげ <br>[sound:k-2171_引き下げ.mp3]
[sound:k-2171_引き下げ.mp3]	reduction, cut<br> <b>引き下げ</b> <br> (ひきさげ)
<b>工学</b> <br> 彼は電気工学を専攻しています。	[sound:s-2171_彼は電気工学を専攻しています。.mp3] <br>  かれはでんきこうがくをせんこうしています。 <br> He is majoring in electrical engineering.
[sound:s-2171_彼は電気工学を専攻しています。.mp3]	<b>工学</b> <br> 彼は電気工学を専攻しています。<br>  かれはでんきこうがくをせんこうしています <br> He is majoring in electrical engineering.
引き上げ	[sound:k-2172_引き上げ.mp3]<br>ひきあげ <br> pulling up, drawing up, salvage, re-floatation; raising, increase, upward revision
pulling up, drawing up, salvage, re-floatation; raising, increase, upward revision	<b>引き上げ<b> <br> ひきあげ <br>[sound:k-2172_引き上げ.mp3]
[sound:k-2172_引き上げ.mp3]	pulling up, drawing up, salvage, re-floatation; raising, increase, upward revision<br> <b>引き上げ</b> <br> (ひきあげ)
<b>商工</b> <br> この地域は商工業が発展しています。	[sound:s-2172_この地域は商工業が発展しています。.mp3] <br>  このちいきはしょうこうぎょうがはってんしています。 <br> Commerce and industry are thriving in this area.
[sound:s-2172_この地域は商工業が発展しています。.mp3]	<b>商工</b> <br> この地域は商工業が発展しています。<br>  このちいきはしょうこうぎょうがはってんしています <br> Commerce and industry are thriving in this area.
引退	[sound:k-2173_引退.mp3]<br>いんたい <br> retire
retire	<b>引退<b> <br> いんたい <br>[sound:k-2173_引退.mp3]
[sound:k-2173_引退.mp3]	retire<br> <b>引退</b> <br> (いんたい)
<b>大工</b> <br> 彼は素晴らしい大工です。	[sound:s-2173_彼は素晴らしい大工です。.mp3] <br>  かれはすばらしいだいくです。 <br> He is a wonderful carpenter.
[sound:s-2173_彼は素晴らしい大工です。.mp3]	<b>大工</b> <br> 彼は素晴らしい大工です。<br>  かれはすばらしいだいくです <br> He is a wonderful carpenter.
隠し引き出し	[sound:k-2174_隠し引き出し.mp3]<br>かくしひきだし <br> secret withdrawal
secret withdrawal	<b>隠し引き出し<b> <br> かくしひきだし <br>[sound:k-2174_隠し引き出し.mp3]
[sound:k-2174_隠し引き出し.mp3]	secret withdrawal<br> <b>隠し引き出し</b> <br> (かくしひきだし)
<b>建設</b> <br> この地域で新しい橋の建設が進行中です。	[sound:s-2174_この地域で新しい橋の建設が進行中です。.mp3] <br>  このちいきであたらしいはしのけんせつがしんこうちゅうです。 <br> The construction of a new bridge is underway in this area.
[sound:s-2174_この地域で新しい橋の建設が進行中です。.mp3]	<b>建設</b> <br> この地域で新しい橋の建設が進行中です。<br>  このちいきであたらしいはしのけんせつがしんこうちゅうです <br> The construction of a new bridge is underway in this area.
強引	[sound:k-2175_強引.mp3]<br>ごういん <br> overbearing, coercive, pushy, forcible, high-handed
overbearing, coercive, pushy, forcible, high-handed	<b>強引<b> <br> ごういん <br>[sound:k-2175_強引.mp3]
[sound:k-2175_強引.mp3]	overbearing, coercive, pushy, forcible, high-handed<br> <b>強引</b> <br> (ごういん)
<b>建築</b> <br> この建物はモダンな建築様式です。	[sound:s-2175_この建物はモダンな建築様式です。.mp3] <br>  このたてものはもだんなけんちくようしきです。 <br> This building features modern architectural style.
[sound:s-2175_この建物はモダンな建築様式です。.mp3]	<b>建築</b> <br> この建物はモダンな建築様式です。<br>  このたてものはもだんなけんちくようしきです <br> This building features modern architectural style.
駆け引き	[sound:k-2176_駆け引き.mp3]<br>かけひき <br> bargaining, haggling; tactics, strategy
bargaining, haggling; tactics, strategy	<b>駆け引き<b> <br> かけひき <br>[sound:k-2176_駆け引き.mp3]
[sound:k-2176_駆け引き.mp3]	bargaining, haggling; tactics, strategy<br> <b>駆け引き</b> <br> (かけひき)
<b>建物</b> <br> この建物は歴史的な価値があります。	[sound:s-2176_この建物は歴史的な価値があります。.mp3] <br>  このたてものはれきしてきなかちがあります。 <br> This building has historical value.
[sound:s-2176_この建物は歴史的な価値があります。.mp3]	<b>建物</b> <br> この建物は歴史的な価値があります。<br>  このたてものはれきしてきなかちがあります <br> This building has historical value.
引き金	[sound:k-2177_引き金.mp3]<br>ひきがね <br> trigger, gunlock
trigger, gunlock	<b>引き金<b> <br> ひきがね <br>[sound:k-2177_引き金.mp3]
[sound:k-2177_引き金.mp3]	trigger, gunlock<br> <b>引き金</b> <br> (ひきがね)
<b>再建</b> <br> この地域は震災後、復興と再建が進められています。	[sound:s-2177_この地域は震災後、復興と再建が進められています。.mp3] <br>  このちいきはしんさいご、ふっこうとさいけんがすすめられています。 <br> Reconstruction and rebuilding are underway in this area after the earthquake.
[sound:s-2177_この地域は震災後、復興と再建が進められています。.mp3]	<b>再建</b> <br> この地域は震災後、復興と再建が進められています。<br>  このちいきはしんさいご、ふっこうとさいけんがすすめられています <br> Reconstruction and rebuilding are underway in this area after the earthquake.
引き続き	[sound:k-2178_引き続き.mp3]<br>ひきつづき <br> continuing for a long time, in succession, without a break
continuing for a long time, in succession, without a break	<b>引き続き<b> <br> ひきつづき <br>[sound:k-2178_引き続き.mp3]
[sound:k-2178_引き続き.mp3]	continuing for a long time, in succession, without a break<br> <b>引き続き</b> <br> (ひきつづき)
<b>建設省</b> <br> 建設省は都市計画に関する政策を策定しています。	[sound:s-2178_建設省は都市計画に関する政策を策定しています。.mp3] <br>  けんせつしょうはとしけいかくにかんするせいさくをさくていしています。 <br> The Ministry of Construction is formulating policies related to urban planning.
[sound:s-2178_建設省は都市計画に関する政策を策定しています。.mp3]	<b>建設省</b> <br> 建設省は都市計画に関する政策を策定しています。<br>  けんせつしょうはとしけいかくにかんするせいさくをさくていしています <br> The Ministry of Construction is formulating policies related to urban planning.
割引	[sound:k-2179_割引.mp3]<br>わりびき <br> discount, reduction, rebate, tenths discounted
discount, reduction, rebate, tenths discounted	<b>割引<b> <br> わりびき <br>[sound:k-2179_割引.mp3]
[sound:k-2179_割引.mp3]	discount, reduction, rebate, tenths discounted<br> <b>割引</b> <br> (わりびき)
<b>二階建て</b> <br> 私たちは二階建ての家を買う予定です。	[sound:s-2179_私たちは二階建ての家を買う予定です。.mp3] <br>  わたしたちはにかいだてのいえをかうよていです。 <br> We plan to buy a two-story house.
[sound:s-2179_私たちは二階建ての家を買う予定です。.mp3]	<b>二階建て</b> <br> 私たちは二階建ての家を買う予定です。<br>  わたしたちはにかいだてのいえをかうよていです <br> We plan to buy a two-story house.
使わす	[sound:k-2180_使わす.mp3]<br>つかわす <br> to send, to dispatch, to despatch
to send, to dispatch, to despatch	<b>使わす<b> <br> つかわす <br>[sound:k-2180_使わす.mp3]
[sound:k-2180_使わす.mp3]	to send, to dispatch, to despatch<br> <b>使わす</b> <br> (つかわす)
<b>建前</b> <br> 彼の言動と本音の間には建前がある。	[sound:s-2180_彼の言動と本音の間には建前がある。.mp3] <br>  かれのげんどうとほんねのあいだにはたてまえがある。 <br> There is a public stance between his words and true feelings.
[sound:s-2180_彼の言動と本音の間には建前がある。.mp3]	<b>建前</b> <br> 彼の言動と本音の間には建前がある。<br>  かれのげんどうとほんねのあいだにはたてまえがある <br> There is a public stance between his words and true feelings.
使う	[sound:k-2181_使う.mp3]<br>つかう <br> to use (a thing, method, etc.), to make use of, to put to use; to use (a person, animal, puppet, etc.), to employ, to handle, to manage, to manipulate; to use (time, money, etc.), to spend, to consume; to use (language), to speak; to take (one's lunch), to circulate (bad money)
to use (a thing, method, etc.), to make use of, to put to use; to use (a person, animal, puppet, etc.), to employ, to handle, to manage, to manipulate; to use (time, money, etc.), to spend, to consume; to use (language), to speak; to take (one's lunch), to circulate (bad money)	<b>使う<b> <br> つかう <br>[sound:k-2181_使う.mp3]
[sound:k-2181_使う.mp3]	to use<br> <b>a thing, method, etc.), to make use of, to put to use; to use (a person, animal, puppet, etc.), to employ, to handle, to manage, to manipulate; to use (time, money, etc.), to spend, to consume; to use (language), to speak; to take (one's lunch), to circulate (bad money) (使う</b> <br> (つかう)
<b>建国</b> <br> その国の建国記念日は毎年祝われます。	[sound:s-2181_その国の建国記念日は毎年祝われます。.mp3] <br>  そのくにのけんこくきねんびはまいねんいわれます。 <br> The founding anniversary of the country is celebrated every year.
[sound:s-2181_その国の建国記念日は毎年祝われます。.mp3]	<b>建国</b> <br> その国の建国記念日は毎年祝われます。<br>  そのくにのけんこくきねんびはまいねんいわれます <br> The founding anniversary of the country is celebrated every year.
使用	[sound:k-2182_使用.mp3]<br>しよう <br> use, application, employment, utilization, utilisation
use, application, employment, utilization, utilisation	<b>使用<b> <br> しよう <br>[sound:k-2182_使用.mp3]
[sound:k-2182_使用.mp3]	use, application, employment, utilization, utilisation<br> <b>使用</b> <br> (しよう)
<b>建造物</b> <br> この町には歴史的な建造物がたくさんあります。	[sound:s-2182_この町には歴史的な建造物がたくさんあります。.mp3] <br>  このまちにはれきしてきなけんぞうぶつがたくさんあります。 <br> There are many historical structures in this town.
[sound:s-2182_この町には歴史的な建造物がたくさんあります。.mp3]	<b>建造物</b> <br> この町には歴史的な建造物がたくさんあります。<br>  このまちにはれきしてきなけんぞうぶつがたくさんあります <br> There are many historical structures in this town.
大使	[sound:k-2183_大使.mp3]<br>たいし <br> ambassador
ambassador	<b>大使<b> <br> たいし <br>[sound:k-2183_大使.mp3]
[sound:k-2183_大使.mp3]	ambassador<br> <b>大使</b> <br> (たいし)
<b>建つ</b> <br> この土地には新しいビルが建ちます。	[sound:s-2183_この土地には新しいビルが建ちます。.mp3] <br> このとちにはあたらしいびるがたちます。 <br>A new building will be built on this land.
[sound:s-2183_この土地には新しいビルが建ちます。.mp3]	<b>建つ</b> <br> この土地には新しいビルが建ちます。<br> このとちにはあたらしいびるがたちます <br>A new building will be built on this land.
行使	[sound:k-2184_行使.mp3]<br>こうし <br> use, exercise
use, exercise	<b>行使<b> <br> こうし <br>[sound:k-2184_行使.mp3]
[sound:k-2184_行使.mp3]	use, exercise<br> <b>行使</b> <br> (こうし)
<b>英語</b> <br> 彼女は英語を流暢に話せます。	[sound:s-2184_彼女は英語を流暢に話せます。.mp3] <br> かのじょはえいごをりゅうちょうにはなせます。 <br>She speaks English fluently.
[sound:s-2184_彼女は英語を流暢に話せます。.mp3]	<b>英語</b> <br> 彼女は英語を流暢に話せます。<br> かのじょはえいごをりゅうちょうにはなせます <br>She speaks English fluently.
大使館	[sound:k-2185_大使館.mp3]<br>たいしかん <br> embassy
embassy	<b>大使館<b> <br> たいしかん <br>[sound:k-2185_大使館.mp3]
[sound:k-2185_大使館.mp3]	embassy<br> <b>大使館</b> <br> (たいしかん)
<b>日本語</b> <br> 外国人が日本語を学ぶのは難しいです。	[sound:s-2185_外国人が日本語を学ぶのは難しいです。.mp3] <br> がいこくじんがにほんごをまなぶのはむずかしいです。 <br>It's difficult for foreigners to learn Japanese.
[sound:s-2185_外国人が日本語を学ぶのは難しいです。.mp3]	<b>日本語</b> <br> 外国人が日本語を学ぶのは難しいです。<br> がいこくじんがにほんごをまなぶのはむずかしいです <br>It's difficult for foreigners to learn Japanese.
使い	[sound:k-2186_使い.mp3]<br>つかい <br> errand, message, messenger, bearer, use, usage, trainer, tamer, mission, familiar spirit, going as envoy
errand, message, messenger, bearer, use, usage, trainer, tamer, mission, familiar spirit, going as envoy	<b>使い<b> <br> つかい <br>[sound:k-2186_使い.mp3]
[sound:k-2186_使い.mp3]	errand, message, messenger, bearer, use, usage, trainer, tamer, mission, familiar spirit, going as envoy<br> <b>使い</b> <br> (つかい)
<b>物語</b> <br> その小説は幻想的な物語です。	[sound:s-2186_その小説は幻想的な物語です。.mp3] <br> そのしょうせつはげんそうてきなものがたりです。 <br>The novel is a fantastical story.
[sound:s-2186_その小説は幻想的な物語です。.mp3]	<b>物語</b> <br> その小説は幻想的な物語です。<br> そのしょうせつはげんそうてきなものがたりです <br>The novel is a fantastical story.
使途	[sound:k-2187_使途.mp3]<br>しと <br> purpose for which money is spent, the way money is spent
purpose for which money is spent, the way money is spent	<b>使途<b> <br> しと <br>[sound:k-2187_使途.mp3]
[sound:k-2187_使途.mp3]	purpose for which money is spent, the way money is spent<br> <b>使途</b> <br> (しと)
<b>語らう</b> <br> 彼らは古い時代の出来事について語り合っている。	[sound:s-2187_彼らは古い時代の出来事について語り合っている。.mp3] <br> かれらはふるいじだいのできごとについてかたりあっている。 <br>They are talking about events from ancient times.
[sound:s-2187_彼らは古い時代の出来事について語り合っている。.mp3]	<b>語らう</b> <br> 彼らは古い時代の出来事について語り合っている。<br> かれらはふるいじだいのできごとについてかたりあっている <br>They are talking about events from ancient times.
特使	[sound:k-2188_特使.mp3]<br>とくし <br> special envoy
special envoy	<b>特使<b> <br> とくし <br>[sound:k-2188_特使.mp3]
[sound:k-2188_特使.mp3]	special envoy<br> <b>特使</b> <br> (とくし)
<b>語る</b> <br> 彼は自分の経験を興味深く語ってくれた。	[sound:s-2188_彼は自分の経験を興味深く語ってくれた。.mp3] <br> かれはじぶんのけいけんをきょうみぶかくかたってくれた。 <br>He told his experiences in an interesting way.
[sound:s-2188_彼は自分の経験を興味深く語ってくれた。.mp3]	<b>語る</b> <br> 彼は自分の経験を興味深く語ってくれた。<br> かれはじぶんのけいけんをきょうみぶかくかたってくれた <br>He told his experiences in an interesting way.
労使	[sound:k-2189_労使.mp3]<br>ろうし <br> labour and management, labor and management
labour and management, labor and management	<b>労使<b> <br> ろうし <br>[sound:k-2189_労使.mp3]
[sound:k-2189_労使.mp3]	labour and management, labor and management<br> <b>労使</b> <br> (ろうし)
<b>言語</b> <br> 言語学を学ぶことは興味深いです。	[sound:s-2189_言語学を学ぶことは興味深いです。.mp3] <br> げんごがくをまなぶことはきょうみぶかいです。 <br>Studying linguistics is fascinating.
[sound:s-2189_言語学を学ぶことは興味深いです。.mp3]	<b>言語</b> <br> 言語学を学ぶことは興味深いです。<br> げんごがくをまなぶことはきょうみぶかいです <br>Studying linguistics is fascinating.
要求	[sound:k-2190_要求.mp3]<br>ようきゅう <br> demand, firm request, requisition, requirement, desire
demand, firm request, requisition, requirement, desire	<b>要求<b> <br> ようきゅう <br>[sound:k-2190_要求.mp3]
[sound:k-2190_要求.mp3]	demand, firm request, requisition, requirement, desire<br> <b>要求</b> <br> (ようきゅう)
<b>語り</b> <br> 彼の語り口は聞き手を引き込む。	[sound:s-2190_彼の語り口は聞き手を引き込む。.mp3] <br> かれのかたりぐちはききてをひきこむ。 <br>His way of storytelling captivates the listener.
[sound:s-2190_彼の語り口は聞き手を引き込む。.mp3]	<b>語り</b> <br> 彼の語り口は聞き手を引き込む。<br> かれのかたりぐちはききてをひきこむ <br>His way of storytelling captivates the listener.
請求	[sound:k-2191_請求.mp3]<br>せいきゅう <br> claim, demand, charge, application, request, billing (for a service)
claim, demand, charge, application, request, billing (for a service)	<b>請求<b> <br> せいきゅう <br>[sound:k-2191_請求.mp3]
[sound:k-2191_請求.mp3]	claim, demand, charge, application, request, billing<br> <b>for a service) (請求</b> <br> (せいきゅう)
<b>用語</b> <br> 医学の用語は専門的です。	[sound:s-2191_医学の用語は専門的です。.mp3] <br> いがくのようごはせんもんてきです。 <br>Medical terminology is specialized.
[sound:s-2191_医学の用語は専門的です。.mp3]	<b>用語</b> <br> 医学の用語は専門的です。<br> いがくのようごはせんもんてきです <br>Medical terminology is specialized.
求刑	[sound:k-2192_求刑.mp3]<br>きゅうけい <br> prosecution
prosecution	<b>求刑<b> <br> きゅうけい <br>[sound:k-2192_求刑.mp3]
[sound:k-2192_求刑.mp3]	prosecution<br> <b>求刑</b> <br> (きゅうけい)
<b>国語</b> <br> 国語の授業は毎週木曜日に行われます。	[sound:s-2192_国語の授業は毎週木曜日に行われます。.mp3] <br> こくごのじゅぎょうはまいしゅうもくようびにおこなわれます。 <br>Japanese language classes are held every Thursday.
[sound:s-2192_国語の授業は毎週木曜日に行われます。.mp3]	<b>国語</b> <br> 国語の授業は毎週木曜日に行われます。<br> こくごのじゅぎょうはまいしゅうもくようびにおこなわれます <br>Japanese language classes are held every Thursday.
求人	[sound:k-2193_求人.mp3]<br>きゅうじん <br> offer of job (situation)
offer of job (situation)	<b>求人<b> <br> きゅうじん <br>[sound:k-2193_求人.mp3]
[sound:k-2193_求人.mp3]	offer of job<br> <b>situation) (求人</b> <br> (きゅうじん)
<b>外国語</b> <br> 外国語を学ぶことは国際的な視野を広げる。	[sound:s-2193_外国語を学ぶことは国際的な視野を広げる。.mp3] <br> がいこくごをまなぶことはこくさいてきなしやをひろげる。 <br>Learning foreign languages broadens your international perspective.
[sound:s-2193_外国語を学ぶことは国際的な視野を広げる。.mp3]	<b>外国語</b> <br> 外国語を学ぶことは国際的な視野を広げる。<br> がいこくごをまなぶことはこくさいてきなしやをひろげる <br>Learning foreign languages broadens your international perspective.
求心力	[sound:k-2194_求心力.mp3]<br>きゅうしんりょく <br> centripetal force, cohesive power, unifying force
centripetal force, cohesive power, unifying force	<b>求心力<b> <br> きゅうしんりょく <br>[sound:k-2194_求心力.mp3]
[sound:k-2194_求心力.mp3]	centripetal force, cohesive power, unifying force<br> <b>求心力</b> <br> (きゅうしんりょく)
<b>球</b> <br> 子供たちは公園で球を投げて遊んでいます。	[sound:s-2194_子供たちは公園で球を投げて遊んでいます。.mp3] <br> こどもたちはこうえんでたまをなげてあそんでいます。 <br>The children are playing catch with a ball in the park.
[sound:s-2194_子供たちは公園で球を投げて遊んでいます。.mp3]	<b>球</b> <br> 子供たちは公園で球を投げて遊んでいます。<br> こどもたちはこうえんでたまをなげてあそんでいます <br>The children are playing catch with a ball in the park.
身代金要求	[sound:k-2195_身代金要求.mp3]<br>みのしろきんようきゅう <br> ransom demand
ransom demand	<b>身代金要求<b> <br> みのしろきんようきゅう <br>[sound:k-2195_身代金要求.mp3]
[sound:k-2195_身代金要求.mp3]	ransom demand<br> <b>身代金要求</b> <br> (みのしろきんようきゅう)
<b>地球</b> <br> 地球は私たちの唯一の住処です。	[sound:s-2195_地球は私たちの唯一の住処です。.mp3] <br> ちきゅうはわたしたちのゆいいつのすみかです。 <br>Earth is our only home.
[sound:s-2195_地球は私たちの唯一の住処です。.mp3]	<b>地球</b> <br> 地球は私たちの唯一の住処です。<br> ちきゅうはわたしたちのゆいいつのすみかです <br>Earth is our only home.
請求権	[sound:k-2196_請求権.mp3]<br>せいきゅうけん <br> claim rights
claim rights	<b>請求権<b> <br> せいきゅうけん <br>[sound:k-2196_請求権.mp3]
[sound:k-2196_請求権.mp3]	claim rights<br> <b>請求権</b> <br> (せいきゅうけん)
<b>野球</b> <br> 夏になると野球の試合が盛んになります。	[sound:s-2196_夏になると野球の試合が盛んになります。.mp3] <br> なつになるとやきゅうのしあいがさかんになります。 <br>Baseball games become popular in summer.
[sound:s-2196_夏になると野球の試合が盛んになります。.mp3]	<b>野球</b> <br> 夏になると野球の試合が盛んになります。<br> なつになるとやきゅうのしあいがさかんになります <br>Baseball games become popular in summer.
欲求	[sound:k-2197_欲求.mp3]<br>よっきゅう <br> desire
desire	<b>欲求<b> <br> よっきゅう <br>[sound:k-2197_欲求.mp3]
[sound:k-2197_欲求.mp3]	desire<br> <b>欲求</b> <br> (よっきゅう)
<b>球場</b> <br> その球場は昔からの伝統がある。	[sound:s-2197_その球場は昔からの伝統がある。.mp3] <br> そのきゅうじょうはむかしからのでんとうがある。 <br>The stadium has a long-standing tradition.
[sound:s-2197_その球場は昔からの伝統がある。.mp3]	<b>球場</b> <br> その球場は昔からの伝統がある。<br> そのきゅうじょうはむかしからのでんとうがある <br>The stadium has a long-standing tradition.
追求	[sound:k-2198_追求.mp3]<br>ついきゅう <br> pursuing (goal), pursuit, seeking, search; to pursue (e.g. goal), to seek
pursuing (goal), pursuit, seeking, search; to pursue (e.g. goal), to seek	<b>追求<b> <br> ついきゅう <br>[sound:k-2198_追求.mp3]
[sound:k-2198_追求.mp3]	pursuing<br> <b>goal), pursuit, seeking, search; to pursue (e.g. goal), to seek (追求</b> <br> (ついきゅう)
<b>球団</b> <br> 彼はプロの野球球団に入団した。	[sound:s-2198_彼はプロの野球球団に入団した。.mp3] <br> かれはぷろのやきゅうきゅうだんににゅうだんした。 <br>He joined a professional baseball team.
[sound:s-2198_彼はプロの野球球団に入団した。.mp3]	<b>球団</b> <br> 彼はプロの野球球団に入団した。<br> かれはぷろのやきゅうきゅうだんににゅうだんした <br>He joined a professional baseball team.
求職	[sound:k-2199_求職.mp3]<br>きゅうしょく <br> job hunting, seeking employment
job hunting, seeking employment	<b>求職<b> <br> きゅうしょく <br>[sound:k-2199_求職.mp3]
[sound:k-2199_求職.mp3]	job hunting, seeking employment<br> <b>求職</b> <br> (きゅうしょく)
<b>四球</b> <br> 彼は四球で出塁しました。	[sound:s-2199_彼は四球で出塁しました。.mp3] <br> かれはよんきゅうでしゅつるいしました。 <br>He reached base on a walk.
[sound:s-2199_彼は四球で出塁しました。.mp3]	<b>四球</b> <br> 彼は四球で出塁しました。<br> かれはよんきゅうでしゅつるいしました <br>He reached base on a walk.
事務所	[sound:k-2200_事務所.mp3]<br>じむしょ <br> office
office	<b>事務所<b> <br> じむしょ <br>[sound:k-2200_事務所.mp3]
[sound:k-2200_事務所.mp3]	office<br> <b>事務所</b> <br> (じむしょ)
<b>投球</b> <br> 彼の投球は速い。	[sound:s-2200_彼の投球は速い。.mp3] <br> かれのとうきゅうははやい。 <br>His pitching is fast.
[sound:s-2200_彼の投球は速い。.mp3]	<b>投球</b> <br> 彼の投球は速い。<br> かれのとうきゅうははやい <br>His pitching is fast.
場所	[sound:k-2201_場所.mp3]<br>ばしょ <br> place, location
place, location	<b>場所<b> <br> ばしょ <br>[sound:k-2201_場所.mp3]
[sound:k-2201_場所.mp3]	place, location<br> <b>場所</b> <br> (ばしょ)
<b>速球</b> <br> 彼は速球を得意としている。	[sound:s-2201_彼は速球を得意としている。.mp3] <br> かれはそっきゅうをとくいとしている。 <br>He is good at throwing fastballs.
[sound:s-2201_彼は速球を得意としている。.mp3]	<b>速球</b> <br> 彼は速球を得意としている。<br> かれはそっきゅうをとくいとしている <br>He is good at throwing fastballs.
研究所	[sound:k-2202_研究所.mp3]<br>けんきゅうしょ, けんきゅうじょ <br> research establishment (institute, laboratory, etc.)
research establishment (institute, laboratory, etc.)	<b>研究所<b> <br> けんきゅうしょ, けんきゅうじょ <br>[sound:k-2202_研究所.mp3]
[sound:k-2202_研究所.mp3]	research establishment<br> <b>institute, laboratory, etc.) (研究所</b> <br> (けんきゅうしょ, けんきゅうじょ)
<b>制球</b> <br> 彼の制球力は素晴らしい。	[sound:s-2202_彼の制球力は素晴らしい。.mp3] <br> かれのせいきゅうりょくはすばらしい。 <br>His pitching control is excellent.
[sound:s-2202_彼の制球力は素晴らしい。.mp3]	<b>制球</b> <br> 彼の制球力は素晴らしい。<br> かれのせいきゅうりょくはすばらしい <br>His pitching control is excellent.
所得	[sound:k-2203_所得.mp3]<br>しょとく <br> income, earnings
income, earnings	<b>所得<b> <br> しょとく <br>[sound:k-2203_所得.mp3]
[sound:k-2203_所得.mp3]	income, earnings<br> <b>所得</b> <br> (しょとく)
<b>直球</b> <br> 彼は直球を投げることが得意です。	[sound:s-2203_彼は直球を投げることが得意です。.mp3] <br> かれはちょっきゅうをなげることがとくいです。 <br>He is good at throwing straight pitches.
[sound:s-2203_彼は直球を投げることが得意です。.mp3]	<b>直球</b> <br> 彼は直球を投げることが得意です。<br> かれはちょっきゅうをなげることがとくいです <br>He is good at throwing straight pitches.
住所	[sound:k-2204_住所.mp3]<br>じゅうしょ <br> address (e.g. of house), residence, domicile
address (e.g. of house), residence, domicile	<b>住所<b> <br> じゅうしょ <br>[sound:k-2204_住所.mp3]
[sound:k-2204_住所.mp3]	address<br> <b>e.g. of house), residence, domicile (住所</b> <br> (じゅうしょ)
<b>経営</b> <br> 彼は会社の経営に成功した。	[sound:s-2204_彼は会社の経営に成功した。.mp3] <br> かれはかいしゃのけいえいにせいこうした。 <br>He succeeded in managing the company.
[sound:s-2204_彼は会社の経営に成功した。.mp3]	<b>経営</b> <br> 彼は会社の経営に成功した。<br> かれはかいしゃのけいえいにせいこうした <br>He succeeded in managing the company.
所長	[sound:k-2205_所長.mp3]<br>しょちょう <br> chief, head
chief, head	<b>所長<b> <br> しょちょう <br>[sound:k-2205_所長.mp3]
[sound:k-2205_所長.mp3]	chief, head<br> <b>所長</b> <br> (しょちょう)
<b>運営</b> <br> そのプロジェクトの運営は円滑に進んでいる。	[sound:s-2205_そのプロジェクトの運営は円滑に進んでいる。.mp3] <br> そのぷろじぇくとのうんえいはえんかつにすすんでいる。 <br>The operation of the project is progressing smoothly.
[sound:s-2205_そのプロジェクトの運営は円滑に進んでいる。.mp3]	<b>運営</b> <br> そのプロジェクトの運営は円滑に進んでいる。<br> そのぷろじぇくとのうんえいはえんかつにすすんでいる <br>The operation of the project is progressing smoothly.
所得税	[sound:k-2206_所得税.mp3]<br>しょとくぜい <br> income tax
income tax	<b>所得税<b> <br> しょとくぜい <br>[sound:k-2206_所得税.mp3]
[sound:k-2206_所得税.mp3]	income tax<br> <b>所得税</b> <br> (しょとくぜい)
<b>営業</b> <br> 彼は会社の営業部長です。	[sound:s-2206_彼は会社の営業部長です。.mp3] <br> かれはかいしゃのえいぎょうぶちょうです。 <br>He is the head of the company's sales department.
[sound:s-2206_彼は会社の営業部長です。.mp3]	<b>営業</b> <br> 彼は会社の営業部長です。<br> かれはかいしゃのえいぎょうぶちょうです <br>He is the head of the company's sales department.
裁判所	[sound:k-2207_裁判所.mp3]<br>さいばんしょ <br> court, courthouse
court, courthouse	<b>裁判所<b> <br> さいばんしょ <br>[sound:k-2207_裁判所.mp3]
[sound:k-2207_裁判所.mp3]	court, courthouse<br> <b>裁判所</b> <br> (さいばんしょ)
<b>経営者</b> <br> 彼は成功した経営者です。	[sound:s-2207_彼は成功した経営者です。.mp3] <br> かれはせいこうしたけいえいしゃです。 <br>He is a successful entrepreneur.
[sound:s-2207_彼は成功した経営者です。.mp3]	<b>経営者</b> <br> 彼は成功した経営者です。<br> かれはせいこうしたけいえいしゃです <br>He is a successful entrepreneur.
所属	[sound:k-2208_所属.mp3]<br>しょぞく <br> attached to, belong to, member
attached to, belong to, member	<b>所属<b> <br> しょぞく <br>[sound:k-2208_所属.mp3]
[sound:k-2208_所属.mp3]	attached to, belong to, member<br> <b>所属</b> <br> (しょぞく)
<b>国営</b> <br> その企業は国営企業です。	[sound:s-2208_その企業は国営企業です。.mp3] <br> そのきぎょうはこくえいきぎょうです。 <br>The company is a state-run enterprise.
[sound:s-2208_その企業は国営企業です。.mp3]	<b>国営</b> <br> その企業は国営企業です。<br> そのきぎょうはこくえいきぎょうです <br>The company is a state-run enterprise.
無所属	[sound:k-2209_無所属.mp3]<br>むしょぞく <br> independent
independent	<b>無所属<b> <br> むしょぞく <br>[sound:k-2209_無所属.mp3]
[sound:k-2209_無所属.mp3]	independent<br> <b>無所属</b> <br> (むしょぞく)
<b>陣営</b> <br> 政治的な陣営が対立している。	[sound:s-2209_政治的な陣営が対立している。.mp3] <br> せいじてきなじんえいがたいりつしている。 <br>Political factions are in conflict.
[sound:s-2209_政治的な陣営が対立している。.mp3]	<b>陣営</b> <br> 政治的な陣営が対立している。<br> せいじてきなじんえいがたいりつしている <br>Political factions are in conflict.
次官	[sound:k-2210_次官.mp3]<br>じかん <br> vice-minister, undersecretary
vice-minister, undersecretary	<b>次官<b> <br> じかん <br>[sound:k-2210_次官.mp3]
[sound:k-2210_次官.mp3]	vice-minister, undersecretary<br> <b>次官</b> <br> (じかん)
<b>民営</b> <br> その病院は民営です。	[sound:s-2210_その病院は民営です。.mp3] <br> そのびょういんはみんえいです。 <br>The hospital is privately owned.
[sound:s-2210_その病院は民営です。.mp3]	<b>民営</b> <br> その病院は民営です。<br> そのびょういんはみんえいです <br>The hospital is privately owned.
事務次官	[sound:k-2211_事務次官.mp3]<br>じむじかん <br> permanent vice-president, undersecretary, vice-minister
permanent vice-president, undersecretary, vice-minister	<b>事務次官<b> <br> じむじかん <br>[sound:k-2211_事務次官.mp3]
[sound:k-2211_事務次官.mp3]	permanent vice-president, undersecretary, vice-minister<br> <b>事務次官</b> <br> (じむじかん)
<b>営業所</b> <br> 新しい営業所がオープンしました。	[sound:s-2211_新しい営業所がオープンしました。.mp3] <br> あたらしいえいぎょうしょがおーぷんしました。 <br>The new branch office has opened.
[sound:s-2211_新しい営業所がオープンしました。.mp3]	<b>営業所</b> <br> 新しい営業所がオープンしました。<br> あたらしいえいぎょうしょがおーぷんしました <br>The new branch office has opened.
次期	[sound:k-2212_次期.mp3]<br>じき <br> next term, next period; next version, next release
next term, next period; next version, next release	<b>次期<b> <br> じき <br>[sound:k-2212_次期.mp3]
[sound:k-2212_次期.mp3]	next term, next period; next version, next release<br> <b>次期</b> <br> (じき)
<b>公営</b> <br> そのプールは公営です。	[sound:s-2212_そのプールは公営です。.mp3] <br> そのぷーるはこうえいです。 <br>The pool is publicly owned.
[sound:s-2212_そのプールは公営です。.mp3]	<b>公営</b> <br> そのプールは公営です。<br> そのぷーるはこうえいです <br>The pool is publicly owned.
次長	[sound:k-2213_次長.mp3]<br>じちょう <br> vice-, assistant director, vice-director
vice-, assistant director, vice-director	<b>次長<b> <br> じちょう <br>[sound:k-2213_次長.mp3]
[sound:k-2213_次長.mp3]	vice-, assistant director, vice-director<br> <b>次長</b> <br> (じちょう)
<b>市営</b> <br> この公園は市営です。	[sound:s-2213_この公園は市営です。.mp3] <br> このこうえんはしえいです。 <br>This park is city-owned.
[sound:s-2213_この公園は市営です。.mp3]	<b>市営</b> <br> この公園は市営です。<br> このこうえんはしえいです <br>This park is city-owned.
次々	[sound:k-2214_次々.mp3]<br>つぎつぎ <br> in succession, one by one
in succession, one by one	<b>次々<b> <br> つぎつぎ <br>[sound:k-2214_次々.mp3]
[sound:k-2214_次々.mp3]	in succession, one by one<br> <b>次々</b> <br> (つぎつぎ)
<b>空</b> <br> 青い空が広がっている。	[sound:s-2214_青い空が広がっている。.mp3] <br> あおいそらがひろがっている。 <br>The blue sky is spread out.
[sound:s-2214_青い空が広がっている。.mp3]	<b>空</b> <br> 青い空が広がっている。<br> あおいそらがひろがっている <br>The blue sky is spread out.
次回	[sound:k-2215_次回.mp3]<br>じかい <br> next time (occasion)
next time (occasion)	<b>次回<b> <br> じかい <br>[sound:k-2215_次回.mp3]
[sound:k-2215_次回.mp3]	next time<br> <b>occasion) (次回</b> <br> (じかい)
<b>空港</b> <br> 空港へのアクセスが便利です。	[sound:s-2215_空港へのアクセスが便利です。.mp3] <br> くうこうへのあくせすがべんりです。 <br>Access to the airport is convenient.
[sound:s-2215_空港へのアクセスが便利です。.mp3]	<b>空港</b> <br> 空港へのアクセスが便利です。<br> くうこうへのあくせすがべんりです <br>Access to the airport is convenient.
次第に	[sound:k-2216_次第に.mp3]<br>しだいに <br> gradually (progress into a state); in sequence, in order, in turn
gradually (progress into a state); in sequence, in order, in turn	<b>次第に<b> <br> しだいに <br>[sound:k-2216_次第に.mp3]
[sound:k-2216_次第に.mp3]	gradually<br> <b>progress into a state); in sequence, in order, in turn (次第に</b> <br> (しだいに)
<b>航空</b> <br> 航空会社で働いています。	[sound:s-2216_航空会社で働いています。.mp3] <br> こうくうがいしゃではたらいています。 <br>I work for an airline company.
[sound:s-2216_航空会社で働いています。.mp3]	<b>航空</b> <br> 航空会社で働いています。<br> こうくうがいしゃではたらいています <br>I work for an airline company.
二次	[sound:k-2217_二次.mp3]<br>にじ <br> secondary, subordinate
secondary, subordinate	<b>二次<b> <br> にじ <br>[sound:k-2217_二次.mp3]
[sound:k-2217_二次.mp3]	secondary, subordinate<br> <b>二次</b> <br> (にじ)
<b>空気</b> <br> この場所の空気が新鮮です。	[sound:s-2217_この場所の空気が新鮮です。.mp3] <br> このばしょのくうきがしんせんです。 <br>The air in this place is fresh.
[sound:s-2217_この場所の空気が新鮮です。.mp3]	<b>空気</b> <br> この場所の空気が新鮮です。<br> このばしょのくうきがしんせんです <br>The air in this place is fresh.
政務次官	[sound:k-2218_政務次官.mp3]<br>せいむじかん <br> parliamentary vice-minister
parliamentary vice-minister	<b>政務次官<b> <br> せいむじかん <br>[sound:k-2218_政務次官.mp3]
[sound:k-2218_政務次官.mp3]	parliamentary vice-minister<br> <b>政務次官</b> <br> (せいむじかん)
<b>航空機</b> <br> 航空機が雲の上を飛んでいる。	[sound:s-2218_航空機が雲の上を飛んでいる。.mp3] <br> こうくうきがくものうえをとんでいる。 <br>The aircraft is flying above the clouds.
[sound:s-2218_航空機が雲の上を飛んでいる。.mp3]	<b>航空機</b> <br> 航空機が雲の上を飛んでいる。<br> こうくうきがくものうえをとんでいる <br>The aircraft is flying above the clouds.
五十三次	[sound:k-2219_五十三次.mp3]<br>ごじゅうさんつぎ <br> the 53 Toukaidou stages
the 53 Toukaidou stages	<b>五十三次<b> <br> ごじゅうさんつぎ <br>[sound:k-2219_五十三次.mp3]
[sound:k-2219_五十三次.mp3]	the 53 Toukaidou stages<br> <b>五十三次</b> <br> (ごじゅうさんつぎ)
<b>空間</b> <br> 星々が美しい空間だ。	[sound:s-2219_星々が美しい空間だ。.mp3] <br> ほしぼしがうつくしいくうかんだ。 <br>It's a beautiful space with stars.
[sound:s-2219_星々が美しい空間だ。.mp3]	<b>空間</b> <br> 星々が美しい空間だ。<br> ほしぼしがうつくしいくうかんだ <br>It's a beautiful space with stars.
水	[sound:k-2220_水.mp3]<br>みず <br> water (cold, fresh)
water (cold, fresh)	<b>水<b> <br> みず <br>[sound:k-2220_水.mp3]
[sound:k-2220_水.mp3]	water<br> <b>cold, fresh) (水</b> <br> (みず)
<b>空爆</b> <br> 戦争中、多くの場所が空爆された。	[sound:s-2220_戦争中、多くの場所が空爆された。.mp3] <br> せんそうちゅう、おおくのばしょがくうばくされた。 <br>Many places were bombed during the war.
[sound:s-2220_戦争中、多くの場所が空爆された。.mp3]	<b>空爆</b> <br> 戦争中、多くの場所が空爆された。<br> せんそうちゅう、おおくのばしょがくうばくされた <br>Many places were bombed during the war.
水準	[sound:k-2221_水準.mp3]<br>すいじゅん <br> level, standard; water level
level, standard; water level	<b>水準<b> <br> すいじゅん <br>[sound:k-2221_水準.mp3]
[sound:k-2221_水準.mp3]	level, standard; water level<br> <b>水準</b> <br> (すいじゅん)
<b>空軍</b> <br> その国は強力な空軍を持っている。	[sound:s-2221_その国は強力な空軍を持っている。.mp3] <br> そのくにはきょうりょくなくうぐんをもっている。 <br>The country has a powerful air force.
[sound:s-2221_その国は強力な空軍を持っている。.mp3]	<b>空軍</b> <br> その国は強力な空軍を持っている。<br> そのくにはきょうりょくなくうぐんをもっている <br>The country has a powerful air force.
水道	[sound:k-2222_水道.mp3]<br>すいどう <br> water service, water supply
water service, water supply	<b>水道<b> <br> すいどう <br>[sound:k-2222_水道.mp3]
[sound:k-2222_水道.mp3]	water service, water supply<br> <b>水道</b> <br> (すいどう)
<b>上空</b> <br> 飛行機が上空を飛んでいる。	[sound:s-2222_飛行機が上空を飛んでいる。.mp3] <br> ひこうきがじょうくうをとんでいる。 <br>The airplane is flying overhead.
[sound:s-2222_飛行機が上空を飛んでいる。.mp3]	<b>上空</b> <br> 飛行機が上空を飛んでいる。<br> ひこうきがじょうくうをとんでいる <br>The airplane is flying overhead.
水面	[sound:k-2223_水面.mp3]<br>すいめん, みなも, みのも <br> water's surface
water's surface	<b>水面<b> <br> すいめん, みなも, みのも <br>[sound:k-2223_水面.mp3]
[sound:k-2223_水面.mp3]	water's surface<br> <b>水面</b> <br> (すいめん, みなも, みのも)
<b>架空</b> <br> 架空の電線が通っている。	[sound:s-2223_架空の電線が通っている。.mp3] <br> かくうのでんせんがとおっている。 <br>Overhead power lines are running.
[sound:s-2223_架空の電線が通っている。.mp3]	<b>架空</b> <br> 架空の電線が通っている。<br> かくうのでんせんがとおっている <br>Overhead power lines are running.
水泳	[sound:k-2224_水泳.mp3]<br>すいえい <br> swimming
swimming	<b>水泳<b> <br> すいえい <br>[sound:k-2224_水泳.mp3]
[sound:k-2224_水泳.mp3]	swimming<br> <b>水泳</b> <br> (すいえい)
<b>職</b> <br> 彼は新しい職を探しています。	[sound:s-2224_彼は新しい職を探しています。.mp3] <br> かれはあたらしいしょくをさがしています。 <br>He is looking for a new job.
[sound:s-2224_彼は新しい職を探しています。.mp3]	<b>職</b> <br> 彼は新しい職を探しています。<br> かれはあたらしいしょくをさがしています <br>He is looking for a new job.
水田	[sound:k-2225_水田.mp3]<br>すいでん <br> (water-filled) paddy field
(water-filled) paddy field	<b>水田<b> <br> すいでん <br>[sound:k-2225_水田.mp3]
[sound:k-2225_水田.mp3]	(water-filled) paddy field<br> <b>水田</b> <br> (すいでん)
<b>職員</b> <br> その病院の職員数が増えました。	[sound:s-2225_その病院の職員数が増えました。.mp3] <br> そのびょういんのしょくいんかずがふえました。 <br>The number of staff at the hospital has increased.
[sound:s-2225_その病院の職員数が増えました。.mp3]	<b>職員</b> <br> その病院の職員数が増えました。<br> そのびょういんのしょくいんかずがふえました <br>The number of staff at the hospital has increased.
水俣病	[sound:k-2226_水俣病.mp3]<br>みなまたびょう <br> Minamata disease
Minamata disease	<b>水俣病<b> <br> みなまたびょう <br>[sound:k-2226_水俣病.mp3]
[sound:k-2226_水俣病.mp3]	Minamata disease<br> <b>水俣病</b> <br> (みなまたびょう)
<b>汚職</b> <br> 政治家が汚職スキャンダルに巻き込まれた。	[sound:s-2226_政治家が汚職スキャンダルに巻き込まれた。.mp3] <br> せいじかがおしょくスキャンダルにまきこまれた。 <br>The politician was involved in a corruption scandal.
[sound:s-2226_政治家が汚職スキャンダルに巻き込まれた。.mp3]	<b>汚職</b> <br> 政治家が汚職スキャンダルに巻き込まれた。<br> せいじかがおしょくスキャンダルにまきこまれた <br>The politician was involved in a corruption scandal.
水産	[sound:k-2227_水産.mp3]<br>すいさん <br> marine products, fisheries
marine products, fisheries	<b>水産<b> <br> すいさん <br>[sound:k-2227_水産.mp3]
[sound:k-2227_水産.mp3]	marine products, fisheries<br> <b>水産</b> <br> (すいさん)
<b>現職</b> <br> 彼は現職の市長です。	[sound:s-2227_彼は現職の市長です。.mp3] <br> かれはげんしょくのしちょうです。 <br>He is the incumbent mayor.
[sound:s-2227_彼は現職の市長です。.mp3]	<b>現職</b> <br> 彼は現職の市長です。<br> かれはげんしょくのしちょうです <br>He is the incumbent mayor.
水質	[sound:k-2228_水質.mp3]<br>すいしつ <br> water quality
water quality	<b>水質<b> <br> すいしつ <br>[sound:k-2228_水質.mp3]
[sound:k-2228_水質.mp3]	water quality<br> <b>水質</b> <br> (すいしつ)
<b>就職</b> <br> 彼女は優秀な企業に就職した。	[sound:s-2228_彼女は優秀な企業に就職した。.mp3] <br> かのじょはゆうしゅうなきぎょうにしゅうしょくした。 <br>She got a job at an excellent company.
[sound:s-2228_彼女は優秀な企業に就職した。.mp3]	<b>就職</b> <br> 彼女は優秀な企業に就職した。<br> かのじょはゆうしゅうなきぎょうにしゅうしょくした <br>She got a job at an excellent company.
下水道	[sound:k-2229_下水道.mp3]<br>げすいどう <br> drain, sewer, drainage system
drain, sewer, drainage system	<b>下水道<b> <br> げすいどう <br>[sound:k-2229_下水道.mp3]
[sound:k-2229_下水道.mp3]	drain, sewer, drainage system<br> <b>下水道</b> <br> (げすいどう)
<b>職業</b> <br> 私の父の職業は医者です。	[sound:s-2229_私の父の職業は医者です。.mp3] <br> わたしのちちのしょくぎょうはいしゃです。 <br>My father's profession is a doctor.
[sound:s-2229_私の父の職業は医者です。.mp3]	<b>職業</b> <br> 私の父の職業は医者です。<br> わたしのちちのしょくぎょうはいしゃです <br>My father's profession is a doctor.
半	[sound:k-2230_半.mp3]<br>はん <br> half
half	<b>半<b> <br> はん <br>[sound:k-2230_半.mp3]
[sound:k-2230_半.mp3]	half<br> <b>半</b> <br> (はん)
<b>職場</b> <br> 彼女は新しい職場で働いています。	[sound:s-2230_彼女は新しい職場で働いています。.mp3] <br> かのじょはあたらしいしょくばではたらいています。 <br>She works at a new workplace.
[sound:s-2230_彼女は新しい職場で働いています。.mp3]	<b>職場</b> <br> 彼女は新しい職場で働いています。<br> かのじょはあたらしいしょくばではたらいています <br>She works at a new workplace.
時半	[sound:k-2231_時半.mp3]<br>じはん <br> about an hour, short time; half past (the hour)
about an hour, short time; half past (the hour)	<b>時半<b> <br> じはん <br>[sound:k-2231_時半.mp3]
[sound:k-2231_時半.mp3]	about an hour, short time; half past<br> <b>the hour) (時半</b> <br> (じはん)
<b>辞職</b> <br> 彼は健康上の理由で辞職した。	[sound:s-2231_彼は健康上の理由で辞職した。.mp3] <br> かれはけんこうじょうのりゆうでじしょくした。 <br>He resigned for health reasons.
[sound:s-2231_彼は健康上の理由で辞職した。.mp3]	<b>辞職</b> <br> 彼は健康上の理由で辞職した。<br> かれはけんこうじょうのりゆうでじしょくした <br>He resigned for health reasons.
後半	[sound:k-2232_後半.mp3]<br>こうはん <br> second half, latter half
second half, latter half	<b>後半<b> <br> こうはん <br>[sound:k-2232_後半.mp3]
[sound:k-2232_後半.mp3]	second half, latter half<br> <b>後半</b> <br> (こうはん)
<b>退職</b> <br> 彼は長年の勤めの後、退職した。	[sound:s-2232_彼は長年の勤めの後、退職した。.mp3] <br> かれはながねんのつとめのあと、たいしょくした。 <br>"After many years of service, he retired."
[sound:s-2232_彼は長年の勤めの後、退職した。.mp3]	<b>退職</b> <br> 彼は長年の勤めの後、退職した。<br> かれはながねんのつとめのあと、たいしょくした <br>After many years of service, he retired.
半ば	[sound:k-2233_半ば.mp3]<br>なかば <br> middle, half, semi, halfway, partly
middle, half, semi, halfway, partly	<b>半ば<b> <br> なかば <br>[sound:k-2233_半ば.mp3]
[sound:k-2233_半ば.mp3]	middle, half, semi, halfway, partly<br> <b>半ば</b> <br> (なかば)
<b>無職</b> <br> 彼は現在無職です。	[sound:s-2233_彼は現在無職です。.mp3] <br> かれはげんざいむしょくです。 <br>He is currently unemployed.
[sound:s-2233_彼は現在無職です。.mp3]	<b>無職</b> <br> 彼は現在無職です。<br> かれはげんざいむしょくです <br>He is currently unemployed.
半分	[sound:k-2234_半分.mp3]<br>はんぶん <br> half
half	<b>半分<b> <br> はんぶん <br>[sound:k-2234_半分.mp3]
[sound:k-2234_半分.mp3]	half<br> <b>半分</b> <br> (はんぶん)
<b>証券</b> <br> 彼は証券会社で働いています。	[sound:s-2234_彼は証券会社で働いています。.mp3] <br> かれはしょうけんがいしゃではたらいています。 <br>He works at a securities firm.
[sound:s-2234_彼は証券会社で働いています。.mp3]	<b>証券</b> <br> 彼は証券会社で働いています。<br> かれはしょうけんがいしゃではたらいています <br>He works at a securities firm.
前半	[sound:k-2235_前半.mp3]<br>ぜんはん, ぜんぱん <br> first half
first half	<b>前半<b> <br> ぜんはん, ぜんぱん <br>[sound:k-2235_前半.mp3]
[sound:k-2235_前半.mp3]	first half<br> <b>前半</b> <br> (ぜんはん, ぜんぱん)
<b>証人</b> <br> 彼は事件の証人として呼ばれた。	[sound:s-2235_彼は事件の証人として呼ばれた。.mp3] <br> かれはじけんのしょうにんとしてよばれた。 <br>He was called as a witness to the incident.
[sound:s-2235_彼は事件の証人として呼ばれた。.mp3]	<b>証人</b> <br> 彼は事件の証人として呼ばれた。<br> かれはじけんのしょうにんとしてよばれた <br>He was called as a witness to the incident.
大半	[sound:k-2236_大半.mp3]<br>たいはん <br> majority, mostly, generally
majority, mostly, generally	<b>大半<b> <br> たいはん <br>[sound:k-2236_大半.mp3]
[sound:k-2236_大半.mp3]	majority, mostly, generally<br> <b>大半</b> <br> (たいはん)
<b>証言</b> <br> 彼の証言は事件の真相を明らかにした。	[sound:s-2236_彼の証言は事件の真相を明らかにした。.mp3] <br> かれのしょうげんはじけんのしんそうをあきらかにした。 <br>His testimony revealed the truth of the incident.
[sound:s-2236_彼の証言は事件の真相を明らかにした。.mp3]	<b>証言</b> <br> 彼の証言は事件の真相を明らかにした。<br> かれのしょうげんはじけんのしんそうをあきらかにした <br>His testimony revealed the truth of the incident.
過半数	[sound:k-2237_過半数.mp3]<br>かはんすう <br> majority
majority	<b>過半数<b> <br> かはんすう <br>[sound:k-2237_過半数.mp3]
[sound:k-2237_過半数.mp3]	majority<br> <b>過半数</b> <br> (かはんすう)
<b>保証</b> <br> その商品には一年間の保証が付いています。	[sound:s-2237_その商品には一年間の保証が付いています。.mp3] <br> そのしょうひんにはいちねんかんのほしょうがついています。 <br>The product comes with a one-year guarantee.
[sound:s-2237_その商品には一年間の保証が付いています。.mp3]	<b>保証</b> <br> その商品には一年間の保証が付いています。<br> そのしょうひんにはいちねんかんのほしょうがついています <br>The product comes with a one-year guarantee.
朝鮮半島	[sound:k-2238_朝鮮半島.mp3]<br>ちょうせんはんとう <br> Korean peninsula
Korean peninsula	<b>朝鮮半島<b> <br> ちょうせんはんとう <br>[sound:k-2238_朝鮮半島.mp3]
[sound:k-2238_朝鮮半島.mp3]	Korean peninsula<br> <b>朝鮮半島</b> <br> (ちょうせんはんとう)
<b>証拠</b> <br> 彼には犯行の証拠がない。	[sound:s-2238_彼には犯行の証拠がない。.mp3] <br> かれにははんこうのしょうこがない。 <br>There is no evidence of his crime.
[sound:s-2238_彼には犯行の証拠がない。.mp3]	<b>証拠</b> <br> 彼には犯行の証拠がない。<br> かれにははんこうのしょうこがない <br>There is no evidence of his crime.
半数	[sound:k-2239_半数.mp3]<br>はんすう <br> half the number; haploid
half the number; haploid	<b>半数<b> <br> はんすう <br>[sound:k-2239_半数.mp3]
[sound:k-2239_半数.mp3]	half the number; haploid<br> <b>半数</b> <br> (はんすう)
<b>証明</b> <br> 彼のアリバイは証明された。	[sound:s-2239_彼のアリバイは証明された。.mp3] <br> かれのありばいはしょうめいされた。 <br>His alibi was verified.
[sound:s-2239_彼のアリバイは証明された。.mp3]	<b>証明</b> <br> 彼のアリバイは証明された。<br> かれのありばいはしょうめいされた <br>His alibi was verified.
作品	[sound:k-2240_作品.mp3]<br>さくひん <br> work (e.g. book, film, composition, etc.), opus, performance, production
work (e.g. book, film, composition, etc.), opus, performance, production	<b>作品<b> <br> さくひん <br>[sound:k-2240_作品.mp3]
[sound:k-2240_作品.mp3]	work<br> <b>e.g. book, film, composition, etc.), opus, performance, production (作品</b> <br> (さくひん)
<b>有価証券</b> <br> 彼は有価証券の取引で成功した。	[sound:s-2240_彼は有価証券の取引で成功した。.mp3] <br> かれはゆうかしょうけんのとりひきでせいこうした。 <br>He succeeded in trading marketable securities.
[sound:s-2240_彼は有価証券の取引で成功した。.mp3]	<b>有価証券</b> <br> 彼は有価証券の取引で成功した。<br> かれはゆうかしょうけんのとりひきでせいこうした <br>He succeeded in trading marketable securities.
商品	[sound:k-2241_商品.mp3]<br>しょうひん <br> commodity, article of commerce, goods, stock, merchandise
commodity, article of commerce, goods, stock, merchandise	<b>商品<b> <br> しょうひん <br>[sound:k-2241_商品.mp3]
[sound:k-2241_商品.mp3]	commodity, article of commerce, goods, stock, merchandise<br> <b>商品</b> <br> (しょうひん)
<b>証書</b> <br> その証書は大切な記念となった。	[sound:s-2241_その証書は大切な記念となった。.mp3] <br> そのしょうしょはたいせつなきねんとなった。 <br>The certificate became an important memento.
[sound:s-2241_その証書は大切な記念となった。.mp3]	<b>証書</b> <br> その証書は大切な記念となった。<br> そのしょうしょはたいせつなきねんとなった <br>The certificate became an important memento.
製品	[sound:k-2242_製品.mp3]<br>せいひん <br> manufactured goods, finished goods, product
manufactured goods, finished goods, product	<b>製品<b> <br> せいひん <br>[sound:k-2242_製品.mp3]
[sound:k-2242_製品.mp3]	manufactured goods, finished goods, product<br> <b>製品</b> <br> (せいひん)
<b>検証</b> <br> 科学的な検証が行われた。	[sound:s-2242_科学的な検証が行われた。.mp3] <br> かがくてきなけんしょうがおこなわれた。 <br>Scientific verification was conducted.
[sound:s-2242_科学的な検証が行われた。.mp3]	<b>検証</b> <br> 科学的な検証が行われた。<br> かがくてきなけんしょうがおこなわれた <br>Scientific verification was conducted.
食品	[sound:k-2243_食品.mp3]<br>しょくひん <br> commodity, foodstuff
commodity, foodstuff	<b>食品<b> <br> しょくひん <br>[sound:k-2243_食品.mp3]
[sound:k-2243_食品.mp3]	commodity, foodstuff<br> <b>食品</b> <br> (しょくひん)
<b>証</b> <br> 彼の証は事件の真相を明らかにした。	[sound:s-2243_彼の証は事件の真相を明らかにした。.mp3] <br> かれのあかしはじけんのしんそうをあきらかにした。 <br>His testimony revealed the truth of the incident.
[sound:s-2243_彼の証は事件の真相を明らかにした。.mp3]	<b>証</b> <br> 彼の証は事件の真相を明らかにした。<br> かれのあかしはじけんのしんそうをあきらかにした <br>His testimony revealed the truth of the incident.
部品	[sound:k-2244_部品.mp3]<br>ぶひん <br> parts, accessories
parts, accessories	<b>部品<b> <br> ぶひん <br>[sound:k-2244_部品.mp3]
[sound:k-2244_部品.mp3]	parts, accessories<br> <b>部品</b> <br> (ぶひん)
<b>土</b> <br> この土は肥沃です。	[sound:s-2244_この土は肥沃です。.mp3] <br> このつちはひよくです。 <br>This soil is fertile.
[sound:s-2244_この土は肥沃です。.mp3]	<b>土</b> <br> この土は肥沃です。<br> このつちはひよくです <br>This soil is fertile.
医薬品	[sound:k-2245_医薬品.mp3]<br>いやくひん <br> medical supplies
medical supplies	<b>医薬品<b> <br> いやくひん <br>[sound:k-2245_医薬品.mp3]
[sound:k-2245_医薬品.mp3]	medical supplies<br> <b>医薬品</b> <br> (いやくひん)
<b>土地</b> <br> 彼は自分の土地に家を建てた。	[sound:s-2245_彼は自分の土地に家を建てた。.mp3] <br> かれはじぶんのとちにいえをたてた。 <br>He built a house on his own land.
[sound:s-2245_彼は自分の土地に家を建てた。.mp3]	<b>土地</b> <br> 彼は自分の土地に家を建てた。<br> かれはじぶんのとちにいえをたてた <br>He built a house on his own land.
品質	[sound:k-2246_品質.mp3]<br>ひんしつ <br> (material) quality
(material) quality	<b>品質<b> <br> ひんしつ <br>[sound:k-2246_品質.mp3]
[sound:k-2246_品質.mp3]	(material) quality<br> <b>品質</b> <br> (ひんしつ)
<b>領土</b> <br> その国は領土を拡大した。	[sound:s-2246_その国は領土を拡大した。.mp3] <br> そのくにはりょうどをかくだいした。 <br>The country expanded its territory.
[sound:s-2246_その国は領土を拡大した。.mp3]	<b>領土</b> <br> その国は領土を拡大した。<br> そのくにはりょうどをかくだいした <br>The country expanded its territory.
用品	[sound:k-2247_用品.mp3]<br>ようひん <br> articles, supplies, parts
articles, supplies, parts	<b>用品<b> <br> ようひん <br>[sound:k-2247_用品.mp3]
[sound:k-2247_用品.mp3]	articles, supplies, parts<br> <b>用品</b> <br> (ようひん)
<b>土曜</b> <br> 土曜日には友達と遊ぶ予定です。	[sound:s-2247_土曜日には友達と遊ぶ予定です。.mp3] <br> どようびにはともだちとあそぶよていです。 <br>I have plans to hang out with friends on Saturday.
[sound:s-2247_土曜日には友達と遊ぶ予定です。.mp3]	<b>土曜</b> <br> 土曜日には友達と遊ぶ予定です。<br> どようびにはともだちとあそぶよていです <br>I have plans to hang out with friends on Saturday.
品種	[sound:k-2248_品種.mp3]<br>ひんしゅ <br> kind (of goods), brand; (taxonomical) form; breed, cultivar
kind (of goods), brand; (taxonomical) form; breed, cultivar	<b>品種<b> <br> ひんしゅ <br>[sound:k-2248_品種.mp3]
[sound:k-2248_品種.mp3]	kind<br> <b>of goods), brand; (taxonomical) form; breed, cultivar (品種</b> <br> (ひんしゅ)
<b>国土</b> <br> この国土は多様な文化で育まれてきた。	[sound:s-2248_この国土は多様な文化で育まれてきた。.mp3] <br> このこくどはたようなぶんかではぐまれてきた。 <br>This homeland has been nurtured by diverse cultures.
[sound:s-2248_この国土は多様な文化で育まれてきた。.mp3]	<b>国土</b> <br> この国土は多様な文化で育まれてきた。<br> このこくどはたようなぶんかではぐまれてきた <br>This homeland has been nurtured by diverse cultures.
品目	[sound:k-2249_品目.mp3]<br>ひんもく <br> list of articles
list of articles	<b>品目<b> <br> ひんもく <br>[sound:k-2249_品目.mp3]
[sound:k-2249_品目.mp3]	list of articles<br> <b>品目</b> <br> (ひんもく)
<b>土俵</b> <br> 土俵の上で力士が激闘を繰り広げる。	[sound:s-2249_土俵の上で力士が激闘を繰り広げる。.mp3] <br> どひょうのうえでりきしはげきとうをくりひろげる。 <br>Sumo wrestlers engage in fierce battles on the sumo ring.
[sound:s-2249_土俵の上で力士が激闘を繰り広げる。.mp3]	<b>土俵</b> <br> 土俵の上で力士が激闘を繰り広げる。<br> どひょうのうえでりきしはげきとうをくりひろげる <br>Sumo wrestlers engage in fierce battles on the sumo ring.
昨年	[sound:k-2250_昨年.mp3]<br>さくねん <br> last year
last year	<b>昨年<b> <br> さくねん <br>[sound:k-2250_昨年.mp3]
[sound:k-2250_昨年.mp3]	last year<br> <b>昨年</b> <br> (さくねん)
<b>土木</b> <br> 彼は土木工学を専攻しています。	[sound:s-2250_彼は土木工学を専攻しています。.mp3] <br> かれはどぼくこうがくをせんこうしています。 <br>He is majoring in civil engineering.
[sound:s-2250_彼は土木工学を専攻しています。.mp3]	<b>土木</b> <br> 彼は土木工学を専攻しています。<br> かれはどぼくこうがくをせんこうしています <br>He is majoring in civil engineering.
一昨年	[sound:k-2251_一昨年.mp3]<br>いっさくねん, おととし <br> year before last
year before last	<b>一昨年<b> <br> いっさくねん, おととし <br>[sound:k-2251_一昨年.mp3]
[sound:k-2251_一昨年.mp3]	year before last<br> <b>一昨年</b> <br> (いっさくねん, おととし)
<b>全土</b> <br> 洪水が全土を覆った。	[sound:s-2251_洪水が全土を覆った。.mp3] <br> こうずいがぜんどをおおった。 <br>The flood covered the entire land.
[sound:s-2251_洪水が全土を覆った。.mp3]	<b>全土</b> <br> 洪水が全土を覆った。<br> こうずいがぜんどをおおった <br>The flood covered the entire land.
昨秋	[sound:k-2252_昨秋.mp3]<br>さくしゅう <br> autumn of last year, fall of last year
autumn of last year, fall of last year	<b>昨秋<b> <br> さくしゅう <br>[sound:k-2252_昨秋.mp3]
[sound:k-2252_昨秋.mp3]	autumn of last year, fall of last year<br> <b>昨秋</b> <br> (さくしゅう)
<b>土壌</b> <br> 土壌の状態が作物の収穫に影響する。	[sound:s-2252_土壌の状態が作物の収穫に影響する。.mp3] <br> どじょうのじょうたいがさくもつのしゅうかくにえいきょうする。 <br>The condition of the soil affects the harvest of crops.
[sound:s-2252_土壌の状態が作物の収穫に影響する。.mp3]	<b>土壌</b> <br> 土壌の状態が作物の収穫に影響する。<br> どじょうのじょうたいがさくもつのしゅうかくにえいきょうする <br>The condition of the soil affects the harvest of crops.
昨年度	[sound:k-2253_昨年度.mp3]<br>さくねんど <br> previous fiscal year
previous fiscal year	<b>昨年度<b> <br> さくねんど <br>[sound:k-2253_昨年度.mp3]
[sound:k-2253_昨年度.mp3]	previous fiscal year<br> <b>昨年度</b> <br> (さくねんど)
<b>風土</b> <br> この地域の風土は異なる。	[sound:s-2253_この地域の風土は異なる。.mp3] <br> このちいきのふうどはことなる。 <br>The climate and culture of this region are different.
[sound:s-2253_この地域の風土は異なる。.mp3]	<b>風土</b> <br> この地域の風土は異なる。<br> このちいきのふうどはことなる <br>The climate and culture of this region are different.
昨春	[sound:k-2254_昨春.mp3]<br>さくしゅん <br> last spring, the spring of last year
last spring, the spring of last year	<b>昨春<b> <br> さくしゅん <br>[sound:k-2254_昨春.mp3]
