<b>権力</b> <br> 権力を乱用することは許されません。	[sound:s-3381_権力を乱用することは許されません。.mp3] <br> けんりょくをらんようすることはゆるされません。 <br>Abuse of power is not allowed.
[sound:s-3381_権力を乱用することは許されません。.mp3]	<b>権力</b> <br> 権力を乱用することは許されません。<br> けんりょくをらんようすることはゆるされません <br>Abuse of power is not allowed.
井戸	[sound:k-3382_井戸.mp3]<br>いど <br> water well
water well	<b>井戸<b> <br> いど <br>[sound:k-3382_井戸.mp3]
[sound:k-3382_井戸.mp3]	water well<br> <b>井戸</b> <br> (いど)
<b>原子力</b> <br> 原子力発電は多くの国で利用されています。	[sound:s-3382_原子力発電は多くの国で利用されています。.mp3] <br> げんしりょくはつでんはおおくのくにでりようされています。 <br>Nuclear power generation is used in many countries.
[sound:s-3382_原子力発電は多くの国で利用されています。.mp3]	<b>原子力</b> <br> 原子力発電は多くの国で利用されています。<br> げんしりょくはつでんはおおくのくにでりようされています <br>Nuclear power generation is used in many countries.
油井	[sound:k-3383_油井.mp3]<br>ゆせい <br> oil well
oil well	<b>油井<b> <br> ゆせい <br>[sound:k-3383_油井.mp3]
[sound:k-3383_油井.mp3]	oil well<br> <b>油井</b> <br> (ゆせい)
<b>実力</b> <br> 彼は実力を証明しました。	[sound:s-3383_彼は実力を証明しました。.mp3] <br> かれはじつりょくをしょうめいしました。 <br>He proved his capability.
[sound:s-3383_彼は実力を証明しました。.mp3]	<b>実力</b> <br> 彼は実力を証明しました。<br> かれはじつりょくをしょうめいしました <br>He proved his capability.
筒井	[sound:k-3384_筒井.mp3]<br>つつい <br> round well
round well	<b>筒井<b> <br> つつい <br>[sound:k-3384_筒井.mp3]
[sound:k-3384_筒井.mp3]	round well<br> <b>筒井</b> <br> (つつい)
<b>能力</b> <br> 彼女は多才な能力を持っています。	[sound:s-3384_彼女は多才な能力を持っています。.mp3] <br> かのじょはたさいなのうりょくをもっています。 <br>She has versatile abilities.
[sound:s-3384_彼女は多才な能力を持っています。.mp3]	<b>能力</b> <br> 彼女は多才な能力を持っています。<br> かのじょはたさいなのうりょくをもっています <br>She has versatile abilities.
井戸掘り	[sound:k-3385_井戸掘り.mp3]<br>いどほり <br> well digging, well digger
well digging, well digger	<b>井戸掘り<b> <br> いどほり <br>[sound:k-3385_井戸掘り.mp3]
[sound:k-3385_井戸掘り.mp3]	well digging, well digger<br> <b>井戸掘り</b> <br> (いどほり)
<b>武力</b> <br> 戦争は武力で解決するべきではありません。	[sound:s-3385_戦争は武力で解決するべきではありません。.mp3] <br> せんそうはぶりょくでかいけつするべきではありません。 <br>Wars should not be resolved by force.
[sound:s-3385_戦争は武力で解決するべきではありません。.mp3]	<b>武力</b> <br> 戦争は武力で解決するべきではありません。<br> せんそうはぶりょくでかいけつするべきではありません <br>Wars should not be resolved by force.
井筒	[sound:k-3386_井筒.mp3]<br>いづつ <br> well crib
well crib	<b>井筒<b> <br> いづつ <br>[sound:k-3386_井筒.mp3]
[sound:k-3386_井筒.mp3]	well crib<br> <b>井筒</b> <br> (いづつ)
<b>暴力団</b> <br> 暴力団の活動が厳しく取り締まられています。	[sound:s-3386_暴力団の活動が厳しく取り締まられています。.mp3] <br> ぼうりょくだんのかつどうがきびしくとりしまられています。 <br>Activities of organized crime groups are strictly regulated.
[sound:s-3386_暴力団の活動が厳しく取り締まられています。.mp3]	<b>暴力団</b> <br> 暴力団の活動が厳しく取り締まられています。<br> ぼうりょくだんのかつどうがきびしくとりしまられています <br>Activities of organized crime groups are strictly regulated.
市井	[sound:k-3387_市井.mp3]<br>しせい <br> the street, the town
the street, the town	<b>市井<b> <br> しせい <br>[sound:k-3387_市井.mp3]
[sound:k-3387_市井.mp3]	the street, the town<br> <b>市井</b> <br> (しせい)
<b>有力</b> <br> その政治家は有力な支持を得ています。	[sound:s-3387_その政治家は有力な支持を得ています。.mp3] <br> そのせいじかはゆうりょくなしべをえています。 <br>The politician has gained strong support.
[sound:s-3387_その政治家は有力な支持を得ています。.mp3]	<b>有力</b> <br> その政治家は有力な支持を得ています。<br> そのせいじかはゆうりょくなしべをえています <br>The politician has gained strong support.
井戸水	[sound:k-3388_井戸水.mp3]<br>いどみず <br> well water
well water	<b>井戸水<b> <br> いどみず <br>[sound:k-3388_井戸水.mp3]
[sound:k-3388_井戸水.mp3]	well water<br> <b>井戸水</b> <br> (いどみず)
<b>学校</b> <br> 学校が明日から夏休みです。	[sound:s-3388_学校が明日から夏休みです。.mp3] <br> がっこうがあしたからなつやすみです。 <br>School will be on summer vacation starting tomorrow.
[sound:s-3388_学校が明日から夏休みです。.mp3]	<b>学校</b> <br> 学校が明日から夏休みです。<br> がっこうがあしたからなつやすみです <br>School will be on summer vacation starting tomorrow.
井戸端会議	[sound:k-3389_井戸端会議.mp3]<br>いどばたかいぎ <br> content-free chat, idle gossip
content-free chat, idle gossip	<b>井戸端会議<b> <br> いどばたかいぎ <br>[sound:k-3389_井戸端会議.mp3]
[sound:k-3389_井戸端会議.mp3]	content-free chat, idle gossip<br> <b>井戸端会議</b> <br> (いどばたかいぎ)
<b>学生</b> <br> 彼は大学の学生です。	[sound:s-3389_彼は大学の学生です。.mp3] <br> かれはだいがくのがくせいです。 <br>He is a university student.
[sound:s-3389_彼は大学の学生です。.mp3]	<b>学生</b> <br> 彼は大学の学生です。<br> かれはだいがくのがくせいです <br>He is a university student.
何	[sound:k-3390_何.mp3]<br>なに, なん <br> what; how many (some counter); euph. for genitals or sex
what; how many (some counter); euph. for genitals or sex	<b>何<b> <br> なに, なん <br>[sound:k-3390_何.mp3]
[sound:k-3390_何.mp3]	what; how many<br> <b>some counter); euph. for genitals or sex (何</b> <br> (なに, なん)
<b>大学</b> <br> 私の妹は有名な大学に通っています。	[sound:s-3390_私の妹は有名な大学に通っています。.mp3] <br> わたしのいもうとはゆうめいなだいがくにかよっています。 <br>My sister attends a famous university.
[sound:s-3390_私の妹は有名な大学に通っています。.mp3]	<b>大学</b> <br> 私の妹は有名な大学に通っています。<br> わたしのいもうとはゆうめいなだいがくにかよっています <br>My sister attends a famous university.
何か	[sound:k-3391_何か.mp3]<br>なにか, なんか <br> something
something	<b>何か<b> <br> なにか, なんか <br>[sound:k-3391_何か.mp3]
[sound:k-3391_何か.mp3]	something<br> <b>何か</b> <br> (なにか, なんか)
<b>医学</b> <br> 医学の勉強は難しいですが、やりがいがあります。	[sound:s-3391_医学の勉強は難しいですが、やりがいがあります。.mp3] <br> いがくのべんきょうはむずかしいですが、やりがいがあります。 <br>Studying medicine is challenging but rewarding.
[sound:s-3391_医学の勉強は難しいですが、やりがいがあります。.mp3]	<b>医学</b> <br> 医学の勉強は難しいですが、やりがいがあります。<br> いがくのべんきょうはむずかしいですが、やりがいがあります <br>Studying medicine is challenging but rewarding.
何も	[sound:k-3392_何も.mp3]<br>なにも <br> nothing (with neg. verbs), not any; and everything else (with noun plus "mo"), all
nothing (with neg. verbs), not any; and everything else (with noun plus "mo"), all	<b>何も<b> <br> なにも <br>[sound:k-3392_何も.mp3]
[sound:k-3392_何も.mp3]	nothing<br> <b>with neg. verbs), not any; and everything else (with noun plus "mo"), all (何も</b> <br> (なにも)
<b>科学</b> <br> 科学の進歩が人類の生活を変えました。	[sound:s-3392_科学の進歩が人類の生活を変えました。.mp3] <br> かがくのしんぽがじんるいのせいかつをかえました。 <br>Scientific advancements have changed human life.
[sound:s-3392_科学の進歩が人類の生活を変えました。.mp3]	<b>科学</b> <br> 科学の進歩が人類の生活を変えました。<br> かがくのしんぽがじんるいのせいかつをかえました <br>Scientific advancements have changed human life.
何とか	[sound:k-3393_何とか.mp3]<br>なんとか <br> something, something or other, so-and-so; somehow, anyhow, one way or another
something, something or other, so-and-so; somehow, anyhow, one way or another	<b>何とか<b> <br> なんとか <br>[sound:k-3393_何とか.mp3]
[sound:k-3393_何とか.mp3]	something, something or other, so-and-so; somehow, anyhow, one way or another<br> <b>何とか</b> <br> (なんとか)
<b>学部</b> <br> 彼は心理学部に所属しています。	[sound:s-3393_彼は心理学部に所属しています。.mp3] <br> かれはしんりがくぶにしょぞくしています。 <br>He belongs to the psychology department.
[sound:s-3393_彼は心理学部に所属しています。.mp3]	<b>学部</b> <br> 彼は心理学部に所属しています。<br> かれはしんりがくぶにしょぞくしています <br>He belongs to the psychology department.
何の	[sound:k-3394_何の.mp3]<br>どの <br> which, what (way)
which, what (way)	<b>何の<b> <br> どの <br>[sound:k-3394_何の.mp3]
[sound:k-3394_何の.mp3]	which, what<br> <b>way) (何の</b> <br> (どの)
<b>文学</b> <br> 彼は文学に興味を持っています。	[sound:s-3394_彼は文学に興味を持っています。.mp3] <br> かれはぶんがくにきょうみをもっています。 <br>He is interested in literature.
[sound:s-3394_彼は文学に興味を持っています。.mp3]	<b>文学</b> <br> 彼は文学に興味を持っています。<br> かれはぶんがくにきょうみをもっています <br>He is interested in literature.
何より	[sound:k-3395_何より.mp3]<br>なにより <br> most, best, above all
most, best, above all	<b>何より<b> <br> なにより <br>[sound:k-3395_何より.mp3]
[sound:k-3395_何より.mp3]	most, best, above all<br> <b>何より</b> <br> (なにより)
<b>学</b> <br> 学び続けることは重要です。	[sound:s-3395_学び続けることは重要です。.mp3] <br> まなびつづけることはじゅうようです。 <br>Continuous learning is important.
[sound:s-3395_学び続けることは重要です。.mp3]	<b>学</b> <br> 学び続けることは重要です。<br> まなびつづけることはじゅうようです <br>Continuous learning is important.
何でも	[sound:k-3396_何でも.mp3]<br>なんでも <br> any, whatever one likes, by all means, anything, everything
any, whatever one likes, by all means, anything, everything	<b>何でも<b> <br> なんでも <br>[sound:k-3396_何でも.mp3]
[sound:k-3396_何でも.mp3]	any, whatever one likes, by all means, anything, everything<br> <b>何でも</b> <br> (なんでも)
<b>学園</b> <br> 彼女は音楽学園で勉強しています。	[sound:s-3396_彼女は音楽学園で勉強しています。.mp3] <br> かのじょはおんがくがくえんでべんきょうしています。 <br>She studies at a music academy.
[sound:s-3396_彼女は音楽学園で勉強しています。.mp3]	<b>学園</b> <br> 彼女は音楽学園で勉強しています。<br> かのじょはおんがくがくえんでべんきょうしています <br>She studies at a music academy.
何度	[sound:k-3397_何度.mp3]<br>なんど <br> how many times?, how often?
how many times?, how often?	<b>何度<b> <br> なんど <br>[sound:k-3397_何度.mp3]
[sound:k-3397_何度.mp3]	how many times?, how often?<br> <b>何度</b> <br> (なんど)
<b>学者</b> <br> 彼は有名な科学者です。	[sound:s-3397_彼は有名な科学者です。.mp3] <br> かれはゆうめいなかがくしゃです。 <br>He is a famous scientist.
[sound:s-3397_彼は有名な科学者です。.mp3]	<b>学者</b> <br> 彼は有名な科学者です。<br> かれはゆうめいなかがくしゃです <br>He is a famous scientist.
何と	[sound:k-3398_何と.mp3]<br>なんと <br> what, how, whatever
what, how, whatever	<b>何と<b> <br> なんと <br>[sound:k-3398_何と.mp3]
[sound:k-3398_何と.mp3]	what, how, whatever<br> <b>何と</b> <br> (なんと)
<b>問う</b> <br> その問題について議論しましょう。	[sound:s-3398_その問題について議論しましょう。.mp3] <br> そのもんだいについてぎろんしましょう。 <br>Let's discuss the issue.
[sound:s-3398_その問題について議論しましょう。.mp3]	<b>問う</b> <br> その問題について議論しましょう。<br> そのもんだいについてぎろんしましょう <br>Let's discuss the issue.
何とも	[sound:k-3399_何とも.mp3]<br>なんとも <br> nothing (with neg. verb), quite, not a bit
nothing (with neg. verb), quite, not a bit	<b>何とも<b> <br> なんとも <br>[sound:k-3399_何とも.mp3]
[sound:k-3399_何とも.mp3]	nothing<br> <b>with neg. verb), quite, not a bit (何とも</b> <br> (なんとも)
<b>問</b> <br> 問は質問の意味です。	[sound:s-3399_問は質問の意味です。.mp3] <br> もんはしつもんのいみです。 <br>Question means a query.
[sound:s-3399_問は質問の意味です。.mp3]	<b>問</b> <br> 問は質問の意味です。<br> もんはしつもんのいみです <br>Question means a query.
南	[sound:k-3400_南.mp3]<br>みなみ <br> south
south	<b>南<b> <br> みなみ <br>[sound:k-3400_南.mp3]
[sound:k-3400_南.mp3]	south<br> <b>南</b> <br> (みなみ)
<b>質問</b> <br> 会議で質問をする機会があります。	[sound:s-3400_会議で質問をする機会があります。.mp3] <br> かいぎでしつもんをするきかいがあります。 <br>There will be an opportunity to ask questions at the meeting.
[sound:s-3400_会議で質問をする機会があります。.mp3]	<b>質問</b> <br> 会議で質問をする機会があります。<br> かいぎでしつもんをするきかいがあります <br>There will be an opportunity to ask questions at the meeting.
南アフリカ	[sound:k-3401_南アフリカ.mp3]<br>みなみアフリカ <br> South Africa
South Africa	<b>南アフリカ<b> <br> みなみアフリカ <br>[sound:k-3401_南アフリカ.mp3]
[sound:k-3401_南アフリカ.mp3]	South Africa<br> <b>南アフリカ</b> <br> (みなみアフリカ)
<b>訪問</b> <br> 彼は友人を訪問しました。	[sound:s-3401_彼は友人を訪問しました。.mp3] <br> かれはゆうじんをほうもんしました。 <br>He visited a friend.
[sound:s-3401_彼は友人を訪問しました。.mp3]	<b>訪問</b> <br> 彼は友人を訪問しました。<br> かれはゆうじんをほうもんしました <br>He visited a friend.
南北	[sound:k-3402_南北.mp3]<br>なんぼく <br> south and north
south and north	<b>南北<b> <br> なんぼく <br>[sound:k-3402_南北.mp3]
[sound:k-3402_南北.mp3]	south and north<br> <b>南北</b> <br> (なんぼく)
<b>問題</b> <br> この問題について解決策を見つけなければなりません。	[sound:s-3402_この問題について解決策を見つけなければなりません。.mp3] <br> このもんだいについてかいけつさくをみつけなければなりません。 <br>We must find a solution to this problem.
[sound:s-3402_この問題について解決策を見つけなければなりません。.mp3]	<b>問題</b> <br> この問題について解決策を見つけなければなりません。<br> このもんだいについてかいけつさくをみつけなければなりません <br>We must find a solution to this problem.
東南	[sound:k-3403_東南.mp3]<br>とうなん, ひがしみなみ <br> south-east
south-east	<b>東南<b> <br> とうなん, ひがしみなみ <br>[sound:k-3403_東南.mp3]
[sound:k-3403_東南.mp3]	south-east<br> <b>東南</b> <br> (とうなん, ひがしみなみ)
<b>問い合わせ</b> <br> 詳細について問い合わせました。	[sound:s-3403_詳細について問い合わせました。.mp3] <br> しょうさいについてといあわせました。 <br>I inquired about the details.
[sound:s-3403_詳細について問い合わせました。.mp3]	<b>問い合わせ</b> <br> 詳細について問い合わせました。<br> しょうさいについてといあわせました <br>I inquired about the details.
南部	[sound:k-3404_南部.mp3]<br>なんぶ <br> southern part
southern part	<b>南部<b> <br> なんぶ <br>[sound:k-3404_南部.mp3]
[sound:k-3404_南部.mp3]	southern part<br> <b>南部</b> <br> (なんぶ)
<b>喚問</b> <br> 彼は警察に喚問されました。	[sound:s-3404_彼は警察に喚問されました。.mp3] <br> かれはけいさつにかんもんされました。 <br>He was summoned by the police.
[sound:s-3404_彼は警察に喚問されました。.mp3]	<b>喚問</b> <br> 彼は警察に喚問されました。<br> かれはけいさつにかんもんされました <br>He was summoned by the police.
南西	[sound:k-3405_南西.mp3]<br>なんせい, みなみにし <br> southwest
southwest	<b>南西<b> <br> なんせい, みなみにし <br>[sound:k-3405_南西.mp3]
[sound:k-3405_南西.mp3]	southwest<br> <b>南西</b> <br> (なんせい, みなみにし)
<b>疑問</b> <br> 彼の行動には疑問が残ります。	[sound:s-3405_彼の行動には疑問が残ります。.mp3] <br> かれのこうどうにはぎもんがのこります。 <br>There are doubts about his actions.
[sound:s-3405_彼の行動には疑問が残ります。.mp3]	<b>疑問</b> <br> 彼の行動には疑問が残ります。<br> かれのこうどうにはぎもんがのこります <br>There are doubts about his actions.
中南米	[sound:k-3406_中南米.mp3]<br>ちゅうなんべい <br> Central and South America
Central and South America	<b>中南米<b> <br> ちゅうなんべい <br>[sound:k-3406_中南米.mp3]
[sound:k-3406_中南米.mp3]	Central and South America<br> <b>中南米</b> <br> (ちゅうなんべい)
<b>顧問</b> <br> 彼は弁護士の顧問です。	[sound:s-3406_彼は弁護士の顧問です。.mp3] <br> かれはべんごしのこもんです。 <br>He is a legal advisor.
[sound:s-3406_彼は弁護士の顧問です。.mp3]	<b>顧問</b> <br> 彼は弁護士の顧問です。<br> かれはべんごしのこもんです <br>He is a legal advisor.
南米	[sound:k-3407_南米.mp3]<br>なんべい <br> South America
South America	<b>南米<b> <br> なんべい <br>[sound:k-3407_南米.mp3]
[sound:k-3407_南米.mp3]	South America<br> <b>南米</b> <br> (なんべい)
<b>問い</b> <br> 彼は彼女に問いを提出しました。	[sound:s-3407_彼は彼女に問いを提出しました。.mp3] <br> かれはかのじょにといをていしゅつしました。 <br>He submitted a question to her.
[sound:s-3407_彼は彼女に問いを提出しました。.mp3]	<b>問い</b> <br> 彼は彼女に問いを提出しました。<br> かれはかのじょにといをていしゅつしました <br>He submitted a question to her.
南極	[sound:k-3408_南極.mp3]<br>なんきょく <br> South Pole; the Antarctic, Antarctica
South Pole; the Antarctic, Antarctica	<b>南極<b> <br> なんきょく <br>[sound:k-3408_南極.mp3]
[sound:k-3408_南極.mp3]	South Pole; the Antarctic, Antarctica<br> <b>南極</b> <br> (なんきょく)
<b>高さ</b> <br> この山の高さは3000メートルです。	[sound:s-3408_この山の高さは3000メートルです。.mp3] <br> このやまのたかさは3000めーとるです。 <br>The height of this mountain is 3000 meters.
[sound:s-3408_この山の高さは3000メートルです。.mp3]	<b>高さ</b> <br> この山の高さは3000メートルです。<br> このやまのたかさは3000めーとるです <br>The height of this mountain is 3000 meters.
南東	[sound:k-3409_南東.mp3]<br>なんとう, みなみひがし <br> southeast
southeast	<b>南東<b> <br> なんとう, みなみひがし <br>[sound:k-3409_南東.mp3]
[sound:k-3409_南東.mp3]	southeast<br> <b>南東</b> <br> (なんとう, みなみひがし)
<b>高校</b> <br> 彼は高校で野球をしています。	[sound:s-3409_彼は高校で野球をしています。.mp3] <br> かれはこうこうでやきゅうをしています。 <br>He plays baseball in high school.
[sound:s-3409_彼は高校で野球をしています。.mp3]	<b>高校</b> <br> 彼は高校で野球をしています。<br> かれはこうこうでやきゅうをしています <br>He plays baseball in high school.
石	[sound:k-3410_石.mp3]<br>こく <br> measure of volume (approx. 180.39 liters, 6.37 cub. ft.); measure of a Japanese-style boat's loading capacity (approx. 278.26 liters)
measure of volume (approx. 180.39 liters, 6.37 cub. ft.); measure of a Japanese-style boat's loading capacity (approx. 278.26 liters)	<b>石<b> <br> こく <br>[sound:k-3410_石.mp3]
[sound:k-3410_石.mp3]	measure of volume<br> <b>approx. 180.39 liters, 6.37 cub. ft.); measure of a Japanese-style boat's loading capacity (approx. 278.26 liters) (石</b> <br> (こく)
<b>最高</b> <br> 今日の天気は最高です。	[sound:s-3410_今日の天気は最高です。.mp3] <br> きょうのてんきはさいこうです。 <br>Today's weather is excellent.
[sound:s-3410_今日の天気は最高です。.mp3]	<b>最高</b> <br> 今日の天気は最高です。<br> きょうのてんきはさいこうです <br>Today's weather is excellent.
石油	[sound:k-3411_石油.mp3]<br>せきゆ <br> oil, petroleum, kerosene
oil, petroleum, kerosene	<b>石油<b> <br> せきゆ <br>[sound:k-3411_石油.mp3]
[sound:k-3411_石油.mp3]	oil, petroleum, kerosene<br> <b>石油</b> <br> (せきゆ)
<b>円高</b> <br> 円高の影響で輸出が減少しました。	[sound:s-3411_円高の影響で輸出が減少しました。.mp3] <br> えんたかのえいきょうでゆしゅつがけんしょうしました。 <br>"Due to the yen's strength, exports decreased."
[sound:s-3411_円高の影響で輸出が減少しました。.mp3]	<b>円高</b> <br> 円高の影響で輸出が減少しました。<br> えんたかのえいきょうでゆしゅつがけんしょうしました <br>Due to the yen's strength, exports decreased.
化石	[sound:k-3412_化石.mp3]<br>かせき <br> fossil, petrifaction, fossilization, fossilisation
fossil, petrifaction, fossilization, fossilisation	<b>化石<b> <br> かせき <br>[sound:k-3412_化石.mp3]
[sound:k-3412_化石.mp3]	fossil, petrifaction, fossilization, fossilisation<br> <b>化石</b> <br> (かせき)
<b>高</b> <br> 山の頂上は高いです。	[sound:s-3412_山の頂上は高いです。.mp3] <br> やまのちょうじょうはたかいです。 <br>The mountain top is high.
[sound:s-3412_山の頂上は高いです。.mp3]	<b>高</b> <br> 山の頂上は高いです。<br> やまのちょうじょうはたかいです <br>The mountain top is high.
石炭	[sound:k-3413_石炭.mp3]<br>せきたん <br> coal
coal	<b>石炭<b> <br> せきたん <br>[sound:k-3413_石炭.mp3]
[sound:k-3413_石炭.mp3]	coal<br> <b>石炭</b> <br> (せきたん)
<b>高い</b> <br> この建物は高いです。	[sound:s-3413_この建物は高いです。.mp3] <br> このたてものはたかいです。 <br>This building is tall.
[sound:s-3413_この建物は高いです。.mp3]	<b>高い</b> <br> この建物は高いです。<br> このたてものはたかいです <br>This building is tall.
石橋	[sound:k-3414_石橋.mp3]<br>いしばし, せっきょう <br> stone bridge
stone bridge	<b>石橋<b> <br> いしばし, せっきょう <br>[sound:k-3414_石橋.mp3]
[sound:k-3414_石橋.mp3]	stone bridge<br> <b>石橋</b> <br> (いしばし, せっきょう)
<b>高まる</b> <br> 期待が高まっています。	[sound:s-3414_期待が高まっています。.mp3] <br> きたいがたかまっています。 <br>Expectations are rising.
[sound:s-3414_期待が高まっています。.mp3]	<b>高まる</b> <br> 期待が高まっています。<br> きたいがたかまっています <br>Expectations are rising.
宝石	[sound:k-3415_宝石.mp3]<br>ほうせき <br> gem, jewel
gem, jewel	<b>宝石<b> <br> ほうせき <br>[sound:k-3415_宝石.mp3]
[sound:k-3415_宝石.mp3]	gem, jewel<br> <b>宝石</b> <br> (ほうせき)
<b>高官</b> <br> 彼は政府の高官です。	[sound:s-3415_彼は政府の高官です。.mp3] <br> かれはせいふのこうかんです。 <br>He is a high-ranking government official.
[sound:s-3415_彼は政府の高官です。.mp3]	<b>高官</b> <br> 彼は政府の高官です。<br> かれはせいふのこうかんです <br>He is a high-ranking government official.
石垣	[sound:k-3416_石垣.mp3]<br>いしがき <br> stone wall
stone wall	<b>石垣<b> <br> いしがき <br>[sound:k-3416_石垣.mp3]
[sound:k-3416_石垣.mp3]	stone wall<br> <b>石垣</b> <br> (いしがき)
<b>高校生</b> <br> 私は高校生の頃、野球部に所属していました。	[sound:s-3416_私は高校生の頃、野球部に所属していました。.mp3] <br> わたしはこうこうせいのころ、やきゅうぶにしょぞくしていました。 <br>"When I was in high school, I belonged to the baseball club."
[sound:s-3416_私は高校生の頃、野球部に所属していました。.mp3]	<b>高校生</b> <br> 私は高校生の頃、野球部に所属していました。<br> わたしはこうこうせいのころ、やきゅうぶにしょぞくしていました <br>When I was in high school, I belonged to the baseball club.
土石	[sound:k-3417_土石.mp3]<br>どせき <br> earth and stones
earth and stones	<b>土石<b> <br> どせき <br>[sound:k-3417_土石.mp3]
[sound:k-3417_土石.mp3]	earth and stones<br> <b>土石</b> <br> (どせき)
<b>高齢</b> <br> 彼の祖母は高齢ですが、元気です。	[sound:s-3417_彼の祖母は高齢ですが、元気です。.mp3] <br> かれのそぼはこうれいですが、げんきです。 <br>His grandmother is elderly but healthy.
[sound:s-3417_彼の祖母は高齢ですが、元気です。.mp3]	<b>高齢</b> <br> 彼の祖母は高齢ですが、元気です。<br> かれのそぼはこうれいですが、げんきです <br>His grandmother is elderly but healthy.
布石	[sound:k-3418_布石.mp3]<br>ふせき <br> strategic arrangement of go stones, preparation
strategic arrangement of go stones, preparation	<b>布石<b> <br> ふせき <br>[sound:k-3418_布石.mp3]
[sound:k-3418_布石.mp3]	strategic arrangement of go stones, preparation<br> <b>布石</b> <br> (ふせき)
<b>代わり</b> <br> 彼は私の代わりに会議に出席しました。	[sound:s-3418_彼は私の代わりに会議に出席しました。.mp3] <br> かれはわたしのかわりにかいぎにしゅっせきしました。 <br>He attended the meeting in my place.
[sound:s-3418_彼は私の代わりに会議に出席しました。.mp3]	<b>代わり</b> <br> 彼は私の代わりに会議に出席しました。<br> かれはわたしのかわりにかいぎにしゅっせきしました <br>He attended the meeting in my place.
石神	[sound:k-3419_石神.mp3]<br>しゃくじん, いしがみ <br> stone which is worshipped, image of a god in stone
stone which is worshipped, image of a god in stone	<b>石神<b> <br> しゃくじん, いしがみ <br>[sound:k-3419_石神.mp3]
[sound:k-3419_石神.mp3]	stone which is worshipped, image of a god in stone<br> <b>石神</b> <br> (しゃくじん, いしがみ)
<b>時代</b> <br> これは新しい時代の始まりです。	[sound:s-3419_これは新しい時代の始まりです。.mp3] <br> これはあたらしいじだいのはじまりです。 <br>This is the beginning of a new era.
[sound:s-3419_これは新しい時代の始まりです。.mp3]	<b>時代</b> <br> これは新しい時代の始まりです。<br> これはあたらしいじだいのはじまりです <br>This is the beginning of a new era.
足	[sound:k-3420_足.mp3]<br>あし <br> foot; leg; gait; pace; bottom structural component (i.e. radical) of a kanji; means of transportation
foot; leg; gait; pace; bottom structural component (i.e. radical) of a kanji; means of transportation	<b>足<b> <br> あし <br>[sound:k-3420_足.mp3]
[sound:k-3420_足.mp3]	foot; leg; gait; pace; bottom structural component<br> <b>i.e. radical) of a kanji; means of transportation (足</b> <br> (あし)
<b>代表</b> <br> 彼はチームの代表です。	[sound:s-3420_彼はチームの代表です。.mp3] <br> かれはちーむのだいひょうです。 <br>He is the representative of the team.
[sound:s-3420_彼はチームの代表です。.mp3]	<b>代表</b> <br> 彼はチームの代表です。<br> かれはちーむのだいひょうです <br>He is the representative of the team.
不足	[sound:k-3421_不足.mp3]<br>ふそく <br> insufficiency, shortage, deficiency, lack, dearth
insufficiency, shortage, deficiency, lack, dearth	<b>不足<b> <br> ふそく <br>[sound:k-3421_不足.mp3]
[sound:k-3421_不足.mp3]	insufficiency, shortage, deficiency, lack, dearth<br> <b>不足</b> <br> (ふそく)
<b>現代</b> <br> 私たちは現代の技術を活用しています。	[sound:s-3421_私たちは現代の技術を活用しています。.mp3] <br> わたしたちはげんだいのぎじゅつをかつようしています。 <br>We are utilizing modern technology.
[sound:s-3421_私たちは現代の技術を活用しています。.mp3]	<b>現代</b> <br> 私たちは現代の技術を活用しています。<br> わたしたちはげんだいのぎじゅつをかつようしています <br>We are utilizing modern technology.
発足	[sound:k-3422_発足.mp3]<br>ほっそく, はっそく <br> starting, inauguration, launch, founding, establishment, start-up
starting, inauguration, launch, founding, establishment, start-up	<b>発足<b> <br> ほっそく, はっそく <br>[sound:k-3422_発足.mp3]
[sound:k-3422_発足.mp3]	starting, inauguration, launch, founding, establishment, start-up<br> <b>発足</b> <br> (ほっそく, はっそく)
<b>世代</b> <br> このテクノロジーは次世代に影響を与えます。	[sound:s-3422_このテクノロジーは次世代に影響を与えます。.mp3] <br> このてくのろじーはじせだいにえいきょうをあたえます。 <br>This technology will impact the next generation.
[sound:s-3422_このテクノロジーは次世代に影響を与えます。.mp3]	<b>世代</b> <br> このテクノロジーは次世代に影響を与えます。<br> このてくのろじーはじせだいにえいきょうをあたえます <br>This technology will impact the next generation.
満足	[sound:k-3423_満足.mp3]<br>まんぞく <br> satisfaction; sufficiency
satisfaction; sufficiency	<b>満足<b> <br> まんぞく <br>[sound:k-3423_満足.mp3]
[sound:k-3423_満足.mp3]	satisfaction; sufficiency<br> <b>満足</b> <br> (まんぞく)
<b>近代</b> <br> 近代の発明が産業革命を引き起こしました。	[sound:s-3423_近代の発明が産業革命を引き起こしました。.mp3] <br> きんだいのはつめいがさんぎょうかくめいをひきおこしました。 <br>Modern inventions triggered the Industrial Revolution.
[sound:s-3423_近代の発明が産業革命を引き起こしました。.mp3]	<b>近代</b> <br> 近代の発明が産業革命を引き起こしました。<br> きんだいのはつめいがさんぎょうかくめいをひきおこしました <br>Modern inventions triggered the Industrial Revolution.
足並み	[sound:k-3424_足並み.mp3]<br>あしなみ <br> pace, step
pace, step	<b>足並み<b> <br> あしなみ <br>[sound:k-3424_足並み.mp3]
[sound:k-3424_足並み.mp3]	pace, step<br> <b>足並み</b> <br> (あしなみ)
<b>代理</b> <br> 彼は会社の代理として出張します。	[sound:s-3424_彼は会社の代理として出張します。.mp3] <br> かれはかいしゃのだいりとしてしゅっちょうします。 <br>He travels on behalf of the company.
[sound:s-3424_彼は会社の代理として出張します。.mp3]	<b>代理</b> <br> 彼は会社の代理として出張します。<br> かれはかいしゃのだいりとしてしゅっちょうします <br>He travels on behalf of the company.
足元	[sound:k-3425_足元.mp3]<br>あしもと, そっか <br> at one's feet, underfoot; gait, pace, step; you, thou
at one's feet, underfoot; gait, pace, step; you, thou	<b>足元<b> <br> あしもと, そっか <br>[sound:k-3425_足元.mp3]
[sound:k-3425_足元.mp3]	at one's feet, underfoot; gait, pace, step; you, thou<br> <b>足元</b> <br> (あしもと, そっか)
<b>交代</b> <br> その選手はベンチに交代しました。	[sound:s-3425_その選手はベンチに交代しました。.mp3] <br> そのせんしゅはべんちにこうだいしました。 <br>The player was substituted and went to the bench.
[sound:s-3425_その選手はベンチに交代しました。.mp3]	<b>交代</b> <br> その選手はベンチに交代しました。<br> そのせんしゅはべんちにこうだいしました <br>The player was substituted and went to the bench.
手足	[sound:k-3426_手足.mp3]<br>てあし <br> one's hands and feet, limbs
one's hands and feet, limbs	<b>手足<b> <br> てあし <br>[sound:k-3426_手足.mp3]
[sound:k-3426_手足.mp3]	one's hands and feet, limbs<br> <b>手足</b> <br> (てあし)
<b>代議</b> <br> 彼は代議員として国会に出席します。	[sound:s-3426_彼は代議員として国会に出席します。.mp3] <br> かれはだいぎいんとしてこっかいにしゅっせきします。 <br>He attends the parliament as a representative.
[sound:s-3426_彼は代議員として国会に出席します。.mp3]	<b>代議</b> <br> 彼は代議員として国会に出席します。<br> かれはだいぎいんとしてこっかいにしゅっせきします <br>He attends the parliament as a representative.
足跡	[sound:k-3427_足跡.mp3]<br>あしあと, そくせき <br> footprints
footprints	<b>足跡<b> <br> あしあと, そくせき <br>[sound:k-3427_足跡.mp3]
[sound:k-3427_足跡.mp3]	footprints<br> <b>足跡</b> <br> (あしあと, そくせき)
<b>代行</b> <br> 彼は私の代行を務めます。	[sound:s-3427_彼は私の代行を務めます。.mp3] <br> かれはわたしのだいこうをつとめます。 <br>He acts as my proxy.
[sound:s-3427_彼は私の代行を務めます。.mp3]	<b>代行</b> <br> 彼は私の代行を務めます。<br> かれはわたしのだいこうをつとめます <br>He acts as my proxy.
出足	[sound:k-3428_出足.mp3]<br>であし <br> start, turnout; constant forward movement (sumo)
start, turnout; constant forward movement (sumo)	<b>出足<b> <br> であし <br>[sound:k-3428_出足.mp3]
[sound:k-3428_出足.mp3]	start, turnout; constant forward movement<br> <b>sumo) (出足</b> <br> (であし)
<b>明らか</b> <br> 彼の意図は明らかではありません。	[sound:s-3428_彼の意図は明らかではありません。.mp3] <br> かれのいとはあきらかではありません。 <br>His intentions are not clear.
[sound:s-3428_彼の意図は明らかではありません。.mp3]	<b>明らか</b> <br> 彼の意図は明らかではありません。<br> かれのいとはあきらかではありません <br>His intentions are not clear.
足場	[sound:k-3429_足場.mp3]<br>あしば <br> scaffold, footing, foothold
scaffold, footing, foothold	<b>足場<b> <br> あしば <br>[sound:k-3429_足場.mp3]
[sound:k-3429_足場.mp3]	scaffold, footing, foothold<br> <b>足場</b> <br> (あしば)
<b>声明</b> <br> 会社から重要な声明が出されました。	[sound:s-3429_会社から重要な声明が出されました。.mp3] <br> かいしゃからじゅうようなせいめいがだされました。 <br>An important statement was issued by the company.
[sound:s-3429_会社から重要な声明が出されました。.mp3]	<b>声明</b> <br> 会社から重要な声明が出されました。<br> かいしゃからじゅうようなせいめいがだされました <br>An important statement was issued by the company.
違い	[sound:k-3430_違い.mp3]<br>ちがい <br> difference, discrepancy
difference, discrepancy	<b>違い<b> <br> ちがい <br>[sound:k-3430_違い.mp3]
[sound:k-3430_違い.mp3]	difference, discrepancy<br> <b>違い</b> <br> (ちがい)
<b>説明</b> <br> 先生は授業で問題を説明しました。	[sound:s-3430_先生は授業で問題を説明しました。.mp3] <br> せんせいはじゅぎょうでもんだいをせつめいしました。 <br>The teacher explained the problem in class.
[sound:s-3430_先生は授業で問題を説明しました。.mp3]	<b>説明</b> <br> 先生は授業で問題を説明しました。<br> せんせいはじゅぎょうでもんだいをせつめいしました <br>The teacher explained the problem in class.
違反	[sound:k-3431_違反.mp3]<br>いはん <br> violation (of law), transgression, infringement, breach
violation (of law), transgression, infringement, breach	<b>違反<b> <br> いはん <br>[sound:k-3431_違反.mp3]
[sound:k-3431_違反.mp3]	violation<br> <b>of law), transgression, infringement, breach (違反</b> <br> (いはん)
<b>不明</b> <br> その物体の正体は不明です。	[sound:s-3431_その物体の正体は不明です。.mp3] <br> そのぶったいのしょうたいはふめいです。 <br>The true identity of the object is unknown.
[sound:s-3431_その物体の正体は不明です。.mp3]	<b>不明</b> <br> その物体の正体は不明です。<br> そのぶったいのしょうたいはふめいです <br>The true identity of the object is unknown.
違憲	[sound:k-3432_違憲.mp3]<br>いけん <br> unconstitutionality
unconstitutionality	<b>違憲<b> <br> いけん <br>[sound:k-3432_違憲.mp3]
[sound:k-3432_違憲.mp3]	unconstitutionality<br> <b>違憲</b> <br> (いけん)
<b>明確</b> <br> 彼の目標は明確です。	[sound:s-3432_彼の目標は明確です。.mp3] <br> かれのもくひょうはめいかくです。 <br>His goals are clear.
[sound:s-3432_彼の目標は明確です。.mp3]	<b>明確</b> <br> 彼の目標は明確です。<br> かれのもくひょうはめいかくです <br>His goals are clear.
違法	[sound:k-3433_違法.mp3]<br>いほう <br> illegal, illegality, invalid, unlawfulness
illegal, illegality, invalid, unlawfulness	<b>違法<b> <br> いほう <br>[sound:k-3433_違法.mp3]
[sound:k-3433_違法.mp3]	illegal, illegality, invalid, unlawfulness<br> <b>違法</b> <br> (いほう)
<b>公明党</b> <br> 公明党は日本の政治の一部です。	[sound:s-3433_公明党は日本の政治の一部です。.mp3] <br> こうめいとうはにほんのせいじのいちぶです。 <br>Komeito is part of Japan's politics.
[sound:s-3433_公明党は日本の政治の一部です。.mp3]	<b>公明党</b> <br> 公明党は日本の政治の一部です。<br> こうめいとうはにほんのせいじのいちぶです <br>Komeito is part of Japan's politics.
間違い	[sound:k-3434_間違い.mp3]<br>まちがい <br> mistake
mistake	<b>間違い<b> <br> まちがい <br>[sound:k-3434_間違い.mp3]
[sound:k-3434_間違い.mp3]	mistake<br> <b>間違い</b> <br> (まちがい)
<b>解明</b> <br> 科学者たちは謎を解明しようとしています。	[sound:s-3434_科学者たちは謎を解明しようとしています。.mp3] <br> かがくしゃたちはなぞをかいめいしようとしています。 <br>Scientists are trying to unravel the mystery.
[sound:s-3434_科学者たちは謎を解明しようとしています。.mp3]	<b>解明</b> <br> 科学者たちは謎を解明しようとしています。<br> かがくしゃたちはなぞをかいめいしようとしています <br>Scientists are trying to unravel the mystery.
相違	[sound:k-3435_相違.mp3]<br>そうい <br> difference, discrepancy, variation
difference, discrepancy, variation	<b>相違<b> <br> そうい <br>[sound:k-3435_相違.mp3]
[sound:k-3435_相違.mp3]	difference, discrepancy, variation<br> <b>相違</b> <br> (そうい)
<b>公明</b> <br> 彼は公明な態度を示しました。	[sound:s-3435_彼は公明な態度を示しました。.mp3] <br> かれはこうめいなたいどをしめしました。 <br>He showed a fair attitude.
[sound:s-3435_彼は公明な態度を示しました。.mp3]	<b>公明</b> <br> 彼は公明な態度を示しました。<br> かれはこうめいなたいどをしめしました <br>He showed a fair attitude.
違和感	[sound:k-3436_違和感.mp3]<br>いわかん <br> uncomfortable feeling, feeling out of place, sense of discomfort; malaise, physical unease
uncomfortable feeling, feeling out of place, sense of discomfort; malaise, physical unease	<b>違和感<b> <br> いわかん <br>[sound:k-3436_違和感.mp3]
[sound:k-3436_違和感.mp3]	uncomfortable feeling, feeling out of place, sense of discomfort; malaise, physical unease<br> <b>違和感</b> <br> (いわかん)
<b>表明</b> <br> 彼は彼の意見を明確に表明しました。	[sound:s-3436_彼は彼の意見を明確に表明しました。.mp3] <br> かれはかれのいけんをめいかくにひょうめいしました。 <br>He clearly expressed his opinion.
[sound:s-3436_彼は彼の意見を明確に表明しました。.mp3]	<b>表明</b> <br> 彼は彼の意見を明確に表明しました。<br> かれはかれのいけんをめいかくにひょうめいしました <br>He clearly expressed his opinion.
食い違い	[sound:k-3437_食い違い.mp3]<br>くいちがい <br> discrepancy, different or conflicting opinions
discrepancy, different or conflicting opinions	<b>食い違い<b> <br> くいちがい <br>[sound:k-3437_食い違い.mp3]
[sound:k-3437_食い違い.mp3]	discrepancy, different or conflicting opinions<br> <b>食い違い</b> <br> (くいちがい)
<b>未明</b> <br> 事件の詳細は未明です。	[sound:s-3437_事件の詳細は未明です。.mp3] <br> じけんのしょうさいはみめいです。 <br>The details of the incident are unknown.
[sound:s-3437_事件の詳細は未明です。.mp3]	<b>未明</b> <br> 事件の詳細は未明です。<br> じけんのしょうさいはみめいです <br>The details of the incident are unknown.
間違いない	[sound:k-3438_間違いない.mp3]<br>まちがいない <br> I have no doubt, You can depend on it, certain
I have no doubt, You can depend on it, certain	<b>間違いない<b> <br> まちがいない <br>[sound:k-3438_間違いない.mp3]
[sound:k-3438_間違いない.mp3]	I have no doubt, You can depend on it, certain<br> <b>間違いない</b> <br> (まちがいない)
<b>実</b> <br> 実は私も同じ意見です。	[sound:s-3438_実は私も同じ意見です。.mp3] <br> じつはわたしもおなじいけんです。 <br>"Actually, I share the same opinion."
[sound:s-3438_実は私も同じ意見です。.mp3]	<b>実</b> <br> 実は私も同じ意見です。<br> じつはわたしもおなじいけんです <br>Actually, I share the same opinion.
違う	[sound:k-3439_違う.mp3]<br>ちがう <br> to differ (from), to vary; to not be in the usual condition; to not match the correct (answer, etc.); to be different from promised
to differ (from), to vary; to not be in the usual condition; to not match the correct (answer, etc.); to be different from promised	<b>違う<b> <br> ちがう <br>[sound:k-3439_違う.mp3]
[sound:k-3439_違う.mp3]	to differ<br> <b>from), to vary; to not be in the usual condition; to not match the correct (answer, etc.); to be different from promised (違う</b> <br> (ちがう)
<b>実は</b> <br> 実は、彼女は昨日会社を辞めました。	[sound:s-3439_実は、彼女は昨日会社を辞めました。.mp3] <br> じつは、かのじょはきのうかいしゃをやめました。 <br>"Actually, she quit the company yesterday."
[sound:s-3439_実は、彼女は昨日会社を辞めました。.mp3]	<b>実は</b> <br> 実は、彼女は昨日会社を辞めました。<br> じつは、かのじょはきのうかいしゃをやめました <br>Actually, she quit the company yesterday.
消費	[sound:k-3440_消費.mp3]<br>しょうひ <br> consumption, expenditure
consumption, expenditure	<b>消費<b> <br> しょうひ <br>[sound:k-3440_消費.mp3]
[sound:k-3440_消費.mp3]	consumption, expenditure<br> <b>消費</b> <br> (しょうひ)
<b>実に</b> <br> その結果は実に驚くべきです。	[sound:s-3440_その結果は実に驚くべきです。.mp3] <br> そのけっかはじつにおどろくべきです。 <br>The result is truly astonishing.
[sound:s-3440_その結果は実に驚くべきです。.mp3]	<b>実に</b> <br> その結果は実に驚くべきです。<br> そのけっかはじつにおどろくべきです <br>The result is truly astonishing.
消費者	[sound:k-3441_消費者.mp3]<br>しょうひしゃ <br> consumer
consumer	<b>消費者<b> <br> しょうひしゃ <br>[sound:k-3441_消費者.mp3]
[sound:k-3441_消費者.mp3]	consumer<br> <b>消費者</b> <br> (しょうひしゃ)
<b>現実</b> <br> あの計画は現実的ではないようです。	[sound:s-3441_あの計画は現実的ではないようです。.mp3] <br> あのけいかくはげんじつてきではないようです。 <br>That plan doesn't seem realistic.
[sound:s-3441_あの計画は現実的ではないようです。.mp3]	<b>現実</b> <br> あの計画は現実的ではないようです。<br> あのけいかくはげんじつてきではないようです <br>That plan doesn't seem realistic.
消費税	[sound:k-3442_消費税.mp3]<br>しょうひぜい <br> consumption tax (incl. sales tax, VAT, excise duty, etc.)
consumption tax (incl. sales tax, VAT, excise duty, etc.)	<b>消費税<b> <br> しょうひぜい <br>[sound:k-3442_消費税.mp3]
[sound:k-3442_消費税.mp3]	consumption tax<br> <b>incl. sales tax, VAT, excise duty, etc.) (消費税</b> <br> (しょうひぜい)
<b>事実</b> <br> その事実は否定できません。	[sound:s-3442_その事実は否定できません。.mp3] <br> そのじじつはひていできません。 <br>That fact cannot be denied.
[sound:s-3442_その事実は否定できません。.mp3]	<b>事実</b> <br> その事実は否定できません。<br> そのじじつはひていできません <br>That fact cannot be denied.
解消	[sound:k-3443_解消.mp3]<br>かいしょう <br> cancellation, liquidation, resolution, reduction (e.g. of stress)
cancellation, liquidation, resolution, reduction (e.g. of stress)	<b>解消<b> <br> かいしょう <br>[sound:k-3443_解消.mp3]
[sound:k-3443_解消.mp3]	cancellation, liquidation, resolution, reduction<br> <b>e.g. of stress) (解消</b> <br> (かいしょう)
<b>実施</b> <br> 新しい政策の実施が始まりました。	[sound:s-3443_新しい政策の実施が始まりました。.mp3] <br> あたらしいせいさくのじっじがはじまりました。 <br>The implementation of the new policy has begun.
[sound:s-3443_新しい政策の実施が始まりました。.mp3]	<b>実施</b> <br> 新しい政策の実施が始まりました。<br> あたらしいせいさくのじっじがはじまりました <br>The implementation of the new policy has begun.
消極的	[sound:k-3444_消極的.mp3]<br>しょうきょくてき <br> negative, half-hearted, passive, unmotivated
negative, half-hearted, passive, unmotivated	<b>消極的<b> <br> しょうきょくてき <br>[sound:k-3444_消極的.mp3]
[sound:k-3444_消極的.mp3]	negative, half-hearted, passive, unmotivated<br> <b>消極的</b> <br> (しょうきょくてき)
<b>確実</b> <br> 彼の勝利は確実です。	[sound:s-3444_彼の勝利は確実です。.mp3] <br> かれのしょうりはかくじつです。 <br>His victory is certain.
[sound:s-3444_彼の勝利は確実です。.mp3]	<b>確実</b> <br> 彼の勝利は確実です。<br> かれのしょうりはかくじつです <br>His victory is certain.
消防	[sound:k-3445_消防.mp3]<br>しょうぼう <br> fire fighting, fire department
fire fighting, fire department	<b>消防<b> <br> しょうぼう <br>[sound:k-3445_消防.mp3]
[sound:k-3445_消防.mp3]	fire fighting, fire department<br> <b>消防</b> <br> (しょうぼう)
<b>事実上</b> <br> 彼は事実上のリーダーです。	[sound:s-3445_彼は事実上のリーダーです。.mp3] <br> かれはじじつじょうのりーダーです。 <br>He is the de facto leader.
[sound:s-3445_彼は事実上のリーダーです。.mp3]	<b>事実上</b> <br> 彼は事実上のリーダーです。<br> かれはじじつじょうのりーダーです <br>He is the de facto leader.
消しゴム	[sound:k-3446_消しゴム.mp3]<br>けしゴム <br> eraser, India rubber
eraser, India rubber	<b>消しゴム<b> <br> けしゴム <br>[sound:k-3446_消しゴム.mp3]
[sound:k-3446_消しゴム.mp3]	eraser, India rubber<br> <b>消しゴム</b> <br> (けしゴム)
<b>実験</b> <br> 科学者たちは新しい実験を行っています。	[sound:s-3446_科学者たちは新しい実験を行っています。.mp3] <br> かがくしゃたちはあたらしいじっけんをおこなっています。 <br>Scientists are conducting new experiments.
[sound:s-3446_科学者たちは新しい実験を行っています。.mp3]	<b>実験</b> <br> 科学者たちは新しい実験を行っています。<br> かがくしゃたちはあたらしいじっけんをおこなっています <br>Scientists are conducting new experiments.
消印	[sound:k-3447_消印.mp3]<br>けしいん <br> postmark, (postal) cancellation mark
postmark, (postal) cancellation mark	<b>消印<b> <br> けしいん <br>[sound:k-3447_消印.mp3]
[sound:k-3447_消印.mp3]	postmark,<br> <b>postal) cancellation mark (消印</b> <br> (けしいん)
<b>実現</b> <br> 彼の夢が実現しました。	[sound:s-3447_彼の夢が実現しました。.mp3] <br> かれのゆめがじつげんしました。 <br>His dream has come true.
[sound:s-3447_彼の夢が実現しました。.mp3]	<b>実現</b> <br> 彼の夢が実現しました。<br> かれのゆめがじつげんしました <br>His dream has come true.
取り消し	[sound:k-3448_取り消し.mp3]<br>とりけし <br> cancellation, cancel, CAN
cancellation, cancel, CAN	<b>取り消し<b> <br> とりけし <br>[sound:k-3448_取り消し.mp3]
[sound:k-3448_取り消し.mp3]	cancellation, cancel, CAN<br> <b>取り消し</b> <br> (とりけし)
<b>円</b> <br> この硬貨は100円です。	[sound:s-3448_この硬貨は100円です。.mp3] <br> このこうかはひゃくえんです。 <br>This coin is 100 yen.
[sound:s-3448_この硬貨は100円です。.mp3]	<b>円</b> <br> この硬貨は100円です。<br> このこうかはひゃくえんです <br>This coin is 100 yen.
消息筋	[sound:k-3449_消息筋.mp3]<br>しょうそくすじ <br> informed circles
informed circles	<b>消息筋<b> <br> しょうそくすじ <br>[sound:k-3449_消息筋.mp3]
[sound:k-3449_消息筋.mp3]	informed circles<br> <b>消息筋</b> <br> (しょうそくすじ)
<b>円高</b> <br> 円高の影響で輸出業者は苦しんでいます。	[sound:s-3449_円高の影響で輸出業者は苦しんでいます。.mp3] <br> えんたかのえいきょうでゆしゅつぎょうしゃはくるしんでいます。 <br>Exporters are struggling due to the strong yen.
[sound:s-3449_円高の影響で輸出業者は苦しんでいます。.mp3]	<b>円高</b> <br> 円高の影響で輸出業者は苦しんでいます。<br> えんたかのえいきょうでゆしゅつぎょうしゃはくるしんでいます <br>Exporters are struggling due to the strong yen.
境	[sound:k-3450_境.mp3]<br>さかい <br> border, boundary, mental state
border, boundary, mental state	<b>境<b> <br> さかい <br>[sound:k-3450_境.mp3]
[sound:k-3450_境.mp3]	border, boundary, mental state<br> <b>境</b> <br> (さかい)
<b>円安</b> <br> 円安が輸入コストを押し上げました。	[sound:s-3450_円安が輸入コストを押し上げました。.mp3] <br> えんやすがゆにゅうこすとをおしあげました。 <br>The weak yen pushed up import costs.
[sound:s-3450_円安が輸入コストを押し上げました。.mp3]	<b>円安</b> <br> 円安が輸入コストを押し上げました。<br> えんやすがゆにゅうこすとをおしあげました <br>The weak yen pushed up import costs.
環境	[sound:k-3451_環境.mp3]<br>かんきょう <br> environment, circumstance
environment, circumstance	<b>環境<b> <br> かんきょう <br>[sound:k-3451_環境.mp3]
[sound:k-3451_環境.mp3]	environment, circumstance<br> <b>環境</b> <br> (かんきょう)
<b>円相場</b> <br> 円相場の変動が輸出業界に影響を与えます。	[sound:s-3451_円相場の変動が輸出業界に影響を与えます。.mp3] <br> えんそうばのへんどうがゆしゅつぎょうかいにえいきょうをあたえます。 <br>Fluctuations in the yen exchange rate affect the export industry.
[sound:s-3451_円相場の変動が輸出業界に影響を与えます。.mp3]	<b>円相場</b> <br> 円相場の変動が輸出業界に影響を与えます。<br> えんそうばのへんどうがゆしゅつぎょうかいにえいきょうをあたえます <br>Fluctuations in the yen exchange rate affect the export industry.
国境	[sound:k-3452_国境.mp3]<br>こっきょう, くにざかい <br> national or state border
national or state border	<b>国境<b> <br> こっきょう, くにざかい <br>[sound:k-3452_国境.mp3]
[sound:k-3452_国境.mp3]	national or state border<br> <b>国境</b> <br> (こっきょう, くにざかい)
<b>一円</b> <br> その商品はたった一円です。	[sound:s-3452_その商品はたった一円です。.mp3] <br> そのしょうひんはたったいちえんです。 <br>That item costs only one yen.
[sound:s-3452_その商品はたった一円です。.mp3]	<b>一円</b> <br> その商品はたった一円です。<br> そのしょうひんはたったいちえんです <br>That item costs only one yen.
環境庁	[sound:k-3453_環境庁.mp3]<br>かんきょうちょう <br> Environment Agency
Environment Agency	<b>環境庁<b> <br> かんきょうちょう <br>[sound:k-3453_環境庁.mp3]
[sound:k-3453_環境庁.mp3]	Environment Agency<br> <b>環境庁</b> <br> (かんきょうちょう)
<b>円滑</b> <br> 交渉は円滑に進みました。	[sound:s-3453_交渉は円滑に進みました。.mp3] <br> こうしょうはえんかつにすすみました。 <br>The negotiations proceeded smoothly.
[sound:s-3453_交渉は円滑に進みました。.mp3]	<b>円滑</b> <br> 交渉は円滑に進みました。<br> こうしょうはえんかつにすすみました <br>The negotiations proceeded smoothly.
心境	[sound:k-3454_心境.mp3]<br>しんきょう <br> mental state
mental state	<b>心境<b> <br> しんきょう <br>[sound:k-3454_心境.mp3]
[sound:k-3454_心境.mp3]	mental state<br> <b>心境</b> <br> (しんきょう)
<b>円形</b> <br> その公園には円形の噴水があります。	[sound:s-3454_その公園には円形の噴水があります。.mp3] <br> そのこうえんにはえんけいのふんすいがあります。 <br>There is a circular fountain in the park.
[sound:s-3454_その公園には円形の噴水があります。.mp3]	<b>円形</b> <br> その公園には円形の噴水があります。<br> そのこうえんにはえんけいのふんすいがあります <br>There is a circular fountain in the park.
境界	[sound:k-3455_境界.mp3]<br>きょうかい <br> boundary
boundary	<b>境界<b> <br> きょうかい <br>[sound:k-3455_境界.mp3]
[sound:k-3455_境界.mp3]	boundary<br> <b>境界</b> <br> (きょうかい)
<b>円卓</b> <br> 円卓会議は重要な意思決定を行います。	[sound:s-3455_円卓会議は重要な意思決定を行います。.mp3] <br> えんたくかいぎはじゅうようないしけっていをおこないます。 <br>Roundtable meetings make important decisions.
[sound:s-3455_円卓会議は重要な意思決定を行います。.mp3]	<b>円卓</b> <br> 円卓会議は重要な意思決定を行います。<br> えんたくかいぎはじゅうようないしけっていをおこないます <br>Roundtable meetings make important decisions.
苦境	[sound:k-3456_苦境.mp3]<br>くきょう <br> trouble, crisis, predicament, squeeze, pinch
trouble, crisis, predicament, squeeze, pinch	<b>苦境<b> <br> くきょう <br>[sound:k-3456_苦境.mp3]
[sound:k-3456_苦境.mp3]	trouble, crisis, predicament, squeeze, pinch<br> <b>苦境</b> <br> (くきょう)
<b>円満</b> <br> 彼らの結婚生活は円満です。	[sound:s-3456_彼らの結婚生活は円満です。.mp3] <br> かれらのけっこんせいかつはえんまんです。 <br>Their married life is harmonious.
[sound:s-3456_彼らの結婚生活は円満です。.mp3]	<b>円満</b> <br> 彼らの結婚生活は円満です。<br> かれらのけっこんせいかつはえんまんです <br>Their married life is harmonious.
境内	[sound:k-3457_境内.mp3]<br>けいだい <br> compound, grounds
compound, grounds	<b>境内<b> <br> けいだい <br>[sound:k-3457_境内.mp3]
[sound:k-3457_境内.mp3]	compound, grounds<br> <b>境内</b> <br> (けいだい)
<b>円筒</b> <br> その建物は円筒形をしています。	[sound:s-3457_その建物は円筒形をしています。.mp3] <br> そのたてものはえんとうけいをしています。 <br>The building is cylindrical in shape.
[sound:s-3457_その建物は円筒形をしています。.mp3]	<b>円筒</b> <br> その建物は円筒形をしています。<br> そのたてものはえんとうけいをしています <br>The building is cylindrical in shape.
越境	[sound:k-3458_越境.mp3]<br>えっきょう <br> border transgression
border transgression	<b>越境<b> <br> えっきょう <br>[sound:k-3458_越境.mp3]
[sound:k-3458_越境.mp3]	border transgression<br> <b>越境</b> <br> (えっきょう)
<b>関</b> <br> 彼は関心のあるトピックについて話しました。	[sound:s-3458_彼は関心のあるトピックについて話しました。.mp3] <br> かれはかんしんのあるとぴっくについてはなしました。 <br>He talked about a topic he is interested in.
[sound:s-3458_彼は関心のあるトピックについて話しました。.mp3]	<b>関</b> <br> 彼は関心のあるトピックについて話しました。<br> かれはかんしんのあるとぴっくについてはなしました <br>He talked about a topic he is interested in.
境地	[sound:k-3459_境地.mp3]<br>きょうち <br> one's lot, circumstance, situation in life
one's lot, circumstance, situation in life	<b>境地<b> <br> きょうち <br>[sound:k-3459_境地.mp3]
[sound:k-3459_境地.mp3]	one's lot, circumstance, situation in life<br> <b>境地</b> <br> (きょうち)
<b>関係</b> <br> 彼らは親密な関係にあります。	[sound:s-3459_彼らは親密な関係にあります。.mp3] <br> かれらはしんみつなかんけいにあります。 <br>They have a close relationship.
[sound:s-3459_彼らは親密な関係にあります。.mp3]	<b>関係</b> <br> 彼らは親密な関係にあります。<br> かれらはしんみつなかんけいにあります <br>They have a close relationship.
神	[sound:k-3460_神.mp3]<br>かみ <br> god, deity, divinity, spirit, kami
god, deity, divinity, spirit, kami	<b>神<b> <br> かみ <br>[sound:k-3460_神.mp3]
[sound:k-3460_神.mp3]	god, deity, divinity, spirit, kami<br> <b>神</b> <br> (かみ)
<b>関係者</b> <br> この計画には多くの関係者が関わっています。	[sound:s-3460_この計画には多くの関係者が関わっています。.mp3] <br> このけいかくにはおおくのかんけいしゃがかかわっています。 <br>Many stakeholders are involved in this plan.
[sound:s-3460_この計画には多くの関係者が関わっています。.mp3]	<b>関係者</b> <br> この計画には多くの関係者が関わっています。<br> このけいかくにはおおくのかんけいしゃがかかわっています <br>Many stakeholders are involved in this plan.
精神	[sound:k-3461_精神.mp3]<br>せいしん <br> mind, soul, heart, spirit, intention
mind, soul, heart, spirit, intention	<b>精神<b> <br> せいしん <br>[sound:k-3461_精神.mp3]
[sound:k-3461_精神.mp3]	mind, soul, heart, spirit, intention<br> <b>精神</b> <br> (せいしん)
<b>関心</b> <br> 彼は自然に関心を持っています。	[sound:s-3461_彼は自然に関心を持っています。.mp3] <br> かれはしぜんにかんしんをもっています。 <br>He has an interest in nature.
[sound:s-3461_彼は自然に関心を持っています。.mp3]	<b>関心</b> <br> 彼は自然に関心を持っています。<br> かれはしぜんにかんしんをもっています <br>He has an interest in nature.
阪神	[sound:k-3462_阪神.mp3]<br>はんしん <br> Osaka-Kobe; Hanshin (company name: railway, dept. store, baseball team, etc.)
Osaka-Kobe; Hanshin (company name: railway, dept. store, baseball team, etc.)	<b>阪神<b> <br> はんしん <br>[sound:k-3462_阪神.mp3]
[sound:k-3462_阪神.mp3]	Osaka-Kobe; Hanshin<br> <b>company name: railway, dept. store, baseball team, etc.) (阪神</b> <br> (はんしん)
<b>関連</b> <br> この問題は環境問題と関連しています。	[sound:s-3462_この問題は環境問題と関連しています。.mp3] <br> このもんだいはかんきょうもんだいとかんれんしています。 <br>This issue is related to environmental problems.
[sound:s-3462_この問題は環境問題と関連しています。.mp3]	<b>関連</b> <br> この問題は環境問題と関連しています。<br> このもんだいはかんきょうもんだいとかんれんしています <br>This issue is related to environmental problems.
神経	[sound:k-3463_神経.mp3]<br>しんけい <br> nerve, sensitivity
nerve, sensitivity	<b>神経<b> <br> しんけい <br>[sound:k-3463_神経.mp3]
[sound:k-3463_神経.mp3]	nerve, sensitivity<br> <b>神経</b> <br> (しんけい)
<b>機関</b> <br> この機関は地域の発展に貢献しています。	[sound:s-3463_この機関は地域の発展に貢献しています。.mp3] <br> このきかんはちいきのはってんにこうけんしています。 <br>This organization contributes to the development of the region.
[sound:s-3463_この機関は地域の発展に貢献しています。.mp3]	<b>機関</b> <br> この機関は地域の発展に貢献しています。<br> このきかんはちいきのはってんにこうけんしています <br>This organization contributes to the development of the region.
神社	[sound:k-3464_神社.mp3]<br>じんじゃ <br> Shinto shrine
Shinto shrine	<b>神社<b> <br> じんじゃ <br>[sound:k-3464_神社.mp3]
[sound:k-3464_神社.mp3]	Shinto shrine<br> <b>神社</b> <br> (じんじゃ)
<b>関西</b> <br> 関西地方は観光地として人気があります。	[sound:s-3464_関西地方は観光地として人気があります。.mp3] <br> かんさいちほうはかんこうちとしてにんきがあります。 <br>The Kansai region is popular as a tourist destination.
[sound:s-3464_関西地方は観光地として人気があります。.mp3]	<b>関西</b> <br> 関西地方は観光地として人気があります。<br> かんさいちほうはかんこうちとしてにんきがあります <br>The Kansai region is popular as a tourist destination.
精神的	[sound:k-3465_精神的.mp3]<br>せいしんてき <br> mental, emotional
mental, emotional	<b>精神的<b> <br> せいしんてき <br>[sound:k-3465_精神的.mp3]
[sound:k-3465_精神的.mp3]	mental, emotional<br> <b>精神的</b> <br> (せいしんてき)
<b>関税</b> <br> この商品には高い関税がかかります。	[sound:s-3465_この商品には高い関税がかかります。.mp3] <br> このしょうひんにはたかいかんぜいがかかります。 <br>This product is subject to high tariffs.
[sound:s-3465_この商品には高い関税がかかります。.mp3]	<b>関税</b> <br> この商品には高い関税がかかります。<br> このしょうひんにはたかいかんぜいがかかります <br>This product is subject to high tariffs.
神宮	[sound:k-3466_神宮.mp3]<br>じんぐう <br> Shinto shrine
Shinto shrine	<b>神宮<b> <br> じんぐう <br>[sound:k-3466_神宮.mp3]
[sound:k-3466_神宮.mp3]	Shinto shrine<br> <b>神宮</b> <br> (じんぐう)
<b>金融機関</b> <br> 金融機関は経済活動に重要な役割を果たします。	[sound:s-3466_金融機関は経済活動に重要な役割を果たします。.mp3] <br> きんゆうきかんはけいざいかつどうにじゅうようなやくわりをはたします。 <br>Financial institutions play a crucial role in economic activities.
[sound:s-3466_金融機関は経済活動に重要な役割を果たします。.mp3]	<b>金融機関</b> <br> 金融機関は経済活動に重要な役割を果たします。<br> きんゆうきかんはけいざいかつどうにじゅうようなやくわりをはたします <br>Financial institutions play a crucial role in economic activities.
神話	[sound:k-3467_神話.mp3]<br>しんわ <br> myth, legend
myth, legend	<b>神話<b> <br> しんわ <br>[sound:k-3467_神話.mp3]
[sound:k-3467_神話.mp3]	myth, legend<br> <b>神話</b> <br> (しんわ)
<b>関与</b> <br> 彼は事件に関与していると疑われています。	[sound:s-3467_彼は事件に関与していると疑われています。.mp3] <br> かれはじけんにかんよしているとうだわれています。 <br>He is suspected of being involved in the incident.
[sound:s-3467_彼は事件に関与していると疑われています。.mp3]	<b>関与</b> <br> 彼は事件に関与していると疑われています。<br> かれはじけんにかんよしているとうだわれています <br>He is suspected of being involved in the incident.
神様	[sound:k-3468_神様.mp3]<br>かみさま <br> God
God	<b>神様<b> <br> かみさま <br>[sound:k-3468_神様.mp3]
[sound:k-3468_神様.mp3]	God<br> <b>神様</b> <br> (かみさま)
<b>決まって</b> <br> 彼の予測はほとんど決まっている。	[sound:s-3468_彼の予測はほとんど決まっている。.mp3] <br> かれのよそくはほとんどきまっている。 <br>His predictions are almost always accurate.
[sound:s-3468_彼の予測はほとんど決まっている。.mp3]	<b>決まって</b> <br> 彼の予測はほとんど決まっている。<br> かれのよそくはほとんどきまっている <br>His predictions are almost always accurate.
神楽	[sound:k-3469_神楽.mp3]<br>かぐら <br> ancient Shinto music and dancing
ancient Shinto music and dancing	<b>神楽<b> <br> かぐら <br>[sound:k-3469_神楽.mp3]
[sound:k-3469_神楽.mp3]	ancient Shinto music and dancing<br> <b>神楽</b> <br> (かぐら)
<b>決して</b> <br> 彼は決して諦めません。	[sound:s-3469_彼は決して諦めません。.mp3] <br> かれはけっしてあきらめません。 <br>He never gives up.
[sound:s-3469_彼は決して諦めません。.mp3]	<b>決して</b> <br> 彼は決して諦めません。<br> かれはけっしてあきらめません <br>He never gives up.
一番	[sound:k-3470_一番.mp3]<br>いちばん <br> best, first, number one; game, round, bout, fall, event (in a meet)
best, first, number one; game, round, bout, fall, event (in a meet)	<b>一番<b> <br> いちばん <br>[sound:k-3470_一番.mp3]
[sound:k-3470_一番.mp3]	best, first, number one; game, round, bout, fall, event<br> <b>in a meet) (一番</b> <br> (いちばん)
<b>解決</b> <br> この問題を解決するのは難しいです。	[sound:s-3470_この問題を解決するのは難しいです。.mp3] <br> このもんだいをかいけつするのはむずかしいです。 <br>It's difficult to resolve this issue.
[sound:s-3470_この問題を解決するのは難しいです。.mp3]	<b>解決</b> <br> この問題を解決するのは難しいです。<br> このもんだいをかいけつするのはむずかしいです <br>It's difficult to resolve this issue.
番組	[sound:k-3471_番組.mp3]<br>ばんぐみ <br> program (e.g. TV), programme
program (e.g. TV), programme	<b>番組<b> <br> ばんぐみ <br>[sound:k-3471_番組.mp3]
[sound:k-3471_番組.mp3]	program<br> <b>e.g. TV), programme (番組</b> <br> (ばんぐみ)
<b>決議</b> <br> 彼らは新しい決議を提案しました。	[sound:s-3471_彼らは新しい決議を提案しました。.mp3] <br> かれらはあたらしいけつぎをていあんしました。 <br>They proposed a new resolution.
[sound:s-3471_彼らは新しい決議を提案しました。.mp3]	<b>決議</b> <br> 彼らは新しい決議を提案しました。<br> かれらはあたらしいけつぎをていあんしました <br>They proposed a new resolution.
番号	[sound:k-3472_番号.mp3]<br>ばんごう <br> number, series of digits
number, series of digits	<b>番号<b> <br> ばんごう <br>[sound:k-3472_番号.mp3]
[sound:k-3472_番号.mp3]	number, series of digits<br> <b>番号</b> <br> (ばんごう)
<b>決定</b> <br> 彼の行動は私たちの未来に影響を与える決定をします。	[sound:s-3472_彼の行動は私たちの未来に影響を与える決定をします。.mp3] <br> かれのこうどうはわたしたちのみらいにえいきょうをあたえるけっていをします。 <br>His actions will make decisions that affect our future.
[sound:s-3472_彼の行動は私たちの未来に影響を与える決定をします。.mp3]	<b>決定</b> <br> 彼の行動は私たちの未来に影響を与える決定をします。<br> かれのこうどうはわたしたちのみらいにえいきょうをあたえるけっていをします <br>His actions will make decisions that affect our future.
本番	[sound:k-3473_本番.mp3]<br>ほんばん <br> performance, take, going before an audience or on-air; game, season, crucial moment; actual sexual intercourse (i.e. not simulated)
performance, take, going before an audience or on-air; game, season, crucial moment; actual sexual intercourse (i.e. not simulated)	<b>本番<b> <br> ほんばん <br>[sound:k-3473_本番.mp3]
[sound:k-3473_本番.mp3]	performance, take, going before an audience or on-air; game, season, crucial moment; actual sexual intercourse<br> <b>i.e. not simulated) (本番</b> <br> (ほんばん)
<b>判決</b> <br> 裁判官は有罪という判決を下しました。	[sound:s-3473_裁判官は有罪という判決を下しました。.mp3] <br> さいはんかんはゆうざいというはんけつをくだしました。 <br>The judge delivered a guilty verdict.
[sound:s-3473_裁判官は有罪という判決を下しました。.mp3]	<b>判決</b> <br> 裁判官は有罪という判決を下しました。<br> さいはんかんはゆうざいというはんけつをくだしました <br>The judge delivered a guilty verdict.
番手	[sound:k-3474_番手.mp3]<br>ばんて <br> (yarn) count; n-th place (e.g. in a race), n-th in position (e.g. a starting lineup)
(yarn) count; n-th place (e.g. in a race), n-th in position (e.g. a starting lineup)	<b>番手<b> <br> ばんて <br>[sound:k-3474_番手.mp3]
[sound:k-3474_番手.mp3]	(yarn) count; n-th place<br> <b>e.g. in a race), n-th in position (e.g. a starting lineup) (番手</b> <br> (ばんて)
<b>決算</b> <br> 会社の決算は非常に良かったです。	[sound:s-3474_会社の決算は非常に良かったです。.mp3] <br> かいしゃのけっさんはひじょうによかったです。 <br>The company's financial results were very good.
[sound:s-3474_会社の決算は非常に良かったです。.mp3]	<b>決算</b> <br> 会社の決算は非常に良かったです。<br> かいしゃのけっさんはひじょうによかったです <br>The company's financial results were very good.
出番	[sound:k-3475_出番.mp3]<br>でばん <br> one's turn
one's turn	<b>出番<b> <br> でばん <br>[sound:k-3475_出番.mp3]
[sound:k-3475_出番.mp3]	one's turn<br> <b>出番</b> <br> (でばん)
<b>決勝</b> <br> 決勝戦は非常に緊張した瞬間でした。	[sound:s-3475_決勝戦は非常に緊張した瞬間でした。.mp3] <br> けっしょうせんはひじょうにきんちょうしたしゅんかんでした。 <br>The final match was a very tense moment.
[sound:s-3475_決勝戦は非常に緊張した瞬間でした。.mp3]	<b>決勝</b> <br> 決勝戦は非常に緊張した瞬間でした。<br> けっしょうせんはひじょうにきんちょうしたしゅんかんでした <br>The final match was a very tense moment.
二番	[sound:k-3476_二番.mp3]<br>にばん <br> second, number two, runner-up
second, number two, runner-up	<b>二番<b> <br> にばん <br>[sound:k-3476_二番.mp3]
[sound:k-3476_二番.mp3]	second, number two, runner-up<br> <b>二番</b> <br> (にばん)
<b>決意</b> <br> 彼は成功するために強い決意を持っています。	[sound:s-3476_彼は成功するために強い決意を持っています。.mp3] <br> かれはせいこうするためにつよいけついをもっています。 <br>He is determined to succeed.
[sound:s-3476_彼は成功するために強い決意を持っています。.mp3]	<b>決意</b> <br> 彼は成功するために強い決意を持っています。<br> かれはせいこうするためにつよいけついをもっています <br>He is determined to succeed.
順番	[sound:k-3477_順番.mp3]<br>じゅんばん <br> turn (in line), order of things, sequential order
turn (in line), order of things, sequential order	<b>順番<b> <br> じゅんばん <br>[sound:k-3477_順番.mp3]
[sound:k-3477_順番.mp3]	turn<br> <b>in line), order of things, sequential order (順番</b> <br> (じゅんばん)
<b>決断</b> <br> 彼は重大な決断を下さなければなりませんでした。	[sound:s-3477_彼は重大な決断を下さなければなりませんでした。.mp3] <br> かれはじゅうだいなけつだんをくださなければなりませんでした。 <br>He had to make a significant decision.
[sound:s-3477_彼は重大な決断を下さなければなりませんでした。.mp3]	<b>決断</b> <br> 彼は重大な決断を下さなければなりませんでした。<br> かれはじゅうだいなけつだんをくださなければなりませんでした <br>He had to make a significant decision.
番付	[sound:k-3478_番付.mp3]<br>ばんづけ <br> ranking of entertainers, sumo wrestlers, etc.
ranking of entertainers, sumo wrestlers, etc.	<b>番付<b> <br> ばんづけ <br>[sound:k-3478_番付.mp3]
[sound:k-3478_番付.mp3]	ranking of entertainers, sumo wrestlers, etc.<br> <b>番付</b> <br> (ばんづけ)
<b>子</b> <br> 彼女は可愛らしい子を持っています。	[sound:s-3478_彼女は可愛らしい子を持っています。.mp3] <br> かのじょはかわいらしいこをもっています。 <br>She has an adorable child.
[sound:s-3478_彼女は可愛らしい子を持っています。.mp3]	<b>子</b> <br> 彼女は可愛らしい子を持っています。<br> かのじょはかわいらしいこをもっています <br>She has an adorable child.
背番号	[sound:k-3479_背番号.mp3]<br>せばんごう <br> number on player's back
number on player's back	<b>背番号<b> <br> せばんごう <br>[sound:k-3479_背番号.mp3]
[sound:k-3479_背番号.mp3]	number on player's back<br> <b>背番号</b> <br> (せばんごう)
<b>子供</b> <br> 公園ではたくさんの子供が遊んでいます。	[sound:s-3479_公園ではたくさんの子供が遊んでいます。.mp3] <br> こうえんではたくさんのこどもがあそんでいます。 <br>Many children are playing in the park.
[sound:s-3479_公園ではたくさんの子供が遊んでいます。.mp3]	<b>子供</b> <br> 公園ではたくさんの子供が遊んでいます。<br> こうえんではたくさんのこどもがあそんでいます <br>Many children are playing in the park.
規制	[sound:k-3480_規制.mp3]<br>きせい <br> regulation, (traffic) policing, control, restriction
regulation, (traffic) policing, control, restriction	<b>規制<b> <br> きせい <br>[sound:k-3480_規制.mp3]
[sound:k-3480_規制.mp3]	regulation,<br> <b>traffic) policing, control, restriction (規制</b> <br> (きせい)
<b>女子</b> <br> 彼女は優れた女子選手です。	[sound:s-3480_彼女は優れた女子選手です。.mp3] <br> かのじょはすぐれたじょしせんしゅです。 <br>She is an excellent female athlete.
[sound:s-3480_彼女は優れた女子選手です。.mp3]	<b>女子</b> <br> 彼女は優れた女子選手です。<br> かのじょはすぐれたじょしせんしゅです <br>She is an excellent female athlete.
規模	[sound:k-3481_規模.mp3]<br>きぼ <br> scale, scope, plan, structure
scale, scope, plan, structure	<b>規模<b> <br> きぼ <br>[sound:k-3481_規模.mp3]
[sound:k-3481_規模.mp3]	scale, scope, plan, structure<br> <b>規模</b> <br> (きぼ)
<b>男子</b> <br> 男子チームは優勝しました。	[sound:s-3481_男子チームは優勝しました。.mp3] <br> たんしチームはゆうしょうしました。 <br>The boys' team won the championship.
[sound:s-3481_男子チームは優勝しました。.mp3]	<b>男子</b> <br> 男子チームは優勝しました。<br> たんしチームはゆうしょうしました <br>The boys' team won the championship.
規定	[sound:k-3482_規定.mp3]<br>きてい <br> regulation, provisions
regulation, provisions	<b>規定<b> <br> きてい <br>[sound:k-3482_規定.mp3]
[sound:k-3482_規定.mp3]	regulation, provisions<br> <b>規定</b> <br> (きてい)
<b>原子力</b> <br> 原子力は複雑な技術を必要とします。	[sound:s-3482_原子力は複雑な技術を必要とします。.mp3] <br> げんしりょくはふくざつなぎじゅつをひつようとします。 <br>Nuclear power requires complex technology.
[sound:s-3482_原子力は複雑な技術を必要とします。.mp3]	<b>原子力</b> <br> 原子力は複雑な技術を必要とします。<br> げんしりょくはふくざつなぎじゅつをひつようとします <br>Nuclear power requires complex technology.
大規模	[sound:k-3483_大規模.mp3]<br>だいきぼ <br> large-scale
large-scale	<b>大規模<b> <br> だいきぼ <br>[sound:k-3483_大規模.mp3]
[sound:k-3483_大規模.mp3]	large-scale<br> <b>大規模</b> <br> (だいきぼ)
<b>様子</b> <br> 彼の様子は少し心配です。	[sound:s-3483_彼の様子は少し心配です。.mp3] <br> かれのようすはすこししんぱいです。 <br>His condition seems a bit worrying.
[sound:s-3483_彼の様子は少し心配です。.mp3]	<b>様子</b> <br> 彼の様子は少し心配です。<br> かれのようすはすこししんぱいです <br>His condition seems a bit worrying.
新規	[sound:k-3484_新規.mp3]<br>しんき <br> new, fresh; new customer; new rules or regulations
new, fresh; new customer; new rules or regulations	<b>新規<b> <br> しんき <br>[sound:k-3484_新規.mp3]
[sound:k-3484_新規.mp3]	new, fresh; new customer; new rules or regulations<br> <b>新規</b> <br> (しんき)
<b>息子</b> <br> 彼の息子は医者になりたいと言っています。	[sound:s-3484_彼の息子は医者になりたいと言っています。.mp3] <br> かれのむすこはいしゃになりたいといっています。 <br>His son says he wants to become a doctor.
[sound:s-3484_彼の息子は医者になりたいと言っています。.mp3]	<b>息子</b> <br> 彼の息子は医者になりたいと言っています。<br> かれのむすこはいしゃになりたいといっています <br>His son says he wants to become a doctor.
規則	[sound:k-3485_規則.mp3]<br>きそく <br> rules, regulations, conventions
rules, regulations, conventions	<b>規則<b> <br> きそく <br>[sound:k-3485_規則.mp3]
[sound:k-3485_規則.mp3]	rules, regulations, conventions<br> <b>規則</b> <br> (きそく)
<b>金子</b> <br> その寺院には貴重な金子が保管されています。	[sound:s-3485_その寺院には貴重な金子が保管されています。.mp3] <br> そのてらいんにはきちょうなきんごがほかんされています。 <br>The temple stores precious gold.
[sound:s-3485_その寺院には貴重な金子が保管されています。.mp3]	<b>金子</b> <br> その寺院には貴重な金子が保管されています。<br> そのてらいんにはきちょうなきんごがほかんされています <br>The temple stores precious gold.
規格	[sound:k-3486_規格.mp3]<br>きかく <br> standard, norm
standard, norm	<b>規格<b> <br> きかく <br>[sound:k-3486_規格.mp3]
[sound:k-3486_規格.mp3]	standard, norm<br> <b>規格</b> <br> (きかく)
<b>甲子</b> <br> 甲子園は高校野球の全国大会です。	[sound:s-3486_甲子園は高校野球の全国大会です。.mp3] <br> こうしえんはこうこうやきゅうのぜんこくたいかいです。 <br>Koshien is the national high school baseball tournament.
[sound:s-3486_甲子園は高校野球の全国大会です。.mp3]	<b>甲子</b> <br> 甲子園は高校野球の全国大会です。<br> こうしえんはこうこうやきゅうのぜんこくたいかいです <br>Koshien is the national high school baseball tournament.
正規	[sound:k-3487_正規.mp3]<br>せいき <br> regular, legal, formal, established, legitimate
regular, legal, formal, established, legitimate	<b>正規<b> <br> せいき <br>[sound:k-3487_正規.mp3]
[sound:k-3487_正規.mp3]	regular, legal, formal, established, legitimate<br> <b>正規</b> <br> (せいき)
<b>遺伝子</b> <br> 遺伝子操作の技術は進歩しています。	[sound:s-3487_遺伝子操作の技術は進歩しています。.mp3] <br> いでんじそうさのぎじゅつはしんぽしています。 <br>Genetic engineering technology is advancing.
[sound:s-3487_遺伝子操作の技術は進歩しています。.mp3]	<b>遺伝子</b> <br> 遺伝子操作の技術は進歩しています。<br> いでんじそうさのぎじゅつはしんぽしています <br>Genetic engineering technology is advancing.
規約	[sound:k-3488_規約.mp3]<br>きやく <br> agreement, rules, code, protocol, convention
agreement, rules, code, protocol, convention	<b>規約<b> <br> きやく <br>[sound:k-3488_規約.mp3]
[sound:k-3488_規約.mp3]	agreement, rules, code, protocol, convention<br> <b>規約</b> <br> (きやく)
<b>動</b> <br> 彼女の感情が動き始めました。	[sound:s-3488_彼女の感情が動き始めました。.mp3] <br> かのじょのかんじょうがうごきはじめました。 <br>Her emotions began to stir.
[sound:s-3488_彼女の感情が動き始めました。.mp3]	<b>動</b> <br> 彼女の感情が動き始めました。<br> かのじょのかんじょうがうごきはじめました <br>Her emotions began to stir.
小規模	[sound:k-3489_小規模.mp3]<br>しょうきぼ <br> small scale
small scale	<b>小規模<b> <br> しょうきぼ <br>[sound:k-3489_小規模.mp3]
[sound:k-3489_小規模.mp3]	small scale<br> <b>小規模</b> <br> (しょうきぼ)
<b>動き</b> <br> その計画は動き出しました。	[sound:s-3489_その計画は動き出しました。.mp3] <br> そのけいかくはうごきだしました。 <br>The plan started to move forward.
[sound:s-3489_その計画は動き出しました。.mp3]	<b>動き</b> <br> その計画は動き出しました。<br> そのけいかくはうごきだしました <br>The plan started to move forward.
技術	[sound:k-3490_技術.mp3]<br>ぎじゅつ <br> art, craft, technique, technology, engineering, skill
art, craft, technique, technology, engineering, skill	<b>技術<b> <br> ぎじゅつ <br>[sound:k-3490_技術.mp3]
[sound:k-3490_技術.mp3]	art, craft, technique, technology, engineering, skill<br> <b>技術</b> <br> (ぎじゅつ)
<b>運動</b> <br> 毎日の運動は健康に良いです。	[sound:s-3490_毎日の運動は健康に良いです。.mp3] <br> まいにちのうんどうはけんこうにいいです。 <br>Daily exercise is good for health.
[sound:s-3490_毎日の運動は健康に良いです。.mp3]	<b>運動</b> <br> 毎日の運動は健康に良いです。<br> まいにちのうんどうはけんこうにいいです <br>Daily exercise is good for health.
芸術	[sound:k-3491_芸術.mp3]<br>げいじゅつ <br> (fine) art, the arts
(fine) art, the arts	<b>芸術<b> <br> げいじゅつ <br>[sound:k-3491_芸術.mp3]
[sound:k-3491_芸術.mp3]	(fine) art, the arts<br> <b>芸術</b> <br> (げいじゅつ)
<b>活動</b> <br> 彼は地域の慈善活動に積極的に参加しています。	[sound:s-3491_彼は地域の慈善活動に積極的に参加しています。.mp3] <br> かれはちいきのじせんかつどうにせっきょくてきにさんかしています。 <br>He actively participates in local charity activities.
[sound:s-3491_彼は地域の慈善活動に積極的に参加しています。.mp3]	<b>活動</b> <br> 彼は地域の慈善活動に積極的に参加しています。<br> かれはちいきのじせんかつどうにせっきょくてきにさんかしています <br>He actively participates in local charity activities.
美術	[sound:k-3492_美術.mp3]<br>びじゅつ <br> art, fine arts
art, fine arts	<b>美術<b> <br> びじゅつ <br>[sound:k-3492_美術.mp3]
[sound:k-3492_美術.mp3]	art, fine arts<br> <b>美術</b> <br> (びじゅつ)
<b>行動</b> <br> 彼の行動はその問題を解決するのに役立ちました。	[sound:s-3492_彼の行動はその問題を解決するのに役立ちました。.mp3] <br> かれのこうどうはそのもんだいをかいけつするのにやくたちました。 <br>His actions helped solve the problem.
[sound:s-3492_彼の行動はその問題を解決するのに役立ちました。.mp3]	<b>行動</b> <br> 彼の行動はその問題を解決するのに役立ちました。<br> かれのこうどうはそのもんだいをかいけつするのにやくたちました <br>His actions helped solve the problem.
手術	[sound:k-3493_手術.mp3]<br>しゅじゅつ <br> surgical operation
surgical operation	<b>手術<b> <br> しゅじゅつ <br>[sound:k-3493_手術.mp3]
[sound:k-3493_手術.mp3]	surgical operation<br> <b>手術</b> <br> (しゅじゅつ)
<b>自動車</b> <br> 私は自動車を運転するのが好きです。	[sound:s-3493_私は自動車を運転するのが好きです。.mp3] <br> わたしはしどうしゃをうんてんするのがすきです。 <br>I like driving cars.
[sound:s-3493_私は自動車を運転するのが好きです。.mp3]	<b>自動車</b> <br> 私は自動車を運転するのが好きです。<br> わたしはしどうしゃをうんてんするのがすきです <br>I like driving cars.
美術館	[sound:k-3494_美術館.mp3]<br>びじゅつかん <br> art gallery, art museum
art gallery, art museum	<b>美術館<b> <br> びじゅつかん <br>[sound:k-3494_美術館.mp3]
[sound:k-3494_美術館.mp3]	art gallery, art museum<br> <b>美術館</b> <br> (びじゅつかん)
<b>動物</b> <br> 動物園ではさまざまな動物を見ることができます。	[sound:s-3494_動物園ではさまざまな動物を見ることができます。.mp3] <br> どうぶつえんではさまざまなどうぶつをみることができます。 <br>You can see various animals at the zoo.
[sound:s-3494_動物園ではさまざまな動物を見ることができます。.mp3]	<b>動物</b> <br> 動物園ではさまざまな動物を見ることができます。<br> どうぶつえんではさまざまなどうぶつをみることができます <br>You can see various animals at the zoo.
戦術	[sound:k-3495_戦術.mp3]<br>せんじゅつ <br> tactics
tactics	<b>戦術<b> <br> せんじゅつ <br>[sound:k-3495_戦術.mp3]
[sound:k-3495_戦術.mp3]	tactics<br> <b>戦術</b> <br> (せんじゅつ)
<b>不動産</b> <br> 彼は不動産業界で成功しました。	[sound:s-3495_彼は不動産業界で成功しました。.mp3] <br> かれはふどうさんぎょうかいでせいこうしました。 <br>He succeeded in the real estate industry.
[sound:s-3495_彼は不動産業界で成功しました。.mp3]	<b>不動産</b> <br> 彼は不動産業界で成功しました。<br> かれはふどうさんぎょうかいでせいこうしました <br>He succeeded in the real estate industry.
技術者	[sound:k-3496_技術者.mp3]<br>ぎじゅつしゃ <br> engineer, technical expert, technician, crafts-person
engineer, technical expert, technician, crafts-person	<b>技術者<b> <br> ぎじゅつしゃ <br>[sound:k-3496_技術者.mp3]
[sound:k-3496_技術者.mp3]	engineer, technical expert, technician, crafts-person<br> <b>技術者</b> <br> (ぎじゅつしゃ)
<b>動向</b> <br> 彼の最近の動向は不透明です。	[sound:s-3496_彼の最近の動向は不透明です。.mp3] <br> かれのさいきんのどうこうはふとうめいです。 <br>His recent movements are unclear.
[sound:s-3496_彼の最近の動向は不透明です。.mp3]	<b>動向</b> <br> 彼の最近の動向は不透明です。<br> かれのさいきんのどうこうはふとうめいです <br>His recent movements are unclear.
学術	[sound:k-3497_学術.mp3]<br>がくじゅつ <br> science, learning, scholarship
science, learning, scholarship	<b>学術<b> <br> がくじゅつ <br>[sound:k-3497_学術.mp3]
[sound:k-3497_学術.mp3]	science, learning, scholarship<br> <b>学術</b> <br> (がくじゅつ)
<b>移動</b> <br> 彼は海外への転勤で家族と一緒に移動しました。	[sound:s-3497_彼は海外への転勤で家族と一緒に移動しました。.mp3] <br> かれはかいがいへのてんきんでかぞくといっしょにいどうしました。 <br>He moved abroad with his family due to a job transfer.
[sound:s-3497_彼は海外への転勤で家族と一緒に移動しました。.mp3]	<b>移動</b> <br> 彼は海外への転勤で家族と一緒に移動しました。<br> かれはかいがいへのてんきんでかぞくといっしょにいどうしました <br>He moved abroad with his family due to a job transfer.
科学技術庁	[sound:k-3498_科学技術庁.mp3]<br>かがくぎじゅつちょう <br> Science and Technology Agency
Science and Technology Agency	<b>科学技術庁<b> <br> かがくぎじゅつちょう <br>[sound:k-3498_科学技術庁.mp3]
[sound:k-3498_科学技術庁.mp3]	Science and Technology Agency<br> <b>科学技術庁</b> <br> (かがくぎじゅつちょう)
<b>京</b> <br> 日本の首都は東京です。	[sound:s-3498_日本の首都は東京です。.mp3] <br> にほんのしゅとはとうきょうです。 <br>The capital of Japan is Tokyo.
[sound:s-3498_日本の首都は東京です。.mp3]	<b>京</b> <br> 日本の首都は東京です。<br> にほんのしゅとはとうきょうです <br>The capital of Japan is Tokyo.
技術的	[sound:k-3499_技術的.mp3]<br>ぎじゅつてき <br> technical, practical
technical, practical	<b>技術的<b> <br> ぎじゅつてき <br>[sound:k-3499_技術的.mp3]
[sound:k-3499_技術的.mp3]	technical, practical<br> <b>技術的</b> <br> (ぎじゅつてき)
<b>東京</b> <br> 東京は世界有数の大都市です。	[sound:s-3499_東京は世界有数の大都市です。.mp3] <br> とうきょうはせかいゆうすうのたいとしです。 <br>Tokyo is one of the world's leading metropolises.
[sound:s-3499_東京は世界有数の大都市です。.mp3]	<b>東京</b> <br> 東京は世界有数の大都市です。<br> とうきょうはせかいゆうすうのたいとしです <br>Tokyo is one of the world's leading metropolises.
保護	[sound:k-3500_保護.mp3]<br>ほご <br> care, protection, shelter, safeguard, guardianship, favor, favour, patronage
care, protection, shelter, safeguard, guardianship, favor, favour, patronage	<b>保護<b> <br> ほご <br>[sound:k-3500_保護.mp3]
[sound:k-3500_保護.mp3]	care, protection, shelter, safeguard, guardianship, favor, favour, patronage<br> <b>保護</b> <br> (ほご)
<b>北京</b> <br> 北京は中国の首都です。	[sound:s-3500_北京は中国の首都です。.mp3] <br> べいじんはちゅうごくのしゅとです。 <br>Beijing is the capital of China.
[sound:s-3500_北京は中国の首都です。.mp3]	<b>北京</b> <br> 北京は中国の首都です。<br> べいじんはちゅうごくのしゅとです <br>Beijing is the capital of China.
弁護士	[sound:k-3501_弁護士.mp3]<br>べんごし <br> lawyer, attorney
lawyer, attorney	<b>弁護士<b> <br> べんごし <br>[sound:k-3501_弁護士.mp3]
[sound:k-3501_弁護士.mp3]	lawyer, attorney<br> <b>弁護士</b> <br> (べんごし)
<b>京都</b> <br> 京都は日本の歴史的な都市です。	[sound:s-3501_京都は日本の歴史的な都市です。.mp3] <br> きょうとはにほんのれきしてきなとしです。 <br>Kyoto is a historically significant city in Japan.
[sound:s-3501_京都は日本の歴史的な都市です。.mp3]	<b>京都</b> <br> 京都は日本の歴史的な都市です。<br> きょうとはにほんのれきしてきなとしです <br>Kyoto is a historically significant city in Japan.
看護婦	[sound:k-3502_看護婦.mp3]<br>かんごふ <br> (female) nurse
(female) nurse	<b>看護婦<b> <br> かんごふ <br>[sound:k-3502_看護婦.mp3]
[sound:k-3502_看護婦.mp3]	(female) nurse<br> <b>看護婦</b> <br> (かんごふ)
<b>東京証券取引所</b> <br> 東京証券取引所は日本の経済の中心です。	[sound:s-3502_東京証券取引所は日本の経済の中心です。.mp3] <br> とうきょうしょうけんとりひきじょはにほんのけいさいのちゅうしんです。 <br>The Tokyo Stock Exchange is the center of Japan's economy.
[sound:s-3502_東京証券取引所は日本の経済の中心です。.mp3]	<b>東京証券取引所</b> <br> 東京証券取引所は日本の経済の中心です。<br> とうきょうしょうけんとりひきじょはにほんのけいさいのちゅうしんです <br>The Tokyo Stock Exchange is the center of Japan's economy.
介護	[sound:k-3503_介護.mp3]<br>かいご <br> nursing
nursing	<b>介護<b> <br> かいご <br>[sound:k-3503_介護.mp3]
[sound:k-3503_介護.mp3]	nursing<br> <b>介護</b> <br> (かいご)
<b>帝京</b> <br> 帝京大学は歴史ある大学です。	[sound:s-3503_帝京大学は歴史ある大学です。.mp3] <br> ていきょうだいがくはれきしあるだいがくです。 <br>Teikyo University is a prestigious university.
[sound:s-3503_帝京大学は歴史ある大学です。.mp3]	<b>帝京</b> <br> 帝京大学は歴史ある大学です。<br> ていきょうだいがくはれきしあるだいがくです <br>Teikyo University is a prestigious university.
看護	[sound:k-3504_看護.mp3]<br>かんご <br> nursing, (army) nurse
nursing, (army) nurse	<b>看護<b> <br> かんご <br>[sound:k-3504_看護.mp3]
[sound:k-3504_看護.mp3]	nursing,<br> <b>army) nurse (看護</b> <br> (かんご)
<b>中京</b> <br> 中京地域は産業の中心地です。	[sound:s-3504_中京地域は産業の中心地です。.mp3] <br> ちゅうきょうちいきはさんぎょうのちゅうしんちです。 <br>The Chukyo region is an industrial hub.
[sound:s-3504_中京地域は産業の中心地です。.mp3]	<b>中京</b> <br> 中京地域は産業の中心地です。<br> ちゅうきょうちいきはさんぎょうのちゅうしんちです <br>The Chukyo region is an industrial hub.
弁護	[sound:k-3505_弁護.mp3]<br>べんご <br> defense, defence, pleading, advocacy
defense, defence, pleading, advocacy	<b>弁護<b> <br> べんご <br>[sound:k-3505_弁護.mp3]
[sound:k-3505_弁護.mp3]	defense, defence, pleading, advocacy<br> <b>弁護</b> <br> (べんご)
<b>在京</b> <br> 彼は現在在京しています。	[sound:s-3505_彼は現在在京しています。.mp3] <br> かれはげんざいざいきょうしています。 <br>He is currently residing in Tokyo.
[sound:s-3505_彼は現在在京しています。.mp3]	<b>在京</b> <br> 彼は現在在京しています。<br> かれはげんざいざいきょうしています <br>He is currently residing in Tokyo.
護憲	[sound:k-3506_護憲.mp3]<br>ごけん <br> protecting the constitution
protecting the constitution	<b>護憲<b> <br> ごけん <br>[sound:k-3506_護憲.mp3]
[sound:k-3506_護憲.mp3]	protecting the constitution<br> <b>護憲</b> <br> (ごけん)
<b>上京</b> <br> 彼女は進学のために上京しました。	[sound:s-3506_彼女は進学のために上京しました。.mp3] <br> かのじょはしんがくのためにじょうきょうしました。 <br>She moved to Tokyo for further education.
[sound:s-3506_彼女は進学のために上京しました。.mp3]	<b>上京</b> <br> 彼女は進学のために上京しました。<br> かのじょはしんがくのためにじょうきょうしました <br>She moved to Tokyo for further education.
防護	[sound:k-3507_防護.mp3]<br>ぼうご <br> protection
protection	<b>防護<b> <br> ぼうご <br>[sound:k-3507_防護.mp3]
[sound:k-3507_防護.mp3]	protection<br> <b>防護</b> <br> (ぼうご)
<b>京成</b> <br> 京成線は東京と千葉を結ぶ鉄道路線です。	[sound:s-3507_京成線は東京と千葉を結ぶ鉄道路線です。.mp3] <br> けいせいせんはとうきょうとちばをむすぶてつどうろせんです。 <br>The Keisei Line is a railway line connecting Tokyo and Chiba.
[sound:s-3507_京成線は東京と千葉を結ぶ鉄道路線です。.mp3]	<b>京成</b> <br> 京成線は東京と千葉を結ぶ鉄道路線です。<br> けいせいせんはとうきょうとちばをむすぶてつどうろせんです <br>The Keisei Line is a railway line connecting Tokyo and Chiba.
援護	[sound:k-3508_援護.mp3]<br>えんご <br> covering, protection, backing, relief
covering, protection, backing, relief	<b>援護<b> <br> えんご <br>[sound:k-3508_援護.mp3]
[sound:k-3508_援護.mp3]	covering, protection, backing, relief<br> <b>援護</b> <br> (えんご)
<b>安全</b> <br> 安全な環境が重要です。	[sound:s-3508_安全な環境が重要です。.mp3] <br> あんぜんなかんきょうがじゅうようです。 <br>A safe environment is crucial.
[sound:s-3508_安全な環境が重要です。.mp3]	<b>安全</b> <br> 安全な環境が重要です。<br> あんぜんなかんきょうがじゅうようです <br>A safe environment is crucial.
擁護	[sound:k-3509_擁護.mp3]<br>ようご <br> protection, advocacy, support, defence, championship, vindication; to protect (e.g. rights, etc.), to advocate (e.g. free trade, etc.), to support
protection, advocacy, support, defence, championship, vindication; to protect (e.g. rights, etc.), to advocate (e.g. free trade, etc.), to support	<b>擁護<b> <br> ようご <br>[sound:k-3509_擁護.mp3]
[sound:k-3509_擁護.mp3]	protection, advocacy, support, defence, championship, vindication; to protect<br> <b>e.g. rights, etc.), to advocate (e.g. free trade, etc.), to support (擁護</b> <br> (ようご)
<b>全体</b> <br> 全体的な変化が見られます。	[sound:s-3509_全体的な変化が見られます。.mp3] <br> ぜんたいてきなへんかがみられます。 <br>Overall changes can be observed.
[sound:s-3509_全体的な変化が見られます。.mp3]	<b>全体</b> <br> 全体的な変化が見られます。<br> ぜんたいてきなへんかがみられます <br>Overall changes can be observed.
展開	[sound:k-3510_展開.mp3]<br>てんかい <br> development; expansion (opposite of compression)
development; expansion (opposite of compression)	<b>展開<b> <br> てんかい <br>[sound:k-3510_展開.mp3]
[sound:k-3510_展開.mp3]	development; expansion<br> <b>opposite of compression) (展開</b> <br> (てんかい)
<b>全国</b> <br> そのイベントは全国から参加者が集まりました。	[sound:s-3510_そのイベントは全国から参加者が集まりました。.mp3] <br> そのイベントはぜんこくからさんかしゃがあつまりました。 <br>Participants from all over the country gathered at the event.
[sound:s-3510_そのイベントは全国から参加者が集まりました。.mp3]	<b>全国</b> <br> そのイベントは全国から参加者が集まりました。<br> そのイベントはぜんこくからさんかしゃがあつまりました <br>Participants from all over the country gathered at the event.
発展	[sound:k-3511_発展.mp3]<br>はってん <br> development, growth
development, growth	<b>発展<b> <br> はってん <br>[sound:k-3511_発展.mp3]
[sound:k-3511_発展.mp3]	development, growth<br> <b>発展</b> <br> (はってん)
<b>安全保障</b> <br> 安全保障政策は国の安定に不可欠です。	[sound:s-3511_安全保障政策は国の安定に不可欠です。.mp3] <br> あんぜんほしょうせいさくはくにのあんていにふかけつです。 <br>Security policies are essential for national stability.
[sound:s-3511_安全保障政策は国の安定に不可欠です。.mp3]	<b>安全保障</b> <br> 安全保障政策は国の安定に不可欠です。<br> あんぜんほしょうせいさくはくにのあんていにふかけつです <br>Security policies are essential for national stability.
進展	[sound:k-3512_進展.mp3]<br>しんてん <br> progress, development
progress, development	<b>進展<b> <br> しんてん <br>[sound:k-3512_進展.mp3]
[sound:k-3512_進展.mp3]	progress, development<br> <b>進展</b> <br> (しんてん)
<b>全員</b> <br> 会議には全員出席してください。	[sound:s-3512_会議には全員出席してください。.mp3] <br> かいぎにはぜんいんしゅっせきしてください。 <br>"Please attend the meeting, everyone."
[sound:s-3512_会議には全員出席してください。.mp3]	<b>全員</b> <br> 会議には全員出席してください。<br> かいぎにはぜんいんしゅっせきしてください <br>Please attend the meeting, everyone.
展示	[sound:k-3513_展示.mp3]<br>てんじ <br> exhibition, display
exhibition, display	<b>展示<b> <br> てんじ <br>[sound:k-3513_展示.mp3]
[sound:k-3513_展示.mp3]	exhibition, display<br> <b>展示</b> <br> (てんじ)
<b>全日</b> <br> 全日制の学校に通っています。	[sound:s-3513_全日制の学校に通っています。.mp3] <br> ぜんにちせいのがっこうにかよっています。 <br>I go to a full-time school.
[sound:s-3513_全日制の学校に通っています。.mp3]	<b>全日</b> <br> 全日制の学校に通っています。<br> ぜんにちせいのがっこうにかよっています <br>I go to a full-time school.
展望	[sound:k-3514_展望.mp3]<br>てんぼう <br> view, outlook, prospect
view, outlook, prospect	<b>展望<b> <br> てんぼう <br>[sound:k-3514_展望.mp3]
[sound:k-3514_展望.mp3]	view, outlook, prospect<br> <b>展望</b> <br> (てんぼう)
<b>全面</b> <br> その改革は全面的に支持されました。	[sound:s-3514_その改革は全面的に支持されました。.mp3] <br> そのかいかくはぜんめんてきにしびされました。 <br>The reform was fully supported.
[sound:s-3514_その改革は全面的に支持されました。.mp3]	<b>全面</b> <br> その改革は全面的に支持されました。<br> そのかいかくはぜんめんてきにしびされました <br>The reform was fully supported.
展覧会	[sound:k-3515_展覧会.mp3]<br>てんらんかい <br> exhibition
exhibition	<b>展覧会<b> <br> てんらんかい <br>[sound:k-3515_展覧会.mp3]
[sound:k-3515_展覧会.mp3]	exhibition<br> <b>展覧会</b> <br> (てんらんかい)
<b>心不全</b> <br> 彼は心不全の症状を訴えています。	[sound:s-3515_彼は心不全の症状を訴えています。.mp3] <br> かれはしんふぜんのしょうじょうをうっています。 <br>He complains of symptoms of heart failure.
[sound:s-3515_彼は心不全の症状を訴えています。.mp3]	<b>心不全</b> <br> 彼は心不全の症状を訴えています。<br> かれはしんふぜんのしょうじょうをうっています <br>He complains of symptoms of heart failure.
個展	[sound:k-3516_個展.mp3]<br>こてん <br> one-man exhibition, one-woman exhibition
one-man exhibition, one-woman exhibition	<b>個展<b> <br> こてん <br>[sound:k-3516_個展.mp3]
[sound:k-3516_個展.mp3]	one-man exhibition, one-woman exhibition<br> <b>個展</b> <br> (こてん)
<b>全部</b> <br> 全部を理解するのは難しいです。	[sound:s-3516_全部を理解するのは難しいです。.mp3] <br> ぜんぶをりかいするのはむずかしいです。 <br>Understanding everything is difficult.
[sound:s-3516_全部を理解するのは難しいです。.mp3]	<b>全部</b> <br> 全部を理解するのは難しいです。<br> ぜんぶをりかいするのはむずかしいです <br>Understanding everything is difficult.
展示会	[sound:k-3517_展示会.mp3]<br>てんじかい <br> exhibition
exhibition	<b>展示会<b> <br> てんじかい <br>[sound:k-3517_展示会.mp3]
[sound:k-3517_展示会.mp3]	exhibition<br> <b>展示会</b> <br> (てんじかい)
<b>全力</b> <br> 彼は全力で仕事に取り組んでいます。	[sound:s-3517_彼は全力で仕事に取り組んでいます。.mp3] <br> かれはぜんりょくでしごとにとりくんでいます。 <br>He is putting all his effort into his work.
[sound:s-3517_彼は全力で仕事に取り組んでいます。.mp3]	<b>全力</b> <br> 彼は全力で仕事に取り組んでいます。<br> かれはぜんりょくでしごとにとりくんでいます <br>He is putting all his effort into his work.
出展	[sound:k-3518_出展.mp3]<br>しゅってん <br> exhibit, display
exhibit, display	<b>出展<b> <br> しゅってん <br>[sound:k-3518_出展.mp3]
[sound:k-3518_出展.mp3]	exhibit, display<br> <b>出展</b> <br> (しゅってん)
<b>目的</b> <br> 旅行の目的はリラックスすることです。	[sound:s-3518_旅行の目的はリラックスすることです。.mp3] <br> りょこうのもくてきはりらっくすすることです。 <br>The purpose of the trip is to relax.
[sound:s-3518_旅行の目的はリラックスすることです。.mp3]	<b>目的</b> <br> 旅行の目的はリラックスすることです。<br> りょこうのもくてきはりらっくすすることです <br>The purpose of the trip is to relax.
美術展	[sound:k-3519_美術展.mp3]<br>びじゅつてん <br> art exhibition
art exhibition	<b>美術展<b> <br> びじゅつてん <br>[sound:k-3519_美術展.mp3]
[sound:k-3519_美術展.mp3]	art exhibition<br> <b>美術展</b> <br> (びじゅつてん)
<b>目標</b> <br> 成功するためには明確な目標を持つ必要があります。	[sound:s-3519_成功するためには明確な目標を持つ必要があります。.mp3] <br> せいこうするためにはめいかくなもくひょうをもつひつようがあります。 <br>"To succeed, you need to have clear goals."
[sound:s-3519_成功するためには明確な目標を持つ必要があります。.mp3]	<b>目標</b> <br> 成功するためには明確な目標を持つ必要があります。<br> せいこうするためにはめいかくなもくひょうをもつひつようがあります <br>To succeed, you need to have clear goals.
状態	[sound:k-3520_状態.mp3]<br>じょうたい <br> current status, condition, situation, circumstances, state
current status, condition, situation, circumstances, state	<b>状態<b> <br> じょうたい <br>[sound:k-3520_状態.mp3]
[sound:k-3520_状態.mp3]	current status, condition, situation, circumstances, state<br> <b>状態</b> <br> (じょうたい)
<b>注目</b> <br> 彼女の演技は注目されています。	[sound:s-3520_彼女の演技は注目されています。.mp3] <br> かのじょのえんぎはちゅうもくされています。 <br>Her performance is drawing attention.
[sound:s-3520_彼女の演技は注目されています。.mp3]	<b>注目</b> <br> 彼女の演技は注目されています。<br> かのじょのえんぎはちゅうもくされています <br>Her performance is drawing attention.
事態	[sound:k-3521_事態.mp3]<br>じたい <br> situation, (present) state of affairs, circumstances
situation, (present) state of affairs, circumstances	<b>事態<b> <br> じたい <br>[sound:k-3521_事態.mp3]
[sound:k-3521_事態.mp3]	situation,<br> <b>present) state of affairs, circumstances (事態</b> <br> (じたい)
<b>項目</b> <br> この書類には複数の項目が含まれています。	[sound:s-3521_この書類には複数の項目が含まれています。.mp3] <br> このしょるいにはふくすうのこうもくがふくまれています。 <br>This document contains multiple items.
[sound:s-3521_この書類には複数の項目が含まれています。.mp3]	<b>項目</b> <br> この書類には複数の項目が含まれています。<br> このしょるいにはふくすうのこうもくがふくまれています <br>This document contains multiple items.
実態	[sound:k-3522_実態.mp3]<br>じったい <br> true state, actual condition, reality
true state, actual condition, reality	<b>実態<b> <br> じったい <br>[sound:k-3522_実態.mp3]
[sound:k-3522_実態.mp3]	true state, actual condition, reality<br> <b>実態</b> <br> (じったい)
<b>名目</b> <br> これは名目上の役職です。	[sound:s-3522_これは名目上の役職です。.mp3] <br> これはめいもくじょうのやくしょくです。 <br>This is a nominal position.
[sound:s-3522_これは名目上の役職です。.mp3]	<b>名目</b> <br> これは名目上の役職です。<br> これはめいもくじょうのやくしょくです <br>This is a nominal position.
態度	[sound:k-3523_態度.mp3]<br>たいど <br> attitude, manner, behaviour
attitude, manner, behaviour	<b>態度<b> <br> たいど <br>[sound:k-3523_態度.mp3]
[sound:k-3523_態度.mp3]	attitude, manner, behaviour<br> <b>態度</b> <br> (たいど)
<b>種目</b> <br> 五輪競技には多くの種目があります。	[sound:s-3523_五輪競技には多くの種目があります。.mp3] <br> ごりんきょうきにはおおくのしゅもくがあります。 <br>There are many events in the Olympics.
[sound:s-3523_五輪競技には多くの種目があります。.mp3]	<b>種目</b> <br> 五輪競技には多くの種目があります。<br> ごりんきょうきにはおおくのしゅもくがあります <br>There are many events in the Olympics.
態	[sound:k-3524_態.mp3]<br>ざま <br> mess, sorry state, plight, sad sight; way, manner
mess, sorry state, plight, sad sight; way, manner	<b>態<b> <br> ざま <br>[sound:k-3524_態.mp3]
[sound:k-3524_態.mp3]	mess, sorry state, plight, sad sight; way, manner<br> <b>態</b> <br> (ざま)
<b>目玉</b> <br> その新製品は会社の目玉商品です。	[sound:s-3524_その新製品は会社の目玉商品です。.mp3] <br> そのしんせいひんはかいしゃのめだましょうひんです。 <br>That new product is the company's flagship product.
[sound:s-3524_その新製品は会社の目玉商品です。.mp3]	<b>目玉</b> <br> その新製品は会社の目玉商品です。<br> そのしんせいひんはかいしゃのめだましょうひんです <br>That new product is the company's flagship product.
態勢	[sound:k-3525_態勢.mp3]<br>たいせい <br> attitude, conditions, preparations
attitude, conditions, preparations	<b>態勢<b> <br> たいせい <br>[sound:k-3525_態勢.mp3]
[sound:k-3525_態勢.mp3]	attitude, conditions, preparations<br> <b>態勢</b> <br> (たいせい)
<b>目前</b> <br> 問題の解決は目前に迫っています。	[sound:s-3525_問題の解決は目前に迫っています。.mp3] <br> もんだいのかいけつはもくぜんにせまっています。 <br>The solution to the problem is imminent.
[sound:s-3525_問題の解決は目前に迫っています。.mp3]	<b>目前</b> <br> 問題の解決は目前に迫っています。<br> もんだいのかいけつはもくぜんにせまっています <br>The solution to the problem is imminent.
形態	[sound:k-3526_形態.mp3]<br>けいたい <br> form, shape, figure
form, shape, figure	<b>形態<b> <br> けいたい <br>[sound:k-3526_形態.mp3]
[sound:k-3526_形態.mp3]	form, shape, figure<br> <b>形態</b> <br> (けいたい)
<b>目の前</b> <br> 彼女は目の前でその事故を目撃しました。	[sound:s-3526_彼女は目の前でその事故を目撃しました。.mp3] <br> かのじょはめのまえでそのじこをもくげきしました。 <br>She witnessed the accident right in front of her.
[sound:s-3526_彼女は目の前でその事故を目撃しました。.mp3]	<b>目の前</b> <br> 彼女は目の前でその事故を目撃しました。<br> かのじょはめのまえでそのじこをもくげきしました <br>She witnessed the accident right in front of her.
実態調査	[sound:k-3527_実態調査.mp3]<br>じったいちょうさ <br> factual investigation
factual investigation	<b>実態調査<b> <br> じったいちょうさ <br>[sound:k-3527_実態調査.mp3]
[sound:k-3527_実態調査.mp3]	factual investigation<br> <b>実態調査</b> <br> (じったいちょうさ)
<b>品目</b> <br> この店ではさまざまな品目を取り扱っています。	[sound:s-3527_この店ではさまざまな品目を取り扱っています。.mp3] <br> このみせではさまざまなしなもくをとりあつかっています。 <br>This store deals with various items.
[sound:s-3527_この店ではさまざまな品目を取り扱っています。.mp3]	<b>品目</b> <br> この店ではさまざまな品目を取り扱っています。<br> このみせではさまざまなしなもくをとりあつかっています <br>This store deals with various items.
生態系	[sound:k-3528_生態系.mp3]<br>せいたいけい <br> ecosystem
ecosystem	<b>生態系<b> <br> せいたいけい <br>[sound:k-3528_生態系.mp3]
[sound:k-3528_生態系.mp3]	ecosystem<br> <b>生態系</b> <br> (せいたいけい)
<b>表</b> <br> この表には最新の情報が載っています。	[sound:s-3528_この表には最新の情報が載っています。.mp3] <br> このひょうにはさいしんのじょうほうがのっています。 <br>This table contains the latest information.
[sound:s-3528_この表には最新の情報が載っています。.mp3]	<b>表</b> <br> この表には最新の情報が載っています。<br> このひょうにはさいしんのじょうほうがのっています <br>This table contains the latest information.
生態	[sound:k-3529_生態.mp3]<br>せいたい <br> mode of life, ecology; (animal) territory
mode of life, ecology; (animal) territory	<b>生態<b> <br> せいたい <br>[sound:k-3529_生態.mp3]
[sound:k-3529_生態.mp3]	mode of life, ecology;<br> <b>animal) territory (生態</b> <br> (せいたい)
<b>代表</b> <br> 彼はチームの代表として出場します。	[sound:s-3529_彼はチームの代表として出場します。.mp3] <br> かれはチームのだいひょうとしてしゅつじょうします。 <br>He will participate as the team's representative.
[sound:s-3529_彼はチームの代表として出場します。.mp3]	<b>代表</b> <br> 彼はチームの代表として出場します。<br> かれはチームのだいひょうとしてしゅつじょうします <br>He will participate as the team's representative.
指導	[sound:k-3530_指導.mp3]<br>しどう <br> leadership, guidance, coaching; shido (disciplinary action for a minor infringement of the rules of judo)
leadership, guidance, coaching; shido (disciplinary action for a minor infringement of the rules of judo)	<b>指導<b> <br> しどう <br>[sound:k-3530_指導.mp3]
[sound:k-3530_指導.mp3]	leadership, guidance, coaching; shido<br> <b>disciplinary action for a minor infringement of the rules of judo) (指導</b> <br> (しどう)
<b>発表</b> <br> 彼の新しい発表は驚きました。	[sound:s-3530_彼の新しい発表は驚きました。.mp3] <br> かれのあたらしいはっぴょうはおどろきました。 <br>His new presentation was surprising.
[sound:s-3530_彼の新しい発表は驚きました。.mp3]	<b>発表</b> <br> 彼の新しい発表は驚きました。<br> かれのあたらしいはっぴょうはおどろきました <br>His new presentation was surprising.
導入	[sound:k-3531_導入.mp3]<br>どうにゅう <br> introduction, bringing in, leading in, installation
introduction, bringing in, leading in, installation	<b>導入<b> <br> どうにゅう <br>[sound:k-3531_導入.mp3]
[sound:k-3531_導入.mp3]	introduction, bringing in, leading in, installation<br> <b>導入</b> <br> (どうにゅう)
<b>表現</b> <br> 彼の表現力は素晴らしいです。	[sound:s-3531_彼の表現力は素晴らしいです。.mp3] <br> かれのひょうげんりょくはすばらしいです。 <br>His expression skills are excellent.
[sound:s-3531_彼の表現力は素晴らしいです。.mp3]	<b>表現</b> <br> 彼の表現力は素晴らしいです。<br> かれのひょうげんりょくはすばらしいです <br>His expression skills are excellent.
主導	[sound:k-3532_主導.mp3]<br>しゅどう <br> main leadership
main leadership	<b>主導<b> <br> しゅどう <br>[sound:k-3532_主導.mp3]
[sound:k-3532_主導.mp3]	main leadership<br> <b>主導</b> <br> (しゅどう)
<b>表情</b> <br> 彼女の表情から彼女の気持ちがわかります。	[sound:s-3532_彼女の表情から彼女の気持ちがわかります。.mp3] <br> かのじょのひょうじょうからかのじょのきもちがわかります。 <br>You can tell how she feels from her expression.
[sound:s-3532_彼女の表情から彼女の気持ちがわかります。.mp3]	<b>表情</b> <br> 彼女の表情から彼女の気持ちがわかります。<br> かのじょのひょうじょうからかのじょのきもちがわかります <br>You can tell how she feels from her expression.
半導体	[sound:k-3533_半導体.mp3]<br>はんどうたい <br> semiconductor, solid-state
semiconductor, solid-state	<b>半導体<b> <br> はんどうたい <br>[sound:k-3533_半導体.mp3]
[sound:k-3533_半導体.mp3]	semiconductor, solid-state<br> <b>半導体</b> <br> (はんどうたい)
<b>表明</b> <br> 彼は真実を表明しました。	[sound:s-3533_彼は真実を表明しました。.mp3] <br> かれはしんじつをひょうめいしました。 <br>He confessed the truth.
[sound:s-3533_彼は真実を表明しました。.mp3]	<b>表明</b> <br> 彼は真実を表明しました。<br> かれはしんじつをひょうめいしました <br>He confessed the truth.
主導権	[sound:k-3534_主導権.mp3]<br>しゅどうけん <br> hegemony, leadership, initiative
hegemony, leadership, initiative	<b>主導権<b> <br> しゅどうけん <br>[sound:k-3534_主導権.mp3]
[sound:k-3534_主導権.mp3]	hegemony, leadership, initiative<br> <b>主導権</b> <br> (しゅどうけん)
<b>表れ</b> <br> 彼の表れた行動は彼の性格を示しています。	[sound:s-3534_彼の表れた行動は彼の性格を示しています。.mp3] <br> かれのあらわれたこうどうはかれのせいかくをしめしています。 <br>His actions revealed his character.
[sound:s-3534_彼の表れた行動は彼の性格を示しています。.mp3]	<b>表れ</b> <br> 彼の表れた行動は彼の性格を示しています。<br> かれのあらわれたこうどうはかれのせいかくをしめしています <br>His actions revealed his character.
誘導	[sound:k-3535_誘導.mp3]<br>ゆうどう <br> guidance, leading, induction, introduction, incitement, inducement
guidance, leading, induction, introduction, incitement, inducement	<b>誘導<b> <br> ゆうどう <br>[sound:k-3535_誘導.mp3]
[sound:k-3535_誘導.mp3]	guidance, leading, induction, introduction, incitement, inducement<br> <b>誘導</b> <br> (ゆうどう)
<b>表示</b> <br> この画面には重要な情報が表示されています。	[sound:s-3535_この画面には重要な情報が表示されています。.mp3] <br> このがめんにはじゅうようなじょうほうがひょうじされています。 <br>Important information is displayed on this screen.
[sound:s-3535_この画面には重要な情報が表示されています。.mp3]	<b>表示</b> <br> この画面には重要な情報が表示されています。<br> このがめんにはじゅうようなじょうほうがひょうじされています <br>Important information is displayed on this screen.
超電導	[sound:k-3536_超電導.mp3]<br>ちょうでんどう <br> superconductivity
superconductivity	<b>超電導<b> <br> ちょうでんどう <br>[sound:k-3536_超電導.mp3]
[sound:k-3536_超電導.mp3]	superconductivity<br> <b>超電導</b> <br> (ちょうでんどう)
<b>表面</b> <br> 表面の傷は修復できますか?	[sound:s-3536_表面の傷は修復できますか?.mp3] <br> ひょうめんのきずはしゅうふくできますか? <br>Can the surface scratches be repaired?
[sound:s-3536_表面の傷は修復できますか?.mp3]	(<b>表面</b>) 表面の傷は修復できますか?	ひょうめんのきずはしゅうふくできますか? <br>Can the surface scratches be repaired?
学習指導要領	[sound:k-3537_学習指導要領.mp3]<br>がくしゅうしどうようりょう <br> government course (curriculum) guidelines
government course (curriculum) guidelines	<b>学習指導要領<b> <br> がくしゅうしどうようりょう <br>[sound:k-3537_学習指導要領.mp3]
[sound:k-3537_学習指導要領.mp3]	government course<br> <b>curriculum) guidelines (学習指導要領</b> <br> (がくしゅうしどうようりょう)
<b>公表</b> <br> 新しい政策が公表されました。	[sound:s-3537_新しい政策が公表されました。.mp3] <br> あたらしいせいさくがこうひょうされました。 <br>The new policy has been announced.
[sound:s-3537_新しい政策が公表されました。.mp3]	<b>公表</b> <br> 新しい政策が公表されました。<br> あたらしいせいさくがこうひょうされました <br>The new policy has been announced.
盲導犬	[sound:k-3538_盲導犬.mp3]<br>もうどうけん <br> guide dog for the blind, seeing eye dog
guide dog for the blind, seeing eye dog	<b>盲導犬<b> <br> もうどうけん <br>[sound:k-3538_盲導犬.mp3]
[sound:k-3538_盲導犬.mp3]	guide dog for the blind, seeing eye dog<br> <b>盲導犬</b> <br> (もうどうけん)
<b>戦い</b> <br> 彼らは激しい戦いを繰り広げました。	[sound:s-3538_彼らは激しい戦いを繰り広げました。.mp3] <br> かれらははげしいたたかいをくりひろげました。 <br>They fought a fierce battle.
[sound:s-3538_彼らは激しい戦いを繰り広げました。.mp3]	<b>戦い</b> <br> 彼らは激しい戦いを繰り広げました。<br> かれらははげしいたたかいをくりひろげました <br>They fought a fierce battle.
先導	[sound:k-3539_先導.mp3]<br>せんどう <br> guidance, leadership
guidance, leadership	<b>先導<b> <br> せんどう <br>[sound:k-3539_先導.mp3]
[sound:k-3539_先導.mp3]	guidance, leadership<br> <b>先導</b> <br> (せんどう)
<b>戦争</b> <br> 戦争は多くの犠牲者を出しました。	[sound:s-3539_戦争は多くの犠牲者を出しました。.mp3] <br> せんそうはおおくのぎせいじゃをだしました。 <br>The war resulted in many casualties.
[sound:s-3539_戦争は多くの犠牲者を出しました。.mp3]	<b>戦争</b> <br> 戦争は多くの犠牲者を出しました。<br> せんそうはおおくのぎせいじゃをだしました <br>The war resulted in many casualties.
北朝鮮	[sound:k-3540_北朝鮮.mp3]<br>きたちょうせん <br> North Korea
North Korea	<b>北朝鮮<b> <br> きたちょうせん <br>[sound:k-3540_北朝鮮.mp3]
[sound:k-3540_北朝鮮.mp3]	North Korea<br> <b>北朝鮮</b> <br> (きたちょうせん)
<b>戦後</b> <br> 戦後の復興は困難でした。	[sound:s-3540_戦後の復興は困難でした。.mp3] <br> せんごのふっこうはこんなんでした。 <br>The post-war reconstruction was difficult.
[sound:s-3540_戦後の復興は困難でした。.mp3]	<b>戦後</b> <br> 戦後の復興は困難でした。<br> せんごのふっこうはこんなんでした <br>The post-war reconstruction was difficult.
鮮やか	[sound:k-3541_鮮やか.mp3]<br>あざやか <br> vivid, clear, brilliant
vivid, clear, brilliant	<b>鮮やか<b> <br> あざやか <br>[sound:k-3541_鮮やか.mp3]
[sound:k-3541_鮮やか.mp3]	vivid, clear, brilliant<br> <b>鮮やか</b> <br> (あざやか)
<b>作戦</b> <br> 我々は新しい作戦を立てる必要があります。	[sound:s-3541_我々は新しい作戦を立てる必要があります。.mp3] <br> われわれはあたらしいさくせんをたてるひつようがあります。 <br>We need to devise a new strategy.
[sound:s-3541_我々は新しい作戦を立てる必要があります。.mp3]	<b>作戦</b> <br> 我々は新しい作戦を立てる必要があります。<br> われわれはあたらしいさくせんをたてるひつようがあります <br>We need to devise a new strategy.
朝鮮	[sound:k-3542_朝鮮.mp3]<br>ちょうせん <br> Korea
Korea	<b>朝鮮<b> <br> ちょうせん <br>[sound:k-3542_朝鮮.mp3]
[sound:k-3542_朝鮮.mp3]	Korea<br> <b>朝鮮</b> <br> (ちょうせん)
<b>戦闘</b> <br> 戦闘は激しいものになりました。	[sound:s-3542_戦闘は激しいものになりました。.mp3] <br> せんとうははげしいものになりました。 <br>The combat became intense.
[sound:s-3542_戦闘は激しいものになりました。.mp3]	<b>戦闘</b> <br> 戦闘は激しいものになりました。<br> せんとうははげしいものになりました <br>The combat became intense.
朝鮮民主主義人民共和国	[sound:k-3543_朝鮮民主主義人民共和国.mp3]<br>ちょうせんみんしゅしゅぎじんみんきょうわこく <br> Democratic People's Republic of Korea (North Korea), DPRK
Democratic People's Republic of Korea (North Korea), DPRK	<b>朝鮮民主主義人民共和国<b> <br> ちょうせんみんしゅしゅぎじんみんきょうわこく <br>[sound:k-3543_朝鮮民主主義人民共和国.mp3]
[sound:k-3543_朝鮮民主主義人民共和国.mp3]	Democratic People's Republic of Korea<br> <b>North Korea), DPRK (朝鮮民主主義人民共和国</b> <br> (ちょうせんみんしゅしゅぎじんみんきょうわこく)
<b>戦略</b> <br> 会社は新しい市場戦略を開発しました。	[sound:s-3543_会社は新しい市場戦略を開発しました。.mp3] <br> かいしゃはあたらしいしじょうせんりゃくをかいはつしました。 <br>The company developed a new market strategy.
[sound:s-3543_会社は新しい市場戦略を開発しました。.mp3]	<b>戦略</b> <br> 会社は新しい市場戦略を開発しました。<br> かいしゃはあたらしいしじょうせんりゃくをかいはつしました <br>The company developed a new market strategy.
朝鮮半島	[sound:k-3544_朝鮮半島.mp3]<br>ちょうせんはんとう <br> Korean peninsula
Korean peninsula	<b>朝鮮半島<b> <br> ちょうせんはんとう <br>[sound:k-3544_朝鮮半島.mp3]
[sound:k-3544_朝鮮半島.mp3]	Korean peninsula<br> <b>朝鮮半島</b> <br> (ちょうせんはんとう)
<b>停戦</b> <br> 交渉が成功し、停戦が宣言されました。	[sound:s-3544_交渉が成功し、停戦が宣言されました。.mp3] <br> こうしょうがせいこうし、ていせんがせんげんされました。 <br>"Negotiations were successful, and a ceasefire was declared."
[sound:s-3544_交渉が成功し、停戦が宣言されました。.mp3]	<b>停戦</b> <br> 交渉が成功し、停戦が宣言されました。<br> こうしょうがせいこうし、ていせんがせんげんされました <br>Negotiations were successful, and a ceasefire was declared.
鮮明	[sound:k-3545_鮮明.mp3]<br>せんめい <br> vivid, clear, distinct
vivid, clear, distinct	<b>鮮明<b> <br> せんめい <br>[sound:k-3545_鮮明.mp3]
[sound:k-3545_鮮明.mp3]	vivid, clear, distinct<br> <b>鮮明</b> <br> (せんめい)
<b>冷戦</b> <br> 冷戦時代には東西の対立が続きました。	[sound:s-3545_冷戦時代には東西の対立が続きました。.mp3] <br> れいせんじたいにはとうざいのたいりつがつづきました。 <br>The Cold War era saw continued East-West confrontation.
[sound:s-3545_冷戦時代には東西の対立が続きました。.mp3]	<b>冷戦</b> <br> 冷戦時代には東西の対立が続きました。<br> れいせんじたいにはとうざいのたいりつがつづきました <br>The Cold War era saw continued East-West confrontation.
新鮮	[sound:k-3546_新鮮.mp3]<br>しんせん <br> fresh
fresh	<b>新鮮<b> <br> しんせん <br>[sound:k-3546_新鮮.mp3]
[sound:k-3546_新鮮.mp3]	fresh<br> <b>新鮮</b> <br> (しんせん)
<b>回戦</b> <br> 決勝戦への道は次の回戦で決まります。	[sound:s-3546_決勝戦への道は次の回戦で決まります。.mp3] <br> けっしょうせんへのみちはつきのかいせんできまります。 <br>The path to the finals will be decided in the next round.
[sound:s-3546_決勝戦への道は次の回戦で決まります。.mp3]	<b>回戦</b> <br> 決勝戦への道は次の回戦で決まります。<br> けっしょうせんへのみちはつきのかいせんできまります <br>The path to the finals will be decided in the next round.
生鮮	[sound:k-3547_生鮮.mp3]<br>せいせん <br> fresh
fresh	<b>生鮮<b> <br> せいせん <br>[sound:k-3547_生鮮.mp3]
[sound:k-3547_生鮮.mp3]	fresh<br> <b>生鮮</b> <br> (せいせん)
<b>挑戦</b> <br> 彼は常に新しい挑戦を求めています。	[sound:s-3547_彼は常に新しい挑戦を求めています。.mp3] <br> かれはつねにあたらしいちょうせんをもとめています。 <br>He always seeks new challenges.
[sound:s-3547_彼は常に新しい挑戦を求めています。.mp3]	<b>挑戦</b> <br> 彼は常に新しい挑戦を求めています。<br> かれはつねにあたらしいちょうせんをもとめています <br>He always seeks new challenges.
鮮度	[sound:k-3548_鮮度.mp3]<br>せんど <br> (degree of) freshness
(degree of) freshness	<b>鮮度<b> <br> せんど <br>[sound:k-3548_鮮度.mp3]
[sound:k-3548_鮮度.mp3]	(degree of) freshness<br> <b>鮮度</b> <br> (せんど)
<b>経</b> <br> 彼の経歴は非常に印象的です。	[sound:s-3548_彼の経歴は非常に印象的です。.mp3] <br> かれのけいれきはひじょうにいんしょうてきです。 <br>His resume is very impressive.
[sound:s-3548_彼の経歴は非常に印象的です。.mp3]	<b>経</b> <br> 彼の経歴は非常に印象的です。<br> かれのけいれきはひじょうにいんしょうてきです <br>His resume is very impressive.
新鮮さ	[sound:k-3549_新鮮さ.mp3]<br>しんせんさ <br> freshness
freshness	<b>新鮮さ<b> <br> しんせんさ <br>[sound:k-3549_新鮮さ.mp3]
[sound:k-3549_新鮮さ.mp3]	freshness<br> <b>新鮮さ</b> <br> (しんせんさ)
<b>経営</b> <br> その企業は効果的な経営を行っています。	[sound:s-3549_その企業は効果的な経営を行っています。.mp3] <br> そのききょうはこうかてきなけいえいをおこなっています。 <br>The company is practicing effective management.
[sound:s-3549_その企業は効果的な経営を行っています。.mp3]	<b>経営</b> <br> その企業は効果的な経営を行っています。<br> そのききょうはこうかてきなけいえいをおこなっています <br>The company is practicing effective management.
準備	[sound:k-3550_準備.mp3]<br>じゅんび <br> preparation, setup, arrangements, provision, reserve
preparation, setup, arrangements, provision, reserve	<b>準備<b> <br> じゅんび <br>[sound:k-3550_準備.mp3]
[sound:k-3550_準備.mp3]	preparation, setup, arrangements, provision, reserve<br> <b>準備</b> <br> (じゅんび)
<b>経済</b> <br> 経済状況は安定していますか?	[sound:s-3550_経済状況は安定していますか?.mp3] <br> けいざいじょうきょうはあんていしていますか? <br>Is the economic situation stable?
[sound:s-3550_経済状況は安定していますか?.mp3]	(<b>経済</b>) 経済状況は安定していますか?	けいざいじょうきょうはあんていしていますか? <br>Is the economic situation stable?
整備	[sound:k-3551_整備.mp3]<br>せいび <br> maintenance, servicing, outfitting
maintenance, servicing, outfitting	<b>整備<b> <br> せいび <br>[sound:k-3551_整備.mp3]
[sound:k-3551_整備.mp3]	maintenance, servicing, outfitting<br> <b>整備</b> <br> (せいび)
<b>経験</b> <br> 彼は豊富な経験を持っています。	[sound:s-3551_彼は豊富な経験を持っています。.mp3] <br> かれはほうふなけいけんをもっています。 <br>He has extensive experience.
[sound:s-3551_彼は豊富な経験を持っています。.mp3]	<b>経験</b> <br> 彼は豊富な経験を持っています。<br> かれはほうふなけいけんをもっています <br>He has extensive experience.
設備	[sound:k-3552_設備.mp3]<br>せつび <br> equipment, device, facilities, installation
equipment, device, facilities, installation	<b>設備<b> <br> せつび <br>[sound:k-3552_設備.mp3]
[sound:k-3552_設備.mp3]	equipment, device, facilities, installation<br> <b>設備</b> <br> (せつび)
<b>経営者</b> <br> 彼は優れた経営者です。	[sound:s-3552_彼は優れた経営者です。.mp3] <br> かれはすぐれたけいえいしゃです。 <br>He is an excellent manager.
[sound:s-3552_彼は優れた経営者です。.mp3]	<b>経営者</b> <br> 彼は優れた経営者です。<br> かれはすぐれたけいえいしゃです <br>He is an excellent manager.
備える	[sound:k-3553_備える.mp3]<br>そなえる <br> to furnish, to provide for, to equip, to install; to have ready, to prepare for; to possess, to have, to be endowed with, to be armed with
to furnish, to provide for, to equip, to install; to have ready, to prepare for; to possess, to have, to be endowed with, to be armed with	<b>備える<b> <br> そなえる <br>[sound:k-3553_備える.mp3]
[sound:k-3553_備える.mp3]	to furnish, to provide for, to equip, to install; to have ready, to prepare for; to possess, to have, to be endowed with, to be armed with<br> <b>備える</b> <br> (そなえる)
<b>経団連</b> <br> 経団連は日本の大手企業を代表する組織です。	[sound:s-3553_経団連は日本の大手企業を代表する組織です。.mp3] <br> けいだんれんはにほんのおおてきききょうをだいひょうするそしきです。 <br>Keidanren represents major Japanese corporations.
[sound:s-3553_経団連は日本の大手企業を代表する組織です。.mp3]	<b>経団連</b> <br> 経団連は日本の大手企業を代表する組織です。<br> けいだんれんはにほんのおおてきききょうをだいひょうするそしきです <br>Keidanren represents major Japanese corporations.
警備	[sound:k-3554_警備.mp3]<br>けいび <br> defense, defence, guard, policing, security
defense, defence, guard, policing, security	<b>警備<b> <br> けいび <br>[sound:k-3554_警備.mp3]
[sound:k-3554_警備.mp3]	defense, defence, guard, policing, security<br> <b>警備</b> <br> (けいび)
<b>経費</b> <br> 旅行の経費は予算内に収まりますか?	[sound:s-3554_旅行の経費は予算内に収まりますか?.mp3] <br> りょこうのけいひはよさんないにおさまりますか? <br>Will the travel expenses fit within the budget?
[sound:s-3554_旅行の経費は予算内に収まりますか?.mp3]	(<b>経費</b>) 旅行の経費は予算内に収まりますか?	りょこうのけいひはよさんないにおさまりますか? <br>Will the travel expenses fit within the budget?
守備	[sound:k-3555_守備.mp3]<br>しゅび <br> defense, defence
defense, defence	<b>守備<b> <br> しゅび <br>[sound:k-3555_守備.mp3]
[sound:k-3555_守備.mp3]	defense, defence<br> <b>守備</b> <br> (しゅび)
<b>経緯</b> <br> その問題の経緯を理解するのは重要です。	[sound:s-3555_その問題の経緯を理解するのは重要です。.mp3] <br> そのもんだいのけいいをりかいするのはじゅうようです。 <br>Understanding the background of the issue is important.
[sound:s-3555_その問題の経緯を理解するのは重要です。.mp3]	<b>経緯</b> <br> その問題の経緯を理解するのは重要です。<br> そのもんだいのけいいをりかいするのはじゅうようです <br>Understanding the background of the issue is important.
予備	[sound:k-3556_予備.mp3]<br>よび <br> preparation, preliminaries, reserve, spare
preparation, preliminaries, reserve, spare	<b>予備<b> <br> よび <br>[sound:k-3556_予備.mp3]
[sound:k-3556_予備.mp3]	preparation, preliminaries, reserve, spare<br> <b>予備</b> <br> (よび)
<b>経済的</b> <br> 彼は経済的な成功を収めました。	[sound:s-3556_彼は経済的な成功を収めました。.mp3] <br> かれはけいざいてきなせいこうをおさめました。 <br>He achieved financial success.
[sound:s-3556_彼は経済的な成功を収めました。.mp3]	<b>経済的</b> <br> 彼は経済的な成功を収めました。<br> かれはけいざいてきなせいこうをおさめました <br>He achieved financial success.
装備	[sound:k-3557_装備.mp3]<br>そうび <br> equipment
equipment	<b>装備<b> <br> そうび <br>[sound:k-3557_装備.mp3]
[sound:k-3557_装備.mp3]	equipment<br> <b>装備</b> <br> (そうび)
<b>経常</b> <br> 会社の経常利益が増加しています。	[sound:s-3557_会社の経常利益が増加しています。.mp3] <br> かいしゃのけいじょうりえきがぞうかしています。 <br>The company's ordinary profit is increasing.
[sound:s-3557_会社の経常利益が増加しています。.mp3]	<b>経常</b> <br> 会社の経常利益が増加しています。<br> かいしゃのけいじょうりえきがぞうかしています <br>The company's ordinary profit is increasing.
軍備	[sound:k-3558_軍備.mp3]<br>ぐんび <br> armaments, military preparations
armaments, military preparations	<b>軍備<b> <br> ぐんび <br>[sound:k-3558_軍備.mp3]
[sound:k-3558_軍備.mp3]	armaments, military preparations<br> <b>軍備</b> <br> (ぐんび)
<b>通り</b> <br> その道は車で通行止めです。	[sound:s-3558_その道は車で通行止めです。.mp3] <br> そのみちはくるまでつうこうどめです。 <br>The road is closed to traffic.
[sound:s-3558_その道は車で通行止めです。.mp3]	<b>通り</b> <br> その道は車で通行止めです。<br> そのみちはくるまでつうこうどめです <br>The road is closed to traffic.
備蓄	[sound:k-3559_備蓄.mp3]<br>びちく <br> emergency stores, stored, reserved
emergency stores, stored, reserved	<b>備蓄<b> <br> びちく <br>[sound:k-3559_備蓄.mp3]
[sound:k-3559_備蓄.mp3]	emergency stores, stored, reserved<br> <b>備蓄</b> <br> (びちく)
<b>通信</b> <br> インターネットを通信手段として利用する。	[sound:s-3559_インターネットを通信手段として利用する。.mp3] <br> いんたーねっとをつうしんしゅだんとしてりようする。 <br>Use the Internet as a means of communication.
[sound:s-3559_インターネットを通信手段として利用する。.mp3]	<b>通信</b> <br> インターネットを通信手段として利用する。<br> いんたーねっとをつうしんしゅだんとしてりようする <br>Use the Internet as a means of communication.
宅	[sound:k-3560_宅.mp3]<br>たく <br> house, home, husband
house, home, husband	<b>宅<b> <br> たく <br>[sound:k-3560_宅.mp3]
[sound:k-3560_宅.mp3]	house, home, husband<br> <b>宅</b> <br> (たく)
<b>見通し</b> <br> この計画の見通しは良好です。	[sound:s-3560_この計画の見通しは良好です。.mp3] <br> このけいかくのみとおしはりょうこうです。 <br>The outlook for this plan is good.
[sound:s-3560_この計画の見通しは良好です。.mp3]	<b>見通し</b> <br> この計画の見通しは良好です。<br> このけいかくのみとおしはりょうこうです <br>The outlook for this plan is good.
自宅	[sound:k-3561_自宅.mp3]<br>じたく <br> one's home
one's home	<b>自宅<b> <br> じたく <br>[sound:k-3561_自宅.mp3]
[sound:k-3561_自宅.mp3]	one's home<br> <b>自宅</b> <br> (じたく)
<b>共通</b> <br> この二つの計画には共通点があります。	[sound:s-3561_この二つの計画には共通点があります。.mp3] <br> このふたつのけいかくにはきょうつうてんがあります。 <br>These two plans have something in common.
[sound:s-3561_この二つの計画には共通点があります。.mp3]	<b>共通</b> <br> この二つの計画には共通点があります。<br> このふたつのけいかくにはきょうつうてんがあります <br>These two plans have something in common.
住宅	[sound:k-3562_住宅.mp3]<br>じゅうたく <br> residence, housing, residential building
residence, housing, residential building	<b>住宅<b> <br> じゅうたく <br>[sound:k-3562_住宅.mp3]
[sound:k-3562_住宅.mp3]	residence, housing, residential building<br> <b>住宅</b> <br> (じゅうたく)
<b>交通</b> <br> この地域の交通は便利です。	[sound:s-3562_この地域の交通は便利です。.mp3] <br> このちいきのこうつうはべんりです。 <br>Transportation in this area is convenient.
[sound:s-3562_この地域の交通は便利です。.mp3]	<b>交通</b> <br> この地域の交通は便利です。<br> このちいきのこうつうはべんりです <br>Transportation in this area is convenient.
在宅	[sound:k-3563_在宅.mp3]<br>ざいたく <br> being in, being at home
being in, being at home	<b>在宅<b> <br> ざいたく <br>[sound:k-3563_在宅.mp3]
[sound:k-3563_在宅.mp3]	being in, being at home<br> <b>在宅</b> <br> (ざいたく)
<b>通貨</b> <br> その国の通貨はドルです。	[sound:s-3563_その国の通貨はドルです。.mp3] <br> そのくにのつうかはどるです。 <br>The currency of that country is the dollar.
[sound:s-3563_その国の通貨はドルです。.mp3]	<b>通貨</b> <br> その国の通貨はドルです。<br> そのくにのつうかはどるです <br>The currency of that country is the dollar.
家宅	[sound:k-3564_家宅.mp3]<br>かたく <br> domicile, premises
domicile, premises	<b>家宅<b> <br> かたく <br>[sound:k-3564_家宅.mp3]
[sound:k-3564_家宅.mp3]	domicile, premises<br> <b>家宅</b> <br> (かたく)
<b>通常</b> <br> 通常の営業時間は午前9時から午後5時までです。	[sound:s-3564_通常の営業時間は午前9時から午後5時までです。.mp3] <br> つうじょうのえいぎょうじかんはごぜんくじからごご5しまでです。 <br>Normal business hours are from 9 am to 5 pm.
[sound:s-3564_通常の営業時間は午前9時から午後5時までです。.mp3]	<b>通常</b> <br> 通常の営業時間は午前9時から午後5時までです。<br> つうじょうのえいぎょうじかんはごぜんくじからごご5しまでです <br>Normal business hours are from 9 am to 5 pm.
住宅地	[sound:k-3565_住宅地.mp3]<br>じゅうたくち <br> housing district, residential district
housing district, residential district	<b>住宅地<b> <br> じゅうたくち <br>[sound:k-3565_住宅地.mp3]
[sound:k-3565_住宅地.mp3]	housing district, residential district<br> <b>住宅地</b> <br> (じゅうたくち)
<b>普通</b> <br> そのバスは普通の速度で走ります。	[sound:s-3565_そのバスは普通の速度で走ります。.mp3] <br> そのばすはふつうのそくどではしります。 <br>The bus runs at an average speed.
[sound:s-3565_そのバスは普通の速度で走ります。.mp3]	<b>普通</b> <br> そのバスは普通の速度で走ります。<br> そのばすはふつうのそくどではしります <br>The bus runs at an average speed.
宅地	[sound:k-3566_宅地.mp3]<br>たくち <br> building lot, residential land
building lot, residential land	<b>宅地<b> <br> たくち <br>[sound:k-3566_宅地.mp3]
[sound:k-3566_宅地.mp3]	building lot, residential land<br> <b>宅地</b> <br> (たくち)
<b>通産省</b> <br> 通産省は経済産業省の旧称です。	[sound:s-3566_通産省は経済産業省の旧称です。.mp3] <br> つうさんしょうはけいざいさんぎょうしょうのきゅうしょうです。 <br>"The Ministry of International Trade and Industry is the former name of the Ministry of Economy, Trade and Industry."
[sound:s-3566_通産省は経済産業省の旧称です。.mp3]	<b>通産省</b> <br> 通産省は経済産業省の旧称です。<br> つうさんしょうはけいざいさんぎょうしょうのきゅうしょうです <br>The Ministry of International Trade and Industry is the former name of the Ministry of Economy, Trade and Industry.
帰宅	[sound:k-3567_帰宅.mp3]<br>きたく <br> returning home
returning home	<b>帰宅<b> <br> きたく <br>[sound:k-3567_帰宅.mp3]
[sound:k-3567_帰宅.mp3]	returning home<br> <b>帰宅</b> <br> (きたく)
<b>通算</b> <br> 通算して、私は10冊の本を読みました。	[sound:s-3567_通算して、私は10冊の本を読みました。.mp3] <br> 通算して、わたしは10さつのほんをよみました。 <br>"In total, I have read 10 books."
[sound:s-3567_通算して、私は10冊の本を読みました。.mp3]	<b>通算</b> <br> 通算して、私は10冊の本を読みました。<br> 通算して、わたしは10さつのほんをよみました <br>In total, I have read 10 books.
宅配	[sound:k-3568_宅配.mp3]<br>たくはい <br> home delivery
home delivery	<b>宅配<b> <br> たくはい <br>[sound:k-3568_宅配.mp3]
[sound:k-3568_宅配.mp3]	home delivery<br> <b>宅配</b> <br> (たくはい)
<b>外</b> <br> 雨が降っているので、外に出かけるのはやめたほうがいいです。	[sound:s-3568_雨が降っているので、外に出かけるのはやめたほうがいいです。.mp3] <br> あめがふっているので、そとにでかけるのはやめたほうがいいです。 <br>"Since it's raining, it's better not to go outside."
[sound:s-3568_雨が降っているので、外に出かけるのはやめたほうがいいです。.mp3]	<b>外</b> <br> 雨が降っているので、外に出かけるのはやめたほうがいいです。<br> あめがふっているので、そとにでかけるのはやめたほうがいいです <br>Since it's raining, it's better not to go outside.
住宅街	[sound:k-3569_住宅街.mp3]<br>じゅうたくがい <br> residential area
residential area	<b>住宅街<b> <br> じゅうたくがい <br>[sound:k-3569_住宅街.mp3]
[sound:k-3569_住宅街.mp3]	residential area<br> <b>住宅街</b> <br> (じゅうたくがい)
<b>海外</b> <br> 夏休みには海外旅行に行きたいです。	[sound:s-3569_夏休みには海外旅行に行きたいです。.mp3] <br> なつやすみにはかいがいりょこうにいきたいです。 <br>I want to go on a trip abroad during summer vacation.
[sound:s-3569_夏休みには海外旅行に行きたいです。.mp3]	<b>海外</b> <br> 夏休みには海外旅行に行きたいです。<br> なつやすみにはかいがいりょこうにいきたいです <br>I want to go on a trip abroad during summer vacation.
障害	[sound:k-3570_障害.mp3]<br>しょうがい, しょうげ <br> obstacle, impediment, hindrance, difficulty, barrier; handicap, impairment, disability, disorder, malfunction
obstacle, impediment, hindrance, difficulty, barrier; handicap, impairment, disability, disorder, malfunction	<b>障害<b> <br> しょうがい, しょうげ <br>[sound:k-3570_障害.mp3]
[sound:k-3570_障害.mp3]	obstacle, impediment, hindrance, difficulty, barrier; handicap, impairment, disability, disorder, malfunction<br> <b>障害</b> <br> (しょうがい, しょうげ)
<b>外交</b> <br> その国は積極的な外交政策を採用しています。	[sound:s-3570_その国は積極的な外交政策を採用しています。.mp3] <br> そのくにはせっきょくてきながいこうせいさくをさいようしています。 <br>The country adopts an active diplomatic policy.
[sound:s-3570_その国は積極的な外交政策を採用しています。.mp3]	<b>外交</b> <br> その国は積極的な外交政策を採用しています。<br> そのくにはせっきょくてきながいこうせいさくをさいようしています <br>The country adopts an active diplomatic policy.
被害	[sound:k-3571_被害.mp3]<br>ひがい <br> damage
damage	<b>被害<b> <br> ひがい <br>[sound:k-3571_被害.mp3]
[sound:k-3571_被害.mp3]	damage<br> <b>被害</b> <br> (ひがい)
<b>外国</b> <br> 外国の文化に興味があります。	[sound:s-3571_外国の文化に興味があります。.mp3] <br> がいこくのぶんかにきょうみがあります。 <br>I'm interested in foreign cultures.
[sound:s-3571_外国の文化に興味があります。.mp3]	<b>外国</b> <br> 外国の文化に興味があります。<br> がいこくのぶんかにきょうみがあります <br>I'm interested in foreign cultures.
災害	[sound:k-3572_災害.mp3]<br>さいがい <br> calamity, disaster, misfortune
calamity, disaster, misfortune	<b>災害<b> <br> さいがい <br>[sound:k-3572_災害.mp3]
[sound:k-3572_災害.mp3]	calamity, disaster, misfortune<br> <b>災害</b> <br> (さいがい)
<b>外国人</b> <br> この街には多くの外国人が住んでいます。	[sound:s-3572_この街には多くの外国人が住んでいます。.mp3] <br> このまちにはおおくのがいこくじんがすんでいます。 <br>Many foreigners live in this town.
[sound:s-3572_この街には多くの外国人が住んでいます。.mp3]	<b>外国人</b> <br> この街には多くの外国人が住んでいます。<br> このまちにはおおくのがいこくじんがすんでいます <br>Many foreigners live in this town.
損害	[sound:k-3573_損害.mp3]<br>そんがい <br> damage, injury, loss
damage, injury, loss	<b>損害<b> <br> そんがい <br>[sound:k-3573_損害.mp3]
[sound:k-3573_損害.mp3]	damage, injury, loss<br> <b>損害</b> <br> (そんがい)
<b>外相</b> <br> 外相が会議で新しい提案をしました。	[sound:s-3573_外相が会議で新しい提案をしました。.mp3] <br> がいしょうがかいぎであたらしいていあんをしました。 <br>The Foreign Minister made a new proposal at the meeting.
[sound:s-3573_外相が会議で新しい提案をしました。.mp3]	<b>外相</b> <br> 外相が会議で新しい提案をしました。<br> がいしょうがかいぎであたらしいていあんをしました <br>The Foreign Minister made a new proposal at the meeting.
障害者	[sound:k-3574_障害者.mp3]<br>しょうがいしゃ <br> (physically) handicapped person, disabled person
(physically) handicapped person, disabled person	<b>障害者<b> <br> しょうがいしゃ <br>[sound:k-3574_障害者.mp3]
[sound:k-3574_障害者.mp3]	(physically) handicapped person, disabled person<br> <b>障害者</b> <br> (しょうがいしゃ)
<b>外務省</b> <br> 彼は外務省で働いています。	[sound:s-3574_彼は外務省で働いています。.mp3] <br> かれはがいむしょうではたらいています。 <br>He works at the Ministry of Foreign Affairs.
[sound:s-3574_彼は外務省で働いています。.mp3]	<b>外務省</b> <br> 彼は外務省で働いています。<br> かれはがいむしょうではたらいています <br>He works at the Ministry of Foreign Affairs.
公害	[sound:k-3575_公害.mp3]<br>こうがい <br> pollution, public nuisance, contamination
pollution, public nuisance, contamination	<b>公害<b> <br> こうがい <br>[sound:k-3575_公害.mp3]
[sound:k-3575_公害.mp3]	pollution, public nuisance, contamination<br> <b>公害</b> <br> (こうがい)
<b>外務</b> <br> 彼は外務の仕事をしています。	[sound:s-3575_彼は外務の仕事をしています。.mp3] <br> かれはがいむのしごとをしています。 <br>He is doing foreign affairs work.
[sound:s-3575_彼は外務の仕事をしています。.mp3]	<b>外務</b> <br> 彼は外務の仕事をしています。<br> かれはがいむのしごとをしています <br>He is doing foreign affairs work.
被害者	[sound:k-3576_被害者.mp3]<br>ひがいしゃ <br> victim, injured party, sufferer
victim, injured party, sufferer	<b>被害者<b> <br> ひがいしゃ <br>[sound:k-3576_被害者.mp3]
[sound:k-3576_被害者.mp3]	victim, injured party, sufferer<br> <b>被害者</b> <br> (ひがいしゃ)
<b>内外</b> <br> その問題は内外から関心を持たれています。	[sound:s-3576_その問題は内外から関心を持たれています。.mp3] <br> そのもんだいはないがいからかんしんをもたれています。 <br>The issue is of interest both domestically and internationally.
[sound:s-3576_その問題は内外から関心を持たれています。.mp3]	<b>内外</b> <br> その問題は内外から関心を持たれています。<br> そのもんだいはないがいからかんしんをもたれています <br>The issue is of interest both domestically and internationally.
侵害	[sound:k-3577_侵害.mp3]<br>しんがい <br> infringement, violation, trespass, impairment
infringement, violation, trespass, impairment	<b>侵害<b> <br> しんがい <br>[sound:k-3577_侵害.mp3]
[sound:k-3577_侵害.mp3]	infringement, violation, trespass, impairment<br> <b>侵害</b> <br> (しんがい)
<b>意外</b> <br> 彼の行動は私たちには意外でした。	[sound:s-3577_彼の行動は私たちには意外でした。.mp3] <br> かれのこうどうはわたしたちにはいがいでした。 <br>His behavior was unexpected for us.
[sound:s-3577_彼の行動は私たちには意外でした。.mp3]	<b>意外</b> <br> 彼の行動は私たちには意外でした。<br> かれのこうどうはわたしたちにはいがいでした <br>His behavior was unexpected for us.
害	[sound:k-3578_害.mp3]<br>がい <br> injury, harm, evil influence, damage
injury, harm, evil influence, damage	<b>害<b> <br> がい <br>[sound:k-3578_害.mp3]
[sound:k-3578_害.mp3]	injury, harm, evil influence, damage<br> <b>害</b> <br> (がい)
<b>最も</b> <br> 最も重要なポイントは何ですか？	[sound:s-3578_最も重要なポイントは何ですか？.mp3] <br> もっともじゅうようなぽいんとはなんですか？ <br>What is the most important point?
[sound:s-3578_最も重要なポイントは何ですか？.mp3]	(<b>最も</b>) 最も重要なポイントは何ですか？	もっともじゅうようなぽいんとはなんですか？ <br>What is the most important point?
殺害	[sound:k-3579_殺害.mp3]<br>さつがい, せつがい, せちがい <br> killing, murder
killing, murder	<b>殺害<b> <br> さつがい, せつがい, せちがい <br>[sound:k-3579_殺害.mp3]
[sound:k-3579_殺害.mp3]	killing, murder<br> <b>殺害</b> <br> (さつがい, せつがい, せちがい)
<b>最近</b> <br> 最近、彼女とよく会います。	[sound:s-3579_最近、彼女とよく会います。.mp3] <br> さいきん、かのじょとよくあいます。 <br>I have been meeting her frequently lately.
[sound:s-3579_最近、彼女とよく会います。.mp3]	<b>最近</b> <br> 最近、彼女とよく会います。<br> さいきん、かのじょとよくあいます <br>I have been meeting her frequently lately.
支配	[sound:k-3580_支配.mp3]<br>しはい <br> rule, control, direction
rule, control, direction	<b>支配<b> <br> しはい <br>[sound:k-3580_支配.mp3]
[sound:k-3580_支配.mp3]	rule, control, direction<br> <b>支配</b> <br> (しはい)
<b>最後</b> <br> 会議の最後に、彼は重要なアイデアを提案しました。	[sound:s-3580_会議の最後に、彼は重要なアイデアを提案しました。.mp3] <br> かいぎのさいごに、かれはじゅうようなあいであをていあんしました。 <br>"At the end of the meeting, he proposed an important idea."
[sound:s-3580_会議の最後に、彼は重要なアイデアを提案しました。.mp3]	<b>最後</b> <br> 会議の最後に、彼は重要なアイデアを提案しました。<br> かいぎのさいごに、かれはじゅうようなあいであをていあんしました <br>At the end of the meeting, he proposed an important idea.
心配	[sound:k-3581_心配.mp3]<br>しんぱい <br> worry, concern, anxiety; care, help, aid, assistance
worry, concern, anxiety; care, help, aid, assistance	<b>心配<b> <br> しんぱい <br>[sound:k-3581_心配.mp3]
[sound:k-3581_心配.mp3]	worry, concern, anxiety; care, help, aid, assistance<br> <b>心配</b> <br> (しんぱい)
<b>最高</b> <br> 彼の演技は最高でした。	[sound:s-3581_彼の演技は最高でした。.mp3] <br> かれのえんぎはさいこうでした。 <br>His performance was excellent.
[sound:s-3581_彼の演技は最高でした。.mp3]	<b>最高</b> <br> 彼の演技は最高でした。<br> かれのえんぎはさいこうでした <br>His performance was excellent.
配分	[sound:k-3582_配分.mp3]<br>はいぶん <br> distribution, allotment
distribution, allotment	<b>配分<b> <br> はいぶん <br>[sound:k-3582_配分.mp3]
[sound:k-3582_配分.mp3]	distribution, allotment<br> <b>配分</b> <br> (はいぶん)
<b>最終</b> <br> 最終的な決定は来週行われます。	[sound:s-3582_最終的な決定は来週行われます。.mp3] <br> さいしゅうてきなけっていはらいしゅうおこなわれます。 <br>The final decision will be made next week.
[sound:s-3582_最終的な決定は来週行われます。.mp3]	<b>最終</b> <br> 最終的な決定は来週行われます。<br> さいしゅうてきなけっていはらいしゅうおこなわれます <br>The final decision will be made next week.
配慮	[sound:k-3583_配慮.mp3]<br>はいりょ <br> consideration, concern, forethought
consideration, concern, forethought	<b>配慮<b> <br> はいりょ <br>[sound:k-3583_配慮.mp3]
[sound:k-3583_配慮.mp3]	consideration, concern, forethought<br> <b>配慮</b> <br> (はいりょ)
<b>最初</b> <br> 新しい仕事に就くときは、最初は緊張します。	[sound:s-3583_新しい仕事に就くときは、最初は緊張します。.mp3] <br> あたらしいしごとにつくときは、さいしょはきんちょうします。 <br>"When starting a new job, one is nervous at first."
[sound:s-3583_新しい仕事に就くときは、最初は緊張します。.mp3]	<b>最初</b> <br> 新しい仕事に就くときは、最初は緊張します。<br> あたらしいしごとにつくときは、さいしょはきんちょうします <br>When starting a new job, one is nervous at first.
配当	[sound:k-3584_配当.mp3]<br>はいとう <br> dividend, share
dividend, share	<b>配当<b> <br> はいとう <br>[sound:k-3584_配当.mp3]
[sound:k-3584_配当.mp3]	dividend, share<br> <b>配当</b> <br> (はいとう)
<b>最大</b> <br> 彼は会社の最大の株主です。	[sound:s-3584_彼は会社の最大の株主です。.mp3] <br> かれはかいしゃのさいだいのかぶぬしです。 <br>He is the largest shareholder in the company.
[sound:s-3584_彼は会社の最大の株主です。.mp3]	<b>最大</b> <br> 彼は会社の最大の株主です。<br> かれはかいしゃのさいだいのかぶぬしです <br>He is the largest shareholder in the company.
気配	[sound:k-3585_気配.mp3]<br>けはい, きはい <br> indication, sign, hint, presence, trend; quotation (esp. stock market)
indication, sign, hint, presence, trend; quotation (esp. stock market)	<b>気配<b> <br> けはい, きはい <br>[sound:k-3585_気配.mp3]
[sound:k-3585_気配.mp3]	indication, sign, hint, presence, trend; quotation<br> <b>esp. stock market) (気配</b> <br> (けはい, きはい)
<b>最高裁</b> <br> 最高裁はその事件について判断を下しました。	[sound:s-3585_最高裁はその事件について判断を下しました。.mp3] <br> さいこうさいはそのじけんについてはんだんをおろしました。 <br>The Supreme Court made a judgment on the case.
[sound:s-3585_最高裁はその事件について判断を下しました。.mp3]	<b>最高裁</b> <br> 最高裁はその事件について判断を下しました。<br> さいこうさいはそのじけんについてはんだんをおろしました <br>The Supreme Court made a judgment on the case.
配置	[sound:k-3586_配置.mp3]<br>はいち <br> arrangement (of resources), deployment, stationing, posting, disposition
arrangement (of resources), deployment, stationing, posting, disposition	<b>配置<b> <br> はいち <br>[sound:k-3586_配置.mp3]
[sound:k-3586_配置.mp3]	arrangement<br> <b>of resources), deployment, stationing, posting, disposition (配置</b> <br> (はいち)
<b>最低</b> <br> 彼の行動は最低です。	[sound:s-3586_彼の行動は最低です。.mp3] <br> かれのこうどうはさいていです。 <br>His behavior is the worst.
[sound:s-3586_彼の行動は最低です。.mp3]	<b>最低</b> <br> 彼の行動は最低です。<br> かれのこうどうはさいていです <br>His behavior is the worst.
配る	[sound:k-3587_配る.mp3]<br>くばる <br> to distribute, to deliver, to deal (cards)
to distribute, to deliver, to deal (cards)	<b>配る<b> <br> くばる <br>[sound:k-3587_配る.mp3]
[sound:k-3587_配る.mp3]	to distribute, to deliver, to deal<br> <b>cards) (配る</b> <br> (くばる)
<b>最終的</b> <br> 最終的には、あなたの意見を尊重します。	[sound:s-3587_最終的には、あなたの意見を尊重します。.mp3] <br> さいしゅうてきには、あなたのいけんをそんちょうします。 <br>"Ultimately, I will respect your opinion."
[sound:s-3587_最終的には、あなたの意見を尊重します。.mp3]	<b>最終的</b> <br> 最終的には、あなたの意見を尊重します。<br> さいしゅうてきには、あなたのいけんをそんちょうします <br>Ultimately, I will respect your opinion.
配給	[sound:k-3588_配給.mp3]<br>はいきゅう <br> distribution (e.g. films, rice)
distribution (e.g. films, rice)	<b>配給<b> <br> はいきゅう <br>[sound:k-3588_配給.mp3]
[sound:k-3588_配給.mp3]	distribution<br> <b>e.g. films, rice) (配給</b> <br> (はいきゅう)
<b>言わば</b> <br> 彼は言わばそのグループのリーダーです。	[sound:s-3588_彼は言わばそのグループのリーダーです。.mp3] <br> かれはいわばそのグループのリーダーです。 <br>"He is, so to speak, the leader of the group."
[sound:s-3588_彼は言わばそのグループのリーダーです。.mp3]	<b>言わば</b> <br> 彼は言わばそのグループのリーダーです。<br> かれはいわばそのグループのリーダーです <br>He is, so to speak, the leader of the group.
宅配	[sound:k-3589_宅配.mp3]<br>たくはい <br> home delivery
home delivery	<b>宅配<b> <br> たくはい <br>[sound:k-3589_宅配.mp3]
[sound:k-3589_宅配.mp3]	home delivery<br> <b>宅配</b> <br> (たくはい)
<b>言う</b> <br> 彼はいつも正直に言います。	[sound:s-3589_彼はいつも正直に言います。.mp3] <br> かれはいつもしょうじきにいいます。 <br>He always speaks honestly.
[sound:s-3589_彼はいつも正直に言います。.mp3]	<b>言う</b> <br> 彼はいつも正直に言います。<br> かれはいつもしょうじきにいいます <br>He always speaks honestly.
副社長	[sound:k-3590_副社長.mp3]<br>ふくしゃちょう <br> executive vice-president
executive vice-president	<b>副社長<b> <br> ふくしゃちょう <br>[sound:k-3590_副社長.mp3]
[sound:k-3590_副社長.mp3]	executive vice-president<br> <b>副社長</b> <br> (ふくしゃちょう)
<b>言</b> <br> 彼女の言には深い意味があります。	[sound:s-3590_彼女の言には深い意味があります。.mp3] <br> かのじょのげんにはふかいいみがあります。 <br>Her words have a profound meaning.
[sound:s-3590_彼女の言には深い意味があります。.mp3]	<b>言</b> <br> 彼女の言には深い意味があります。<br> かのじょのげんにはふかいいみがあります <br>Her words have a profound meaning.
副作用	[sound:k-3591_副作用.mp3]<br>ふくさよう <br> reaction, secondary effect, side effect
reaction, secondary effect, side effect	<b>副作用<b> <br> ふくさよう <br>[sound:k-3591_副作用.mp3]
[sound:k-3591_副作用.mp3]	reaction, secondary effect, side effect<br> <b>副作用</b> <br> (ふくさよう)
<b>言葉</b> <br> 新しい言葉を学ぶのは楽しいです。	[sound:s-3591_新しい言葉を学ぶのは楽しいです。.mp3] <br> あたらしいことばをまなぶのはたのしいです。 <br>Learning new words is enjoyable.
[sound:s-3591_新しい言葉を学ぶのは楽しいです。.mp3]	<b>言葉</b> <br> 新しい言葉を学ぶのは楽しいです。<br> あたらしいことばをまなぶのはたのしいです <br>Learning new words is enjoyable.
副知事	[sound:k-3592_副知事.mp3]<br>ふくちじ <br> lieutenant governor
lieutenant governor	<b>副知事<b> <br> ふくちじ <br>[sound:k-3592_副知事.mp3]
[sound:k-3592_副知事.mp3]	lieutenant governor<br> <b>副知事</b> <br> (ふくちじ)
宣言 彼は自分の意見を宣言しました   (かれはじぶんのいけんをせんげんしました。)	He declared his opinion.	s-3592_He declared his opinion..mp3
[sound:s-3592_He declared his opinion..mp3]	宣言 彼は自分の意見を宣言しました   (かれはじぶんのいけんをせんげんしました。)	He declared his opinion.		
副賞	[sound:k-3593_副賞.mp3]<br>ふくしょう <br> extra prize
extra prize	<b>副賞<b> <br> ふくしょう <br>[sound:k-3593_副賞.mp3]
[sound:k-3593_副賞.mp3]	extra prize<br> <b>副賞</b> <br> (ふくしょう)
<b>発言</b> <br> 彼の発言には重要なポイントがあります。	[sound:s-3593_彼の発言には重要なポイントがあります。.mp3] <br> かれのはつげんにはじゅうようなぽいんとがあります。 <br>His statement has important points.
[sound:s-3593_彼の発言には重要なポイントがあります。.mp3]	<b>発言</b> <br> 彼の発言には重要なポイントがあります。<br> かれのはつげんにはじゅうようなぽいんとがあります <br>His statement has important points.
副題	[sound:k-3594_副題.mp3]<br>ふくだい <br> subtitle, subheading
subtitle, subheading	<b>副題<b> <br> ふくだい <br>[sound:k-3594_副題.mp3]
[sound:k-3594_副題.mp3]	subtitle, subheading<br> <b>副題</b> <br> (ふくだい)
<b>証言</b> <br> 彼女は法廷で証言しました。	[sound:s-3594_彼女は法廷で証言しました。.mp3] <br> かのじょはほうていでしょうげんしました。 <br>She testified in court.
[sound:s-3594_彼女は法廷で証言しました。.mp3]	<b>証言</b> <br> 彼女は法廷で証言しました。<br> かのじょはほうていでしょうげんしました <br>She testified in court.
副産物	[sound:k-3595_副産物.mp3]<br>ふくさんぶつ <br> byproduct, side line
byproduct, side line	<b>副産物<b> <br> ふくさんぶつ <br>[sound:k-3595_副産物.mp3]
[sound:k-3595_副産物.mp3]	byproduct, side line<br> <b>副産物</b> <br> (ふくさんぶつ)
<b>提言</b> <br> 彼は新しいアイデアを提言しました。	[sound:s-3595_彼は新しいアイデアを提言しました。.mp3] <br> かれはあたらしいあいであをていげんしました。 <br>He suggested a new idea.
[sound:s-3595_彼は新しいアイデアを提言しました。.mp3]	<b>提言</b> <br> 彼は新しいアイデアを提言しました。<br> かれはあたらしいあいであをていげんしました <br>He suggested a new idea.
副葬品	[sound:k-3596_副葬品.mp3]<br>ふくそうひん <br> burial accessories
burial accessories	<b>副葬品<b> <br> ふくそうひん <br>[sound:k-3596_副葬品.mp3]
[sound:k-3596_副葬品.mp3]	burial accessories<br> <b>副葬品</b> <br> (ふくそうひん)
<b>言語</b> <br> 彼は多くの言語を話せます。	[sound:s-3596_彼は多くの言語を話せます。.mp3] <br> かれはおおくのげんごをはなせます。 <br>He can speak many languages.
[sound:s-3596_彼は多くの言語を話せます。.mp3]	<b>言語</b> <br> 彼は多くの言語を話せます。<br> かれはおおくのげんごをはなせます <br>He can speak many languages.
副業	[sound:k-3597_副業.mp3]<br>ふくぎょう <br> side job, sideline, subsidiary business
side job, sideline, subsidiary business	<b>副業<b> <br> ふくぎょう <br>[sound:k-3597_副業.mp3]
[sound:k-3597_副業.mp3]	side job, sideline, subsidiary business<br> <b>副業</b> <br> (ふくぎょう)
<b>一言</b> <br> あなたに一言お願いがあります。	[sound:s-3597_あなたに一言お願いがあります。.mp3] <br> あなたにひとことおねがいがあります。 <br>I have a word to say to you.
[sound:s-3597_あなたに一言お願いがあります。.mp3]	<b>一言</b> <br> あなたに一言お願いがあります。<br> あなたにひとことおねがいがあります <br>I have a word to say to you.
副将	[sound:k-3598_副将.mp3]<br>ふくしょう <br> second in command
second in command	<b>副将<b> <br> ふくしょう <br>[sound:k-3598_副将.mp3]
[sound:k-3598_副将.mp3]	second in command<br> <b>副将</b> <br> (ふくしょう)
<b>氏</b> <br> その家族は古代の名門氏族です。	[sound:s-3598_その家族は古代の名門氏族です。.mp3] <br> そのかぞくはこだいのめいもんしぞくです。 <br>That family is an ancient noble clan.
[sound:s-3598_その家族は古代の名門氏族です。.mp3]	<b>氏</b> <br> その家族は古代の名門氏族です。<br> そのかぞくはこだいのめいもんしぞくです <br>That family is an ancient noble clan.
副読本	[sound:k-3599_副読本.mp3]<br>ふくとくほん, ふくどくほん <br> supplementary reader
supplementary reader	<b>副読本<b> <br> ふくとくほん, ふくどくほん <br>[sound:k-3599_副読本.mp3]
[sound:k-3599_副読本.mp3]	supplementary reader<br> <b>副読本</b> <br> (ふくとくほん, ふくどくほん)
<b>氏名</b> <br> 記入する氏名を教えてください。	[sound:s-3599_記入する氏名を教えてください。.mp3] <br> きにゅうするしめいをおしえてください。 <br>Please tell me your full name for registration.
[sound:s-3599_記入する氏名を教えてください。.mp3]	<b>氏名</b> <br> 記入する氏名を教えてください。<br> きにゅうするしめいをおしえてください <br>Please tell me your full name for registration.
予算	[sound:k-3600_予算.mp3]<br>よさん <br> estimate, budget
estimate, budget	<b>予算<b> <br> よさん <br>[sound:k-3600_予算.mp3]
[sound:k-3600_予算.mp3]	estimate, budget<br> <b>予算</b> <br> (よさん)
<b>同氏</b> <br> 彼は同氏であり、同じ会社に勤めています。	[sound:s-3600_彼は同氏であり、同じ会社に勤めています。.mp3] <br> かれはどうしであり、おなじかいしゃにつとめています。 <br>He is from the same lineage and works in the same company.
[sound:s-3600_彼は同氏であり、同じ会社に勤めています。.mp3]	<b>同氏</b> <br> 彼は同氏であり、同じ会社に勤めています。<br> かれはどうしであり、おなじかいしゃにつとめています <br>He is from the same lineage and works in the same company.
決算	[sound:k-3601_決算.mp3]<br>けっさん <br> balance sheet, settlement of accounts
balance sheet, settlement of accounts	<b>決算<b> <br> けっさん <br>[sound:k-3601_決算.mp3]
[sound:k-3601_決算.mp3]	balance sheet, settlement of accounts<br> <b>決算</b> <br> (けっさん)
<b>両氏</b> <br> 両氏の意見は異なります。	[sound:s-3601_両氏の意見は異なります。.mp3] <br> りょうしのいけんはことなります。 <br>The opinions of both parties differ.
[sound:s-3601_両氏の意見は異なります。.mp3]	<b>両氏</b> <br> 両氏の意見は異なります。<br> りょうしのいけんはことなります <br>The opinions of both parties differ.
通算	[sound:k-3602_通算.mp3]<br>つうさん <br> total
total	<b>通算<b> <br> つうさん <br>[sound:k-3602_通算.mp3]
[sound:k-3602_通算.mp3]	total<br> <b>通算</b> <br> (つうさん)
<b>源氏</b> <br> 源氏物語は日本の古典文学のひとつです。	[sound:s-3602_源氏物語は日本の古典文学のひとつです。.mp3] <br> げんじものがたりはにほんのこてんぶんがくのひとつです。 <br>The Tale of Genji is one of Japan's classic literature.
[sound:s-3602_源氏物語は日本の古典文学のひとつです。.mp3]	<b>源氏</b> <br> 源氏物語は日本の古典文学のひとつです。<br> げんじものがたりはにほんのこてんぶんがくのひとつです <br>The Tale of Genji is one of Japan's classic literature.
計算	[sound:k-3603_計算.mp3]<br>けいさん <br> calculation, reckoning, count; forecast
calculation, reckoning, count; forecast	<b>計算<b> <br> けいさん <br>[sound:k-3603_計算.mp3]
[sound:k-3603_計算.mp3]	calculation, reckoning, count; forecast<br> <b>計算</b> <br> (けいさん)
<b>氏族</b> <br> 彼の氏族は代々の武家です。	[sound:s-3603_彼の氏族は代々の武家です。.mp3] <br> かれのしぞくはだいだいのぶけです。 <br>His clan is a hereditary warrior family.
[sound:s-3603_彼の氏族は代々の武家です。.mp3]	<b>氏族</b> <br> 彼の氏族は代々の武家です。<br> かれのしぞくはだいだいのぶけです <br>His clan is a hereditary warrior family.
補正予算	[sound:k-3604_補正予算.mp3]<br>ほせいよさん <br> revised or supplementary budget
revised or supplementary budget	<b>補正予算<b> <br> ほせいよさん <br>[sound:k-3604_補正予算.mp3]
[sound:k-3604_補正予算.mp3]	revised or supplementary budget<br> <b>補正予算</b> <br> (ほせいよさん)
<b>氏子</b> <br> この神社の氏子は地域の人々です。	[sound:s-3604_この神社の氏子は地域の人々です。.mp3] <br> このじんじゃのししはちいきのひとびとです。 <br>The parishioners of this shrine are the local people.
[sound:s-3604_この神社の氏子は地域の人々です。.mp3]	<b>氏子</b> <br> この神社の氏子は地域の人々です。<br> このじんじゃのししはちいきのひとびとです <br>The parishioners of this shrine are the local people.
公算	[sound:k-3605_公算.mp3]<br>こうさん <br> probability, likelihood
probability, likelihood	<b>公算<b> <br> こうさん <br>[sound:k-3605_公算.mp3]
[sound:k-3605_公算.mp3]	probability, likelihood<br> <b>公算</b> <br> (こうさん)
<b>彼氏</b> <br> 彼女は彼氏とデートに行きました。	[sound:s-3605_彼女は彼氏とデートに行きました。.mp3] <br> かのじょはかれしとでーとにいきました。 <br>She went on a date with her boyfriend.
[sound:s-3605_彼女は彼氏とデートに行きました。.mp3]	<b>彼氏</b> <br> 彼女は彼氏とデートに行きました。<br> かのじょはかれしとでーとにいきました <br>She went on a date with her boyfriend.
概算	[sound:k-3606_概算.mp3]<br>がいさん <br> approximation, rough estimate
approximation, rough estimate	<b>概算<b> <br> がいさん <br>[sound:k-3606_概算.mp3]
[sound:k-3606_概算.mp3]	approximation, rough estimate<br> <b>概算</b> <br> (がいさん)
<b>氏神</b> <br> この神社は地元の氏神です。	[sound:s-3606_この神社は地元の氏神です。.mp3] <br> このじんじゃはじもとのうじがみです。 <br>This shrine is the local guardian deity.
[sound:s-3606_この神社は地元の氏神です。.mp3]	<b>氏神</b> <br> この神社は地元の氏神です。<br> このじんじゃはじもとのうじがみです <br>This shrine is the local guardian deity.
試算	[sound:k-3607_試算.mp3]<br>しさん <br> trial calculation, preliminary calculation
trial calculation, preliminary calculation	<b>試算<b> <br> しさん <br>[sound:k-3607_試算.mp3]
[sound:k-3607_試算.mp3]	trial calculation, preliminary calculation<br> <b>試算</b> <br> (しさん)
<b>現在</b> <br> 私の現在の仕事は忙しいです。	[sound:s-3607_私の現在の仕事は忙しいです。.mp3] <br> わたしのげんざいのしごとはいそがしいです。 <br>My current job is busy.
[sound:s-3607_私の現在の仕事は忙しいです。.mp3]	<b>現在</b> <br> 私の現在の仕事は忙しいです。<br> わたしのげんざいのしごとはいそがしいです <br>My current job is busy.
採算	[sound:k-3608_採算.mp3]<br>さいさん <br> profit
profit	<b>採算<b> <br> さいさん <br>[sound:k-3608_採算.mp3]
[sound:k-3608_採算.mp3]	profit<br> <b>採算</b> <br> (さいさん)
<b>現実</b> <br> 彼は現実を受け入れる必要があります。	[sound:s-3608_彼は現実を受け入れる必要があります。.mp3] <br> かれはげんじつをうけいれるひつようがあります。 <br>He needs to accept reality.
[sound:s-3608_彼は現実を受け入れる必要があります。.mp3]	<b>現実</b> <br> 彼は現実を受け入れる必要があります。<br> かれはげんじつをうけいれるひつようがあります <br>He needs to accept reality.
清算	[sound:k-3609_清算.mp3]<br>せいさん <br> liquidation, settlement
liquidation, settlement	<b>清算<b> <br> せいさん <br>[sound:k-3609_清算.mp3]
[sound:k-3609_清算.mp3]	liquidation, settlement<br> <b>清算</b> <br> (せいさん)
<b>現場</b> <br> 事故現場は警察によって封鎖されました。	[sound:s-3609_事故現場は警察によって封鎖されました。.mp3] <br> じこげんばはけいさつによってふうさされました。 <br>The accident site was cordoned off by the police.
[sound:s-3609_事故現場は警察によって封鎖されました。.mp3]	<b>現場</b> <br> 事故現場は警察によって封鎖されました。<br> じこげんばはけいさつによってふうさされました <br>The accident site was cordoned off by the police.
監視	[sound:k-3610_監視.mp3]<br>かんし <br> observation, guarding, inspection, surveillance
observation, guarding, inspection, surveillance	<b>監視<b> <br> かんし <br>[sound:k-3610_監視.mp3]
[sound:k-3610_監視.mp3]	observation, guarding, inspection, surveillance<br> <b>監視</b> <br> (かんし)
<b>現地</b> <br> 私は現地の文化に興味を持っています。	[sound:s-3610_私は現地の文化に興味を持っています。.mp3] <br> わたしはげんちのぶんかにきょうみをもっています。 <br>I am interested in the local culture.
[sound:s-3610_私は現地の文化に興味を持っています。.mp3]	<b>現地</b> <br> 私は現地の文化に興味を持っています。<br> わたしはげんちのぶんかにきょうみをもっています <br>I am interested in the local culture.
警視庁	[sound:k-3611_警視庁.mp3]<br>けいしちょう <br> police headquarters
police headquarters	<b>警視庁<b> <br> けいしちょう <br>[sound:k-3611_警視庁.mp3]
[sound:k-3611_警視庁.mp3]	police headquarters<br> <b>警視庁</b> <br> (けいしちょう)
<b>現行</b> <br> 現行の政策には多くの問題があります。	[sound:s-3611_現行の政策には多くの問題があります。.mp3] <br> げんこうのせいさくにはおおくのもんだいがあります。 <br>There are many problems with the current policy.
[sound:s-3611_現行の政策には多くの問題があります。.mp3]	<b>現行</b> <br> 現行の政策には多くの問題があります。<br> げんこうのせいさくにはおおくのもんだいがあります <br>There are many problems with the current policy.
視点	[sound:k-3612_視点.mp3]<br>してん <br> opinion, point of view, visual point
opinion, point of view, visual point	<b>視点<b> <br> してん <br>[sound:k-3612_視点.mp3]
[sound:k-3612_視点.mp3]	opinion, point of view, visual point<br> <b>視点</b> <br> (してん)
<b>現状</b> <br> 彼らは現状を改善する方法を模索しています。	[sound:s-3612_彼らは現状を改善する方法を模索しています。.mp3] <br> かれらはげんじょうをかいぜんするほうほうをもさくしています。 <br>They are searching for ways to improve the current situation.
[sound:s-3612_彼らは現状を改善する方法を模索しています。.mp3]	<b>現状</b> <br> 彼らは現状を改善する方法を模索しています。<br> かれらはげんじょうをかいぜんするほうほうをもさくしています <br>They are searching for ways to improve the current situation.
重視	[sound:k-3613_重視.mp3]<br>じゅうし <br> importance, stress, serious consideration
importance, stress, serious consideration	<b>重視<b> <br> じゅうし <br>[sound:k-3613_重視.mp3]
[sound:k-3613_重視.mp3]	importance, stress, serious consideration<br> <b>重視</b> <br> (じゅうし)
<b>現代</b> <br> 現代の若者はテクノロジーに精通しています。	[sound:s-3613_現代の若者はテクノロジーに精通しています。.mp3] <br> げんだいのわかものはてくのろじーにせいつうしています。 <br>Young people nowadays are proficient in technology.
[sound:s-3613_現代の若者はテクノロジーに精通しています。.mp3]	<b>現代</b> <br> 現代の若者はテクノロジーに精通しています。<br> げんだいのわかものはてくのろじーにせいつうしています <br>Young people nowadays are proficient in technology.
視聴率	[sound:k-3614_視聴率.mp3]<br>しちょうりつ <br> ratings (of a television program) (programme)
ratings (of a television program) (programme)	<b>視聴率<b> <br> しちょうりつ <br>[sound:k-3614_視聴率.mp3]
[sound:k-3614_視聴率.mp3]	ratings<br> <b>of a television program) (programme) (視聴率</b> <br> (しちょうりつ)
<b>実現</b> <br> 彼の夢はついに実現しました。	[sound:s-3614_彼の夢はついに実現しました。.mp3] <br> かれのゆめはついにじつげんしました。 <br>His dream finally came true.
[sound:s-3614_彼の夢はついに実現しました。.mp3]	<b>実現</b> <br> 彼の夢はついに実現しました。<br> かれのゆめはついにじつげんしました <br>His dream finally came true.
視野	[sound:k-3615_視野.mp3]<br>しや <br> field of vision, outlook
field of vision, outlook	<b>視野<b> <br> しや <br>[sound:k-3615_視野.mp3]
[sound:k-3615_視野.mp3]	field of vision, outlook<br> <b>視野</b> <br> (しや)
<b>表現</b> <br> 彼女は自分の感情を表現するのが苦手です。	[sound:s-3615_彼女は自分の感情を表現するのが苦手です。.mp3] <br> かのじょはじぶんのかんじょうをひょうげんするのがにがてです。 <br>She is not good at expressing her emotions.
[sound:s-3615_彼女は自分の感情を表現するのが苦手です。.mp3]	<b>表現</b> <br> 彼女は自分の感情を表現するのが苦手です。<br> かのじょはじぶんのかんじょうをひょうげんするのがにがてです <br>She is not good at expressing her emotions.
視察	[sound:k-3616_視察.mp3]<br>しさつ <br> inspection, observation
inspection, observation	<b>視察<b> <br> しさつ <br>[sound:k-3616_視察.mp3]
[sound:k-3616_視察.mp3]	inspection, observation<br> <b>視察</b> <br> (しさつ)
<b>現金</b> <br> 支払いは現金でお願いします。	[sound:s-3616_支払いは現金でお願いします。.mp3] <br> しはらいはげんきんでおねがいします。   Please pay in cash. <br>
[sound:s-3616_支払いは現金でお願いします。.mp3]	<b>現金</b> <br> 支払いは現金でお願いします。<br> しはらいはげんきんでおねがいします   Please pay in cash. <br>
視聴者	[sound:k-3617_視聴者.mp3]<br>しちょうしゃ <br> viewer, (television) audience
viewer, (television) audience	<b>視聴者<b> <br> しちょうしゃ <br>[sound:k-3617_視聴者.mp3]
[sound:k-3617_視聴者.mp3]	viewer,<br> <b>television) audience (視聴者</b> <br> (しちょうしゃ)
<b>理</b> <br> 彼の行動には理があります。	[sound:s-3617_彼の行動には理があります。.mp3] <br> かれのこうどうにはりがあります。 <br>There is reason behind his actions.
[sound:s-3617_彼の行動には理があります。.mp3]	<b>理</b> <br> 彼の行動には理があります。<br> かれのこうどうにはりがあります <br>There is reason behind his actions.
視線	[sound:k-3618_視線.mp3]<br>しせん <br> one's eyes, glance, look
one's eyes, glance, look	<b>視線<b> <br> しせん <br>[sound:k-3618_視線.mp3]
[sound:k-3618_視線.mp3]	one's eyes, glance, look<br> <b>視線</b> <br> (しせん)
<b>管理</b> <br> この施設の管理はとても厳格です。	[sound:s-3618_この施設の管理はとても厳格です。.mp3] <br> このしせつのかんりはとてもげんかくです。 <br>The management of this facility is very strict.
[sound:s-3618_この施設の管理はとても厳格です。.mp3]	<b>管理</b> <br> この施設の管理はとても厳格です。<br> このしせつのかんりはとてもげんかくです <br>The management of this facility is very strict.
視覚	[sound:k-3619_視覚.mp3]<br>しかく <br> sense of sight, vision
sense of sight, vision	<b>視覚<b> <br> しかく <br>[sound:k-3619_視覚.mp3]
[sound:k-3619_視覚.mp3]	sense of sight, vision<br> <b>視覚</b> <br> (しかく)
<b>理事</b> <br> 彼女はその団体の理事を務めています。	[sound:s-3619_彼女はその団体の理事を務めています。.mp3] <br> かのじょはそのだんたいのりじをつとめています。 <br>She serves as a board member of the organization.
[sound:s-3619_彼女はその団体の理事を務めています。.mp3]	<b>理事</b> <br> 彼女はその団体の理事を務めています。<br> かのじょはそのだんたいのりじをつとめています <br>She serves as a board member of the organization.
条件	[sound:k-3620_条件.mp3]<br>じょうけん <br> condition(s), term(s), requirement(s)
condition(s), term(s), requirement(s)	<b>条件<b> <br> じょうけん <br>[sound:k-3620_条件.mp3]
[sound:k-3620_条件.mp3]	condition(s), term(s), requirement(s)<br> <b>条件</b> <br> (じょうけん)
<b>理由</b> <br> 彼は遅刻した理由を説明しました。	[sound:s-3620_彼は遅刻した理由を説明しました。.mp3] <br> かれはちこくしたりゆうをせつめいしました。 <br>He explained the reason for his tardiness.
[sound:s-3620_彼は遅刻した理由を説明しました。.mp3]	<b>理由</b> <br> 彼は遅刻した理由を説明しました。<br> かれはちこくしたりゆうをせつめいしました <br>He explained the reason for his tardiness.
条約	[sound:k-3621_条約.mp3]<br>じょうやく <br> treaty, pact
treaty, pact	<b>条約<b> <br> じょうやく <br>[sound:k-3621_条約.mp3]
[sound:k-3621_条約.mp3]	treaty, pact<br> <b>条約</b> <br> (じょうやく)
<b>処理</b> <br> この問題を迅速に処理する必要があります。	[sound:s-3621_この問題を迅速に処理する必要があります。.mp3] <br> このもんだいをじんそくにしょりするひつようがあります。 <br>This problem needs to be handled promptly.
[sound:s-3621_この問題を迅速に処理する必要があります。.mp3]	<b>処理</b> <br> この問題を迅速に処理する必要があります。<br> このもんだいをじんそくにしょりするひつようがあります <br>This problem needs to be handled promptly.
条項	[sound:k-3622_条項.mp3]<br>じょうこう <br> clause, article, stipulations
clause, article, stipulations	<b>条項<b> <br> じょうこう <br>[sound:k-3622_条項.mp3]
[sound:k-3622_条項.mp3]	clause, article, stipulations<br> <b>条項</b> <br> (じょうこう)
<b>総理</b> <br> 新しい総理大臣が任命されました。	[sound:s-3622_新しい総理大臣が任命されました。.mp3] <br> あたらしいそうりだいじんがにんめいされました。 <br>A new Prime Minister has been appointed.
[sound:s-3622_新しい総理大臣が任命されました。.mp3]	<b>総理</b> <br> 新しい総理大臣が任命されました。<br> あたらしいそうりだいじんがにんめいされました <br>A new Prime Minister has been appointed.
条例	[sound:k-3623_条例.mp3]<br>じょうれい <br> regulations, rules, laws, acts, ordinance
regulations, rules, laws, acts, ordinance	<b>条例<b> <br> じょうれい <br>[sound:k-3623_条例.mp3]
[sound:k-3623_条例.mp3]	regulations, rules, laws, acts, ordinance<br> <b>条例</b> <br> (じょうれい)
<b>理解</b> <br> 彼は私の立場を理解してくれます。	[sound:s-3623_彼は私の立場を理解してくれます。.mp3] <br> かれはわたしのたちばをりかいしてくれます。 <br>He understands my position.
[sound:s-3623_彼は私の立場を理解してくれます。.mp3]	<b>理解</b> <br> 彼は私の立場を理解してくれます。<br> かれはわたしのたちばをりかいしてくれます <br>He understands my position.
条件付き	[sound:k-3624_条件付き.mp3]<br>じょうけんつき <br> conditionally, with conditions attached
conditionally, with conditions attached	<b>条件付き<b> <br> じょうけんつき <br>[sound:k-3624_条件付き.mp3]
[sound:k-3624_条件付き.mp3]	conditionally, with conditions attached<br> <b>条件付き</b> <br> (じょうけんつき)
<b>料理</b> <br> 彼女はとても上手に料理をします。	[sound:s-3624_彼女はとても上手に料理をします。.mp3] <br> かのじょはとてもじょうずにりょうりをします。 <br>She cooks very well.
[sound:s-3624_彼女はとても上手に料理をします。.mp3]	<b>料理</b> <br> 彼女はとても上手に料理をします。<br> かのじょはとてもじょうずにりょうりをします <br>She cooks very well.
無条件	[sound:k-3625_無条件.mp3]<br>むじょうけん <br> unconditional
unconditional	<b>無条件<b> <br> むじょうけん <br>[sound:k-3625_無条件.mp3]
[sound:k-3625_無条件.mp3]	unconditional<br> <b>無条件</b> <br> (むじょうけん)
<b>代理</b> <br> 彼は私の代理で会議に出席しました。	[sound:s-3625_彼は私の代理で会議に出席しました。.mp3] <br> かれはわたしのだいりでかいぎにしゅっせきしました。 <br>He attended the meeting on my behalf.
[sound:s-3625_彼は私の代理で会議に出席しました。.mp3]	<b>代理</b> <br> 彼は私の代理で会議に出席しました。<br> かれはわたしのだいりでかいぎにしゅっせきしました <br>He attended the meeting on my behalf.
労働条件	[sound:k-3626_労働条件.mp3]<br>ろうどうじょうけん <br> working conditions
working conditions	<b>労働条件<b> <br> ろうどうじょうけん <br>[sound:k-3626_労働条件.mp3]
[sound:k-3626_労働条件.mp3]	working conditions<br> <b>労働条件</b> <br> (ろうどうじょうけん)
<b>理念</b> <br> その組織は自由と平等を理念としています。	[sound:s-3626_その組織は自由と平等を理念としています。.mp3] <br> そのそしきはじゆうとびょうどうをりねんとしています。 <br>The organization is founded on the principles of freedom and equality.
[sound:s-3626_その組織は自由と平等を理念としています。.mp3]	<b>理念</b> <br> その組織は自由と平等を理念としています。<br> そのそしきはじゆうとびょうどうをりねんとしています <br>The organization is founded on the principles of freedom and equality.
条文	[sound:k-3627_条文.mp3]<br>じょうぶん <br> text, provisions (act, treaty)
text, provisions (act, treaty)	<b>条文<b> <br> じょうぶん <br>[sound:k-3627_条文.mp3]
[sound:k-3627_条文.mp3]	text, provisions<br> <b>act, treaty) (条文</b> <br> (じょうぶん)
<b>調べ</b> <br> 彼は事件の真相を調べています。	[sound:s-3627_彼は事件の真相を調べています。.mp3] <br> かれはじけんのしんそうをしらべています。 <br>He is investigating the truth behind the incident.
[sound:s-3627_彼は事件の真相を調べています。.mp3]	<b>調べ</b> <br> 彼は事件の真相を調べています。<br> かれはじけんのしんそうをしらべています <br>He is investigating the truth behind the incident.
信条	[sound:k-3628_信条.mp3]<br>しんじょう <br> creed, belief, article of faith
creed, belief, article of faith	<b>信条<b> <br> しんじょう <br>[sound:k-3628_信条.mp3]
[sound:k-3628_信条.mp3]	creed, belief, article of faith<br> <b>信条</b> <br> (しんじょう)
<b>調査</b> <br> この問題に関する調査が行われました。	[sound:s-3628_この問題に関する調査が行われました。.mp3] <br> このもんだいにかんするちょうさがおこなわれました。 <br>An investigation regarding this issue has been conducted.
[sound:s-3628_この問題に関する調査が行われました。.mp3]	<b>調査</b> <br> この問題に関する調査が行われました。<br> このもんだいにかんするちょうさがおこなわれました <br>An investigation regarding this issue has been conducted.
一条	[sound:k-3629_一条.mp3]<br>いちじょう <br> streak, matter, quotation
streak, matter, quotation	<b>一条<b> <br> いちじょう <br>[sound:k-3629_一条.mp3]
[sound:k-3629_一条.mp3]	streak, matter, quotation<br> <b>一条</b> <br> (いちじょう)
<b>調整</b> <br> 予定を調整してみます。	[sound:s-3629_予定を調整してみます。.mp3] <br> よていをちょうせいしてみます。 <br>I'll try to adjust the schedule.
[sound:s-3629_予定を調整してみます。.mp3]	<b>調整</b> <br> 予定を調整してみます。<br> よていをちょうせいしてみます <br>I'll try to adjust the schedule.
幹	[sound:k-3630_幹.mp3]<br>みき, かん <br> (tree) trunk, (arrow) shaft, (tool) handle, backbone, base
(tree) trunk, (arrow) shaft, (tool) handle, backbone, base	<b>幹<b> <br> みき, かん <br>[sound:k-3630_幹.mp3]
[sound:k-3630_幹.mp3]	(tree) trunk,<br> <b>arrow) shaft, (tool) handle, backbone, base (幹</b> <br> (みき, かん)
<b>協調</b> <br> チームは協調して問題を解決しました。	[sound:s-3630_チームは協調して問題を解決しました。.mp3] <br> ちーむはきょうちょうしてもんだいをかいけつしました。 <br>The team cooperated to solve the problem.
[sound:s-3630_チームは協調して問題を解決しました。.mp3]	<b>協調</b> <br> チームは協調して問題を解決しました。<br> ちーむはきょうちょうしてもんだいをかいけつしました <br>The team cooperated to solve the problem.
幹事	[sound:k-3631_幹事.mp3]<br>かんじ <br> executive secretary, coordinator, organizer, person in charge of making arrangements
executive secretary, coordinator, organizer, person in charge of making arrangements	<b>幹事<b> <br> かんじ <br>[sound:k-3631_幹事.mp3]
[sound:k-3631_幹事.mp3]	executive secretary, coordinator, organizer, person in charge of making arrangements<br> <b>幹事</b> <br> (かんじ)
<b>好調</b> <br> 彼らのビジネスは好調です。	[sound:s-3631_彼らのビジネスは好調です。.mp3] <br> かれらのびじねすはこうちょうです。 <br>Their business is doing well.
[sound:s-3631_彼らのビジネスは好調です。.mp3]	<b>好調</b> <br> 彼らのビジネスは好調です。<br> かれらのびじねすはこうちょうです <br>Their business is doing well.
幹部	[sound:k-3632_幹部.mp3]<br>かんぶ <br> management, (executive) staff, leaders, leadership, top brass, upper echelons
management, (executive) staff, leaders, leadership, top brass, upper echelons	<b>幹部<b> <br> かんぶ <br>[sound:k-3632_幹部.mp3]
[sound:k-3632_幹部.mp3]	management,<br> <b>executive) staff, leaders, leadership, top brass, upper echelons (幹部</b> <br> (かんぶ)
<b>調達</b> <br> 資金を調達するのに苦労しています。	[sound:s-3632_資金を調達するのに苦労しています。.mp3] <br> しきんをちょうたつするのにくろうしています。 <br>We are struggling to raise funds.
[sound:s-3632_資金を調達するのに苦労しています。.mp3]	<b>調達</b> <br> 資金を調達するのに苦労しています。<br> しきんをちょうたつするのにくろうしています <br>We are struggling to raise funds.
新幹線	[sound:k-3633_新幹線.mp3]<br>しんかんせん <br> bullet train (very high speed), Shinkansen
bullet train (very high speed), Shinkansen	<b>新幹線<b> <br> しんかんせん <br>[sound:k-3633_新幹線.mp3]
[sound:k-3633_新幹線.mp3]	bullet train<br> <b>very high speed), Shinkansen (新幹線</b> <br> (しんかんせん)
<b>順調</b> <br> 彼のプロジェクトは順調に進んでいます。	[sound:s-3633_彼のプロジェクトは順調に進んでいます。.mp3] <br> かれのぷろじぇくとはじゅんちょうにすすんでいます。 <br>His project is progressing smoothly.
[sound:s-3633_彼のプロジェクトは順調に進んでいます。.mp3]	<b>順調</b> <br> 彼のプロジェクトは順調に進んでいます。<br> かれのぷろじぇくとはじゅんちょうにすすんでいます <br>His project is progressing smoothly.
根幹	[sound:k-3634_根幹.mp3]<br>こんかん <br> basis, nucleus, root and branch
basis, nucleus, root and branch	<b>根幹<b> <br> こんかん <br>[sound:k-3634_根幹.mp3]
[sound:k-3634_根幹.mp3]	basis, nucleus, root and branch<br> <b>根幹</b> <br> (こんかん)
<b>調印</b> <br> 条約が両国の代表によって調印されました。	[sound:s-3634_条約が両国の代表によって調印されました。.mp3] <br> じょうやくがりょうこくのだいひょうによってちょういんされました。 <br>The treaty was signed by representatives of both countries.
[sound:s-3634_条約が両国の代表によって調印されました。.mp3]	<b>調印</b> <br> 条約が両国の代表によって調印されました。<br> じょうやくがりょうこくのだいひょうによってちょういんされました <br>The treaty was signed by representatives of both countries.
幹線	[sound:k-3635_幹線.mp3]<br>かんせん <br> main line, trunk line
main line, trunk line	<b>幹線<b> <br> かんせん <br>[sound:k-3635_幹線.mp3]
[sound:k-3635_幹線.mp3]	main line, trunk line<br> <b>幹線</b> <br> (かんせん)
<b>基調</b> <br> この会議の基調を説明します。	[sound:s-3635_この会議の基調を説明します。.mp3] <br> このかいぎのきちょうをせつめいします。 <br>I will explain the theme of this meeting.
[sound:s-3635_この会議の基調を説明します。.mp3]	<b>基調</b> <br> この会議の基調を説明します。<br> このかいぎのきちょうをせつめいします <br>I will explain the theme of this meeting.
主幹	[sound:k-3636_主幹.mp3]<br>しゅかん <br> chief editor, managing editor; manager, person in charge
chief editor, managing editor; manager, person in charge	<b>主幹<b> <br> しゅかん <br>[sound:k-3636_主幹.mp3]
[sound:k-3636_主幹.mp3]	chief editor, managing editor; manager, person in charge<br> <b>主幹</b> <br> (しゅかん)
<b>上っ調子</b> <br> 彼は最近、上っ調子です。	[sound:s-3636_彼は最近、上っ調子です。.mp3] <br> かれはさいきん、のっちょうしです。 <br>He's been in high spirits lately.
[sound:s-3636_彼は最近、上っ調子です。.mp3]	<b>上っ調子</b> <br> 彼は最近、上っ調子です。<br> かれはさいきん、のっちょうしです <br>He's been in high spirits lately.
基幹	[sound:k-3637_基幹.mp3]<br>きかん <br> mainstay, nucleus, key
mainstay, nucleus, key	<b>基幹<b> <br> きかん <br>[sound:k-3637_基幹.mp3]
[sound:k-3637_基幹.mp3]	mainstay, nucleus, key<br> <b>基幹</b> <br> (きかん)
<b>体</b> <br> 体を動かすことは大切です。	[sound:s-3637_体を動かすことは大切です。.mp3] <br> からだをうごかすことはたいせつです。 <br>It is important to keep the body moving.
[sound:s-3637_体を動かすことは大切です。.mp3]	<b>体</b> <br> 体を動かすことは大切です。<br> からだをうごかすことはたいせつです <br>It is important to keep the body moving.
幹	[sound:k-3638_幹.mp3]<br>から <br> trunk, stem, stalk; shaft (of an arrow); handle
trunk, stem, stalk; shaft (of an arrow); handle	<b>幹<b> <br> から <br>[sound:k-3638_幹.mp3]
[sound:k-3638_幹.mp3]	trunk, stem, stalk; shaft<br> <b>of an arrow); handle (幹</b> <br> (から)
<b>具体的</b> <br> 詳細な計画を立てるために具体的な情報が必要です。	[sound:s-3638_詳細な計画を立てるために具体的な情報が必要です。.mp3] <br> しょうさいなけいかくをたてるためにぐたいてきなじょうほうがひつようです。 <br>Concrete information is needed to make detailed plans.
[sound:s-3638_詳細な計画を立てるために具体的な情報が必要です。.mp3]	<b>具体的</b> <br> 詳細な計画を立てるために具体的な情報が必要です。<br> しょうさいなけいかくをたてるためにぐたいてきなじょうほうがひつようです <br>Concrete information is needed to make detailed plans.
幹事会	[sound:k-3639_幹事会.mp3]<br>かんじかい <br> board of governors
board of governors	<b>幹事会<b> <br> かんじかい <br>[sound:k-3639_幹事会.mp3]
[sound:k-3639_幹事会.mp3]	board of governors<br> <b>幹事会</b> <br> (かんじかい)
<b>全体</b> <br> 問題を全体的に考える必要があります。	[sound:s-3639_問題を全体的に考える必要があります。.mp3] <br> もんだいをぜんたいてきにかんがえるひつようがあります。 <br>We need to consider the problem as a whole.
[sound:s-3639_問題を全体的に考える必要があります。.mp3]	<b>全体</b> <br> 問題を全体的に考える必要があります。<br> もんだいをぜんたいてきにかんがえるひつようがあります <br>We need to consider the problem as a whole.
独自	[sound:k-3640_独自.mp3]<br>どくじ <br> original, peculiar, characteristic, proprietary
original, peculiar, characteristic, proprietary	<b>独自<b> <br> どくじ <br>[sound:k-3640_独自.mp3]
[sound:k-3640_独自.mp3]	original, peculiar, characteristic, proprietary<br> <b>独自</b> <br> (どくじ)
<b>体制</b> <br> 新しい体制が導入されました。	[sound:s-3640_新しい体制が導入されました。.mp3] <br> あたらしいたいせいがどうにゅうされました。 <br>A new system has been introduced.
[sound:s-3640_新しい体制が導入されました。.mp3]	<b>体制</b> <br> 新しい体制が導入されました。<br> あたらしいたいせいがどうにゅうされました <br>A new system has been introduced.
独立	[sound:k-3641_独立.mp3]<br>どくりつ <br> independence (e.g. Independence Day), self-support
independence (e.g. Independence Day), self-support	<b>独立<b> <br> どくりつ <br>[sound:k-3641_独立.mp3]
[sound:k-3641_独立.mp3]	independence<br> <b>e.g. Independence Day), self-support (独立</b> <br> (どくりつ)
団体 (だんたい) - この団体は環境問題に取り組んでいます。 (このだんたいはかんきょうもんだいにとりくんでいます。)	This organization is working on environmental issues.	s-3641_This organization is working on environmental issues..mp3
[sound:s-3641_This organization is working on environmental issues..mp3]	団体 (だんたい) - この団体は環境問題に取り組んでいます。 (このだんたいはかんきょうもんだいにとりくんでいます。)	This organization is working on environmental issues.		
単独	[sound:k-3642_単独.mp3]<br>たんどく <br> sole, independence, single, solo (flight)
sole, independence, single, solo (flight)	<b>単独<b> <br> たんどく <br>[sound:k-3642_単独.mp3]
[sound:k-3642_単独.mp3]	sole, independence, single, solo<br> <b>flight) (単独</b> <br> (たんどく)
<b>共同体</b> <br> 我々は地域共同体の一員です。	[sound:s-3642_我々は地域共同体の一員です。.mp3] <br> われわれはちいききょうどうたいのいちいんです。 <br>We are members of the community.
[sound:s-3642_我々は地域共同体の一員です。.mp3]	<b>共同体</b> <br> 我々は地域共同体の一員です。<br> われわれはちいききょうどうたいのいちいんです <br>We are members of the community.
独特	[sound:k-3643_独特.mp3]<br>どくとく <br> peculiarity, uniqueness, characteristic
peculiarity, uniqueness, characteristic	<b>独特<b> <br> どくとく <br>[sound:k-3643_独特.mp3]
[sound:k-3643_独特.mp3]	peculiarity, uniqueness, characteristic<br> <b>独特</b> <br> (どくとく)
<b>自治体</b> <br> 彼は地元の自治体の役員です。	[sound:s-3643_彼は地元の自治体の役員です。.mp3] <br> かれはじもとのじちたいのやくいんです。 <br>He is an official in the local government.
[sound:s-3643_彼は地元の自治体の役員です。.mp3]	<b>自治体</b> <br> 彼は地元の自治体の役員です。<br> かれはじもとのじちたいのやくいんです <br>He is an official in the local government.
独立国	[sound:k-3644_独立国.mp3]<br>どくりつこく <br> independent state or nation
independent state or nation	<b>独立国<b> <br> どくりつこく <br>[sound:k-3644_独立国.mp3]
[sound:k-3644_独立国.mp3]	independent state or nation<br> <b>独立国</b> <br> (どくりつこく)
<b>体験</b> <br> そのイベントは素晴らしい体験でした。	[sound:s-3644_そのイベントは素晴らしい体験でした。.mp3] <br> そのいべんとはすばらしいたいけんでした。 <br>The event was a wonderful experience.
[sound:s-3644_そのイベントは素晴らしい体験でした。.mp3]	<b>体験</b> <br> そのイベントは素晴らしい体験でした。<br> そのいべんとはすばらしいたいけんでした <br>The event was a wonderful experience.
東独	[sound:k-3645_東独.mp3]<br>とうどく <br> East Germany
East Germany	<b>東独<b> <br> とうどく <br>[sound:k-3645_東独.mp3]
[sound:k-3645_東独.mp3]	East Germany<br> <b>東独</b> <br> (とうどく)
<b>遺体</b> <br> 現場で遺体が発見されました。	[sound:s-3645_現場で遺体が発見されました。.mp3] <br> げんばでいたいがはっけんされました。 <br>A body was found at the scene.
[sound:s-3645_現場で遺体が発見されました。.mp3]	<b>遺体</b> <br> 現場で遺体が発見されました。<br> げんばでいたいがはっけんされました <br>A body was found at the scene.
独裁	[sound:k-3646_独裁.mp3]<br>どくさい <br> dictatorship, despotism
dictatorship, despotism	<b>独裁<b> <br> どくさい <br>[sound:k-3646_独裁.mp3]
[sound:k-3646_独裁.mp3]	dictatorship, despotism<br> <b>独裁</b> <br> (どくさい)
<b>具体</b> <br> この計画は具体的なアクションプランが必要です。	[sound:s-3646_この計画は具体的なアクションプランが必要です。.mp3] <br> このけいかくはぐたいてきなあくしょんぷらんがひつようです。 <br>This plan needs concrete action steps.
[sound:s-3646_この計画は具体的なアクションプランが必要です。.mp3]	<b>具体</b> <br> この計画は具体的なアクションプランが必要です。<br> このけいかくはぐたいてきなあくしょんぷらんがひつようです <br>This plan needs concrete action steps.
独占	[sound:k-3647_独占.mp3]<br>どくせん <br> monopoly; to monopolize, to hog
monopoly; to monopolize, to hog	<b>独占<b> <br> どくせん <br>[sound:k-3647_独占.mp3]
[sound:k-3647_独占.mp3]	monopoly; to monopolize, to hog<br> <b>独占</b> <br> (どくせん)
<b>強化</b> <br> セキュリティを強化するための新しい措置が導入されました。	[sound:s-3647_セキュリティを強化するための新しい措置が導入されました。.mp3] <br> せきゅりてぃをきょうかするためのあたらしいそちがどうにゅうされました。 <br>New measures have been introduced to strengthen security.
[sound:s-3647_セキュリティを強化するための新しい措置が導入されました。.mp3]	<b>強化</b> <br> セキュリティを強化するための新しい措置が導入されました。<br> せきゅりてぃをきょうかするためのあたらしいそちがどうにゅうされました <br>New measures have been introduced to strengthen security.
独禁法	[sound:k-3648_独禁法.mp3]<br>どっきんほう <br> antitrust law, Antitrust Act
antitrust law, Antitrust Act	<b>独禁法<b> <br> どっきんほう <br>[sound:k-3648_独禁法.mp3]
[sound:k-3648_独禁法.mp3]	antitrust law, Antitrust Act<br> <b>独禁法</b> <br> (どっきんほう)
<b>文化</b> <br> 日本の文化は多様で美しいです。	[sound:s-3648_日本の文化は多様で美しいです。.mp3] <br> にほんのぶんかはたようでうつくしいです。 <br>Japanese culture is diverse and beautiful.
[sound:s-3648_日本の文化は多様で美しいです。.mp3]	<b>文化</b> <br> 日本の文化は多様で美しいです。<br> にほんのぶんかはたようでうつくしいです <br>Japanese culture is diverse and beautiful.
独身	[sound:k-3649_独身.mp3]<br>どくしん <br> bachelorhood, single, unmarried, celibate
bachelorhood, single, unmarried, celibate	<b>独身<b> <br> どくしん <br>[sound:k-3649_独身.mp3]
[sound:k-3649_独身.mp3]	bachelorhood, single, unmarried, celibate<br> <b>独身</b> <br> (どくしん)
<b>変化</b> <br> 最近、彼の態度に変化が見られます。	[sound:s-3649_最近、彼の態度に変化が見られます。.mp3] <br> さいきん、かれのたいどにへんかがみられます。 <br>There have been changes in his attitude lately.
[sound:s-3649_最近、彼の態度に変化が見られます。.mp3]	<b>変化</b> <br> 最近、彼の態度に変化が見られます。<br> さいきん、かれのたいどにへんかがみられます <br>There have been changes in his attitude lately.
警察	[sound:k-3650_警察.mp3]<br>けいさつ <br> police
police	<b>警察<b> <br> けいさつ <br>[sound:k-3650_警察.mp3]
[sound:k-3650_警察.mp3]	police<br> <b>警察</b> <br> (けいさつ)
<b>悪化</b> <br> 状況が悪化しています。	[sound:s-3650_状況が悪化しています。.mp3] <br> じょうきょうがあっかしています。 <br>The situation is deteriorating.
[sound:s-3650_状況が悪化しています。.mp3]	<b>悪化</b> <br> 状況が悪化しています。<br> じょうきょうがあっかしています <br>The situation is deteriorating.
警視庁	[sound:k-3651_警視庁.mp3]<br>けいしちょう <br> police headquarters
police headquarters	<b>警視庁<b> <br> けいしちょう <br>[sound:k-3651_警視庁.mp3]
[sound:k-3651_警視庁.mp3]	police headquarters<br> <b>警視庁</b> <br> (けいしちょう)
<b>化学</b> <br> 化学は私のお気に入りの科目です。	[sound:s-3651_化学は私のお気に入りの科目です。.mp3] <br> かがくはわたしのおきにいりのかもくです。 <br>Chemistry is my favorite subject.
[sound:s-3651_化学は私のお気に入りの科目です。.mp3]	<b>化学</b> <br> 化学は私のお気に入りの科目です。<br> かがくはわたしのおきにいりのかもくです <br>Chemistry is my favorite subject.
県警	[sound:k-3652_県警.mp3]<br>けんけい <br> prefectural police
prefectural police	<b>県警<b> <br> けんけい <br>[sound:k-3652_県警.mp3]
[sound:k-3652_県警.mp3]	prefectural police<br> <b>県警</b> <br> (けんけい)
<b>酸化</b> <br> この物質は空気中で酸化します。	[sound:s-3652_この物質は空気中で酸化します。.mp3] <br> このぶっしつはくうちゅうでさんかします。 <br>This substance oxidizes in the air.
[sound:s-3652_この物質は空気中で酸化します。.mp3]	<b>酸化</b> <br> この物質は空気中で酸化します。<br> このぶっしつはくうちゅうでさんかします <br>This substance oxidizes in the air.
警戒	[sound:k-3653_警戒.mp3]<br>けいかい <br> vigilance, precaution, watch, lookout, altertness; to be vigilant, to be cautious, to guard (against)
vigilance, precaution, watch, lookout, altertness; to be vigilant, to be cautious, to guard (against)	<b>警戒<b> <br> けいかい <br>[sound:k-3653_警戒.mp3]
[sound:k-3653_警戒.mp3]	vigilance, precaution, watch, lookout, altertness; to be vigilant, to be cautious, to guard<br> <b>against) (警戒</b> <br> (けいかい)
<b>化粧</b> <br> 彼女は毎朝化粧をします。	[sound:s-3653_彼女は毎朝化粧をします。.mp3] <br> かのじょはまいあさけしょうをします。 <br>She puts on makeup every morning.
[sound:s-3653_彼女は毎朝化粧をします。.mp3]	<b>化粧</b> <br> 彼女は毎朝化粧をします。<br> かのじょはまいあさけしょうをします <br>She puts on makeup every morning.
警察庁	[sound:k-3654_警察庁.mp3]<br>けいさつちょう <br> National Police Agency
National Police Agency	<b>警察庁<b> <br> けいさつちょう <br>[sound:k-3654_警察庁.mp3]
[sound:k-3654_警察庁.mp3]	National Police Agency<br> <b>警察庁</b> <br> (けいさつちょう)
<b>合理化</b> <br> 生産プロセスの合理化が進められています。	[sound:s-3654_生産プロセスの合理化が進められています。.mp3] <br> せいさんぷろせすのごうりかがすすめられています。 <br>Rationalization of the production process is being promoted.
[sound:s-3654_生産プロセスの合理化が進められています。.mp3]	<b>合理化</b> <br> 生産プロセスの合理化が進められています。<br> せいさんぷろせすのごうりかがすすめられています <br>Rationalization of the production process is being promoted.
警備	[sound:k-3655_警備.mp3]<br>けいび <br> defense, defence, guard, policing, security
defense, defence, guard, policing, security	<b>警備<b> <br> けいび <br>[sound:k-3655_警備.mp3]
[sound:k-3655_警備.mp3]	defense, defence, guard, policing, security<br> <b>警備</b> <br> (けいび)
<b>国際化</b> <br> その企業は国際化を進めています。	[sound:s-3655_その企業は国際化を進めています。.mp3] <br> そのきぎょうはこくさいかをすすめています。 <br>The company is globalizing.
[sound:s-3655_その企業は国際化を進めています。.mp3]	<b>国際化</b> <br> その企業は国際化を進めています。<br> そのきぎょうはこくさいかをすすめています <br>The company is globalizing.
警官	[sound:k-3656_警官.mp3]<br>けいかん <br> policeman
policeman	<b>警官<b> <br> けいかん <br>[sound:k-3656_警官.mp3]
[sound:k-3656_警官.mp3]	policeman<br> <b>警官</b> <br> (けいかん)
<b>本格化</b> <br> この計画は本格化されました。	[sound:s-3656_この計画は本格化されました。.mp3] <br> このけいかくはほんかくかされました。 <br>This plan has been put into full-scale operation.
[sound:s-3656_この計画は本格化されました。.mp3]	<b>本格化</b> <br> この計画は本格化されました。<br> このけいかくはほんかくかされました <br>This plan has been put into full-scale operation.
警告	[sound:k-3657_警告.mp3]<br>けいこく <br> warning, advice
warning, advice	<b>警告<b> <br> けいこく <br>[sound:k-3657_警告.mp3]
[sound:k-3657_警告.mp3]	warning, advice<br> <b>警告</b> <br> (けいこく)
<b>上田</b> <br> 上田さんは私の隣人です。	[sound:s-3657_上田さんは私の隣人です。.mp3] <br> うえださんはわたしのりんじんです。 <br>Mr. Ueda is my neighbor.
[sound:s-3657_上田さんは私の隣人です。.mp3]	<b>上田</b> <br> 上田さんは私の隣人です。<br> うえださんはわたしのりんじんです <br>Mr. Ueda is my neighbor.
府警	[sound:k-3658_府警.mp3]<br>ふけい <br> prefectural police
prefectural police	<b>府警<b> <br> ふけい <br>[sound:k-3658_府警.mp3]
[sound:k-3658_府警.mp3]	prefectural police<br> <b>府警</b> <br> (ふけい)
<b>水田</b> <br> この地域では水田が広がっています。	[sound:s-3658_この地域では水田が広がっています。.mp3] <br> このちいきではすいでんがひろがっています。 <br>Paddy fields spread out in this area.
[sound:s-3658_この地域では水田が広がっています。.mp3]	<b>水田</b> <br> この地域では水田が広がっています。<br> このちいきではすいでんがひろがっています <br>Paddy fields spread out in this area.
警報	[sound:k-3659_警報.mp3]<br>けいほう <br> alarm, warning
alarm, warning	<b>警報<b> <br> けいほう <br>[sound:k-3659_警報.mp3]
[sound:k-3659_警報.mp3]	alarm, warning<br> <b>警報</b> <br> (けいほう)
<b>油田</b> <br> その国は豊富な油田を持っています。	[sound:s-3659_その国は豊富な油田を持っています。.mp3] <br> そのくにはほうふなゆでんをもっています。 <br>The country has abundant oil fields.
[sound:s-3659_その国は豊富な油田を持っています。.mp3]	<b>油田</b> <br> その国は豊富な油田を持っています。<br> そのくにはほうふなゆでんをもっています <br>The country has abundant oil fields.
宮城	[sound:k-3660_宮城.mp3]<br>きゅうじょう <br> Imperial Palace
Imperial Palace	<b>宮城<b> <br> きゅうじょう <br>[sound:k-3660_宮城.mp3]
[sound:k-3660_宮城.mp3]	Imperial Palace<br> <b>宮城</b> <br> (きゅうじょう)
<b>田舎</b> <br> 彼女は田舎でのんびりと暮らしたいと言っています。	[sound:s-3660_彼女は田舎でのんびりと暮らしたいと言っています。.mp3] <br> かのじょはいなかでのんびりとくらしたいといっています。 <br>She says she wants to live a relaxed life in the countryside.
[sound:s-3660_彼女は田舎でのんびりと暮らしたいと言っています。.mp3]	<b>田舎</b> <br> 彼女は田舎でのんびりと暮らしたいと言っています。<br> かのじょはいなかでのんびりとくらしたいといっています <br>She says she wants to live a relaxed life in the countryside.
宮内庁	[sound:k-3661_宮内庁.mp3]<br>くないちょう <br> Imperial Household Agency
Imperial Household Agency	<b>宮内庁<b> <br> くないちょう <br>[sound:k-3661_宮内庁.mp3]
[sound:k-3661_宮内庁.mp3]	Imperial Household Agency<br> <b>宮内庁</b> <br> (くないちょう)
<b>桑田</b> <br> 日本では桑田地帯が多く見られます。	[sound:s-3661_日本では桑田地帯が多く見られます。.mp3] <br> にほんではくわたちたいがおおくみられます。 <br>Mulberry fields are commonly seen in Japan.
[sound:s-3661_日本では桑田地帯が多く見られます。.mp3]	<b>桑田</b> <br> 日本では桑田地帯が多く見られます。<br> にほんではくわたちたいがおおくみられます <br>Mulberry fields are commonly seen in Japan.
神宮	[sound:k-3662_神宮.mp3]<br>じんぐう <br> Shinto shrine
Shinto shrine	<b>神宮<b> <br> じんぐう <br>[sound:k-3662_神宮.mp3]
[sound:k-3662_神宮.mp3]	Shinto shrine<br> <b>神宮</b> <br> (じんぐう)
<b>田園</b> <br> その町は美しい田園風景で有名です。	[sound:s-3662_その町は美しい田園風景で有名です。.mp3] <br> そのまちはうつくしいでんえんふうけいでゆうめいです。 <br>The town is famous for its beautiful rural landscape.
[sound:s-3662_その町は美しい田園風景で有名です。.mp3]	<b>田園</b> <br> その町は美しい田園風景で有名です。<br> そのまちはうつくしいでんえんふうけいでゆうめいです <br>The town is famous for its beautiful rural landscape.
宮殿	[sound:k-3663_宮殿.mp3]<br>きゅうでん <br> palace
palace	<b>宮殿<b> <br> きゅうでん <br>[sound:k-3663_宮殿.mp3]
