当初の計画とは違う方向に進みました。 	 とうしょのけいかくとはちがうほうこうにすすみました。 <br> [sound:s-0563_とうしょのけいかくとはちがうほうこうにすすみました。.mp3] <br> <br>We moved in a different direction from the initial plan.
[sound:s-0564_えいがのしょにちにはたくさんのひとがきました。.mp3]	映画の初日にはたくさんの人が来ました。<br> えいがのしょにちにはたくさんのひとがきました。<br> Many people came on the opening day of the movie.	
選手権	[sound:k-0564_選手権.mp3]<br>せんしゅけん <br> championship, title (of champion)
championship, title (of champion)	<b>選手権<b> <br> せんしゅけん <br>[sound:k-0564_選手権.mp3]
[sound:k-0564_選手権.mp3]	championship, title<br> <b>of champion) (選手権</b> <br> (せんしゅけん)
映画の初日にはたくさんの人が来ました。 	 えいがのしょにちにはたくさんのひとがきました。 <br> [sound:s-0564_えいがのしょにちにはたくさんのひとがきました。.mp3] <br> <br>Many people came on the opening day of the movie.
[sound:s-0565_そのしょうひんはしょきのだんかいではにんきがありませんでした。.mp3]	<b>初期</b> - しょき<br>その商品は<b>初期</b>の段階では人気がありませんでした。<br>そのしょうひんはしょきのだんかいではにんきがありませんでした。<br>The product wasn't popular in the <b>early</b> stages.	
総選挙	[sound:k-0565_総選挙.mp3]<br>そうせんきょ <br> general election (of the lower house)
general election (of the lower house)	<b>総選挙<b> <br> そうせんきょ <br>[sound:k-0565_総選挙.mp3]
[sound:k-0565_総選挙.mp3]	general election<br> <b>of the lower house) (総選挙</b> <br> (そうせんきょ)
その商品は初期の段階では人気がありませんでした。 	 そのしょうひんはしょきのだんかいではにんきがありませんでした。 <br> [sound:s-0565_そのしょうひんはしょきのだんかいではにんきがありませんでした。.mp3] <br> <br>The product wasn't popular in the early stages.
[sound:s-0566_そのいえのしょだいはゆうめいなせいじかでした。.mp3]	"<div>&nbsp; 初演 - &nbsp;しょえん
当選	[sound:k-0566_当選.mp3]<br>とうせん <br> being elected; being selected (to win a prize, etc.); winning (in a lottery, raffle, etc.)
being elected; being selected (to win a prize, etc.); winning (in a lottery, raffle, etc.)	<b>当選<b> <br> とうせん <br>[sound:k-0566_当選.mp3]
[sound:k-0566_当選.mp3]	being elected; being selected<br> <b>to win a prize, etc.); winning (in a lottery, raffle, etc.) (当選</b> <br> (とうせん)
その家の初代は有名な政治家でした。 	 そのいえのしょだいはゆうめいなせいじかでした。 <br> [sound:s-0566_そのいえのしょだいはゆうめいなせいじかでした。.mp3] <br> <br>The first generation of that family was a famous politician.
<br>その劇は昨日初演されました。<br></div>
予選	[sound:k-0567_予選.mp3]<br>よせん <br> nomination, primary, preliminary contest
nomination, primary, preliminary contest	<b>予選<b> <br> よせん <br>[sound:k-0567_予選.mp3]
[sound:k-0567_予選.mp3]	nomination, primary, preliminary contest<br> <b>予選</b> <br> (よせん)
彼は初戦で大きな勝利を収めました。 	 かれはしょせんでおおきなしょうりをおさめました。 <br> [sound:s-0567_かれはしょせんでおおきなしょうりをおさめました。.mp3] <br> <br>He achieved a great victory in the first match.
そのげきはきのうしょえんされました。<br>The play had its first performance yesterday."	
小選挙区	[sound:k-0568_小選挙区.mp3]<br>しょうせんきょく <br> small electoral district, single-member constituency
small electoral district, single-member constituency	<b>小選挙区<b> <br> しょうせんきょく <br>[sound:k-0568_小選挙区.mp3]
[sound:k-0568_小選挙区.mp3]	small electoral district, single-member constituency<br> <b>小選挙区</b> <br> (しょうせんきょく)
その劇は昨日初演されました。 	 そのげきはきのうしょえんされました。 <br> [sound:s-0568_そのげきはきのうしょえんされました。.mp3] <br> <br>The play had its first performance yesterday.
[sound:s-0567_かれはしょせんでおおきなしょうりをおさめました。.mp3]	<b>初代</b> - しょだい (first generation)<br>その家の初代は有名な政治家でした。<br>そのいえのしょだいはゆうめいなせいじかでした。<br>The <b>founder</b> of that family was a famous politician.	
選考	[sound:k-0569_選考.mp3]<br>せんこう <br> selection, screening
selection, screening	<b>選考<b> <br> せんこう <br>[sound:k-0569_選考.mp3]
[sound:k-0569_選考.mp3]	selection, screening<br> <b>選考</b> <br> (せんこう)
今月の初旬は天気が良かったです。 	 こんげつのしょじゅんはてんきがよかったです。 <br> [sound:s-0569_こんげつのしょじゅんはてんきがよかったです。.mp3] <br> <br>The weather was good at the beginning of this month.
[sound:s-0568_そのげきはきのうしょえんされました。.mp3]	<b>初旬</b> - しょじゅん (1st 10 days of the month)<br>今月の初旬は天気が良かったです。<br>こんげつのしょじゅんはてんきがよかったです。<br>The weather was good at the <b>beginning</b> of this month.	
立場	[sound:k-0570_立場.mp3]<br>たちば <br> standpoint, position, situation
standpoint, position, situation	<b>立場<b> <br> たちば <br>[sound:k-0570_立場.mp3]
[sound:k-0570_立場.mp3]	standpoint, position, situation<br> <b>立場</b> <br> (たちば)
彼は初場所で優勝しました。 	 かれははつばしょでゆうしょうしました。 <br> [sound:s-0570_かれははつばしょでゆうしょうしました。.mp3] <br> <br>He won the championship in his first tournament.
[sound:s-0569_こんげつのしょじゅんはてんきがよかったです。.mp3]	<b>初戦</b> - しょせん<br>彼は<b>初戦</b>で大きな勝利を収めました。<br>かれはしょせんでおおきなしょうりをおさめました。<br>He achieved a great victory in the <b>first match</b>.	
連立	[sound:k-0571_連立.mp3]<br>れんりつ <br> alliance, coalition
alliance, coalition	<b>連立<b> <br> れんりつ <br>[sound:k-0571_連立.mp3]
[sound:k-0571_連立.mp3]	alliance, coalition<br> <b>連立</b> <br> (れんりつ)
その山の北側に家が建っています。 	 そのやまのきたがわにいえがたっています。 <br> [sound:s-0571_そのやまのきたがわにいえがたっています。.mp3] <br> <br>The house is built on the north side of the mountain.
[sound:s-0570_かれははつばしょでゆうしょうしました。.mp3]	その山の<b>北側</b>に家が建っています。<br>そのやまの<b>きたがわ</b>にいえがたっています。<br>The house is built on the <b>north side</b> of the mountain.	
国立	[sound:k-0572_国立.mp3]<br>こくりつ <br> national
national	<b>国立<b> <br> こくりつ <br>[sound:k-0572_国立.mp3]
[sound:k-0572_国立.mp3]	national<br> <b>国立</b> <br> (こくりつ)
北海道は日本の最北の島です。 	 ほっかいどうはにほんのさいほくのしまです。 <br> [sound:s-0572_ほっかいどうはにほんのさいほくのしまです。.mp3] <br> <br>Hokkaido is the northernmost island of Japan.
[sound:s-0571_そのやまのきたがわにいえがたっています。.mp3]	<b>北海道</b>は日本の<i>最北</i>の島です。<br><b>ほっかいどう</b>はにほんの<i>さいほく</i>のしまです。<br><b>Hokkaido</b> is the <i>northernmost</i> island of Japan.	
成立	[sound:k-0573_成立.mp3]<br>せいりつ <br> coming into existence, arrangements, establishment, conclusion, completion
coming into existence, arrangements, establishment, conclusion, completion	<b>成立<b> <br> せいりつ <br>[sound:k-0573_成立.mp3]
[sound:k-0573_成立.mp3]	coming into existence, arrangements, establishment, conclusion, completion<br> <b>成立</b> <br> (せいりつ)
北京には多くの歴史的な建造物があります。 	 ぺきんにはおおくのれきしてきなけんぞうぶつがあります。 <br> [sound:s-0573_ぺきんにはおおくのれきしてきなけんぞうぶつがあります。.mp3] <br> <br>Beijing has many historical buildings.
[sound:s-0572_ほっかいどうはにほんのさいほくのしまです。.mp3]	<b>北京</b>には多くの歴史的な建造物があります。<br><b>ぺきん</b>にはおおくのれきしてきなけんぞうぶつがあります。<br><b>Beijing</b> has many historical buildings.	
対立	[sound:k-0574_対立.mp3]<br>たいりつ <br> confrontation, opposition, antagonism
confrontation, opposition, antagonism	<b>対立<b> <br> たいりつ <br>[sound:k-0574_対立.mp3]
[sound:k-0574_対立.mp3]	confrontation, opposition, antagonism<br> <b>対立</b> <br> (たいりつ)
北朝鮮は国際的な注目を集めています。 	 きたちょうせんはこくさいてきなちゅうもくをあつめています。 <br> [sound:s-0574_きたちょうせんはこくさいてきなちゅうもくをあつめています。.mp3] <br> <br>North Korea is attracting international attention.
[sound:s-0573_ぺきんにはおおくのれきしてきなけんぞうぶつがあります。.mp3]	<b>北朝鮮</b>は国際的な注目を集めています。<br><b>きたちょうせん</b>はこくさいてきなちゅうもくをあつめています。<br><b>North Korea </b>is attracting international attention.	
独立	[sound:k-0575_独立.mp3]<br>どくりつ <br> independence (e.g. Independence Day), self-support
independence (e.g. Independence Day), self-support	<b>独立<b> <br> どくりつ <br>[sound:k-0575_独立.mp3]
[sound:k-0575_独立.mp3]	independence<br> <b>e.g. Independence Day), self-support (独立</b> <br> (どくりつ)
東北地方は自然が豊かです。 	 とうほくちほうはしぜんがゆたかです。 <br> [sound:s-0575_とうほくちほうはしぜんがゆたかです。.mp3] <br> <br>The Tohoku region is abundant in nature.
[sound:s-0574_きたちょうせんはこくさいてきなちゅうもくをあつめています。.mp3]	<b>東北</b>地方は自然が豊かです。<br><b>とうほく</b>ちほうはしぜんがゆたかです。<br>The <b>Tohoku</b> region is abundant in nature.	
私立	[sound:k-0576_私立.mp3]<br>しりつ, わたくしりつ <br> private (establishment)
private (establishment)	<b>私立<b> <br> しりつ, わたくしりつ <br>[sound:k-0576_私立.mp3]
[sound:k-0576_私立.mp3]	private<br> <b>establishment) (私立</b> <br> (しりつ, わたくしりつ)
その線は南北に走っています。 	 そのせんはなんぼくにはしっています。 <br> [sound:s-0576_そのせんはなんぼくにはしっています。.mp3] <br> <br>The line runs north to south.
[sound:s-0575_とうほくちほうはしぜんがゆたかです。.mp3]	<b>南北</b> - はなんぼく<br><br>その線は<b>南北</b>に走っています。<br>そのせんは<b>なんぼく</b>にはしっています。<br>The line runs <b>north to south</b>.	
設立	[sound:k-0577_設立.mp3]<br>せつりつ <br> establishment, foundation, incorporation (of a business)
establishment, foundation, incorporation (of a business)	<b>設立<b> <br> せつりつ <br>[sound:k-0577_設立.mp3]
[sound:k-0577_設立.mp3]	establishment, foundation, incorporation<br> <b>of a business) (設立</b> <br> (せつりつ)
この地域は北方からの風が強いです。 	 このちいきはほっぽうからのかぜがつよいです。 <br> [sound:s-0577_このちいきはほっぽうからのかぜがつよいです。.mp3] <br> <br>This area has strong winds from the north.
[sound:s-0576_そのせんはなんぼくにはしっています。.mp3]	この地域は<b>北方から</b>の風が強いです。<br>このちいきは<b>ほっぽうから</b>のかぜがつよいです。<br>This area has strong winds <b>from the north</b>.	
並立	[sound:k-0578_並立.mp3]<br>へいりつ <br> standing abreast
standing abreast	<b>並立<b> <br> へいりつ <br>[sound:k-0578_並立.mp3]
[sound:k-0578_並立.mp3]	standing abreast<br> <b>並立</b> <br> (へいりつ)
その国の北部には山が多いです。 	 そのくにのほくぶにはやまがおおいです。 <br> [sound:s-0578_そのくにのほくぶにはやまがおおいです。.mp3] <br> <br>The northern part of the country has many mountains.
[sound:s-0577_このちいきはほっぽうからのかぜがつよいです。.mp3]	その国の<b>北部</b>には山が多いです。<br>そのくにの<b>ほくぶ</b>にはやまがおおいです。<br>The <b>northern part</b> of the country has many mountains.	
確立	[sound:k-0579_確立.mp3]<br>かくりつ <br> establishment
establishment	<b>確立<b> <br> かくりつ <br>[sound:k-0579_確立.mp3]
[sound:k-0579_確立.mp3]	establishment<br> <b>確立</b> <br> (かくりつ)
その船は北東に向かっています。 	 そのふねはほくとうにむかっています。 <br> [sound:s-0579_そのふねはほくとうにむかっています。.mp3] <br> <br>The ship is heading northeast.
[sound:s-0578_そのくにのほくぶにはやまがおおいです。.mp3]	その船は<b>北東</b>に向かっています。<br>そのふねは<b>ほくとう</b>にむかっています。<br>The ship is heading <b>northeast</b>.	
開発	[sound:k-0580_開発.mp3]<br>かいはつ <br> development, exploitation
development, exploitation	<b>開発<b> <br> かいはつ <br>[sound:k-0580_開発.mp3]
[sound:k-0580_開発.mp3]	development, exploitation<br> <b>開発</b> <br> (かいはつ)
(<b>敗北</b>) 戦いで敗北を喫した。	[sound:s-0580_戦いで敗北を喫した。.mp3] <br> たたかいではいぼくをきっした。 <br> They suffered defeat in battle.
[sound:s-0579_そのふねはほくとうにむかっています。.mp3]	<b>敗北</b> <br> 戦いで敗北を喫した。<br> たたかいで<b>はいぼく</b>をきっした <br>They suffered <b>defeat</b> in battle.	
開催	[sound:k-0581_開催.mp3]<br>かいさい <br> holding a meeting, open an exhibition
holding a meeting, open an exhibition	<b>開催<b> <br> かいさい <br>[sound:k-0581_開催.mp3]
[sound:k-0581_開催.mp3]	holding a meeting, open an exhibition<br> <b>開催</b> <br> (かいさい)
(<b>午後</b>) 午後に友達と会う。	[sound:s-0581_午後に友達と会う。.mp3] <br> ごごにともだちとあう。 <br> I will meet my friend in the afternoon.
[sound:s-0580_戦いで敗北を喫した。.mp3]	<b>午後</b> <br> 午後に友達と会う。<br> <b>ごご</b>にともだちとあう <br>I will meet my friend in the <b>afternoon</b>.	
開始	[sound:k-0582_開始.mp3]<br>かいし <br> start, commencement, beginning, initiation
start, commencement, beginning, initiation	<b>開始<b> <br> かいし <br>[sound:k-0582_開始.mp3]
[sound:k-0582_開始.mp3]	start, commencement, beginning, initiation<br> <b>開始</b> <br> (かいし)
(<b>午前</b>) 午前の散歩は気持ちがいいです。	[sound:s-0582_午前の散歩は気持ちがいいです。.mp3] <br> ごぜんのさんぽはきもちがいいです。 <br> Morning walks are pleasant.
[sound:s-0581_午後に友達と会う。.mp3]	<b>午前</b> <br> <b>午前</b>の散歩は気持ちがいいです。<br> <b>ごぜん</b>のさんぽはきもちがいいです <br><b>Morning</b> walks are pleasant.	
開放	[sound:k-0583_開放.mp3]<br>かいほう <br> open, throw open, liberalization, liberalisation
open, throw open, liberalization, liberalisation	<b>開放<b> <br> かいほう <br>[sound:k-0583_開放.mp3]
[sound:k-0583_開放.mp3]	open, throw open, liberalization, liberalisation<br> <b>開放</b> <br> (かいほう)
(<b>正午</b>) 正午に昼食をとります。	[sound:s-0583_正午に昼食をとります。.mp3] <br> しょうごにちゅうしょくをとります。 <br> We'll have lunch at noon.
[sound:s-0582_午前の散歩は気持ちがいいです。.mp3]	<b>正午</b> <br> 正午に昼食をとります。<br><b> しょうご</b>にちゅうしょくをとります <br>We'll have lunch at <b>noon</b>.	
公開	[sound:k-0584_公開.mp3]<br>こうかい <br> open to the public
open to the public	<b>公開<b> <br> こうかい <br>[sound:k-0584_公開.mp3]
[sound:k-0584_公開.mp3]	open to the public<br> <b>公開</b> <br> (こうかい)
(<b>午</b>) 午に昼食を取ります。	[sound:s-0584_午に昼食を取ります。.mp3] <br> ごにちゅうしょくをとります。 <br> We eat lunch at midday.
[sound:s-0583_正午に昼食をとります。.mp3]	<b>子午線</b> <br> 子午線は地球を分割します。<br><b> しごせん</b>はちきゅうをぶんかつします <br>The <b>meridian</b> divides the Earth.	
展開	[sound:k-0585_展開.mp3]<br>てんかい <br> development; expansion (opposite of compression)
development; expansion (opposite of compression)	<b>展開<b> <br> てんかい <br>[sound:k-0585_展開.mp3]
[sound:k-0585_展開.mp3]	development; expansion<br> <b>opposite of compression) (展開</b> <br> (てんかい)
(<b>子午線</b>) 子午線は地球を分割します。	[sound:s-0585_子午線は地球を分割します。.mp3] <br> しごせんはちきゅうをぶんかつします。 <br> The meridian divides the Earth.
[sound:s-0584_午に昼食を取ります。.mp3]	<b>端午</b> <br> 端午の節句には鯉のぼりが飾られます。<br><b> たんご</b>のせっくにはこいのぼりがかざられます <br>Carp streamers are displayed during the Dragon Boat Festival.	
開幕	[sound:k-0586_開幕.mp3]<br>かいまく <br> raising the curtain
raising the curtain	<b>開幕<b> <br> かいまく <br>[sound:k-0586_開幕.mp3]
[sound:k-0586_開幕.mp3]	raising the curtain<br> <b>開幕</b> <br> (かいまく)
(<b>端午</b>) 端午の節句には鯉のぼりが飾られます。	[sound:s-0586_端午の節句には鯉のぼりが飾られます。.mp3] <br> たんごのせっくにはこいのぼりがかざられます。 <br> Carp streamers are displayed during the Dragon Boat Festival.
[sound:s-0585_子午線は地球を分割します。.mp3]	<b>午後中</b> <br> 午後中雨が降り続いた。<br><b> ごごちゅう</b>あめがふりつづいた <br>It rained <b>throughout the afternoon</b>.	
再開	[sound:k-0587_再開.mp3]<br>さいかい <br> reopening, resumption, restarting
reopening, resumption, restarting	<b>再開<b> <br> さいかい <br>[sound:k-0587_再開.mp3]
[sound:k-0587_再開.mp3]	reopening, resumption, restarting<br> <b>再開</b> <br> (さいかい)
(<b>午過ぎ</b>) 午過ぎに会議があります。	[sound:s-0587_午過ぎに会議があります。.mp3] <br> ごすぎにかいぎがあります。 <br> There's a meeting in the late afternoon.
[sound:s-0586_端午の節句には鯉のぼりが飾られます。.mp3]	<b>指</b> <br> 指先で細かい作業をします。<br><b> ゆび</b>さきでこまかいさぎょうをします <br>I do fine work with my <b>fingers</b>.	
開き	[sound:k-0588_開き.mp3]<br>ひらき <br> opening, gap; dried and opened fish
opening, gap; dried and opened fish	<b>開き<b> <br> ひらき <br>[sound:k-0588_開き.mp3]
[sound:k-0588_開き.mp3]	opening, gap; dried and opened fish<br> <b>開き</b> <br> (ひらき)
(<b>午后</b>) 午后に嵐がやってきた。	[sound:s-0588_午后に嵐がやってきた。.mp3] <br> ごこうにあらし がやってきた。 <br> A storm came in the afternoon.
[sound:s-0587_午過ぎに会議があります。.mp3]	<b>指導</b> <br> 先生は生徒に熱心な指導をしています。<br> せんせいはせいとにねっしんな<b>しどう</b>をしています <br>The teacher is providing enthusiastic <b>guidance</b> to the students.	
開会	[sound:k-0589_開会.mp3]<br>かいかい <br> opening of a meeting
opening of a meeting	<b>開会<b> <br> かいかい <br>[sound:k-0589_開会.mp3]
[sound:k-0589_開会.mp3]	opening of a meeting<br> <b>開会</b> <br> (かいかい)
(<b>午後中</b>) 午後中雨が降り続いた。	[sound:s-0589_午後中雨が降り続いた。.mp3] <br> ごごちゅうあめがふりつづいた。 <br> It rained throughout the afternoon.
[sound:s-0588_午后に嵐がやってきた。.mp3]	<b>指揮</b> <br> 指揮官は部隊を率いて戦場に向かった。<br><b> しき</b>かんはぶたいをひきいてせんじょうにむかった <br>The <b>command</b>er led the troops to the battlefield.	
手	[sound:k-0590_手.mp3]<br>て <br> hand, arm; forepaw, foreleg; handle; hand, worker, help; trouble, care, effort; means, way, trick, move, technique, workmanship; hand, handwriting; kind, type, sort; one's hands, one's possession; ability to cope; hand (of cards)
hand, arm; forepaw, foreleg; handle; hand, worker, help; trouble, care, effort; means, way, trick, move, technique, workmanship; hand, handwriting; kind, type, sort; one's hands, one's possession; ability to cope; hand (of cards)	<b>手<b> <br> て <br>[sound:k-0590_手.mp3]
[sound:k-0590_手.mp3]	hand, arm; forepaw, foreleg; handle; hand, worker, help; trouble, care, effort; means, way, trick, move, technique, workmanship; hand, handwriting; kind, type, sort; one's hands, one's possession; ability to cope; hand<br> <b>of cards) (手</b> <br> (て)
(<b>指</b>) 指先で細かい作業をします。	[sound:s-0590_指先で細かい作業をします。.mp3] <br> ゆびさきでこまかいさぎょうをします。 <br> I do fine work with my fingers.
[sound:s-0589_午後中雨が降り続いた。.mp3]	<b>指定</b> <br> その席は指定席です。<br> そのせきは<b>してい</b>せきです <br>That seat is <b>reserved</b>.	
選手	[sound:k-0591_選手.mp3]<br>せんしゅ <br> player (in game), team member
player (in game), team member	<b>選手<b> <br> せんしゅ <br>[sound:k-0591_選手.mp3]
[sound:k-0591_選手.mp3]	player<br> <b>in game), team member (選手</b> <br> (せんしゅ)
(<b>指導</b>) 先生は生徒に熱心な指導をしています。	[sound:s-0591_先生は生徒に熱心な指導をしています。.mp3] <br> せんせいはせいとにねっしんなしどうをしています。 <br> The teacher is providing enthusiastic guidance to the students.
[sound:s-0590_指先で細かい作業をします。.mp3]	<b>指名</b> <br> 彼はキャプテンに指名されました。<br> かれはきゃぷてんに<b>しめい</b>されました <br>He was <b>nominate</b>d as captain.	
選手権	[sound:k-0592_選手権.mp3]<br>せんしゅけん <br> championship, title (of champion)
championship, title (of champion)	<b>選手権<b> <br> せんしゅけん <br>[sound:k-0592_選手権.mp3]
[sound:k-0592_選手権.mp3]	championship, title<br> <b>of champion) (選手権</b> <br> (せんしゅけん)
(<b>指揮</b>) 指揮官は部隊を率いて戦場に向かった。	[sound:s-0592_指揮官は部隊を率いて戦場に向かった。.mp3] <br> しきかんはぶたいをひきいてせんじょうにむかった。 <br> The commander led the troops to the battlefield.
[sound:s-0591_先生は生徒に熱心な指導をしています。.mp3]	<b>指示</b> <br> マネージャーが指示を出しました。<br> まねーじゃーが<b>しじ</b>をだしました <br>The manager gave <b>instructions</b>.	
相手	[sound:k-0593_相手.mp3]<br>あいて <br> companion, partner, company; other party, addressee; opponent (sports, etc.)
companion, partner, company; other party, addressee; opponent (sports, etc.)	<b>相手<b> <br> あいて <br>[sound:k-0593_相手.mp3]
[sound:k-0593_相手.mp3]	companion, partner, company; other party, addressee; opponent<br> <b>sports, etc.) (相手</b> <br> (あいて)
(<b>指定</b>) その席は指定席です。	[sound:s-0593_その席は指定席です。.mp3] <br> そのせきはしていせきです。 <br> That seat is reserved.
[sound:s-0592_指揮官は部隊を率いて戦場に向かった。.mp3]	"<b>指摘</b>&nbsp;-&nbsp;
大手	[sound:k-0594_大手.mp3]<br>おおて, おおで <br> front castle gate; both arms open, outstretched arms; major companies
front castle gate; both arms open, outstretched arms; major companies	<b>大手<b> <br> おおて, おおで <br>[sound:k-0594_大手.mp3]
[sound:k-0594_大手.mp3]	front castle gate; both arms open, outstretched arms; major companies<br> <b>大手</b> <br> (おおて, おおで)
(<b>指名</b>) 彼はキャプテンに指名されました。	[sound:s-0594_彼はキャプテンに指名されました。.mp3] <br> かれはきゃぷてんにしめいされました。 <br> He was nominated as captain.

投手	[sound:k-0595_投手.mp3]<br>とうしゅ <br> (baseball) pitcher
(baseball) pitcher	<b>投手<b> <br> とうしゅ <br>[sound:k-0595_投手.mp3]
[sound:k-0595_投手.mp3]	(baseball) pitcher<br> <b>投手</b> <br> (とうしゅ)
(<b>指示</b>) マネージャーが指示を出しました。	[sound:s-0595_マネージャーが指示を出しました。.mp3] <br> まねーじゃーがしじをだしました。 <br> The manager gave instructions.
<b>してき</b>&nbsp;<br> 先生は間違いを指摘しました。<br> せんせいはまちがいを<b>してき</b>しました <br>The teacher <b>pointed out</b> the mistake."	
若手	[sound:k-0596_若手.mp3]<br>わかて <br> young person
young person	<b>若手<b> <br> わかて <br>[sound:k-0596_若手.mp3]
[sound:k-0596_若手.mp3]	young person<br> <b>若手</b> <br> (わかて)
(<b>指摘</b>) 先生は間違いを指摘しました。	[sound:s-0596_先生は間違いを指摘しました。.mp3] <br> せんせいはまちがいをしてきしました。 <br> The teacher pointed out the mistake.
[sound:s-0593_その席は指定席です。.mp3]	<b>指数</b> <br> 経済指数は上昇しています。<br> けいざい<b>しすう</b>はじょうしょうしています <br>Economic <b>indices</b> are rising.	
手続き	[sound:k-0597_手続き.mp3]<br>てつづき <br> procedure, (legal) process, formalities
procedure, (legal) process, formalities	<b>手続き<b> <br> てつづき <br>[sound:k-0597_手続き.mp3]
[sound:k-0597_手続き.mp3]	procedure,<br> <b>legal) process, formalities (手続き</b> <br> (てつづき)
(<b>指数</b>) 経済指数は上昇しています。	[sound:s-0597_経済指数は上昇しています。.mp3] <br> けいざいしすうはじょうしょうしています。 <br> Economic indices are rising.
[sound:s-0594_彼はキャプテンに指名されました。.mp3]	<b>指標</b> <br> GDPは経済の指標の一つです。<br> GDPはけいざいの<b>しひょう</b>のひとつです <br>GDP is one of the <b>indicators</b> of the economy.	
取っ手	[sound:k-0598_取っ手.mp3]<br>とって, はしゅ <br> handle, grip, knob
handle, grip, knob	<b>取っ手<b> <br> とって, はしゅ <br>[sound:k-0598_取っ手.mp3]
[sound:k-0598_取っ手.mp3]	handle, grip, knob<br> <b>取っ手</b> <br> (とって, はしゅ)
(<b>指標</b>) GDPは経済の指標の一つです。	[sound:s-0598_GDPは経済の指標の一つです。.mp3] <br> GDPはけいざいのしひょうのひとつです。 <br> GDP is one of the indicators of the economy.
[sound:s-0595_マネージャーが指示を出しました。.mp3]	<b>指針</b> <br> その計画には明確な指針が必要です。<br> そのけいかくにはめいかくな<b>ししん</b>がひつようです <br>Clear <b>guidelines</b> are needed for the plan.	
歌手	[sound:k-0599_歌手.mp3]<br>かしゅ <br> singer
singer	<b>歌手<b> <br> かしゅ <br>[sound:k-0599_歌手.mp3]
[sound:k-0599_歌手.mp3]	singer<br> <b>歌手</b> <br> (かしゅ)
(<b>指針</b>) その計画には明確な指針が必要です。	[sound:s-0599_その計画には明確な指針が必要です。.mp3] <br> そのけいかくにはめいかくなしせんがひつようです。 <br> Clear guidelines are needed for the plan.
[sound:s-0596_先生は間違いを指摘しました。.mp3]	<b>政権</b> <br> 新しい政権が発足しました。<br> あたらしい<b>せいけん</b>がほっそくしました <br>A new <b>administration</b> has taken office.	
日米	[sound:k-0600_日米.mp3]<br>にちべい <br> Japan-America
Japan-America	<b>日米<b> <br> にちべい <br>[sound:k-0600_日米.mp3]
[sound:k-0600_日米.mp3]	Japan-America<br> <b>日米</b> <br> (にちべい)
(<b>政権</b>) 新しい政権が発足しました。	[sound:s-0600_新しい政権が発足しました。.mp3] <br> あたらしいせいけんがほっそくしました。 <br> A new administration has taken office.
[sound:s-0597_経済指数は上昇しています。.mp3]	"<b>選手権</b>&nbsp;-&nbsp;
米国	[sound:k-0601_米国.mp3]<br>べいこく <br> America, USA
America, USA	<b>米国<b> <br> べいこく <br>[sound:k-0601_米国.mp3]
[sound:k-0601_米国.mp3]	America, USA<br> <b>米国</b> <br> (べいこく)
(<b>選手権</b>) その大会はバスケットボールの選手権です。	[sound:s-0601_その大会はバスケットボールの選手権です。.mp3] <br> そのたいかいはバスケットボールのせんしゅけんです。 <br> The tournament is the basketball championship.

全米	[sound:k-0602_全米.mp3]<br>ぜんべい <br> all-America, pan-American
all-America, pan-American	<b>全米<b> <br> ぜんべい <br>[sound:k-0602_全米.mp3]
[sound:k-0602_全米.mp3]	all-America, pan-American<br> <b>全米</b> <br> (ぜんべい)
(<b>権利</b>) 人々は権利を主張しています。	[sound:s-0602_人々は権利を主張しています。.mp3] <br> ひとびとはけんりをしゅちょうしています。 <br> People are asserting their rights.
<b>せんしゅけん</b>&nbsp;<br> その大会はバスケットボールの選手権です。<br> そのたいかいはバスケットボールの<b>せんしゅけん</b>です <br>The tournament is the basketball <b>championship</b>."	
対米	[sound:k-0603_対米.mp3]<br>たいべい <br> relating to the USA, toward America, with America
relating to the USA, toward America, with America	<b>対米<b> <br> たいべい <br>[sound:k-0603_対米.mp3]
[sound:k-0603_対米.mp3]	relating to the USA, toward America, with America<br> <b>対米</b> <br> (たいべい)
(<b>権力</b>) 権力を持つ者には責任が伴います。	[sound:s-0603_権力を持つ者には責任が伴います。.mp3] <br> けんりょくをもつものにはせきにんがともないます。 <br> Those who hold authority have responsibilities.
[sound:s-0598_GDPは経済の指標の一つです。.mp3]	<b>権利</b> <br> 人々は権利を主張しています。<br> ひとびとは<b>けんり</b>をしゅちょうしています <br>People are asserting their <b>rights</b>.	
訪米	[sound:k-0604_訪米.mp3]<br>ほうべい <br> visit to America
visit to America	<b>訪米<b> <br> ほうべい <br>[sound:k-0604_訪米.mp3]
[sound:k-0604_訪米.mp3]	visit to America<br> <b>訪米</b> <br> (ほうべい)
(<b>人権</b>) 人権は尊重されるべきです。	[sound:s-0604_人権は尊重されるべきです。.mp3] <br> じんけんはそんちょうされるべきです。 <br> Human rights should be respected.
[sound:s-0599_その計画には明確な指針が必要です。.mp3]	<b>権力</b> <br> 権力を持つ者には<i>責任</i>が伴います。<br><b> けんりょく</b>をもつものには<i>せきにん</i>がともないます <br>Those who hold <b>authority</b> have <i>responsibilities</i>.	
中南米	[sound:k-0605_中南米.mp3]<br>ちゅうなんべい <br> Central and South America
Central and South America	<b>中南米<b> <br> ちゅうなんべい <br>[sound:k-0605_中南米.mp3]
[sound:k-0605_中南米.mp3]	Central and South America<br> <b>中南米</b> <br> (ちゅうなんべい)
(<b>権限</b>) そのプロジェクトの権限は限られています。	[sound:s-0605_そのプロジェクトの権限は限られています。.mp3] <br> そのぷろじぇくとのけんげんはかぎられています。 <br> The authority of that project is limited.
[sound:s-0600_新しい政権が発足しました。.mp3]	<b>人権</b> <br> 人権は尊重されるべきです。<br><b> じんけん</b>はそんちょうされるべきです <br><b>Human rights</b> should be respected.	
南米	[sound:k-0606_南米.mp3]<br>なんべい <br> South America
South America	<b>南米<b> <br> なんべい <br>[sound:k-0606_南米.mp3]
[sound:k-0606_南米.mp3]	South America<br> <b>南米</b> <br> (なんべい)
(<b>債権</b>) 彼は多くの債権を持っています。	[sound:s-0606_彼は多くの債権を持っています。.mp3] <br> かれはおおくのさいけんをもっています。 <br> He holds many credits.
[sound:s-0601_その大会はバスケットボールの選手権です。.mp3]	<b>権限</b> <br> そのプロジェクトの権限は限られています。<br> そのぷろじぇくとの<b>けんげん</b>はかぎられています <br>The <b>authority</b> of that project is limited.	
米価	[sound:k-0607_米価.mp3]<br>べいか <br> rice price
rice price	<b>米価<b> <br> べいか <br>[sound:k-0607_米価.mp3]
[sound:k-0607_米価.mp3]	rice price<br> <b>米価</b> <br> (べいか)
(<b>有権者</b>) 有権者は次の選挙で重要な役割を果たします。	[sound:s-0607_有権者は次の選挙で重要な役割を果たします。.mp3] <br> ゆうけんしゃはつぎのせんきょでじゅうようなやくわりをはたします。 <br> Voters play a crucial role in the next election.
[sound:s-0602_人々は権利を主張しています。.mp3]	<b>債権</b> <br> 彼は多くの債権を持っています。<br> かれはおおくの<b>さいけん</b>をもっています <br>He has many <b>debts</b>.	
反米	[sound:k-0608_反米.mp3]<br>はんべい <br> anti-American
anti-American	<b>反米<b> <br> はんべい <br>[sound:k-0608_反米.mp3]
[sound:k-0608_反米.mp3]	anti-American<br> <b>反米</b> <br> (はんべい)
(<b>主権</b>) 国家は主権を持っています。	[sound:s-0608_国家は主権を持っています。.mp3] <br> こっかはしゅけんをもっています。 <br> The state holds sovereignty.
[sound:s-0603_権力を持つ者には責任が伴います。.mp3]	<b>有権者</b> <br> 有権者は次の選挙で重要な役割を果たします。<br><b> ゆうけんしゃ</b>はつぎのせんきょでじゅうようなやくわりをはたします <br><b>Voters</b> play a crucial role in the next election.	
米穀	[sound:k-0609_米穀.mp3]<br>べいこく <br> rice
rice	<b>米穀<b> <br> べいこく <br>[sound:k-0609_米穀.mp3]
[sound:k-0609_米穀.mp3]	rice<br> <b>米穀</b> <br> (べいこく)
(<b>権</b>) 彼は強い権を持っています。	[sound:s-0609_彼は強い権を持っています。.mp3] <br> かれはつよいけんをもっています。 <br> He holds great power.
[sound:s-0604_人権は尊重されるべきです。.mp3]	<b>主権</b> <br> 国家は主権を持っています。<br> こっかは<b>しゅけん</b>をもっています <br>The state holds <b>sovereignty</b>.	
勢力	[sound:k-0610_勢力.mp3]<br>せいりょく <br> influence, power, might, strength, potency, force, energy
influence, power, might, strength, potency, force, energy	<b>勢力<b> <br> せいりょく <br>[sound:k-0610_勢力.mp3]
[sound:k-0610_勢力.mp3]	influence, power, might, strength, potency, force, energy<br> <b>勢力</b> <br> (せいりょく)
(<b>関心</b>) 彼女は環境問題に関心があります。	[sound:s-0610_彼女は環境問題に関心があります。.mp3] <br> かのじょはかんきょうもんだいにかんしんがあります。 <br> She is interested in environmental issues.
[sound:s-0605_そのプロジェクトの権限は限られています。.mp3]	<b>権</b> <br> 彼は強い権を持っています。<br> かれはつよい<b>けん</b>をもっています <br>He holds great <b>power</b>.	
努力	[sound:k-0611_努力.mp3]<br>どりょく <br> great effort, exertion, endeavour, endeavor, effort
great effort, exertion, endeavour, endeavor, effort	<b>努力<b> <br> どりょく <br>[sound:k-0611_努力.mp3]
[sound:k-0611_努力.mp3]	great effort, exertion, endeavour, endeavor, effort<br> <b>努力</b> <br> (どりょく)
(<b>中心</b>) 都市の中心には高いビルが立っている。	[sound:s-0611_都市の中心には高いビルが立っている。.mp3] <br> としのちゅうしんにはたかいビルがたっている。 <br> Tall buildings stand in the center of the city.
[sound:s-0606_彼は多くの債権を持っています。.mp3]	<b>関心</b> <br> 彼女は<i>環境</i>問題に<b>関心</b>があります。<br> かのじょは<i>かんきょう</i>もんだいに<b>かんしん</b>があります <br>She is <b>interested</b> in <i>environmental</i> issues.	
協力	[sound:k-0612_協力.mp3]<br>きょうりょく <br> cooperation, collaboration
cooperation, collaboration	<b>協力<b> <br> きょうりょく <br>[sound:k-0612_協力.mp3]
[sound:k-0612_協力.mp3]	cooperation, collaboration<br> <b>協力</b> <br> (きょうりょく)
(<b>心不全</b>) 心不全の治療が必要です。	[sound:s-0612_心不全の治療が必要です。.mp3] <br> しんふぜんのちりょうがひつようです。 <br> Treatment for heart failure is necessary.
[sound:s-0607_有権者は次の選挙で重要な役割を果たします。.mp3]	<b>中心</b> <br> 都市の中心には高いビルが立っている。<br> としの<b>ちゅうしん</b>にはたかいビルがたっている <br>Tall buildings stand in the <b>center</b> of the city.	
権力	[sound:k-0613_権力.mp3]<br>けんりょく <br> (political) power, authority, influence
(political) power, authority, influence	<b>権力<b> <br> けんりょく <br>[sound:k-0613_権力.mp3]
[sound:k-0613_権力.mp3]	(political) power, authority, influence<br> <b>権力</b> <br> (けんりょく)
(<b>心から</b>) 彼女は心から感謝しています。	[sound:s-0613_彼女は心から感謝しています。.mp3] <br> かのじょはこころからかんしゃしています。 <br> She is sincerely grateful.
[sound:s-0608_国家は主権を持っています。.mp3]	<b>心不全</b> <br> 心不全の治療が必要です。<br><b> しんふぜん</b>のちりょうがひつようです <br>Treatment for <b>heart failure</b> is necessary.	
原子力	[sound:k-0614_原子力.mp3]<br>げんしりょく <br> atomic energy
atomic energy	<b>原子力<b> <br> げんしりょく <br>[sound:k-0614_原子力.mp3]
[sound:k-0614_原子力.mp3]	atomic energy<br> <b>原子力</b> <br> (げんしりょく)
(<b>心臓</b>) 心臓の健康は重要です。	[sound:s-0614_心臓の健康は重要です。.mp3] <br> しんぞうのけんこうはじゅうようです。 <br> Heart health is important.
[sound:s-0609_彼は強い権を持っています。.mp3]	<b>心から</b> <br> 彼女は心から感謝しています。<br> かのじょは<b>こころから</b>かんしゃしています <br>She is <b>sincerely</b> grateful.	
実力	[sound:k-0615_実力.mp3]<br>じつりょく <br> (real) ability, true strength, merit, efficiency, competency; arms, force
(real) ability, true strength, merit, efficiency, competency; arms, force	<b>実力<b> <br> じつりょく <br>[sound:k-0615_実力.mp3]
[sound:k-0615_実力.mp3]	(real) ability, true strength, merit, efficiency, competency; arms, force<br> <b>実力</b> <br> (じつりょく)
(<b>心配</b>) 彼女の安全を心配しています。	[sound:s-0615_彼女の安全を心配しています。.mp3] <br> かのじょのあんぜんをしんぱいしています。 <br> I'm worried about her safety.
[sound:s-0610_彼女は環境問題に関心があります。.mp3]	<b>心臓</b> <br> 心臓の健康は重要です。<br><b> しんぞう</b>のけんこうはじゅうようです <br><b>Heart</b> health is important.	
能力	[sound:k-0616_能力.mp3]<br>のうりょく <br> ability, faculty
ability, faculty	<b>能力<b> <br> のうりょく <br>[sound:k-0616_能力.mp3]
[sound:k-0616_能力.mp3]	ability, faculty<br> <b>能力</b> <br> (のうりょく)
(<b>心理</b>) 彼の行動の背後には心理的な要因があります。	[sound:s-0616_彼の行動の背後には心理的な要因があります。.mp3] <br> かれのこうどうのはいごにはしんりてきなよういんがあります。 <br> There are psychological factors behind his actions.
[sound:s-0611_都市の中心には高いビルが立っている。.mp3]	<b>心配</b> <br> 彼女の安全を心配しています。<br> かのじょのあんぜんを<b>しんぱい</b>しています <br>I'm <b>worried</b> about her safety.	
武力	[sound:k-0617_武力.mp3]<br>ぶりょく <br> armed might, military power, the sword, force
armed might, military power, the sword, force	<b>武力<b> <br> ぶりょく <br>[sound:k-0617_武力.mp3]
[sound:k-0617_武力.mp3]	armed might, military power, the sword, force<br> <b>武力</b> <br> (ぶりょく)
(<b>安心</b>) 安心して眠れるようになった。	[sound:s-0617_安心して眠れるようになった。.mp3] <br> あんしんしてねむれるようになった。 <br> I can sleep peacefully now.
[sound:s-0612_心不全の治療が必要です。.mp3]	"<b>心理</b>&nbsp;-&nbsp;
暴力団	[sound:k-0618_暴力団.mp3]<br>ぼうりょくだん <br> gangster organization (organisation), crime syndicate, yakuza (Japanese mafia), band of thugs, group of hoodlums
gangster organization (organisation), crime syndicate, yakuza (Japanese mafia), band of thugs, group of hoodlums	<b>暴力団<b> <br> ぼうりょくだん <br>[sound:k-0618_暴力団.mp3]
[sound:k-0618_暴力団.mp3]	gangster organization<br> <b>organisation), crime syndicate, yakuza (Japanese mafia), band of thugs, group of hoodlums (暴力団</b> <br> (ぼうりょくだん)
(<b>都心</b>) このホテルは都心に位置しています。	[sound:s-0618_このホテルは都心に位置しています。.mp3] <br> このホテルはとしんにいちしています。 <br> This hotel is located in the city center.

有力	[sound:k-0619_有力.mp3]<br>ゆうりょく <br> influential, prominent; strong, likely, plausible, potent
influential, prominent; strong, likely, plausible, potent	<b>有力<b> <br> ゆうりょく <br>[sound:k-0619_有力.mp3]
[sound:k-0619_有力.mp3]	influential, prominent; strong, likely, plausible, potent<br> <b>有力</b> <br> (ゆうりょく)
(<b>熱心</b>) 彼は熱心な読者です。	[sound:s-0619_彼は熱心な読者です。.mp3] <br> かれはねっしんなどくしゃです。 <br> He is an enthusiastic reader.
<b>しんり</b><div>
学校	[sound:k-0620_学校.mp3]<br>がっこう <br> school
school	<b>学校<b> <br> がっこう <br>[sound:k-0620_学校.mp3]
[sound:k-0620_学校.mp3]	school<br> <b>学校</b> <br> (がっこう)
(<b>業界</b>) 彼女はファッション業界で働いています。	[sound:s-0620_彼女はファッション業界で働いています。.mp3] <br> かのじょはファッションぎょうかいではたらいています。 <br> She works in the fashion industry.
<i>要因</i>&nbsp;-&nbsp;
学生	[sound:k-0621_学生.mp3]<br>がくせい <br> student (esp. a university student)
student (esp. a university student)	<b>学生<b> <br> がくせい <br>[sound:k-0621_学生.mp3]
[sound:k-0621_学生.mp3]	student<br> <b>esp. a university student) (学生</b> <br> (がくせい)
(<b>世界</b>) 世界中でその話が広まった。	[sound:s-0621_世界中でその話が広まった。.mp3] <br> せかいじゅうでそのはなしがひろまった。 <br> The story spread worldwide.

大学	[sound:k-0622_大学.mp3]<br>だいがく <br> post-secondary education institution, incl. university, college, etc.; the Great Learning - one of the Four Books
post-secondary education institution, incl. university, college, etc.; the Great Learning - one of the Four Books	<b>大学<b> <br> だいがく <br>[sound:k-0622_大学.mp3]
[sound:k-0622_大学.mp3]	post-secondary education institution, incl. university, college, etc.; the Great Learning - one of the Four Books<br> <b>大学</b> <br> (だいがく)
(<b>政界</b>) 彼は政界の重要人物です。	[sound:s-0622_彼は政界の重要人物です。.mp3] <br> かれはせいかいのじゅうようじんぶつです。 <br> He is an important figure in the political world.
<i>よういん</i>&nbsp;<br> 彼の行動の背後には<b>心理</b>的な<i>要因</i>があります。<br> かれのこうどうのはいごには<b>しんり</b>てきな<i>よういん</i>があります <br>There are <b>psychological</b> <i>factors</i> behind his actions.</div>"	
医学	[sound:k-0623_医学.mp3]<br>いがく <br> medical science, medicine
medical science, medicine	<b>医学<b> <br> いがく <br>[sound:k-0623_医学.mp3]
[sound:k-0623_医学.mp3]	medical science, medicine<br> <b>医学</b> <br> (いがく)
(<b>財界</b>) 彼は財界で成功したビジネスマンです。	[sound:s-0623_彼は財界で成功したビジネスマンです。.mp3] <br> かれはざいかいでせいこうしたビジネスマンです。 <br> He is a successful businessman in the financial world.
[sound:s-0613_彼女は心から感謝しています。.mp3]	<b>安心</b> <br> 安心して眠れるようになった。<br><b> あんしん</b>してねむれるようになった <br>I can sleep <b>peace</b>fully now.	
科学	[sound:k-0624_科学.mp3]<br>かがく <br> science
science	<b>科学<b> <br> かがく <br>[sound:k-0624_科学.mp3]
[sound:k-0624_科学.mp3]	science<br> <b>科学</b> <br> (かがく)
(<b>限界</b>) 体力の限界を超えてしまった。	[sound:s-0624_体力の限界を超えてしまった。.mp3] <br> たいりょくのげんかいをこえてしまった。 <br> I exceeded the limits of my physical strength.
[sound:s-0614_心臓の健康は重要です。.mp3]	<b>都心</b> <br> このホテルは都心に位置しています。<br> このホテルは<b>としん</b>にいちしています <br>This hotel is located in the <b>city center</b>.	
学部	[sound:k-0625_学部.mp3]<br>がくぶ <br> department of a university; undergraduate (course, program, etc.)
department of a university; undergraduate (course, program, etc.)	<b>学部<b> <br> がくぶ <br>[sound:k-0625_学部.mp3]
[sound:k-0625_学部.mp3]	department of a university; undergraduate<br> <b>course, program, etc.) (学部</b> <br> (がくぶ)
(<b>世界的</b>) 彼女は世界的な有名人です。	[sound:s-0625_彼女は世界的な有名人です。.mp3] <br> かのじょはせかいてきなゆうめいじんです。 <br> She is a globally famous person.
[sound:s-0615_彼女の安全を心配しています。.mp3]	<b>熱心</b> <br> 彼は熱心な読者です。<br> かれはねっしんなどくしゃです <br>He is an enthusiastic reader.	
文学	[sound:k-0626_文学.mp3]<br>ぶんがく <br> literature
literature	<b>文学<b> <br> ぶんがく <br>[sound:k-0626_文学.mp3]
[sound:k-0626_文学.mp3]	literature<br> <b>文学</b> <br> (ぶんがく)
(<b>経済界</b>) 彼は経済界の専門家です。	[sound:s-0626_彼は経済界の専門家です。.mp3] <br> かれはけいざいかいのせんもんかです。 <br> He is an expert in the economic world.
[sound:s-0616_彼の行動の背後には心理的な要因があります。.mp3]	<b>業界</b> <br> 彼女はファッション業界で働いています。<br> かのじょはファッション<b>ぎょうかい</b>ではたらいています <br>She works in the fashion <b>industry</b>.	
学	[sound:k-0627_学.mp3]<br>がく <br> learning, scholarship, erudition, knowledge
learning, scholarship, erudition, knowledge	<b>学<b> <br> がく <br>[sound:k-0627_学.mp3]
[sound:k-0627_学.mp3]	learning, scholarship, erudition, knowledge<br> <b>学</b> <br> (がく)
(<b>産業界</b>) 彼は産業界で成功した起業家です。	[sound:s-0627_彼は産業界で成功した起業家です。.mp3] <br> かれはさんぎょうかいでせいこうしたきぎょうかです。 <br> He is a successful entrepreneur in the industrial world.
[sound:s-0617_安心して眠れるようになった。.mp3]	<b>世界</b> <br> 世界中でその話が広まった。<br><b> せかい</b>じゅうでそのはなしがひろまった <br>The story spread <b>world</b>wide.	
学園	[sound:k-0628_学園.mp3]<br>がくえん <br> academy, campus
academy, campus	<b>学園<b> <br> がくえん <br>[sound:k-0628_学園.mp3]
[sound:k-0628_学園.mp3]	academy, campus<br> <b>学園</b> <br> (がくえん)
(<b>世界一</b>) この店は世界一のチーズケーキを提供しています。	[sound:s-0628_この店は世界一のチーズケーキを提供しています。.mp3] <br> このみせはせかいいちのチーズケーキをていきょうしています。 <br> This shop offers the best cheesecake in the world.
[sound:s-0618_このホテルは都心に位置しています。.mp3]	<b>政界</b> <br> 彼は政界の重要人物です。<br> かれは<b>せいかい</b>のじゅうようじんぶつです <br>He is an important figure in the <b>political world</b>.	
学者	[sound:k-0629_学者.mp3]<br>がくしゃ <br> scholar
scholar	<b>学者<b> <br> がくしゃ <br>[sound:k-0629_学者.mp3]
[sound:k-0629_学者.mp3]	scholar<br> <b>学者</b> <br> (がくしゃ)
(<b>境界</b>) この川が国の境界です。	[sound:s-0629_この川が国の境界です。.mp3] <br> このかわがくにのきょうかいです。 <br> This river is the boundary of the country.
[sound:s-0619_彼は熱心な読者です。.mp3]	<b>財界</b> <br> 彼は財界で成功したビジネスマンです。<br> かれは<b>ざいかい</b>でせいこうしたビジネスマンです <br>He is a successful businessman in the <b>financial world</b>.	
問う	[sound:k-0630_問う.mp3]<br>とう <br> to ask, to question, to inquire; to charge (i.e. with a crime), to accuse; to care (about); without regard to (with negative verb)
to ask, to question, to inquire; to charge (i.e. with a crime), to accuse; to care (about); without regard to (with negative verb)	<b>問う<b> <br> とう <br>[sound:k-0630_問う.mp3]
[sound:k-0630_問う.mp3]	to ask, to question, to inquire; to charge<br> <b>i.e. with a crime), to accuse; to care (about); without regard to (with negative verb) (問う</b> <br> (とう)
(<b>支援</b>) 彼らは被災者に支援を提供しています。	[sound:s-0630_彼らは被災者に支援を提供しています。.mp3] <br> かれらはひさいしゃにしえんをていきょうしています。 <br> They are providing support to the victims.
[sound:s-0620_彼女はファッション業界で働いています。.mp3]	<b>限界</b> <br> 体力の限界を超えてしまった。<br> たいりょくの<b>げんかい</b>をこえてしまった <br>I exceeded the <b>limits</b> of my physical strength.	
問	[sound:k-0631_問.mp3]<br>もん <br> counter for questions
counter for questions	<b>問<b> <br> もん <br>[sound:k-0631_問.mp3]
[sound:k-0631_問.mp3]	counter for questions<br> <b>問</b> <br> (もん)
(<b>支持</b>) 彼の提案には多くの人々の支持があります。	[sound:s-0631_彼の提案には多くの人々の支持があります。.mp3] <br> かれのていあんにはおおくのひとびとのしじがあります。 <br> His proposal has the support of many people.
[sound:s-0621_世界中でその話が広まった。.mp3]	<b>世界的</b> <br> 彼女は世界的な有名人です。<br> かのじょは<b>せかいてきな</b>ゆうめいじんです <br>She is a <b>globally</b> famous person.	
質問	[sound:k-0632_質問.mp3]<br>しつもん <br> question, inquiry, enquiry
question, inquiry, enquiry	<b>質問<b> <br> しつもん <br>[sound:k-0632_質問.mp3]
[sound:k-0632_質問.mp3]	question, inquiry, enquiry<br> <b>質問</b> <br> (しつもん)
(<b>支局</b>) その企業は地域に支局を持っています。	[sound:s-0632_その企業は地域に支局を持っています。.mp3] <br> そのきぎょうはちいきにしきょくをもっています。 <br> The company has a branch office in the region.
[sound:s-0622_彼は政界の重要人物です。.mp3]	<b>経済界</b> <br> 彼は経済界の専門家です。<br> かれは<b>けいざいかい</b>のせんもんかです <br>He is an expert in the <b>economic world</b>.	
訪問	[sound:k-0633_訪問.mp3]<br>ほうもん <br> call, visit
call, visit	<b>訪問<b> <br> ほうもん <br>[sound:k-0633_訪問.mp3]
[sound:k-0633_訪問.mp3]	call, visit<br> <b>訪問</b> <br> (ほうもん)
(<b>支店</b>) この銀行は市内に数多くの支店を持っています。	[sound:s-0633_この銀行は市内に数多くの支店を持っています。.mp3] <br> このぎんこうはしないにすうおおくのしてんをもっています。 <br> This bank has numerous branch stores in the city.
[sound:s-0623_彼は財界で成功したビジネスマンです。.mp3]	<b>産業界</b> <br> 彼は<b>産業界</b>で成功した<i>起業家</i>です。<br> かれは<b>さんぎょうかい</b>でせいこうした<i>きぎょうか</i>です <br>He is a successful <i>entrepreneur</i> in the <b>industrial world.</b>	
問題	[sound:k-0634_問題.mp3]<br>もんだい <br> problem, question
problem, question	<b>問題<b> <br> もんだい <br>[sound:k-0634_問題.mp3]
[sound:k-0634_問題.mp3]	problem, question<br> <b>問題</b> <br> (もんだい)
(<b>支配</b>) 彼はその地域を支配しています。	[sound:s-0634_彼はその地域を支配しています。.mp3] <br> かれはそのちいきをしはいしています。 <br> He controls the region.
[sound:s-0624_体力の限界を超えてしまった。.mp3]	<b>世界一</b> <br> この店は世界一のチーズケーキを提供しています。<br> このみせはせかいいちのチーズケーキをていきょうしています <br>This shop offers the best cheesecake in the world.	
問い合わせ	[sound:k-0635_問い合わせ.mp3]<br>といあわせ <br> enquiry, inquiry, ENQ, query, interrogation
enquiry, inquiry, ENQ, query, interrogation	<b>問い合わせ<b> <br> といあわせ <br>[sound:k-0635_問い合わせ.mp3]
[sound:k-0635_問い合わせ.mp3]	enquiry, inquiry, ENQ, query, interrogation<br> <b>問い合わせ</b> <br> (といあわせ)
(<b>支部</b>) 私たちは学校の文芸部の支部です。	[sound:s-0635_私たちは学校の文芸部の支部です。.mp3] <br> わたしたちはがっこうのぶんげいぶのしぶです。 <br> We are a branch of the school's literary club.
[sound:s-0625_彼女は世界的な有名人です。.mp3]	<b>境界</b> <br> この川が国の境界です。<br> このかわがくにの<b>きょうかい</b>です <br>This river is the <b>boundary</b> of the country.	
喚問	[sound:k-0636_喚問.mp3]<br>かんもん <br> summons
summons	<b>喚問<b> <br> かんもん <br>[sound:k-0636_喚問.mp3]
[sound:k-0636_喚問.mp3]	summons<br> <b>喚問</b> <br> (かんもん)
(<b>収支</b>) この会社の収支が良くなりました。	[sound:s-0636_この会社の収支が良くなりました。.mp3] <br> このかいしゃのしゅうし がよくなりました。 <br> The balance of income and expenditure of this company has improved.
[sound:s-0626_彼は経済界の専門家です。.mp3]	<b>支援</b> <br> 彼らは被災者に支援を提供しています。<br> かれらはひさいしゃに<b>しえん</b>をていきょうしています <br>They are providing <b>support</b> to the victims.	
疑問	[sound:k-0637_疑問.mp3]<br>ぎもん <br> question, problem, doubt, guess
question, problem, doubt, guess	<b>疑問<b> <br> ぎもん <br>[sound:k-0637_疑問.mp3]
[sound:k-0637_疑問.mp3]	question, problem, doubt, guess<br> <b>疑問</b> <br> (ぎもん)
(<b>支払い</b>) 明日までに請求書の支払いを完了する必要があります。	[sound:s-0637_明日までに請求書の支払いを完了する必要があります。.mp3] <br> あしたまでにせいきゅうしょのしはらいをかんりょうするひつようがあります。 <br> The invoice payment must be completed by tomorrow.
[sound:s-0627_彼は産業界で成功した起業家です。.mp3]	<b>支持</b> <br> 彼の提案には多くの人々の支持があります。<br> かれのていあんにはおおくのひとびとの<b>しじ</b>があります <br>His proposal has the <b>support</b> of many people.	
顧問	[sound:k-0638_顧問.mp3]<br>こもん <br> adviser, advisor, consultant
adviser, advisor, consultant	<b>顧問<b> <br> こもん <br>[sound:k-0638_顧問.mp3]
[sound:k-0638_顧問.mp3]	adviser, advisor, consultant<br> <b>顧問</b> <br> (こもん)
(<b>支出</b>) 家計の支出を節約する必要があります。	[sound:s-0638_家計の支出を節約する必要があります。.mp3] <br> かけいのししゅつをせつやくするひつようがあります。 <br> It's necessary to save on household expenses.
[sound:s-0628_この店は世界一のチーズケーキを提供しています。.mp3]	<b>支局</b> <br> その企業は地域に支局を持っています。<br> そのきぎょうはちいきに<b>しきょく</b>をもっています <br>The company has a <b>branch office</b> in the region.	
問い	[sound:k-0639_問い.mp3]<br>とい <br> question, query
question, query	<b>問い<b> <br> とい <br>[sound:k-0639_問い.mp3]
[sound:k-0639_問い.mp3]	question, query<br> <b>問い</b> <br> (とい)
(<b>支給</b>) その団体は避難民に食料を支給しています。	[sound:s-0639_その団体は避難民に食料を支給しています。.mp3] <br> そのだんたいはひなんみんにしょくりょうをしきゅうしています。 <br> The organization provides food to refugees.
[sound:s-0629_この川が国の境界です。.mp3]	<b>支店</b> <br> この銀行は市内に数多くの支店を持っています。<br> このぎんこうはしないにすうおおくの<b>してん</b>をもっています <br>This bank has numerous branch stores in the city.	
高さ	[sound:k-0640_高さ.mp3]<br>たかさ <br> height
height	<b>高さ<b> <br> たかさ <br>[sound:k-0640_高さ.mp3]
[sound:k-0640_高さ.mp3]	height<br> <b>高さ</b> <br> (たかさ)
(<b>次第に</b>) 彼の健康は次第に改善しています。	[sound:s-0640_彼の健康は次第に改善しています。.mp3] <br> かれのけんこうはしだいにかいぜんしています。 <br> His health is gradually improving.
[sound:s-0630_彼らは被災者に支援を提供しています。.mp3]	<b>支配</b> <br> 彼はその地域を支配しています。<br> かれはそのちいきを<b>しはい</b>しています <br>He <b>controls</b> the region.	
高校	[sound:k-0641_高校.mp3]<br>こうこう <br> senior high school
senior high school	<b>高校<b> <br> こうこう <br>[sound:k-0641_高校.mp3]
[sound:k-0641_高校.mp3]	senior high school<br> <b>高校</b> <br> (こうこう)
(<b>第一歩</b>) これは私たちにとって成功への第一歩です。	[sound:s-0641_これは私たちにとって成功への第一歩です。.mp3] <br> これはわたしたちにとってせいこうへのだいいっぽです。 <br> This is the first step towards success for us.
[sound:s-0631_彼の提案には多くの人々の支持があります。.mp3]	<b>支部</b> <br> 私たちは学校の文芸部の支部です。<br> わたしたちはがっこうのぶんげいぶの<b>しぶ</b>です <br>We are a <b>branch</b> of the school's literary club.	
最高	[sound:k-0642_最高.mp3]<br>さいこう <br> highest, supreme, the most
highest, supreme, the most	<b>最高<b> <br> さいこう <br>[sound:k-0642_最高.mp3]
[sound:k-0642_最高.mp3]	highest, supreme, the most<br> <b>最高</b> <br> (さいこう)
(<b>第三者</b>) 問題の解決には第三者の介入が必要です。	[sound:s-0642_問題の解決には第三者の介入が必要です。.mp3] <br> もんだいのかいけつにはだいさんしゃのかいにゅうがひつようです。 <br> The intervention of a third party is necessary for resolving the issue.
[sound:s-0632_その企業は地域に支局を持っています。.mp3]	<b>収支</b> <br> この会社の収支が良くなりました。<br> このかいしゃの<b>しゅうし</b> がよくなりました <br>The balance of <b>income and expenditure</b> of this company has improved.	
円高	[sound:k-0643_円高.mp3]<br>えんだか <br> high-valued yen, exchange in favor (favour) of the yen
high-valued yen, exchange in favor (favour) of the yen	<b>円高<b> <br> えんだか <br>[sound:k-0643_円高.mp3]
[sound:k-0643_円高.mp3]	high-valued yen, exchange in favor<br> <b>favour) of the yen (円高</b> <br> (えんだか)
(<b>第一人者</b>) 彼はその分野の第一人者です。	[sound:s-0643_彼はその分野の第一人者です。.mp3] <br> かれはそのぶんやのだいいちにんしゃです。 <br> He is a leading figure in that field.
[sound:s-0633_この銀行は市内に数多くの支店を持っています。.mp3]	<b>支払い</b> <br> 明日までに請求書の支払いを完了する必要があります。<br> あしたまでに<i>せいきゅうしょ</i>の<b>しはらい</b>をかんりょうするひつようがあります <br>The <i>invoice</i> <b>payment</b> must be completed by tomorrow.	
高	[sound:k-0644_高.mp3]<br>たか, だか <br> quantity, amount, volume, number, amount of money
quantity, amount, volume, number, amount of money	<b>高<b> <br> たか, だか <br>[sound:k-0644_高.mp3]
[sound:k-0644_高.mp3]	quantity, amount, volume, number, amount of money<br> <b>高</b> <br> (たか, だか)
(<b>第二次世界大戦</b>) 第二次世界大戦は大きな影響を与えました。	[sound:s-0644_第二次世界大戦は大きな影響を与えました。.mp3] <br> だいにじせかいたいせんはおおきなえいきょうをあたえました。 <br> World War II had a significant impact.
[sound:s-0634_彼はその地域を支配しています。.mp3]	<b>支出</b> <br> 家計の支出を節約する必要があります。<br> かけいの<b>ししゅつ</b>をせつやくするひつようがあります <br>It's necessary to save on household <b>expenses</b>.	
高い	[sound:k-0645_高い.mp3]<br>たかい <br> high, tall; expensive
high, tall; expensive	<b>高い<b> <br> たかい <br>[sound:k-0645_高い.mp3]
[sound:k-0645_高い.mp3]	high, tall; expensive<br> <b>高い</b> <br> (たかい)
(<b>第一線</b>) 彼は今もなお医療の第一線で働いています。	[sound:s-0645_彼は今もなお医療の第一線で働いています。.mp3] <br> かれはいまもなおいりょうのだいいっせんではたらいています。 <br> He is still working on the medical frontline.
[sound:s-0635_私たちは学校の文芸部の支部です。.mp3]	<b>支給</b> <br> その団体は避難民に食料を支給しています。<br> そのだんたいはひなんみんにしょくりょうを<b>しきゅう</b>しています <br>The organization <b>provides</b> food to refugees.	
高まる	[sound:k-0646_高まる.mp3]<br>たかまる <br> to rise, to swell, to be promoted
to rise, to swell, to be promoted	<b>高まる<b> <br> たかまる <br>[sound:k-0646_高まる.mp3]
[sound:k-0646_高まる.mp3]	to rise, to swell, to be promoted<br> <b>高まる</b> <br> (たかまる)
(<b>第一声</b>) 彼女の出産後、赤ちゃんの第一声が聞こえた。	[sound:s-0646_彼女の出産後、赤ちゃんの第一声が聞こえた。.mp3] <br> かのじょのしゅっさんご、あかちゃんのだいいっせいがきこえた。 <br> After her delivery, we heard the baby's first cry.
[sound:s-0636_この会社の収支が良くなりました。.mp3]	<b>次第に</b> <br> 彼の健康は次第に改善しています。<br> かれのけんこうは<b>しだいに</b>かいぜんしています <br>His health is <b>gradually</b> improving.	
高官	[sound:k-0647_高官.mp3]<br>こうかん <br> high official
high official	<b>高官<b> <br> こうかん <br>[sound:k-0647_高官.mp3]
[sound:k-0647_高官.mp3]	high official<br> <b>高官</b> <br> (こうかん)
(<b>第三国</b>) その地域はまだ第三国としての問題を抱えています。	[sound:s-0647_その地域はまだ第三国としての問題を抱えています。.mp3] <br> そのちいきはまだだいさんこくとしてのもんだいをかかえています。 <br> The region still faces issues as a third world country.
[sound:s-0637_明日までに請求書の支払いを完了する必要があります。.mp3]	<b>第三者</b> <br> 問題の解決には第三者の介入が必要です。<br> もんだいのかいけつには<b>だいさんしゃ</b>のかいにゅうがひつようです <br>The intervention of a <b>third party</b> is necessary for resolving the issue.	
高校生	[sound:k-0648_高校生.mp3]<br>こうこうせい <br> senior high school student
senior high school student	<b>高校生<b> <br> こうこうせい <br>[sound:k-0648_高校生.mp3]
[sound:k-0648_高校生.mp3]	senior high school student<br> <b>高校生</b> <br> (こうこうせい)
(<b>次第</b>) 電話が鳴り次第、すぐに出ます。	[sound:s-0648_電話が鳴り次第、すぐに出ます。.mp3] <br> でんわがなりしだい、すぐにでます。 <br> I'll leave as soon as the phone rings.
[sound:s-0638_家計の支出を節約する必要があります。.mp3]	<b>第一人者</b> <br> 彼はその分野の第一人者です。<br> かれはそのぶんやの<b>だいいちにんしゃ</b>です <br>He is a <b>leading figure</b> in that field.	
高齢	[sound:k-0649_高齢.mp3]<br>こうれい <br> advanced (old) age
advanced (old) age	<b>高齢<b> <br> こうれい <br>[sound:k-0649_高齢.mp3]
[sound:k-0649_高齢.mp3]	advanced<br> <b>old) age (高齢</b> <br> (こうれい)
(<b>第一義</b>) この言葉の第一義は善意を表すことです。	[sound:s-0649_この言葉の第一義は善意を表すことです。.mp3] <br> このことばのだいいちぎはぜんいをあらわすことです。 <br> The primary meaning of this word is to express goodwill.
[sound:s-0639_その団体は避難民に食料を支給しています。.mp3]	<b>第二次世界大戦</b> <br> 第二次世界大戦は大きな影響を与えました。<br><b> だいにじせかいたいせん</b>はおおきなえいきょうをあたえました <br><b>World War II</b> had a significant impact.	
代わり	[sound:k-0650_代わり.mp3]<br>かわり, がわり <br> substitute, deputy, proxy, alternate, relief, compensation, second helping; in place of, as a substitute for
substitute, deputy, proxy, alternate, relief, compensation, second helping; in place of, as a substitute for	<b>代わり<b> <br> かわり, がわり <br>[sound:k-0650_代わり.mp3]
[sound:k-0650_代わり.mp3]	substitute, deputy, proxy, alternate, relief, compensation, second helping; in place of, as a substitute for<br> <b>代わり</b> <br> (かわり, がわり)
(<b>共産党</b>) その国には共産党があります。	[sound:s-0650_その国には共産党があります。.mp3] <br> そのくににはきょうさんとうがあります。 <br> There is a Communist Party in that country.
[sound:s-0640_彼の健康は次第に改善しています。.mp3]	<b>第一線</b> <br> 彼は今もなお医療の第一線で働いています。<br> かれはいまもなおいりょうの<b>だいいっせん</b>ではたらいています <br>He is still working on the medical <b>frontline</b>.	
時代	[sound:k-0651_時代.mp3]<br>じだい <br> period, epoch, era, age; the times, those days; oldness, ancientness, antiquity; antique, period piece
period, epoch, era, age; the times, those days; oldness, ancientness, antiquity; antique, period piece	<b>時代<b> <br> じだい <br>[sound:k-0651_時代.mp3]
[sound:k-0651_時代.mp3]	period, epoch, era, age; the times, those days; oldness, ancientness, antiquity; antique, period piece<br> <b>時代</b> <br> (じだい)
(<b>産業</b>) この地域の主要産業は観光です。	[sound:s-0651_この地域の主要産業は観光です。.mp3] <br> このちいきのしゅようさんぎょうはかんこうです。 <br> Tourism is the main industry in this area.
[sound:s-0641_これは私たちにとって成功への第一歩です。.mp3]	<b>次第</b> <br> 電話が鳴り次第、すぐに出ます。<br> でんわがなり<b>しだい</b>、すぐにでます <br>I'll leave <b>as soon as</b> the phone rings.	
代表	[sound:k-0652_代表.mp3]<br>だいひょう <br> representative, representation, delegation, type, example, model
representative, representation, delegation, type, example, model	<b>代表<b> <br> だいひょう <br>[sound:k-0652_代表.mp3]
[sound:k-0652_代表.mp3]	representative, representation, delegation, type, example, model<br> <b>代表</b> <br> (だいひょう)
(<b>生産</b>) この工場は日々、大量の製品を生産しています。	[sound:s-0652_この工場は日々、大量の製品を生産しています。.mp3] <br> このこうじょうはひび、たいりょうのせいひんをせいさんしています。 <br> This factory produces a large number of products every day.
[sound:s-0642_問題の解決には第三者の介入が必要です。.mp3]	<b>第一義</b> <br> この言葉の第一義は善意を表すことです。<br> このことばの<b>だいいちぎ</b>はぜんいをあらわすことです <br>The <b>primary meaning</b> of this word is to express goodwill.	
現代	[sound:k-0653_現代.mp3]<br>げんだい <br> nowadays, modern era, modern times, present-day
nowadays, modern era, modern times, present-day	<b>現代<b> <br> げんだい <br>[sound:k-0653_現代.mp3]
[sound:k-0653_現代.mp3]	nowadays, modern era, modern times, present-day<br> <b>現代</b> <br> (げんだい)
(<b>資産</b>) 彼の資産は多岐にわたっています。	[sound:s-0653_彼の資産は多岐にわたっています。.mp3] <br> かれのしさんはたきにわたっています。 <br> His assets are diverse.
[sound:s-0643_彼はその分野の第一人者です。.mp3]	<b>共産党</b> <br> その国には共産党があります。<br> そのくにには<b>きょうさんとう</b>があります <br>There is a <b>Communist Party</b> in that country.	
世代	[sound:k-0654_世代.mp3]<br>せだい <br> generation, the world, the age
generation, the world, the age	<b>世代<b> <br> せだい <br>[sound:k-0654_世代.mp3]
[sound:k-0654_世代.mp3]	generation, the world, the age<br> <b>世代</b> <br> (せだい)
(<b>不動産</b>) 彼は不動産業で成功しています。	[sound:s-0654_彼は不動産業で成功しています。.mp3] <br> かれはふどうさんぎょうでせいこうしています。 <br> He has succeeded in the real estate business.
[sound:s-0644_第二次世界大戦は大きな影響を与えました。.mp3]	<b>産業</b> <br> この地域の<i>主要</i><b>産業</b>は観光です。<br> このちいきの<i>しゅよう</i><b>さんぎょう</b>はかんこうです <br>Tourism is the <i>main</i> <b>industry</b> in this area.	
近代	[sound:k-0655_近代.mp3]<br>きんだい <br> present day, modern times
present day, modern times	<b>近代<b> <br> きんだい <br>[sound:k-0655_近代.mp3]
[sound:k-0655_近代.mp3]	present day, modern times<br> <b>近代</b> <br> (きんだい)
(<b>通産省</b>) 通産省は日本の経済政策に重要な役割を果たしました。	[sound:s-0655_通産省は日本の経済政策に重要な役割を果たしました。.mp3] <br> つうさんしょうはにほんのけいざいせいさくにじゅうようなやくわりをはたしました。 <br> The Ministry of International Trade and Industry played a crucial role in Japan's economic policies.
[sound:s-0645_彼は今もなお医療の第一線で働いています。.mp3]	<b>生産</b> <br> この工場は日々、大量の製品を生産しています。<br> このこうじょうはひび、たいりょうのせいひんを<b>せいさん</b>しています <br>This factory <b>produces</b> a large number of products every day.	
代理	[sound:k-0656_代理.mp3]<br>だいり <br> representation, agency, proxy, deputy, agent, attorney, substitute, alternate, acting (principal, etc.)
representation, agency, proxy, deputy, agent, attorney, substitute, alternate, acting (principal, etc.)	<b>代理<b> <br> だいり <br>[sound:k-0656_代理.mp3]
[sound:k-0656_代理.mp3]	representation, agency, proxy, deputy, agent, attorney, substitute, alternate, acting<br> <b>principal, etc.) (代理</b> <br> (だいり)
(<b>共産</b>) 彼は共産主義の理想を追求しています。	[sound:s-0656_彼は共産主義の理想を追求しています。.mp3] <br> かれはきょうさんしゅぎのりそうをついきゅうしています。 <br> He pursues the ideals of communism.
[sound:s-0646_彼女の出産後、赤ちゃんの第一声が聞こえた。.mp3]	<b>資産</b> <br> 彼の資産は多岐にわたっています。<br> かれの<b>しさん</b>はたきにわたっています <br>His <b>assets</b> are diverse.	
交代	[sound:k-0657_交代.mp3]<br>こうたい <br> alternation, change, relief, relay, shift, substitution (sports, etc.)
alternation, change, relief, relay, shift, substitution (sports, etc.)	<b>交代<b> <br> こうたい <br>[sound:k-0657_交代.mp3]
[sound:k-0657_交代.mp3]	alternation, change, relief, relay, shift, substitution<br> <b>sports, etc.) (交代</b> <br> (こうたい)
(<b>財産</b>) 彼女は父から大きな財産を受け継ぎました。	[sound:s-0657_彼女は父から大きな財産を受け継ぎました。.mp3] <br> かのじょはちちからおおきなざいさんをうけつぎました。 <br> She inherited a large fortune from her father.
[sound:s-0647_その地域はまだ第三国としての問題を抱えています。.mp3]	<b>不動産</b> <br> 彼は不動産業で成功しています。<br> かれは<b>ふどうさんぎょう</b>でせいこうしています <br>He has succeeded in<b> the real estate business</b>.	
代議	[sound:k-0658_代議.mp3]<br>だいぎ <br> representing others in a conference
representing others in a conference	<b>代議<b> <br> だいぎ <br>[sound:k-0658_代議.mp3]
[sound:k-0658_代議.mp3]	representing others in a conference<br> <b>代議</b> <br> (だいぎ)
(<b>国産</b>) 私たちは国産品をサポートすることが重要だと考えています。	[sound:s-0658_私たちは国産品をサポートすることが重要だと考えています。.mp3] <br> わたしたちはこくさんひんをさぽーとすることがじゅうようだとかんがえています。 <br> We believe it's important to support domestically produced goods.
[sound:s-0648_電話が鳴り次第、すぐに出ます。.mp3]	<b>通産省</b> <br> 通産省は日本の経済政策に重要な役割を果たしました。<br><b> つうさんしょう</b>はにほんのけいざいせいさくにじゅうようなやくわりをはたしました <br><b>The Ministry of International Trade and Industry</b> played a crucial role in Japan's economic policies.	
代行	[sound:k-0659_代行.mp3]<br>だいこう <br> acting as agent
acting as agent	<b>代行<b> <br> だいこう <br>[sound:k-0659_代行.mp3]
[sound:k-0659_代行.mp3]	acting as agent<br> <b>代行</b> <br> (だいこう)
(<b>出産</b>) 彼女は元気な赤ちゃんを出産しました。	[sound:s-0659_彼女は元気な赤ちゃんを出産しました。.mp3] <br> かのじょはげんきなあかちゃんをしゅっさんしました。 <br> She gave birth to a healthy baby.
[sound:s-0649_この言葉の第一義は善意を表すことです。.mp3]	<b>共産</b> <br> 彼は<b>共産</b><i>主義</i>の理想を追求しています。<br> かれは<b>きょうさん</b><i>しゅぎ</i>のりそうをついきゅうしています <br>He pursues the <i>ideals</i> of <b>communism</b>.	
明らか	[sound:k-0660_明らか.mp3]<br>あきらか <br> obvious, evident, clear, plain
obvious, evident, clear, plain	<b>明らか<b> <br> あきらか <br>[sound:k-0660_明らか.mp3]
[sound:k-0660_明らか.mp3]	obvious, evident, clear, plain<br> <b>明らか</b> <br> (あきらか)
(<b>結果</b>) 彼の努力の結果、試験に合格しました。	[sound:s-0660_彼の努力の結果、試験に合格しました。.mp3] <br> かれのどりょくのけっか、しけんにごうかくしました。 <br> As a result of his efforts, he passed the exam.
[sound:s-0650_その国には共産党があります。.mp3]	<b>財産</b> <br> 彼女は父から大きな財産を受け継ぎました。<br> かのじょはちちからおおきな<b>ざいさん</b>をうけつぎました <br>She inherited a large <b>fortune</b> from her father.	
声明	[sound:k-0661_声明.mp3]<br>せいめい <br> declaration, statement, proclamation
declaration, statement, proclamation	<b>声明<b> <br> せいめい <br>[sound:k-0661_声明.mp3]
[sound:k-0661_声明.mp3]	declaration, statement, proclamation<br> <b>声明</b> <br> (せいめい)
(<b>結局</b>) 彼は結局、自分の夢を叶えることができませんでした。	[sound:s-0661_彼は結局、自分の夢を叶えることができませんでした。.mp3] <br> かれはけっきょく、じぶんのゆめをかなえることができませんでした。 <br> In the end, he couldn't fulfill his dream.
[sound:s-0651_この地域の主要産業は観光です。.mp3]	<b>国産</b> <br> 私たちは国産品をサポートすることが重要だと考えています。<br> わたしたちは<b>こくさん</b>ひんをさぽーとすることがじゅうようだとかんがえています <br>We believe it's important to support <b>domestically produced </b>goods.	
説明	[sound:k-0662_説明.mp3]<br>せつめい <br> explanation, exposition
explanation, exposition	<b>説明<b> <br> せつめい <br>[sound:k-0662_説明.mp3]
[sound:k-0662_説明.mp3]	explanation, exposition<br> <b>説明</b> <br> (せつめい)
(<b>結婚</b>) 彼らは来年結婚する予定です。	[sound:s-0662_彼らは来年結婚する予定です。.mp3] <br> かれらはらいねんけっこんするよていです。 <br> They plan to get married next year.
[sound:s-0652_この工場は日々、大量の製品を生産しています。.mp3]	<b>出産</b> <br> 彼女は元気な赤ちゃんを出産しました。<br> かのじょはげんきなあかちゃんを<b>しゅっさん</b>しました <br>She <b>gave birth</b> to a healthy baby.	
不明	[sound:k-0663_不明.mp3]<br>ふめい <br> unknown, obscure, indistinct, uncertain, ambiguous, ignorant, lack of wisdom, anonymous, unidentified
unknown, obscure, indistinct, uncertain, ambiguous, ignorant, lack of wisdom, anonymous, unidentified	<b>不明<b> <br> ふめい <br>[sound:k-0663_不明.mp3]
[sound:k-0663_不明.mp3]	unknown, obscure, indistinct, uncertain, ambiguous, ignorant, lack of wisdom, anonymous, unidentified<br> <b>不明</b> <br> (ふめい)
(<b>結論</b>) 議論の結論が出ました。	[sound:s-0663_議論の結論が出ました。.mp3] <br> ぎろんのけつろんがでました。 <br> A conclusion was reached in the discussion.
[sound:s-0653_彼の資産は多岐にわたっています。.mp3]	<b>結果</b> <br> 彼の努力の結果、試験に合格しました。<br> かれのどりょくの<b>けっか</b>、しけんにごうかくしました <br>As a <b>result</b> of his efforts, he passed the exam.	
明確	[sound:k-0664_明確.mp3]<br>めいかく <br> clear up, clarify, define
clear up, clarify, define	<b>明確<b> <br> めいかく <br>[sound:k-0664_明確.mp3]
[sound:k-0664_明確.mp3]	clear up, clarify, define<br> <b>明確</b> <br> (めいかく)
(<b>結ぶ</b>) 彼らは友情で結ばれています。	[sound:s-0664_彼らは友情で結ばれています。.mp3] <br> かれらはゆうじょうでむすばれています。 <br> They are bound by friendship.
[sound:s-0654_彼は不動産業で成功しています。.mp3]	<b>結局</b> <br> 彼は結局、自分の夢を叶えることができませんでした。<br> かれは<b>けっきょく</b>、じぶんのゆめをかなえることができませんでした <br><b>In the end</b>, he couldn't fulfill his dream.	
公明党	[sound:k-0665_公明党.mp3]<br>こうめいとう <br> New Komeito (Japanese political party), New Clean Government Party, Justice Party
New Komeito (Japanese political party), New Clean Government Party, Justice Party	<b>公明党<b> <br> こうめいとう <br>[sound:k-0665_公明党.mp3]
[sound:k-0665_公明党.mp3]	New Komeito<br> <b>Japanese political party), New Clean Government Party, Justice Party (公明党</b> <br> (こうめいとう)
(<b>結成</b>) 新しいバンドが結成されました。	[sound:s-0665_新しいバンドが結成されました。.mp3] <br> あたらしいばんどがけっせいされました。 <br> A new band has been formed.
[sound:s-0655_通産省は日本の経済政策に重要な役割を果たしました。.mp3]	<b>結婚</b> <br> 彼らは来年結婚する予定です。<br> かれらはらいねん<b>けっこん</b>するよていです <br>They plan to get <b>married</b> next year.	
解明	[sound:k-0666_解明.mp3]<br>かいめい <br> clarification, elucidation, explication
clarification, elucidation, explication	<b>解明<b> <br> かいめい <br>[sound:k-0666_解明.mp3]
[sound:k-0666_解明.mp3]	clarification, elucidation, explication<br> <b>解明</b> <br> (かいめい)
(<b>終結</b>) その戦争はついに終結しました。	[sound:s-0666_その戦争はついに終結しました。.mp3] <br> そのせんそうはついにしゅうけつしました。 <br> The war finally came to an end.
[sound:s-0656_彼は共産主義の理想を追求しています。.mp3]	<b>結論</b> <br> 議論の結論が出ました。<br> ぎろんの<b>けつろん</b>がでました <br>A <b>conclusion</b> was reached in the discussion.	
公明	[sound:k-0667_公明.mp3]<br>こうめい <br> fairness, justice
fairness, justice	<b>公明<b> <br> こうめい <br>[sound:k-0667_公明.mp3]
[sound:k-0667_公明.mp3]	fairness, justice<br> <b>公明</b> <br> (こうめい)
(<b>凍結</b>) 道路が凍結していますので、運転に気をつけてください。	[sound:s-0667_道路が凍結していますので、運転に気をつけてください。.mp3] <br> どうろがとうけつしていますので、うんてんにきをつけてください。 <br> The roads are frozen, so please drive carefully.
[sound:s-0657_彼女は父から大きな財産を受け継ぎました。.mp3]	<b>結ぶ</b> <br> 彼らは友情で結ばれています。<br> かれらはゆうじょうで<b>むすば</b>れています <br>They are <b>bound</b> by friendship.	
表明	[sound:k-0668_表明.mp3]<br>ひょうめい <br> declaration, indication, representation, manifestation, demonstration, expression, announcement, assertion
declaration, indication, representation, manifestation, demonstration, expression, announcement, assertion	<b>表明<b> <br> ひょうめい <br>[sound:k-0668_表明.mp3]
[sound:k-0668_表明.mp3]	declaration, indication, representation, manifestation, demonstration, expression, announcement, assertion<br> <b>表明</b> <br> (ひょうめい)
(<b>結び</b>) この論文の結びに、新たな視点を加えました。	[sound:s-0668_この論文の結びに、新たな視点を加えました。.mp3] <br> このろんぶんのむすびに、あたらなしみてんをくわえました。 <br> I added a new perspective to the conclusion of this paper.
[sound:s-0658_私たちは国産品をサポートすることが重要だと考えています。.mp3]	<b>結成</b> <br> 新しいバンドが結成されました。<br> あたらしいばんどが<b>けっせい</b>されました <br>A new band has been <b>formed</b>.	
未明	[sound:k-0669_未明.mp3]<br>みめい <br> early dawn, grey of morning, gray of morning
early dawn, grey of morning, gray of morning	<b>未明<b> <br> みめい <br>[sound:k-0669_未明.mp3]
[sound:k-0669_未明.mp3]	early dawn, grey of morning, gray of morning<br> <b>未明</b> <br> (みめい)
(<b>締結</b>) 両国は平和条約を締結しました。	[sound:s-0669_両国は平和条約を締結しました。.mp3] <br> りょうこくはへいわじょうやくをていけつしました。 <br> The two countries signed a peace treaty.
[sound:s-0659_彼女は元気な赤ちゃんを出産しました。.mp3]	<b>終結</b> <br> その戦争はついに終結しました。<br> そのせんそうはついに<b>しゅうけつ</b>しました <br>The war finally <b>came to an end</b>.	
実	[sound:k-0670_実.mp3]<br>じつ, じち <br> truth, reality; sincerity, honesty, fidelity; content, substance; (good) result
truth, reality; sincerity, honesty, fidelity; content, substance; (good) result	<b>実<b> <br> じつ, じち <br>[sound:k-0670_実.mp3]
[sound:k-0670_実.mp3]	truth, reality; sincerity, honesty, fidelity; content, substance;<br> <b>good) result (実</b> <br> (じつ, じち)
(<b>百</b>) その山には百匹のウサギが住んでいます。	[sound:s-0670_その山には百匹のウサギが住んでいます。.mp3] <br> そのやまにはひゃくひきのうさぎがすんでいます。 <br> There are a hundred rabbits living on that mountain.
[sound:s-0660_彼の努力の結果、試験に合格しました。.mp3]	<b>凍結</b> <br> 道路が凍結していますので、運転に気をつけてください。<br> どうろが<b>とうけつ</b>していますので、うんてんにきをつけてください <br>The roads are <b>frozen</b>, so please drive carefully.	
実は	[sound:k-0671_実は.mp3]<br>じつは <br> as a matter of fact, by the way, to tell you the truth, to be honest, frankly
as a matter of fact, by the way, to tell you the truth, to be honest, frankly	<b>実は<b> <br> じつは <br>[sound:k-0671_実は.mp3]
[sound:k-0671_実は.mp3]	as a matter of fact, by the way, to tell you the truth, to be honest, frankly<br> <b>実は</b> <br> (じつは)
(<b>二百</b>) 彼は二百メートルを泳ぎました。	[sound:s-0671_彼は二百メートルを泳ぎました。.mp3] <br> かれはにひゃくメートルをおよぎました。 <br> He swam two hundred meters.
[sound:s-0661_彼は結局、自分の夢を叶えることができませんでした。.mp3]	<b>結び</b> <br> この論文の結びに、新たな視点を加えました。<br> このろんぶんの<b>むすび</b>に、あたらなしみてんをくわえました <br>I added a new perspective to the <b>conclusion</b> of this paper.	
実に	[sound:k-0672_実に.mp3]<br>じつに, まことに, げに, しんに <br> indeed, really, absolutely, truly, actually, very, quite
indeed, really, absolutely, truly, actually, very, quite	<b>実に<b> <br> じつに, まことに, げに, しんに <br>[sound:k-0672_実に.mp3]
[sound:k-0672_実に.mp3]	indeed, really, absolutely, truly, actually, very, quite<br> <b>実に</b> <br> (じつに, まことに, げに, しんに)
(<b>三百</b>) 彼女は三百円を使いました。	[sound:s-0672_彼女は三百円を使いました。.mp3] <br> かのじょはさんびゃくえんをつかいました。 <br> She spent three hundred yen.
[sound:s-0662_彼らは来年結婚する予定です。.mp3]	<b>締結</b> <br> 両国は平和条約を締結しました。<br> りょうこくはへいわじょうやくを<b>ていけつ</b>しました <br>The two countries <b>concluded</b> a peace treaty.	
現実	[sound:k-0673_現実.mp3]<br>げんじつ <br> reality
reality	<b>現実<b> <br> げんじつ <br>[sound:k-0673_現実.mp3]
[sound:k-0673_現実.mp3]	reality<br> <b>現実</b> <br> (げんじつ)
(<b>百貨店</b>) その百貨店は地元で最も人気があります。	[sound:s-0673_その百貨店は地元で最も人気があります。.mp3] <br> そのひゃっかてんはじもとでもっともにんきがあります。 <br> That department store is the most popular in the local area.
[sound:s-0663_議論の結論が出ました。.mp3]	<b>百</b> <br> その山には百匹のウサギが住んでいます。<br> そのやまには<b>ひゃく</b>ひきのうさぎがすんでいます <br>There are a <b>hundred</b> rabbits living on that mountain.	
事実	[sound:k-0674_事実.mp3]<br>じじつ <br> fact, truth, reality
fact, truth, reality	<b>事実<b> <br> じじつ <br>[sound:k-0674_事実.mp3]
[sound:k-0674_事実.mp3]	fact, truth, reality<br> <b>事実</b> <br> (じじつ)
(<b>百万</b>) 彼は百万円の宝くじに当選しました。	[sound:s-0674_彼は百万円の宝くじに当選しました。.mp3] <br> かれはひゃくまんえんのたからくじにとうせんしました。 <br> He won a million yen in the lottery.
[sound:s-0664_彼らは友情で結ばれています。.mp3]	<b>二百</b> <br> 彼は二百メートルを泳ぎました。<br> かれはにひゃくメートルをおよぎました <br>He swam two hundred meters.	
実施	[sound:k-0675_実施.mp3]<br>じっし <br> enforcement, implementation, putting into practice (practise), carrying out, operation, working (e.g. working parameters), enactment
enforcement, implementation, putting into practice (practise), carrying out, operation, working (e.g. working parameters), enactment	<b>実施<b> <br> じっし <br>[sound:k-0675_実施.mp3]
[sound:k-0675_実施.mp3]	enforcement, implementation, putting into practice<br> <b>practise), carrying out, operation, working (e.g. working parameters), enactment (実施</b> <br> (じっし)
(<b>四百</b>) その学校には四百人の生徒がいます。	[sound:s-0675_その学校には四百人の生徒がいます。.mp3] <br> そのがっこうにはよんひゃくにんのせいとがいます。 <br> There are four hundred students in that school.
[sound:s-0665_新しいバンドが結成されました。.mp3]	<b>三百</b> <br> 彼女は三百円を使いました。<br> かのじょはさんびゃくえんをつかいました <br>She spent three hundred yen.	
確実	[sound:k-0676_確実.mp3]<br>かくじつ <br> certainty, reliability, soundness
certainty, reliability, soundness	<b>確実<b> <br> かくじつ <br>[sound:k-0676_確実.mp3]
[sound:k-0676_確実.mp3]	certainty, reliability, soundness<br> <b>確実</b> <br> (かくじつ)
(<b>百億</b>) そのプロジェクトには百億円が投資されました。	[sound:s-0676_そのプロジェクトには百億円が投資されました。.mp3] <br> そのぷろじぇくとにはひゃくおくえんがとうしされました。 <br> One hundred billion yen was invested in the project.
[sound:s-0666_その戦争はついに終結しました。.mp3]	<b>百貨店</b> <br> その百貨店は地元で最も人気があります。<br> その<b>ひゃっかてん</b>はじもとでもっともにんきがあります <br>That <b>department store </b>is the most popular in the local area.	
事実上	[sound:k-0677_事実上.mp3]<br>じじつじょう <br> (as a) matter of fact, actually, in reality
(as a) matter of fact, actually, in reality	<b>事実上<b> <br> じじつじょう <br>[sound:k-0677_事実上.mp3]
[sound:k-0677_事実上.mp3]	(as a) matter of fact, actually, in reality<br> <b>事実上</b> <br> (じじつじょう)
(<b>数百</b>) 彼は数百ページの本を読んだ。	[sound:s-0677_彼は数百ページの本を読んだ。.mp3] <br> かれはすうひゃくページのほんをよんだ。 <br> He read several hundred pages of the book.
[sound:s-0667_道路が凍結していますので、運転に気をつけてください。.mp3]	<b>百万</b> <br> 彼は百万円の宝くじに当選しました。<br> かれは<b>ひゃくまん</b>えんのたからくじにとうせんしました <br>He won a <b>million</b> yen in the lottery.	
実験	[sound:k-0678_実験.mp3]<br>じっけん <br> experiment
experiment	<b>実験<b> <br> じっけん <br>[sound:k-0678_実験.mp3]
[sound:k-0678_実験.mp3]	experiment<br> <b>実験</b> <br> (じっけん)
(<b>百八十度</b>) 彼は急に方向を百八十度変えた。	[sound:s-0678_彼は急に方向を百八十度変えた。.mp3] <br> かれはきゅうにほうこうをひゃくはちじゅうどかえた。 <br> He suddenly changed direction by one hundred and eighty degrees.
[sound:s-0668_この論文の結びに、新たな視点を加えました。.mp3]	<b>四百</b> <br> その学校には四百人の生徒がいます。<br> そのがっこうにはよんひゃくにんのせいとがいます <br>There are four hundred students in that school.	
実現	[sound:k-0679_実現.mp3]<br>じつげん <br> implementation (e.g. of a system), materialization, materialisation, realization, realisation
implementation (e.g. of a system), materialization, materialisation, realization, realisation	<b>実現<b> <br> じつげん <br>[sound:k-0679_実現.mp3]
[sound:k-0679_実現.mp3]	implementation<br> <b>e.g. of a system), materialization, materialisation, realization, realisation (実現</b> <br> (じつげん)
(<b>百合</b>) 公園には美しい百合が咲いています。	[sound:s-0679_公園には美しい百合が咲いています。.mp3] <br> こうえんにはうつくしいゆりがさいています。 <br> Beautiful lilies are blooming in the park.
[sound:s-0669_両国は平和条約を締結しました。.mp3]	<b>百億</b> <br> そのプロジェクトには百億円が投資されました。<br> そのぷろじぇくとには<b>ひゃくおく</b>えんがとうしされました <br>Ten&nbsp;<b>billion</b> yen was invested in the project.	
円	[sound:k-0680_円.mp3]<br>えん, まる <br> Yen, money; circle
Yen, money; circle	<b>円<b> <br> えん, まる <br>[sound:k-0680_円.mp3]
[sound:k-0680_円.mp3]	Yen, money; circle<br> <b>円</b> <br> (えん, まる)
(<b>派遣</b>) その会社は新しい従業員を派遣しました。	[sound:s-0680_その会社は新しい従業員を派遣しました。.mp3] <br> そのかいしゃはあたらしいじゅうぎょういんをはけんしました。 <br> The company dispatched new employees.
[sound:s-0670_その山には百匹のウサギが住んでいます。.mp3]	<b>数百</b> <br> 彼は数百ページの本を読んだ。<br> かれは<b>すうひゃく</b>ページのほんをよんだ <br>He read <b>several hundred</b> pages of the book.	
円高	[sound:k-0681_円高.mp3]<br>えんだか <br> high-valued yen, exchange in favor (favour) of the yen
high-valued yen, exchange in favor (favour) of the yen	<b>円高<b> <br> えんだか <br>[sound:k-0681_円高.mp3]
[sound:k-0681_円高.mp3]	high-valued yen, exchange in favor<br> <b>favour) of the yen (円高</b> <br> (えんだか)
(<b>派閥</b>) 彼は政治の派閥に所属しています。	[sound:s-0681_彼は政治の派閥に所属しています。.mp3] <br> かれはせいじのはばつにしょぞくしています。 <br> He belongs to a political faction.
[sound:s-0671_彼は二百メートルを泳ぎました。.mp3]	<b>百八十度</b> <br> 彼は急に方向を百八十度変えた。<br> かれはきゅうにほうこうを<b>ひゃくはちじゅうど</b>かえた <br>He suddenly changed direction by <b>one hundred and eighty degrees</b>.	
円安	[sound:k-0682_円安.mp3]<br>えんやす <br> cheap yen
cheap yen	<b>円安<b> <br> えんやす <br>[sound:k-0682_円安.mp3]
[sound:k-0682_円安.mp3]	cheap yen<br> <b>円安</b> <br> (えんやす)
(<b>立派</b>) 彼の演説は立派でした。	[sound:s-0682_彼の演説は立派でした。.mp3] <br> かれのえんぜつはりっぱでした。 <br> His speech was splendid.
[sound:s-0672_彼女は三百円を使いました。.mp3]	<b>百合</b> <br> 公園には美しい百合が咲いています。<br> こうえんにはうつくしい<b>ゆり</b>がさいています <br>Beautiful <b>lilies</b> are blooming in the park.	
円相場	[sound:k-0683_円相場.mp3]<br>えんそうば <br> yen exchange rate
yen exchange rate	<b>円相場<b> <br> えんそうば <br>[sound:k-0683_円相場.mp3]
[sound:k-0683_円相場.mp3]	yen exchange rate<br> <b>円相場</b> <br> (えんそうば)
(<b>右派</b>) 彼は右派の政治家です。	[sound:s-0683_彼は右派の政治家です。.mp3] <br> かれはうはのせいじかです。 <br> He is a right-wing politician.
[sound:s-0673_その百貨店は地元で最も人気があります。.mp3]	<b>派遣</b> <br> その会社は新しい従業員を派遣しました。<br> そのかいしゃはあたらしいじゅうぎょういんを<b>はけん</b>しました <br>The company <b>dispatched</b> new employees.	
一円	[sound:k-0684_一円.mp3]<br>いちえん <br> whole district, one yen, throughout
whole district, one yen, throughout	<b>一円<b> <br> いちえん <br>[sound:k-0684_一円.mp3]
[sound:k-0684_一円.mp3]	whole district, one yen, throughout<br> <b>一円</b> <br> (いちえん)
(<b>左派</b>) 彼女は左派の活動家です。	[sound:s-0684_彼女は左派の活動家です。.mp3] <br> かのじょはさはのかつどうかです。 <br> She is a left-wing activist.
[sound:s-0674_彼は百万円の宝くじに当選しました。.mp3]	<b>派閥</b> <br> 彼は政治の派閥に所属しています。<br> かれはせいじの<b>はばつ</b>にしょぞくしています <br>He belongs to a political <b>faction</b>.	
円滑	[sound:k-0685_円滑.mp3]<br>えんかつ, えんこつ <br> smooth, undisturbed, uninterrupted, harmonious
smooth, undisturbed, uninterrupted, harmonious	<b>円滑<b> <br> えんかつ, えんこつ <br>[sound:k-0685_円滑.mp3]
[sound:k-0685_円滑.mp3]	smooth, undisturbed, uninterrupted, harmonious<br> <b>円滑</b> <br> (えんかつ, えんこつ)
(<b>特派員</b>) 彼は戦地に派遣された特派員です。	[sound:s-0685_彼は戦地に派遣された特派員です。.mp3] <br> かれはせんちにはけんされたとくはいんです。 <br> He is a correspondent dispatched to the battlefield.
[sound:s-0675_その学校には四百人の生徒がいます。.mp3]	<b>立派</b> <br> 彼の演説は立派でした。<br> かれのえんぜつは<b>りっぱ</b>でした <br>His speech was <b>splendid</b>.	
円形	[sound:k-0686_円形.mp3]<br>えんけい, まるがた <br> round shape, circle; circular form
round shape, circle; circular form	<b>円形<b> <br> えんけい, まるがた <br>[sound:k-0686_円形.mp3]
[sound:k-0686_円形.mp3]	round shape, circle; circular form<br> <b>円形</b> <br> (えんけい, まるがた)
(<b>硬派</b>) 彼は硬派なアプローチをとります。	[sound:s-0686_彼は硬派なアプローチをとります。.mp3] <br> かれはこうはなあぷろーちをとります。 <br> He takes a tough approach.
[sound:s-0676_そのプロジェクトには百億円が投資されました。.mp3]	<b>右派</b> <br> 彼は右派の政治家です。<br> かれは<b>うは</b>のせいじかです <br>He is a <b>right-wing</b> politician.	
円卓	[sound:k-0687_円卓.mp3]<br>えんたく <br> round table
round table	<b>円卓<b> <br> えんたく <br>[sound:k-0687_円卓.mp3]
[sound:k-0687_円卓.mp3]	round table<br> <b>円卓</b> <br> (えんたく)
(<b>党派</b>) 彼はどの党派にも属していません。	[sound:s-0687_彼はどの党派にも属していません。.mp3] <br> かれはどのとうはにもぞくしていません。 <br> He doesn't belong to any party affiliation.
[sound:s-0677_彼は数百ページの本を読んだ。.mp3]	<b>左派</b> <br> 彼女は左派の活動家です。<br> かのじょは<b>さは</b>のかつどうかです <br>She is a<b> left-wing</b> activist.	
円満	[sound:k-0688_円満.mp3]<br>えんまん <br> perfection, harmony, peace, smoothness, completeness, satisfaction, integrity
perfection, harmony, peace, smoothness, completeness, satisfaction, integrity	<b>円満<b> <br> えんまん <br>[sound:k-0688_円満.mp3]
[sound:k-0688_円満.mp3]	perfection, harmony, peace, smoothness, completeness, satisfaction, integrity<br> <b>円満</b> <br> (えんまん)
(<b>派手</b>) 彼女は派手な衣装を着てパーティーに行った。	[sound:s-0688_彼女は派手な衣装を着てパーティーに行った。.mp3] <br> かのじょははでないしょうぞうをきてぱーてぃーにいった。 <br> She went to the party wearing flashy clothes.
[sound:s-0678_彼は急に方向を百八十度変えた。.mp3]	<b>特派員</b> <br> 彼は戦地に派遣された特派員です。<br> かれはせんちにはけんされた<b>とくはいん</b>です <br>He is a <b>(special) correspondent</b> dispatched to the battlefield.	
円筒	[sound:k-0689_円筒.mp3]<br>えんとう <br> cylinder
cylinder	<b>円筒<b> <br> えんとう <br>[sound:k-0689_円筒.mp3]
[sound:k-0689_円筒.mp3]	cylinder<br> <b>円筒</b> <br> (えんとう)
(<b>派兵</b>) 政府は国外に軍隊を派兵しました。	[sound:s-0689_政府は国外に軍隊を派兵しました。.mp3] <br> せいふはこくがいにぐんたいをはへいしました。 <br> The government dispatched troops overseas.
[sound:s-0679_公園には美しい百合が咲いています。.mp3]	<b>硬派</b> <br> 彼は硬派なアプローチをとります。<br> かれは<b>こうは</b>なあぷろーちをとります <br>He takes a <b>tough</b> approach.	
関	[sound:k-0690_関.mp3]<br>せき <br> barrier, gate
barrier, gate	<b>関<b> <br> せき <br>[sound:k-0690_関.mp3]
[sound:k-0690_関.mp3]	barrier, gate<br> <b>関</b> <br> (せき)
(<b>点</b>) 地図にはたくさんの点があります。	[sound:s-0690_地図にはたくさんの点があります。.mp3] <br> ちずにはたくさんのてんがあります。 <br> There are many points on the map.
[sound:s-0680_その会社は新しい従業員を派遣しました。.mp3]	<b>党派</b> <br> 彼はどの党派にも属していません。<br> かれはどの<b>とうは</b>にもぞくしていません <br>He doesn't belong to any <b>political party</b>.	
関係	[sound:k-0691_関係.mp3]<br>かんけい <br> relation, connection
relation, connection	<b>関係<b> <br> かんけい <br>[sound:k-0691_関係.mp3]
[sound:k-0691_関係.mp3]	relation, connection<br> <b>関係</b> <br> (かんけい)
(<b>焦点</b>) この問題の焦点を明確にする必要があります。	[sound:s-0691_この問題の焦点を明確にする必要があります。.mp3] <br> このもんだいのしょうてんをめいかくにするひつようがあります。 <br> We need to clarify the focus of this issue.
[sound:s-0681_彼は政治の派閥に所属しています。.mp3]	<b>派手</b> <br> 彼女は派手な衣装を着てパーティーに行った。<br> かのじょは<b>はで</b>ないしょうぞうをきてぱーてぃーにいった <br>She went to the party wearing <b>flashy</b> clothes.	
関係者	[sound:k-0692_関係者.mp3]<br>かんけいしゃ <br> authorized people, authorised people, person(s) concerned
authorized people, authorised people, person(s) concerned	<b>関係者<b> <br> かんけいしゃ <br>[sound:k-0692_関係者.mp3]
[sound:k-0692_関係者.mp3]	authorized people, authorised people, person(s) concerned<br> <b>関係者</b> <br> (かんけいしゃ)
(<b>拠点</b>) その会社は地域に拠点を置いています。	[sound:s-0692_その会社は地域に拠点を置いています。.mp3] <br> そのかいしゃはちいきにきょてんをおいています。 <br> The company has its base in the region.
[sound:s-0682_彼の演説は立派でした。.mp3]	<b>派兵</b> <br> 政府は国外に軍隊を派兵しました。<br> せいふはこくがいにぐんたいを<b>はへい</b>しました <br>The government <b>dispatched</b> troops overseas.	
関心	[sound:k-0693_関心.mp3]<br>かんしん <br> concern, interest
concern, interest	<b>関心<b> <br> かんしん <br>[sound:k-0693_関心.mp3]
[sound:k-0693_関心.mp3]	concern, interest<br> <b>関心</b> <br> (かんしん)
(<b>時点</b>) 彼女の到着は今の時点では確定していません。	[sound:s-0693_彼女の到着は今の時点では確定していません。.mp3] <br> かのじょのとうちゃくはいまのじてんではかくていしていません。 <br> Her arrival is not confirmed at this point in time.
[sound:s-0683_彼は右派の政治家です。.mp3]	<b>点</b> <br> 地図にはたくさんの点があります。<br> ちずにはたくさんの<b>てん</b>があります <br>There are many <b>points</b> on the map.	
関連	[sound:k-0694_関連.mp3]<br>かんれん <br> relation, connection, relevance
relation, connection, relevance	<b>関連<b> <br> かんれん <br>[sound:k-0694_関連.mp3]
[sound:k-0694_関連.mp3]	relation, connection, relevance<br> <b>関連</b> <br> (かんれん)
(<b>得点</b>) 彼は試合で多くの得点を獲得しました。	[sound:s-0694_彼は試合で多くの得点を獲得しました。.mp3] <br> かれはしあいでおおくのとくてんをかくとくしました。 <br> He scored many points in the game.
[sound:s-0684_彼女は左派の活動家です。.mp3]	<b>焦点</b> <br> この問題の焦点を明確にする必要があります。<br> このもんだいの<b>しょうてん</b>をめいかくにするひつようがあります <br>We need to clarify the <b>focus</b> of this issue.	
機関	[sound:k-0695_機関.mp3]<br>きかん <br> mechanism, facility, engine; agency, organisation, institution, organ
mechanism, facility, engine; agency, organisation, institution, organ	<b>機関<b> <br> きかん <br>[sound:k-0695_機関.mp3]
[sound:k-0695_機関.mp3]	mechanism, facility, engine; agency, organisation, institution, organ<br> <b>機関</b> <br> (きかん)
(<b>視点</b>) この問題を別の視点から見てみましょう。	[sound:s-0695_この問題を別の視点から見てみましょう。.mp3] <br> このもんだいをべつのしてんからみてみましょう。 <br> Let's look at this issue from a different perspective.
[sound:s-0685_彼は戦地に派遣された特派員です。.mp3]	<b>拠点</b> <br> その会社は地域に拠点を置いています。<br> そのかいしゃはちいきに<b>きょてん</b>をおいています <br>The company has its <b>base</b> in the region.	
関西	[sound:k-0696_関西.mp3]<br>かんさい, かんせい <br> Kansai (south-western half of Japan, including Osaka)
Kansai (south-western half of Japan, including Osaka)	<b>関西<b> <br> かんさい, かんせい <br>[sound:k-0696_関西.mp3]
[sound:k-0696_関西.mp3]	Kansai<br> <b>south-western half of Japan, including Osaka) (関西</b> <br> (かんさい, かんせい)
(<b>失点</b>) チームは失点を最小限に抑える必要があります。	[sound:s-0696_チームは失点を最小限に抑える必要があります。.mp3] <br> チームはしってんをさいしょうげんにおさえるひつようがあります。 <br> The team needs to minimize conceded points.
[sound:s-0686_彼は硬派なアプローチをとります。.mp3]	<b>時点</b> <br> 彼女の到着は今の時点では確定していません。<br> かのじょのとうちゃくはいまの<b>じてん</b>ではかくていしていません <br>Her arrival is not confirmed at this <b>point in time.</b>	
関税	[sound:k-0697_関税.mp3]<br>かんぜい <br> customs, duty, tariff
customs, duty, tariff	<b>関税<b> <br> かんぜい <br>[sound:k-0697_関税.mp3]
[sound:k-0697_関税.mp3]	customs, duty, tariff<br> <b>関税</b> <br> (かんぜい)
(<b>重点</b>) 彼は教育に重点を置いています。	[sound:s-0697_彼は教育に重点を置いています。.mp3] <br> かれはきょういくにじゅうてんをおいています。 <br> He emphasizes education.
[sound:s-0687_彼はどの党派にも属していません。.mp3]	<b>得点</b> <br> 彼は試合で多くの得点を獲得しました。<br> かれはしあいでおおくの<b>とくてん</b>をかくとくしました <br>He scored many <b>points</b> in the game.	
金融機関	[sound:k-0698_金融機関.mp3]<br>きんゆうきかん <br> financial institutions, banking facilities
financial institutions, banking facilities	<b>金融機関<b> <br> きんゆうきかん <br>[sound:k-0698_金融機関.mp3]
[sound:k-0698_金融機関.mp3]	financial institutions, banking facilities<br> <b>金融機関</b> <br> (きんゆうきかん)
(<b>同点</b>) 試合は同点で終わりました。	[sound:s-0698_試合は同点で終わりました。.mp3] <br> しあいはどうてんでおわりました。 <br> The game ended in a tie.
[sound:s-0688_彼女は派手な衣装を着てパーティーに行った。.mp3]	<b>視点</b> <br> この問題を別の視点から見てみましょう。<br> このもんだいをべつの<b>してん</b>からみてみましょう <br>Let's look at this issue from a different <b>perspective</b>.	
関与	[sound:k-0699_関与.mp3]<br>かんよ <br> participation, taking part in, participating in, being concerned in
participation, taking part in, participating in, being concerned in	<b>関与<b> <br> かんよ <br>[sound:k-0699_関与.mp3]
[sound:k-0699_関与.mp3]	participation, taking part in, participating in, being concerned in<br> <b>関与</b> <br> (かんよ)
(<b>問題点</b>) 彼の提案にはいくつかの問題点があります。	[sound:s-0699_彼の提案にはいくつかの問題点があります。.mp3] <br> かれのていあんにはいくつかのもんだいてんがあります。 <br> There are several issues with his proposal.
[sound:s-0689_政府は国外に軍隊を派兵しました。.mp3]	<b>失点</b> <br> チームは失点を最小限に抑える必要があります。<br> チームは<b>しってん</b>をさいしょうげんにおさえるひつようがあります <br>The team needs to minimize<b> conceded points.</b>	
決まって	[sound:k-0700_決まって.mp3]<br>きまって <br> always, without fail, usually, regularly
always, without fail, usually, regularly	<b>決まって<b> <br> きまって <br>[sound:k-0700_決まって.mp3]
[sound:k-0700_決まって.mp3]	always, without fail, usually, regularly<br> <b>決まって</b> <br> (きまって)
(<b>教育</b>) 教育は未来のための最も重要な投資です。	[sound:s-0700_教育は未来のための最も重要な投資です。.mp3] <br> きょういくはみらいのためのもっともじゅうようなとうしです。 <br> Education is the most important investment for the future.
[sound:s-0690_地図にはたくさんの点があります。.mp3]	<b>重点</b> <br> 彼は教育に重点を置いています。<br> かれはきょういくに<b>じゅうてん</b>をおいています <br>He <b>emphasizes</b> education.	
決して	[sound:k-0701_決して.mp3]<br>けっして, けして <br> never, by no means, decidedly, indisputably
never, by no means, decidedly, indisputably	<b>決して<b> <br> けっして, けして <br>[sound:k-0701_決して.mp3]
[sound:k-0701_決して.mp3]	never, by no means, decidedly, indisputably<br> <b>決して</b> <br> (けっして, けして)
(<b>教授</b>) 彼は大学で数学を教授しています。	[sound:s-0701_彼は大学で数学を教授しています。.mp3] <br> かれはだいがくですうがくをきょうじゅしています。 <br> He teaches mathematics at the university.
[sound:s-0691_この問題の焦点を明確にする必要があります。.mp3]	<b>同点</b> <br> 試合は同点で終わりました。<br> しあいは<b>どうてん</b>でおわりました <br>The game ended in a <b>tie</b>.	
解決	[sound:k-0702_解決.mp3]<br>かいけつ <br> settlement, solution, resolution
settlement, solution, resolution	<b>解決<b> <br> かいけつ <br>[sound:k-0702_解決.mp3]
[sound:k-0702_解決.mp3]	settlement, solution, resolution<br> <b>解決</b> <br> (かいけつ)
(<b>教師</b>) 彼女は小学校で教師をしています。	[sound:s-0702_彼女は小学校で教師をしています。.mp3] <br> かのじょはしょうがっこうできょうしをしています。 <br> She is a teacher at an elementary school.
[sound:s-0692_その会社は地域に拠点を置いています。.mp3]	<b>問題点</b> <br> 彼の提案にはいくつかの問題点があります。<br> かれのていあんにはいくつかの<b>もんだいてん</b>があります <br>There are several <b>issues</b> with his proposal.	
決議	[sound:k-0703_決議.mp3]<br>けつぎ <br> resolution, vote, decision
resolution, vote, decision	<b>決議<b> <br> けつぎ <br>[sound:k-0703_決議.mp3]
[sound:k-0703_決議.mp3]	resolution, vote, decision<br> <b>決議</b> <br> (けつぎ)
(<b>宗教</b>) この国では様々な宗教が信仰されています。	[sound:s-0703_この国では様々な宗教が信仰されています。.mp3] <br> このくにではさまざまなしゅうきょうがしんこうされています。 <br> Various religions are practiced in this country.
[sound:s-0693_彼女の到着は今の時点では確定していません。.mp3]	<b>教育</b> <br> 教育は未来のための最も重要な投資です。<br><b> きょういく</b>はみらいのためのもっともじゅうようなとうしです <br><b>Education</b> is the most important investment for the future.	
決定	[sound:k-0704_決定.mp3]<br>けってい <br> decision, determination
decision, determination	<b>決定<b> <br> けってい <br>[sound:k-0704_決定.mp3]
[sound:k-0704_決定.mp3]	decision, determination<br> <b>決定</b> <br> (けってい)
(<b>教室</b>) 私たちは教室で新しい言葉を学びます。	[sound:s-0704_私たちは教室で新しい言葉を学びます。.mp3] <br> わたしたちはきょうしつであたらしいことばをまなびます。 <br> We learn new words in the classroom.
[sound:s-0694_彼は試合で多くの得点を獲得しました。.mp3]	<b>教授</b> <br> 彼は大学で数学を教授しています。<br> かれはだいがくですうがくを<b>きょうじゅ</b>しています <br>He <b>teaches</b> mathematics at the university.	
判決	[sound:k-0705_判決.mp3]<br>はんけつ <br> judicial decision, judgement, judgment, sentence, decree
judicial decision, judgement, judgment, sentence, decree	<b>判決<b> <br> はんけつ <br>[sound:k-0705_判決.mp3]
[sound:k-0705_判決.mp3]	judicial decision, judgement, judgment, sentence, decree<br> <b>判決</b> <br> (はんけつ)
(<b>教徒</b>) 彼は熱心なキリスト教徒です。	[sound:s-0705_彼は熱心なキリスト教徒です。.mp3] <br> かれはねっしんなきりすときょうとです。 <br> He is a devout Christian believer.
[sound:s-0695_この問題を別の視点から見てみましょう。.mp3]	<b>教師</b> <br> 彼女は小学校で教師をしています。<br> かのじょはしょうがっこうで<b>きょうし</b>をしています <br>She is a <b>teacher</b> at an elementary school.	
決算	[sound:k-0706_決算.mp3]<br>けっさん <br> balance sheet, settlement of accounts
balance sheet, settlement of accounts	<b>決算<b> <br> けっさん <br>[sound:k-0706_決算.mp3]
[sound:k-0706_決算.mp3]	balance sheet, settlement of accounts<br> <b>決算</b> <br> (けっさん)
(<b>教科書</b>) この教科書は学校で使われています。	[sound:s-0706_この教科書は学校で使われています。.mp3] <br> このきょうかしょはがっこうでつかわれています。 <br> This textbook is used in schools.
[sound:s-0696_チームは失点を最小限に抑える必要があります。.mp3]	<b>宗教</b> <br> この国では様々な宗教が信仰されています。<br> このくにではさまざまな<b>しゅうきょう</b>がしんこうされています <br>Various <b>religions</b> are practiced in this country.	
決勝	[sound:k-0707_決勝.mp3]<br>けっしょう <br> decision of a contest, finals (in sports)
decision of a contest, finals (in sports)	<b>決勝<b> <br> けっしょう <br>[sound:k-0707_決勝.mp3]
[sound:k-0707_決勝.mp3]	decision of a contest, finals<br> <b>in sports) (決勝</b> <br> (けっしょう)
(<b>教諭</b>) 彼女は中学校で英語の教諭をしています。	[sound:s-0707_彼女は中学校で英語の教諭をしています。.mp3] <br> かのじょはちゅうがっこうでえいごのきょうゆをしています。 <br> She is an English instructor at the junior high school.
[sound:s-0697_彼は教育に重点を置いています。.mp3]	<b>教室</b> <br> 私たちは教室で新しい言葉を学びます。<br> わたしたちは<b>きょうしつ</b>であたらしいことばをまなびます <br>We learn new words in the <b>classroom</b>.	
決意	[sound:k-0708_決意.mp3]<br>けつい <br> decision, determination
decision, determination	<b>決意<b> <br> けつい <br>[sound:k-0708_決意.mp3]
[sound:k-0708_決意.mp3]	decision, determination<br> <b>決意</b> <br> (けつい)
(<b>助教授</b>) 彼は大学で助教授をしています。	[sound:s-0708_彼は大学で助教授をしています。.mp3] <br> かれはだいがくでじょきょうじゅをしています。 <br> He is an assistant professor at the university.
[sound:s-0698_試合は同点で終わりました。.mp3]	<b>教徒</b> <br> 彼は熱心なキリスト教徒です。<br> かれはねっしんなきりすと<b>きょうと</b>です <br>He is a devout Christian <b>believer</b>.	
決断	[sound:k-0709_決断.mp3]<br>けつだん <br> decision, determination
decision, determination	<b>決断<b> <br> けつだん <br>[sound:k-0709_決断.mp3]
[sound:k-0709_決断.mp3]	decision, determination<br> <b>決断</b> <br> (けつだん)
(<b>教会</b>) 私たちは毎週教会に行きます。	[sound:s-0709_私たちは毎週教会に行きます。.mp3] <br> わたしたちはまいしゅうきょうかいにいきます。 <br> We go to church every week.
[sound:s-0699_彼の提案にはいくつかの問題点があります。.mp3]	<b>教科書</b> <br> この教科書は学校で使われています。<br> この<b>きょうかしょ</b>はがっこうでつかわれています <br>This <b>textbook</b> is used in schools.	
子	[sound:k-0710_子.mp3]<br>こ <br> child; young (animal); young woman, young geisha; offshoot; interest; new shares; bird egg; (after a noun or -masu stem) -er (often of young women)
child; young (animal); young woman, young geisha; offshoot; interest; new shares; bird egg; (after a noun or -masu stem) -er (often of young women)	<b>子<b> <br> こ <br>[sound:k-0710_子.mp3]
[sound:k-0710_子.mp3]	child; young<br> <b>animal); young woman, young geisha; offshoot; interest; new shares; bird egg; (after a noun or -masu stem) -er (often of young women) (子</b> <br> (こ)
(<b>情報</b>) 彼は最新の情報を持っています。	[sound:s-0710_彼は最新の情報を持っています。.mp3] <br> かれはさいしんのじょうほうをもっています。 <br> He has the latest information.
[sound:s-0700_教育は未来のための最も重要な投資です。.mp3]	<b>教諭</b> <br> 彼女は中学校で英語の教諭をしています。<br> かのじょはちゅうがっこうでえいごの<b>きょうゆ</b>をしています <br>She is an English <b>instructor</b> at the junior high school.	
子供	[sound:k-0711_子供.mp3]<br>こども <br> child, children
child, children	<b>子供<b> <br> こども <br>[sound:k-0711_子供.mp3]
[sound:k-0711_子供.mp3]	child, children<br> <b>子供</b> <br> (こども)
(<b>報告</b>) 会議の報告書を作成してください。	[sound:s-0711_会議の報告書を作成してください。.mp3] <br> かいぎのほうこくしょをさくせいしてください。 <br> Please prepare a report for the meeting.
[sound:s-0701_彼は大学で数学を教授しています。.mp3]	<b>助教授</b> <br> 彼は大学で助教授をしています。<br> かれはだいがくで<b>じょきょうじゅ</b>をしています <br>He is an <b>assistant professor </b>at the university.	
女子	[sound:k-0712_女子.mp3]<br>じょし, おなご <br> woman, girl
woman, girl	<b>女子<b> <br> じょし, おなご <br>[sound:k-0712_女子.mp3]
[sound:k-0712_女子.mp3]	woman, girl<br> <b>女子</b> <br> (じょし, おなご)
(<b>報道</b>) その事件は多くの報道で取り上げられました。	[sound:s-0712_その事件は多くの報道で取り上げられました。.mp3] <br> そのじけんはおおくのほうどうでとりあげられました。 <br> The incident was covered by many news outlets.
[sound:s-0702_彼女は小学校で教師をしています。.mp3]	<b>教会</b> <br> 私たちは毎週教会に行きます。<br> わたしたちはまいしゅう<b>きょうかい</b>にいきます <br>We go to <b>church</b> every week.	
男子	[sound:k-0713_男子.mp3]<br>だんし <br> youth, young man
youth, young man	<b>男子<b> <br> だんし <br>[sound:k-0713_男子.mp3]
[sound:k-0713_男子.mp3]	youth, young man<br> <b>男子</b> <br> (だんし)
(<b>報告書</b>) 彼はプロジェクトの進捗状況を報告書にまとめました。	[sound:s-0713_彼はプロジェクトの進捗状況を報告書にまとめました。.mp3] <br> かれはぷろじぇくとのしんちょくじょうきょうをほうこくしょにまとめました。 <br> He summarized the progress of the project in a report.
[sound:s-0703_この国では様々な宗教が信仰されています。.mp3]	<b>情報</b> <br> 彼は最新の情報を持っています。<br> かれはさいしんの<b>じょうほう</b>をもっています <br>He has the latest <b>information</b>.	
原子力	[sound:k-0714_原子力.mp3]<br>げんしりょく <br> atomic energy
atomic energy	<b>原子力<b> <br> げんしりょく <br>[sound:k-0714_原子力.mp3]
[sound:k-0714_原子力.mp3]	atomic energy<br> <b>原子力</b> <br> (げんしりょく)
(<b>広報</b>) その企業は広報部を設けています。	[sound:s-0714_その企業は広報部を設けています。.mp3] <br> そのきぎょうはこうほうぶをもうけています。 <br> The company has a public relations department.
[sound:s-0704_私たちは教室で新しい言葉を学びます。.mp3]	<b>報告</b> <br> 会議の報告書を作成してください。<br> かいぎの<b>ほうこく</b>しょを<i>さくせい</i>してください <br>Please <i>prepare</i> a <b>report</b> for the meeting.	
様子	[sound:k-0715_様子.mp3]<br>ようす <br> aspect, state, appearance
aspect, state, appearance	<b>様子<b> <br> ようす <br>[sound:k-0715_様子.mp3]
[sound:k-0715_様子.mp3]	aspect, state, appearance<br> <b>様子</b> <br> (ようす)
(<b>報酬</b>) その仕事の報酬は十分ですか？	[sound:s-0715_その仕事の報酬は十分ですか？.mp3] <br> そのしごとのほうしゅうはじゅうぶんですか？	Is the compensation for that job sufficient?
[sound:s-0705_彼は熱心なキリスト教徒です。.mp3]	<b>報道</b> <br> その事件は多くの報道で取り上げられました。<br> そのじけんはおおくの<b>ほうどう</b>でとりあげられました <br>The incident was covered by many <b>news outlets</b>.	
息子	[sound:k-0716_息子.mp3]<br>むすこ, そく <br> son; penis
son; penis	<b>息子<b> <br> むすこ, そく <br>[sound:k-0716_息子.mp3]
[sound:k-0716_息子.mp3]	son; penis<br> <b>息子</b> <br> (むすこ, そく)
(<b>報道陣</b>) 報道陣が事件の真相を追求しています。	[sound:s-0716_報道陣が事件の真相を追求しています。.mp3] <br> ほうどうじんがじけんのしんそうをついきゅうしています。 <br> The press corps is investigating the truth of the incident.
[sound:s-0706_この教科書は学校で使われています。.mp3]	<b>報告書</b> <br> 彼はプロジェクトの進捗状況を報告書にまとめました。<br> かれはぷろじぇくとの<i>しんちょくじょうきょう</i>を<b>ほうこくしょ</b>にまとめました <br>He summarized the progress of the project in a <b>report</b>.	
金子	[sound:k-0717_金子.mp3]<br>きんす <br> money, funds
money, funds	<b>金子<b> <br> きんす <br>[sound:k-0717_金子.mp3]
[sound:k-0717_金子.mp3]	money, funds<br> <b>金子</b> <br> (きんす)
(<b>速報</b>) その事件の速報がテレビで放送されました。	[sound:s-0717_その事件の速報がテレビで放送されました。.mp3] <br> そのじけんのそくほうがてれびでほうそうされました。 <br> The breaking news of the incident was broadcasted on TV.
[sound:s-0707_彼女は中学校で英語の教諭をしています。.mp3]	<b>広報</b> <br> その企業は広報部を設けています。<br> そのきぎょうは<b>こうほう</b>ぶをもうけています <br>The company has a <b>public relations</b> department.	
甲子	[sound:k-0718_甲子.mp3]<br>かっし <br> first of the sexagenary cycle
first of the sexagenary cycle	<b>甲子<b> <br> かっし <br>[sound:k-0718_甲子.mp3]
[sound:k-0718_甲子.mp3]	first of the sexagenary cycle<br> <b>甲子</b> <br> (かっし)
(<b>日報</b>) 私たちは毎日の業務を日報に記録します。	[sound:s-0718_私たちは毎日の業務を日報に記録します。.mp3] <br> わたしたちはまいにちのぎょうむをにっぽうにきろくします。 <br> We record our daily tasks in the daily report.
[sound:s-0708_彼は大学で助教授をしています。.mp3]	(<b>報酬</b>) その仕事の報酬は十分ですか？(wages)	
遺伝子	[sound:k-0719_遺伝子.mp3]<br>いでんし <br> gene, genetic
gene, genetic	<b>遺伝子<b> <br> いでんし <br>[sound:k-0719_遺伝子.mp3]
[sound:k-0719_遺伝子.mp3]	gene, genetic<br> <b>遺伝子</b> <br> (いでんし)
(<b>報復</b>) 彼は仕返しとして報復を行った。	[sound:s-0719_彼は仕返しとして報復を行った。.mp3] <br> かれはしかえしとしてほうふくをおこなった。 <br> He retaliated as payback.
[sound:s-0709_私たちは毎週教会に行きます。.mp3]	<b>報道陣</b> <br> 報道陣が事件の真相を追求しています。<br><b> ほうどうじん</b>がじけんのしんそうをついきゅうしています <br><b>The press corps</b> is investigating the truth of the incident.	
動	[sound:k-0720_動.mp3]<br>どう <br> motion, change, confusion
motion, change, confusion	<b>動<b> <br> どう <br>[sound:k-0720_動.mp3]
[sound:k-0720_動.mp3]	motion, change, confusion<br> <b>動</b> <br> (どう)
(<b>経済</b>) 経済の成長が停滞しています。	[sound:s-0720_経済の成長が停滞しています。.mp3] <br> けいざいのせいちょうがていたいしています。 <br> The economy's growth is stagnant.
[sound:s-0710_彼は最新の情報を持っています。.mp3]	<b>速報</b> <br> その事件の速報がテレビで放送されました。<br> そのじけんの<b>そくほう</b>がてれびでほうそうされました <br>The <b>breaking news</b> of the incident was broadcasted on TV.	
動き	[sound:k-0721_動き.mp3]<br>うごき <br> movement, activity, trend, development, change
movement, activity, trend, development, change	<b>動き<b> <br> うごき <br>[sound:k-0721_動き.mp3]
[sound:k-0721_動き.mp3]	movement, activity, trend, development, change<br> <b>動き</b> <br> (うごき)
(<b>救済</b>) 被災者に救済が必要です。	[sound:s-0721_被災者に救済が必要です。.mp3] <br> ひさいしゃにきゅうさいがひつようです。 <br> Relief is needed for the victims.
[sound:s-0711_会議の報告書を作成してください。.mp3]	<b>日報</b> <br> 私たちは毎日の業務を日報に記録します。<br> わたしたちはまいにちのぎょうむを<b>にっぽう</b>にきろくします <br>We record our daily tasks in the <b>daily report</b>.	
運動	[sound:k-0722_運動.mp3]<br>うんどう <br> motion, exercise
motion, exercise	<b>運動<b> <br> うんどう <br>[sound:k-0722_運動.mp3]
[sound:k-0722_運動.mp3]	motion, exercise<br> <b>運動</b> <br> (うんどう)
(<b>返済</b>) ローンの返済が遅れています。	[sound:s-0722_ローンの返済が遅れています。.mp3] <br> ろーんのへんさいがおくれています。 <br> Loan repayments are overdue.
[sound:s-0712_その事件は多くの報道で取り上げられました。.mp3]	<b>報復</b> <br> 彼は仕返しとして報復を行った。<br> かれはしかえしとして<b>ほうふく</b>をおこなった <br>He retaliated as <b>payback</b>.	
活動	[sound:k-0723_活動.mp3]<br>かつどう <br> action, activity
action, activity	<b>活動<b> <br> かつどう <br>[sound:k-0723_活動.mp3]
[sound:k-0723_活動.mp3]	action, activity<br> <b>活動</b> <br> (かつどう)
(<b>経済的</b>) 彼は経済的に困っています。	[sound:s-0723_彼は経済的に困っています。.mp3] <br> かれはけいざいてきにこまっています。 <br> He is struggling financially.
[sound:s-0713_彼はプロジェクトの進捗状況を報告書にまとめました。.mp3]	<b>経済</b> <br> 経済の成長が停滞しています。<br><b> けいざい</b>のせいちょうがていたいしています <br>The <b>economy's</b> growth is stagnant.	
行動	[sound:k-0724_行動.mp3]<br>こうどう <br> action, conduct, behaviour, behavior, mobilization, mobilisation
action, conduct, behaviour, behavior, mobilization, mobilisation	<b>行動<b> <br> こうどう <br>[sound:k-0724_行動.mp3]
[sound:k-0724_行動.mp3]	action, conduct, behaviour, behavior, mobilization, mobilisation<br> <b>行動</b> <br> (こうどう)
(<b>経済界</b>) 彼は経済界の重要人物です。	[sound:s-0724_彼は経済界の重要人物です。.mp3] <br> かれはけいざいかいのじゅうようじんぶつです。 <br> He is an important figure in the business community.
[sound:s-0714_その企業は広報部を設けています。.mp3]	<b>救済</b> <br> 被災者に救済が必要です。<br> ひさいしゃに<b>きゅうさい</b>がひつようです <br><b>Relief</b> is needed for the victims.	
自動車	[sound:k-0725_自動車.mp3]<br>じどうしゃ <br> automobile
automobile	<b>自動車<b> <br> じどうしゃ <br>[sound:k-0725_自動車.mp3]
[sound:k-0725_自動車.mp3]	automobile<br> <b>自動車</b> <br> (じどうしゃ)
(<b>経済企画庁</b>) 経済企画庁は政府の経済政策を立案します。	[sound:s-0725_経済企画庁は政府の経済政策を立案します。.mp3] <br> けいざいきかくちょうはせいふのけいざいせいさくをりつあんします。 <br> The Economic Planning Agency devises government economic policies.
[sound:s-0715_その仕事の報酬は十分ですか？.mp3]	<b>返済</b> <br> ローンの返済が遅れています。<br> ろーんの<b>へんさい</b>がおくれています <br>Loan <b>repayments</b> are overdue.	そのしごとのほうしゅうはじゅうぶんですか？ <br>Is the compensation for that job sufficient?
動物	[sound:k-0726_動物.mp3]<br>どうぶつ <br> animal
animal	<b>動物<b> <br> どうぶつ <br>[sound:k-0726_動物.mp3]
[sound:k-0726_動物.mp3]	animal<br> <b>動物</b> <br> (どうぶつ)
(<b>共済</b>) この団体は共済制度を提供しています。	[sound:s-0726_この団体は共済制度を提供しています。.mp3] <br> このだんたいはきょうさいせいどをていきょうしています。 <br> This organization provides a mutual aid system.
[sound:s-0716_報道陣が事件の真相を追求しています。.mp3]	<b>経済的</b> <br> 彼は経済的に困っています。<br> かれは<b>けいざいてき</b>にこまっています <br>He is struggling <b>financially</b>.	
不動産	[sound:k-0727_不動産.mp3]<br>ふどうさん <br> real estate
real estate	<b>不動産<b> <br> ふどうさん <br>[sound:k-0727_不動産.mp3]
[sound:k-0727_不動産.mp3]	real estate<br> <b>不動産</b> <br> (ふどうさん)
(<b>決済</b>) 支払いの決済を行いました。	[sound:s-0727_支払いの決済を行いました。.mp3] <br> しはらいのけっさいをおこないました。 <br> The payment settlement has been made.
[sound:s-0717_その事件の速報がテレビで放送されました。.mp3]	<b>経済界</b> <br> 彼は経済界の重要人物です。<br> かれは<b>けいざいかい</b>のじゅうようじんぶつです <br>He is an important figure in the <b>business community</b>.	
動向	[sound:k-0728_動向.mp3]<br>どうこう <br> trend, tendency, movement, attitude
trend, tendency, movement, attitude	<b>動向<b> <br> どうこう <br>[sound:k-0728_動向.mp3]
[sound:k-0728_動向.mp3]	trend, tendency, movement, attitude<br> <b>動向</b> <br> (どうこう)
(<b>使用済み</b>) この製品は使用済みです。	[sound:s-0728_この製品は使用済みです。.mp3] <br> このせいひんはしようずみです。 <br> This product is used.
[sound:s-0718_私たちは毎日の業務を日報に記録します。.mp3]	<b>経済企画庁</b> <br> 経済企画庁は政府の経済政策を立案します。<br><b> けいざいきかくちょう</b>はせいふのけいざいせいさくをりつあんします <br>The <b>Economic Planning Agency </b>devises government economic policies.	
移動	[sound:k-0729_移動.mp3]<br>いどう <br> removal, migration, movement; mobile (e.g. communications)
removal, migration, movement; mobile (e.g. communications)	<b>移動<b> <br> いどう <br>[sound:k-0729_移動.mp3]
[sound:k-0729_移動.mp3]	removal, migration, movement; mobile<br> <b>e.g. communications) (移動</b> <br> (いどう)
(<b>経済研究所</b>) 経済研究所で新しいプロジェクトが始まりました。	[sound:s-0729_経済研究所で新しいプロジェクトが始まりました。.mp3] <br> けいざいけんきゅうじょであたらしいぷろじぇくとがはじまりました。 <br> A new project has started at the economic research institute.
[sound:s-0719_彼は仕返しとして報復を行った。.mp3]	<b>共済</b> <br> この団体は<b>共済</b><i>制度</i>を提供しています。<br> このだんたいは<b>きょうさい</b><i>せいど</i>をていきょうしています <br>This organization provides a <b>mutual aid</b> <i>system</i>.	
京	[sound:k-0730_京.mp3]<br>きょう, けい <br> imperial capital (esp. Kyoto); final word of an iroha-uta; 10^16, 10,000,000,000,000,000, ten quadrillion (American), (obs) ten thousand billion (British)
imperial capital (esp. Kyoto); final word of an iroha-uta; 10^16, 10,000,000,000,000,000, ten quadrillion (American), (obs) ten thousand billion (British)	<b>京<b> <br> きょう, けい <br>[sound:k-0730_京.mp3]
[sound:k-0730_京.mp3]	imperial capital<br> <b>esp. Kyoto); final word of an iroha-uta; 10^16, 10,000,000,000,000,000, ten quadrillion (American), (obs) ten thousand billion (British) (京</b> <br> (きょう, けい)
(<b>同党</b>) 彼らは同党の候補者を支持しています。	[sound:s-0730_彼らは同党の候補者を支持しています。.mp3] <br> かれらはどうとうのこうほしゃをしじしています。 <br> They support the candidate from the same party.
[sound:s-0720_経済の成長が停滞しています。.mp3]	<b>決済</b> <br> 支払いの決済を行いました。<br> しはらいの<b>けっさい</b>をおこないました <br>The payment <b>settlement</b> has been made.	
東京	[sound:k-0731_東京.mp3]<br>とうきょう <br> Tokyo (current capital of Japan)
Tokyo (current capital of Japan)	<b>東京<b> <br> とうきょう <br>[sound:k-0731_東京.mp3]
[sound:k-0731_東京.mp3]	Tokyo<br> <b>current capital of Japan) (東京</b> <br> (とうきょう)
(<b>時</b>) 彼は時計を見ています。	[sound:s-0731_彼は時計を見ています。.mp3] <br> かれはとけいをみています。 <br> He is looking at the clock.
[sound:s-0721_被災者に救済が必要です。.mp3]	<b>使用済み</b> <br> この製品は使用済みです。<br> このせいひんは<b>しようずみ</b>です <br>This product is <b>used</b>.	
北京	[sound:k-0732_北京.mp3]<br>ぺきん <br> Beijing (China), Peking
Beijing (China), Peking	<b>北京<b> <br> ぺきん <br>[sound:k-0732_北京.mp3]
[sound:k-0732_北京.mp3]	Beijing<br> <b>China), Peking (北京</b> <br> (ぺきん)
(<b>時間</b>) 昼食の時間は十二時からです。	[sound:s-0732_昼食の時間は十二時からです。.mp3] <br> ちゅうしょくのじかんはじゅうにじからです。 <br> Lunchtime is from twelve o'clock.
[sound:s-0722_ローンの返済が遅れています。.mp3]	<b>経済研究所</b> <br> 経済研究所で新しいプロジェクトが始まりました。<br><b> けいざいけんきゅうじょ</b>であたらしいぷろじぇくとがはじまりました <br>A new project has started at the <b>economic research institute</b>.	
京都	[sound:k-0733_京都.mp3]<br>きょうと <br> Kyoto
Kyoto	<b>京都<b> <br> きょうと <br>[sound:k-0733_京都.mp3]
[sound:k-0733_京都.mp3]	Kyoto<br> <b>京都</b> <br> (きょうと)
(<b>時期</b>) 旅行するのに良い時期です。	[sound:s-0733_旅行するのに良い時期です。.mp3] <br> りょこうするのにいいじきです。 <br> It's a good time to travel.
[sound:s-0723_彼は経済的に困っています。.mp3]	<b>同党</b> <br> 彼らは同党の候補者を支持しています。<br> かれらは<b>どうとう</b>のこうほしゃをしじしています <br>They support the candidate from the <b>same party</b>.	
東京証券取引所	[sound:k-0734_東京証券取引所.mp3]<br>とうきょうしょうけんとりひきじょ <br> Tokyo Stock Exchange, TSE
Tokyo Stock Exchange, TSE	<b>東京証券取引所<b> <br> とうきょうしょうけんとりひきじょ <br>[sound:k-0734_東京証券取引所.mp3]
[sound:k-0734_東京証券取引所.mp3]	Tokyo Stock Exchange, TSE<br> <b>東京証券取引所</b> <br> (とうきょうしょうけんとりひきじょ)
(<b>時代</b>) 昭和時代にはたくさんの変化がありました。	[sound:s-0734_昭和時代にはたくさんの変化がありました。.mp3] <br> しょうわじだいにはたくさんのへんかがありました。 <br> There were many changes in the Showa era.
[sound:s-0724_彼は経済界の重要人物です。.mp3]	<b>時</b> <br> 彼は時計を見ています。<br> かれはとけいをみています <br>He is looking at the clock.	
帝京	[sound:k-0735_帝京.mp3]<br>ていきょう <br> the capital
the capital	<b>帝京<b> <br> ていきょう <br>[sound:k-0735_帝京.mp3]
[sound:k-0735_帝京.mp3]	the capital<br> <b>帝京</b> <br> (ていきょう)
(<b>当時</b>) 私はその事件の当時、その場にいませんでした。	[sound:s-0735_私はその事件の当時、その場にいませんでした。.mp3] <br> わたしはそのじけんのとうじ、そのばにいませんでした。 <br> I wasn't there at the time of the incident.
[sound:s-0725_経済企画庁は政府の経済政策を立案します。.mp3]	<b>時間</b> <br> 昼食の時間は十二時からです。<br> ちゅうしょくの<b>じかん</b>はじゅうにじからです <br>Lunch<b>time</b> is from twelve o'clock.	
中京	[sound:k-0736_中京.mp3]<br>ちゅうきょう <br> Nagoya and environs
Nagoya and environs	<b>中京<b> <br> ちゅうきょう <br>[sound:k-0736_中京.mp3]
[sound:k-0736_中京.mp3]	Nagoya and environs<br> <b>中京</b> <br> (ちゅうきょう)
(<b>同時</b>) その二つのイベントは同時に開催されます。	[sound:s-0736_その二つのイベントは同時に開催されます。.mp3] <br> そのふたつのイベントはどうじにかいさいされます。 <br> The two events will be held simultaneously.
[sound:s-0726_この団体は共済制度を提供しています。.mp3]	<b>時期</b> <br> 旅行するのに良い時期です。<br> りょこうするのにいい<b>じき</b>です <br>It's a good <b>time</b> to travel.	
在京	[sound:k-0737_在京.mp3]<br>ざいきょう <br> being in Tokyo
being in Tokyo	<b>在京<b> <br> ざいきょう <br>[sound:k-0737_在京.mp3]
[sound:k-0737_在京.mp3]	being in Tokyo<br> <b>在京</b> <br> (ざいきょう)
(<b>一時</b>) 彼は一時的な解決策を提案しました。	[sound:s-0737_彼は一時的な解決策を提案しました。.mp3] <br> かれはいちじてきなかいけつさくをていあんしました。 <br> He proposed a temporary solution.
[sound:s-0727_支払いの決済を行いました。.mp3]	<b>時代</b> <br> 昭和時代にはたくさんの変化がありました。<br> しょうわ<b>じだい</b>にはたくさんのへんかがありました <br>There were many changes in the Showa <b>era</b>.	
上京	[sound:k-0738_上京.mp3]<br>じょうきょう <br> proceeding to the capital (Tokyo)
proceeding to the capital (Tokyo)	<b>上京<b> <br> じょうきょう <br>[sound:k-0738_上京.mp3]
[sound:k-0738_上京.mp3]	proceeding to the capital<br> <b>Tokyo) (上京</b> <br> (じょうきょう)
(<b>時事</b>) 彼は時事問題に詳しいです。	[sound:s-0738_彼は時事問題に詳しいです。.mp3] <br> かれはじじもんだいにくわしいです。 <br> He is well-informed about current affairs.
[sound:s-0728_この製品は使用済みです。.mp3]	<b>当時</b> <br> 私はその事件の当時、その場にいませんでした。<br> わたしはそのじけんの<b>とうじ</b>、そのばにいませんでした <br>I wasn't there <b>at the time of </b>the incident.	
京成	[sound:k-0739_京成.mp3]<br>けいせい <br> train line Tokyo - Narita
train line Tokyo - Narita	<b>京成<b> <br> けいせい <br>[sound:k-0739_京成.mp3]
[sound:k-0739_京成.mp3]	train line Tokyo - Narita<br> <b>京成</b> <br> (けいせい)
(<b>時半</b>) 時半に会議が始まります。	[sound:s-0739_時半に会議が始まります。.mp3] <br> じはんにかいぎがはじまります。 <br> The meeting will start at half past the hour.
[sound:s-0729_経済研究所で新しいプロジェクトが始まりました。.mp3]	<b>同時</b> <br> その二つのイベントは同時に開催されます。<br> そのふたつのイベントは<b>どうじ</b>にかいさいされます <br>The two events will be held <b>simultaneously</b>.	
安全	[sound:k-0740_安全.mp3]<br>あんぜん <br> safety; security
safety; security	<b>安全<b> <br> あんぜん <br>[sound:k-0740_安全.mp3]
[sound:k-0740_安全.mp3]	safety; security<br> <b>安全</b> <br> (あんぜん)
(<b>臨時</b>) 臨時のバスが運行されます。	[sound:s-0740_臨時のバスが運行されます。.mp3] <br> りんじのバスがうんこうされます。 <br> Extra buses will be operated.
[sound:s-0730_彼らは同党の候補者を支持しています。.mp3]	<b>一時</b> <br> 彼は一時的な解決策を提案しました。<br> かれは<b>いちじ</b>てきなかいけつさくをていあんしました <br>He proposed a <b>temporary</b> solution.	
全体	[sound:k-0741_全体.mp3]<br>ぜんたい <br> whole, entirety, whatever (is the matter)
whole, entirety, whatever (is the matter)	<b>全体<b> <br> ぜんたい <br>[sound:k-0741_全体.mp3]
[sound:k-0741_全体.mp3]	whole, entirety, whatever<br> <b>is the matter) (全体</b> <br> (ぜんたい)
(<b>政</b>) 彼は政治に関心があります。	[sound:s-0741_彼は政治に関心があります。.mp3] <br> かれはせいじにかんしんがあります。 <br> He is interested in politics.
[sound:s-0731_彼は時計を見ています。.mp3]	<b>時事</b> <br> 彼は時事問題に詳しいです。<br> かれは<b>じじ</b>もんだいにくわしいです <br>He is well-informed about <b>current</b> affairs.	
全国	[sound:k-0742_全国.mp3]<br>ぜんこく, ぜんごく <br> country-wide, nation-wide, whole country, national
country-wide, nation-wide, whole country, national	<b>全国<b> <br> ぜんこく, ぜんごく <br>[sound:k-0742_全国.mp3]
[sound:k-0742_全国.mp3]	country-wide, nation-wide, whole country, national<br> <b>全国</b> <br> (ぜんこく, ぜんごく)
(<b>行政</b>) 行政手続きはオンラインで行われます。	[sound:s-0742_行政手続きはオンラインで行われます。.mp3] <br> ぎょうせいてつづきはオンラインでおこなわれます。 <br> Administrative procedures are conducted online.
[sound:s-0732_昼食の時間は十二時からです。.mp3]	<b>時半</b> <br> 時半に会議が始まります。<br><b> じはん</b>にかいぎがはじまります <br>The meeting will start at <b>half past the hour</b>.	
安全保障	[sound:k-0743_安全保障.mp3]<br>あんぜんほしょう <br> security guarantee (e.g. military security, network security, etc.)
security guarantee (e.g. military security, network security, etc.)	<b>安全保障<b> <br> あんぜんほしょう <br>[sound:k-0743_安全保障.mp3]
[sound:k-0743_安全保障.mp3]	security guarantee<br> <b>e.g. military security, network security, etc.) (安全保障</b> <br> (あんぜんほしょう)
(<b>財政</b>) 彼らは財政改革を推進しています。	[sound:s-0743_彼らは財政改革を推進しています。.mp3] <br> かれらはざいせいかいかくをすいしんしています。 <br> They are promoting financial reforms.
[sound:s-0733_旅行するのに良い時期です。.mp3]	<b>臨時</b> <br> 臨時のバスが運行されます。<br><b> りんじ</b>のバスがうんこうされます <br><b>Temporary</b> buses will be operated.	
全員	[sound:k-0744_全員.mp3]<br>ぜんいん <br> all members (unanimity), all hands, the whole crew, everyone, everybody
all members (unanimity), all hands, the whole crew, everyone, everybody	<b>全員<b> <br> ぜんいん <br>[sound:k-0744_全員.mp3]
[sound:k-0744_全員.mp3]	all members<br> <b>unanimity), all hands, the whole crew, everyone, everybody (全員</b> <br> (ぜんいん)
(<b>政界</b>) 彼は政界で有名な政治家です。	[sound:s-0744_彼は政界で有名な政治家です。.mp3] <br> かれはせいかいでゆうめいなせいじかです。 <br> He is a famous politician in the political world.
[sound:s-0734_昭和時代にはたくさんの変化がありました。.mp3]	<b>政</b> <br> 彼は政治に関心があります。<br> かれはせいじにかんしんがあります <br>He is interested in politics.	
全日	[sound:k-0745_全日.mp3]<br>ぜんじつ <br> all days
all days	<b>全日<b> <br> ぜんじつ <br>[sound:k-0745_全日.mp3]
[sound:k-0745_全日.mp3]	all days<br> <b>全日</b> <br> (ぜんじつ)
(<b>政権</b>) 新しい政権が発足しました。	[sound:s-0745_新しい政権が発足しました。.mp3] <br> あたらしいせいけんがほっそくしました。 <br> A new government has been formed.
[sound:s-0735_私はその事件の当時、その場にいませんでした。.mp3]	<b>行政</b> <br> 行政手続きはオンラインで行われます。<br><b> ぎょうせい</b>てつづきはオンラインでおこなわれます <br><b>Administrative</b> procedures are conducted online.	
全面	[sound:k-0746_全面.mp3]<br>ぜんめん <br> whole surface, entire
whole surface, entire	<b>全面<b> <br> ぜんめん <br>[sound:k-0746_全面.mp3]
[sound:k-0746_全面.mp3]	whole surface, entire<br> <b>全面</b> <br> (ぜんめん)
(<b>政策</b>) その政策は多くの批判を受けました。	[sound:s-0746_その政策は多くの批判を受けました。.mp3] <br> そのせいさくはおおくのひはんをうけました。 <br> That policy received a lot of criticism.
[sound:s-0736_その二つのイベントは同時に開催されます。.mp3]	<b>財政</b> <br> 彼らは財政改革を推進しています。<br> かれらは<b>ざいせい</b>かいかくをすいしんしています <br>They are promoting <b>financial</b> reforms.	
心不全	[sound:k-0747_心不全.mp3]<br>しんふぜん <br> heart failure
heart failure	<b>心不全<b> <br> しんふぜん <br>[sound:k-0747_心不全.mp3]
[sound:k-0747_心不全.mp3]	heart failure<br> <b>心不全</b> <br> (しんふぜん)
(<b>政治</b>) 政治は人々の生活に影響を与えます。	[sound:s-0747_政治は人々の生活に影響を与えます。.mp3] <br> せいじはひとびとのせいかつにえいきょうをあたえます。 <br> Politics influences people's lives.
[sound:s-0737_彼は一時的な解決策を提案しました。.mp3]	<b>政界</b> <br> 彼は政界で有名な政治家です。<br> かれは<b>せいかい</b>でゆうめいなせいじかです <br>He is a famous politician in the <b>political world</b>.	
全部	[sound:k-0748_全部.mp3]<br>ぜんぶ <br> all, entire, whole, altogether
all, entire, whole, altogether	<b>全部<b> <br> ぜんぶ <br>[sound:k-0748_全部.mp3]
[sound:k-0748_全部.mp3]	all, entire, whole, altogether<br> <b>全部</b> <br> (ぜんぶ)
(<b>政治家</b>) 彼は有名な政治家です。	[sound:s-0748_彼は有名な政治家です。.mp3] <br> かれはゆうめいなせいじかです。 <br> He is a famous politician.
[sound:s-0738_彼は時事問題に詳しいです。.mp3]	<b>政権</b> <br> 新しい政権が発足しました。<br> あたらしい<b>せいけん</b>がほっそくしました <br>A new <b>government</b> has been formed.	
全力	[sound:k-0749_全力.mp3]<br>ぜんりょく <br> all one's power, whole energy
all one's power, whole energy	<b>全力<b> <br> ぜんりょく <br>[sound:k-0749_全力.mp3]
[sound:k-0749_全力.mp3]	all one's power, whole energy<br> <b>全力</b> <br> (ぜんりょく)
(<b>政党</b>) この国には複数の政党が存在します。	[sound:s-0749_この国には複数の政党が存在します。.mp3] <br> このくににはふくすうのせいとうがそんざいします。 <br> There are multiple political parties in this country.
[sound:s-0739_時半に会議が始まります。.mp3]	<b>政策</b> <br> その政策は多くの批判を受けました。<br> その<b>せいさく</b>はおおくのひはんをうけました <br>That <b>policy</b> received a lot of criticism.	
目的	[sound:k-0750_目的.mp3]<br>もくてき <br> purpose, goal, aim, objective, intention
purpose, goal, aim, objective, intention	<b>目的<b> <br> もくてき <br>[sound:k-0750_目的.mp3]
[sound:k-0750_目的.mp3]	purpose, goal, aim, objective, intention<br> <b>目的</b> <br> (もくてき)
(<b>政府</b>) 政府は新しい政策を発表しました。	[sound:s-0750_政府は新しい政策を発表しました。.mp3] <br> せいふはあたらしいせいさくをはっぴょうしました。 <br> The government announced a new policy.
[sound:s-0740_臨時のバスが運行されます。.mp3]	<b>政治</b> <br> 政治は人々の生活に影響を与えます。<br><b> せいじ</b>はひとびとのせいかつにえいきょうをあたえます <br><b>Politics</b> influences people's lives.	
目標	[sound:k-0751_目標.mp3]<br>もくひょう <br> mark, objective, target
mark, objective, target	<b>目標<b> <br> もくひょう <br>[sound:k-0751_目標.mp3]
[sound:k-0751_目標.mp3]	mark, objective, target<br> <b>目標</b> <br> (もくひょう)
(<b>事</b>) 事がうまくいくことを願っています。	[sound:s-0751_事がうまくいくことを願っています。.mp3] <br> ことがうまくいくことをねがっています。 <br> I hope things go well.
[sound:s-0741_彼は政治に関心があります。.mp3]	<b>政治家</b> <br> 彼は有名な政治家です。<br> かれはゆうめいな<b>せいじか</b>です <br>He is a famous <b>politician</b>.	
注目	[sound:k-0752_注目.mp3]<br>ちゅうもく <br> notice, attention, observation
notice, attention, observation	<b>注目<b> <br> ちゅうもく <br>[sound:k-0752_注目.mp3]
[sound:k-0752_注目.mp3]	notice, attention, observation<br> <b>注目</b> <br> (ちゅうもく)
(<b>幹事</b>) 彼女はイベントの幹事を務めました。	[sound:s-0752_彼女はイベントの幹事を務めました。.mp3] <br> かのじょはイベントのかんじをつとめました。 <br> She served as the organizer of the event.
[sound:s-0742_行政手続きはオンラインで行われます。.mp3]	<b>政党</b> <br> この国には複数の政党が存在します。<br> このくににはふくすうの<b>せいとう</b>がそんざいします <br>There are multiple <b>political parties</b> in this country.	
項目	[sound:k-0753_項目.mp3]<br>こうもく <br> (data) item, entry
(data) item, entry	<b>項目<b> <br> こうもく <br>[sound:k-0753_項目.mp3]
[sound:k-0753_項目.mp3]	(data) item, entry<br> <b>項目</b> <br> (こうもく)
24. 記事
[sound:s-0743_彼らは財政改革を推進しています。.mp3]	<b>政府</b> <br> 政府は新しい政策を発表しました。<br><b> せいふ</b>はあたらしいせいさくをはっぴょうしました <br>The <b>government</b> announced a new policy.	
名目	[sound:k-0754_名目.mp3]<br>めいもく, みょうもく <br> name, title, appellation, (something) nominal; (under the) pretext (of), pretense
name, title, appellation, (something) nominal; (under the) pretext (of), pretense	<b>名目<b> <br> めいもく, みょうもく <br>[sound:k-0754_名目.mp3]
[sound:k-0754_名目.mp3]	name, title, appellation,<br> <b>something) nominal; (under the) pretext (of), pretense (名目</b> <br> (めいもく, みょうもく)
    - Kanji: 彼は新聞に記事を書いています。 <br> かれはしんぶんにきじをかいています。 <br> 	He is writing an article for the newspaper.
[sound:s-0744_彼は政界で有名な政治家です。.mp3]	<b>事</b> <br> 事がうまくいくことを願っています。<br><b> こと</b>がうまくいくことをねがっています <br>I hope <b>things</b> go well.	
種目	[sound:k-0755_種目.mp3]<br>しゅもく <br> event, item of business
event, item of business	<b>種目<b> <br> しゅもく <br>[sound:k-0755_種目.mp3]
[sound:k-0755_種目.mp3]	event, item of business<br> <b>種目</b> <br> (しゅもく)
(<b>軍事</b>) 彼らは軍事的な問題に対処しています。	[sound:s-0756_彼らは軍事的な問題に対処しています。.mp3] <br> かれらはぐんじてきなもんだいにたいしょしています。 <br> They are dealing with military issues.
[sound:s-0745_新しい政権が発足しました。.mp3]	<b>軍事</b> <br> 彼らは軍事的な問題に対処しています。<br> かれらは<b>ぐんじ</b>てきなもんだいにたいしょしています <br>They are dealing with <b>military</b> issues.	
目玉	[sound:k-0756_目玉.mp3]<br>めだま <br> eyeball; special feature, centerpiece, showpiece, drawcard; special program, loss leader
eyeball; special feature, centerpiece, showpiece, drawcard; special program, loss leader	<b>目玉<b> <br> めだま <br>[sound:k-0756_目玉.mp3]
[sound:k-0756_目玉.mp3]	eyeball; special feature, centerpiece, showpiece, drawcard; special program, loss leader<br> <b>目玉</b> <br> (めだま)
(<b>仕事</b>) 彼女は忙しい仕事をしています。	[sound:s-0757_彼女は忙しい仕事をしています。.mp3] <br> かのじょはいそがしいしごとをしています。 <br> She has a busy job.
[sound:s-0746_その政策は多くの批判を受けました。.mp3]	<b>仕事</b> <br> 彼女は忙しい仕事をしています。<br> かのじょはいそがしい<b>しごと</b>をしています <br>She has a busy <b>job</b>.	
目前	[sound:k-0757_目前.mp3]<br>もくぜん <br> before one's very eyes, under one's nose, imminence, close at hand
before one's very eyes, under one's nose, imminence, close at hand	<b>目前<b> <br> もくぜん <br>[sound:k-0757_目前.mp3]
[sound:k-0757_目前.mp3]	before one's very eyes, under one's nose, imminence, close at hand<br> <b>目前</b> <br> (もくぜん)
(<b>事業</b>) その会社は新しい事業を開始しました。	[sound:s-0758_その会社は新しい事業を開始しました。.mp3] <br> そのかいしゃはあたらしいじぎょうをかいししくしました。 <br> The company started a new business.
[sound:s-0747_政治は人々の生活に影響を与えます。.mp3]	<b>事業</b> <br> その会社は新しい事業を開始しました。<br> そのかいしゃはあたらしい<b>じぎょう</b>をかいししくしました <br>The company started a new <b>business</b>.	
目の前	[sound:k-0758_目の前.mp3]<br>めのまえ <br> before one's eyes, immediate, imminent
before one's eyes, immediate, imminent	<b>目の前<b> <br> めのまえ <br>[sound:k-0758_目の前.mp3]
[sound:k-0758_目の前.mp3]	before one's eyes, immediate, imminent<br> <b>目の前</b> <br> (めのまえ)
(<b>事件</b>) その事件は大きな関心を呼びました。	[sound:s-0759_その事件は大きな関心を呼びました。.mp3] <br> そのじけんはおおきなかんしんをよびました。 <br> The incident attracted a lot of attention.
[sound:s-0748_彼は有名な政治家です。.mp3]	<b>事件</b> <br> その事件は大きな関心を呼びました。<br> その<b>じけん</b>はおおきなかんしんをよびました <br>The <b>incident</b> attracted a lot of attention.	
品目	[sound:k-0759_品目.mp3]<br>ひんもく <br> list of articles
list of articles	<b>品目<b> <br> ひんもく <br>[sound:k-0759_品目.mp3]
[sound:k-0759_品目.mp3]	list of articles<br> <b>品目</b> <br> (ひんもく)
(<b>事故</b>) 彼は車の事故で負傷しました。	[sound:s-0760_彼は車の事故で負傷しました。.mp3] <br> かれはくるまのじこでふしょうしました。 <br> He was injured in a car accident.
[sound:s-0749_この国には複数の政党が存在します。.mp3]	<b>事故</b> <br> 彼は車の事故で負傷しました。<br> かれはくるまの<b>じこ</b>でふしょうしました <br>He was injured in a car <b>accident</b>.	
表	[sound:k-0760_表.mp3]<br>おもて <br> surface; face (i.e. the visible side of an object); front (of a building, etc.), obverse side (i.e. "head") of a coin; outside, exterior; appearance; public; first half (of an innings), top (of an inning); cover (for tatami mats, etc.); foreground
surface; face (i.e. the visible side of an object); front (of a building, etc.), obverse side (i.e. "head") of a coin; outside, exterior; appearance; public; first half (of an innings), top (of an inning); cover (for tatami mats, etc.); foreground	<b>表<b> <br> おもて <br>[sound:k-0760_表.mp3]
[sound:k-0760_表.mp3]	surface; face<br> <b>i.e. the visible side of an object); front (of a building, etc.), obverse side (i.e. "head") of a coin; outside, exterior; appearance; public; first half (of an innings), top (of an inning); cover (for tatami mats, etc.); foreground (表</b> <br> (おもて)
(<b>事実</b>) その話は事実とは異なります。	[sound:s-0761_その話は事実とは異なります。.mp3] <br> そのはなしはじじつとはことなります。 <br> That story is different from the truth.
[sound:s-0750_政府は新しい政策を発表しました。.mp3]	<b>事実</b> <br> その話は事実とは異なります。<br> そのはなしは<b>じじつ</b>とはことなります <br>That story is different from the <b>truth</b>.	
代表	[sound:k-0761_代表.mp3]<br>だいひょう <br> representative, representation, delegation, type, example, model
representative, representation, delegation, type, example, model	<b>代表<b> <br> だいひょう <br>[sound:k-0761_代表.mp3]
[sound:k-0761_代表.mp3]	representative, representation, delegation, type, example, model<br> <b>代表</b> <br> (だいひょう)
(<b>事情</b>) 彼女は自分の事情を説明しました。	[sound:s-0762_彼女は自分の事情を説明しました。.mp3] <br> かのじょはじぶんのじじょうをせつめいしました。 <br> She explained her circumstances.
[sound:s-0751_事がうまくいくことを願っています。.mp3]	<b>事情</b> <br> 彼女は自分の事情を説明しました。<br> かのじょはじぶんの<b>じじょう</b>をせつめいしました <br>She explained her <b>circumstances</b>.	
発表	[sound:k-0762_発表.mp3]<br>はっぴょう <br> announcement, publication
announcement, publication	<b>発表<b> <br> はっぴょう <br>[sound:k-0762_発表.mp3]
[sound:k-0762_発表.mp3]	announcement, publication<br> <b>発表</b> <br> (はっぴょう)
(<b>自ら</b>) 彼は問題を解決するために自ら行動しました。	[sound:s-0763_彼は問題を解決するために自ら行動しました。.mp3] <br> かれはもんだいをかいけつするためにみずからこうどうしました。 <br> He took action himself to solve the problem.
[sound:s-0752_彼女はイベントの幹事を務めました。.mp3]	<b>自ら</b> <br> 彼は問題を解決するために自ら行動しました。<br> かれはもんだいをかいけつするために<b>みずから</b>こうどうしました <br>He took action <b>himself</b> to solve the problem.	
表現	[sound:k-0763_表現.mp3]<br>ひょうげん <br> expression, presentation; representation, notation
expression, presentation; representation, notation	<b>表現<b> <br> ひょうげん <br>[sound:k-0763_表現.mp3]
[sound:k-0763_表現.mp3]	expression, presentation; representation, notation<br> <b>表現</b> <br> (ひょうげん)
(<b>自衛隊</b>) 自衛隊は国の安全を守ります。	[sound:s-0764_自衛隊は国の安全を守ります。.mp3] <br> じえいたいはくにのあんぜんをまもります。 <br> The Self-Defense Forces protect the country's security.
	<b>自衛隊</b> <br> 自衛隊は国の安全を守ります。<br><b> じえいたい</b>はくにのあんぜんをまもります <br><b>The Self-Defense Forces</b> protect the country's security.	
表情	[sound:k-0764_表情.mp3]<br>ひょうじょう <br> facial expression
facial expression	<b>表情<b> <br> ひょうじょう <br>[sound:k-0764_表情.mp3]
[sound:k-0764_表情.mp3]	facial expression<br> <b>表情</b> <br> (ひょうじょう)
(<b>自身</b>) 彼は自身の能力を信じています。	[sound:s-0765_彼は自身の能力を信じています。.mp3] <br> かれはじしんののうりょくをしんじています。 <br> He believes in his own abilities.
	<b>自身</b> <br> 彼は自身の能力を信じています。<br> かれは<b>じしん</b>ののうりょくをしんじています <br>He believes in his <b>own</b> abilities.	
表明	[sound:k-0765_表明.mp3]<br>ひょうめい <br> declaration, indication, representation, manifestation, demonstration, expression, announcement, assertion
declaration, indication, representation, manifestation, demonstration, expression, announcement, assertion	<b>表明<b> <br> ひょうめい <br>[sound:k-0765_表明.mp3]
[sound:k-0765_表明.mp3]	declaration, indication, representation, manifestation, demonstration, expression, announcement, assertion<br> <b>表明</b> <br> (ひょうめい)
(<b>自然</b>) 自然の美しさに感動しました。	[sound:s-0766_自然の美しさに感動しました。.mp3] <br> しぜんのうつくしさにかんどうしました。 <br> I was impressed by the beauty of nature.
[sound:s-0756_彼らは軍事的な問題に対処しています。.mp3]	<b>自然</b> <br> 自然の美しさに感動しました。<br><b> しぜん</b>のうつくしさにかんどうしました <br>I was impressed by the beauty of <b>nature</b>.	
表れ	[sound:k-0766_表れ.mp3]<br>あらわれ <br> embodiment, manifestation, materialization, materialisation, expression, indication
embodiment, manifestation, materialization, materialisation, expression, indication	<b>表れ<b> <br> あらわれ <br>[sound:k-0766_表れ.mp3]
[sound:k-0766_表れ.mp3]	embodiment, manifestation, materialization, materialisation, expression, indication<br> <b>表れ</b> <br> (あらわれ)
(<b>自宅</b>) 彼は自宅で家族と過ごします。	[sound:s-0767_彼は自宅で家族と過ごします。.mp3] <br> かれはじたくでかぞくとすごします。 <br> He spends time with his family at home.
[sound:s-0757_彼女は忙しい仕事をしています。.mp3]	<b>自宅</b> <br> 彼は自宅で家族と過ごします。<br> かれは<b>じたく</b>でかぞくとすごします <br>He spends time with his family at <b>home</b>.	
表示	[sound:k-0767_表示.mp3]<br>ひょうじ <br> indication, expression, display, presentation
indication, expression, display, presentation	<b>表示<b> <br> ひょうじ <br>[sound:k-0767_表示.mp3]
[sound:k-0767_表示.mp3]	indication, expression, display, presentation<br> <b>表示</b> <br> (ひょうじ)
(<b>自動車</b>) 彼は自動車のエンジンを修理しました。	[sound:s-0768_彼は自動車のエンジンを修理しました。.mp3] <br> かれはじどうしゃのエンジンをしゅうりしました。 <br> He repaired the engine of the car.
[sound:s-0758_その会社は新しい事業を開始しました。.mp3]	<b>自動車</b> <br> 彼は自動車のエンジンを修理しました。<br> かれは<b>じどうしゃ</b>のエンジンをしゅうりしました <br>He repaired the engine of the <b>car</b>.	
表面	[sound:k-0768_表面.mp3]<br>ひょうめん <br> surface, outside, face, appearance
surface, outside, face, appearance	<b>表面<b> <br> ひょうめん <br>[sound:k-0768_表面.mp3]
[sound:k-0768_表面.mp3]	surface, outside, face, appearance<br> <b>表面</b> <br> (ひょうめん)
(<b>自分</b>) 自分の意見を持つことが大切です。	[sound:s-0769_自分の意見を持つことが大切です。.mp3] <br> じぶんのいけんをもつことがたいせつです。 <br> It is important to have your own opinion.
[sound:s-0759_その事件は大きな関心を呼びました。.mp3]	<b>自分</b> <br> 自分の意見を持つことが大切です。<br><b> じぶん</b>のいけんをもつことがたいせつです <br>It is important to have your <b>own</b> opinion.	
公表	[sound:k-0769_公表.mp3]<br>こうひょう <br> official announcement, proclamation
official announcement, proclamation	<b>公表<b> <br> こうひょう <br>[sound:k-0769_公表.mp3]
[sound:k-0769_公表.mp3]	official announcement, proclamation<br> <b>公表</b> <br> (こうひょう)
(<b>自由</b>) 彼は自由な時間を楽しんでいます。	[sound:s-0770_彼は自由な時間を楽しんでいます。.mp3] <br> かれはじゆうなじかんをたのしんでいます。 <br> He enjoys his free time.
[sound:s-0760_彼は車の事故で負傷しました。.mp3]	<b>自由</b> <br> 彼は自由な時間を楽しんでいます。<br> かれは<b>じゆう</b>なじかんをたのしんでいます <br>He enjoys his <b>free</b> time.	
戦い	[sound:k-0770_戦い.mp3]<br>たたかい <br> battle, fight, struggle, conflict
battle, fight, struggle, conflict	<b>戦い<b> <br> たたかい <br>[sound:k-0770_戦い.mp3]
[sound:k-0770_戦い.mp3]	battle, fight, struggle, conflict<br> <b>戦い</b> <br> (たたかい)
(<b>自民党</b>) 自民党は政権を維持しました。	[sound:s-0771_自民党は政権を維持しました。.mp3] <br> じみんとうはせいけんをいじしました。 <br> The Liberal Democratic Party maintained power.
[sound:s-0761_その話は事実とは異なります。.mp3]	<b>自民党</b> <br> 自民党は政権を維持しました。<br><b> じみんとう</b>はせいけんをいじしました <br><b>The Liberal Democratic Party</b> maintained power.	
戦争	[sound:k-0771_戦争.mp3]<br>せんそう <br> war
war	<b>戦争<b> <br> せんそう <br>[sound:k-0771_戦争.mp3]
[sound:k-0771_戦争.mp3]	war<br> <b>戦争</b> <br> (せんそう)
(<b>自民</b>) 自民党は国政に影響を与えています。	[sound:s-0772_自民党は国政に影響を与えています。.mp3] <br> じみんとうはこくせいにえいきょうをあたえています。 <br> The Liberal Democratic Party has influence on national politics.
[sound:s-0762_彼女は自分の事情を説明しました。.mp3]	<b>自民</b> <br> 自民党は国政に影響を与えています。<br><b> じみんとう</b>はこくせいにえいきょうをあたえています <br><b>The Liberal Democratic Party</b> has influence on national politics.	
戦後	[sound:k-0772_戦後.mp3]<br>せんご <br> postwar period, period after Second World War
postwar period, period after Second World War	<b>戦後<b> <br> せんご <br>[sound:k-0772_戦後.mp3]
[sound:k-0772_戦後.mp3]	postwar period, period after Second World War<br> <b>戦後</b> <br> (せんご)
(<b>行う</b>) 彼らは毎年フェスティバルを行います。	[sound:s-0773_彼らは毎年フェスティバルを行います。.mp3] <br> かれらはまいねんフェスティバルをおこないます。 <br> They hold a festival every year.
[sound:s-0763_彼は問題を解決するために自ら行動しました。.mp3]	<b>行う</b> <br> 彼らは毎年フェスティバルを行います。<br> かれらはまいねんフェスティバルを<b>おこない</b>ます <br>They <b>hold</b> a festival every year.	
作戦	[sound:k-0773_作戦.mp3]<br>さくせん <br> tactics, strategy; military or naval operations
tactics, strategy; military or naval operations	<b>作戦<b> <br> さくせん <br>[sound:k-0773_作戦.mp3]
[sound:k-0773_作戦.mp3]	tactics, strategy; military or naval operations<br> <b>作戦</b> <br> (さくせん)
(<b>行</b>) 駅まで行くのに電車を利用します。	[sound:s-0774_駅まで行くのに電車を利用します。.mp3] <br> えきまでいくのにでんしゃをりようします。 <br> I use the train to go to the station.
[sound:s-0764_自衛隊は国の安全を守ります。.mp3]	<b>行</b> <br> 駅まで行くのに電車を利用します。<br> えきまで<b>いく</b>のにでんしゃをりようします <br>I use the train to <b>go</b> to the station.	
戦闘	[sound:k-0774_戦闘.mp3]<br>せんとう <br> battle, fight, combat
battle, fight, combat	<b>戦闘<b> <br> せんとう <br>[sound:k-0774_戦闘.mp3]
[sound:k-0774_戦闘.mp3]	battle, fight, combat<br> <b>戦闘</b> <br> (せんとう)
(<b>銀行</b>) 彼は銀行で働いています。	[sound:s-0775_彼は銀行で働いています。.mp3] <br> かれはぎんこうではたらいています。 <br> He works at the bank.
[sound:s-0765_彼は自身の能力を信じています。.mp3]	<b>銀行</b> <br> 彼は銀行で働いています。<br> かれは<b>ぎんこう</b>ではたらいています <br>He works at the <b>bank</b>.	
戦略	[sound:k-0775_戦略.mp3]<br>せんりゃく <br> strategy, tactics
strategy, tactics	<b>戦略<b> <br> せんりゃく <br>[sound:k-0775_戦略.mp3]
[sound:k-0775_戦略.mp3]	strategy, tactics<br> <b>戦略</b> <br> (せんりゃく)
(<b>行政</b>) 行政手続きはオンラインで行われます。	[sound:s-0776_行政手続きはオンラインで行われます。.mp3] <br> ぎょうせいてつづきはオンラインでおこなわれます。 <br> Administrative procedures are conducted online.
[sound:s-0766_自然の美しさに感動しました。.mp3]	<b>行政</b> <br> 行政手続きはオンラインで行われます。<br><b> ぎょうせい</b>てつづきはオンラインでおこなわれます <br><b>Administrative</b> procedures are conducted online.	
停戦	[sound:k-0776_停戦.mp3]<br>ていせん <br> armistice, ceasefire
armistice, ceasefire	<b>停戦<b> <br> ていせん <br>[sound:k-0776_停戦.mp3]
[sound:k-0776_停戦.mp3]	armistice, ceasefire<br> <b>停戦</b> <br> (ていせん)
(<b>行動</b>) 彼の行動は周囲に影響を与えます。	[sound:s-0777_彼の行動は周囲に影響を与えます。.mp3] <br> かれのこうどうはしゅういにえいきょうをあたえます。 <br> His actions influence
[sound:s-0767_彼は自宅で家族と過ごします。.mp3]	<b>行動</b> <br> 彼の<b>行動</b>は<i>周囲</i>に影響を与えます。<br> かれの<b>こうどう</b>は<i>しゅうい</i>にえいきょうをあたえます <br>His <b>actions</b> affect those <i>around</i> him.	
冷戦	[sound:k-0777_冷戦.mp3]<br>れいせん <br> cold war
cold war	<b>冷戦<b> <br> れいせん <br>[sound:k-0777_冷戦.mp3]
[sound:k-0777_冷戦.mp3]	cold war<br> <b>冷戦</b> <br> (れいせん)
 those around him.		s-0778_現行の法律に従ってください。.mp3
[sound:s-0768_彼は自動車のエンジンを修理しました。.mp3]	 those around him.	
回戦	[sound:k-0778_回戦.mp3]<br>かいせん <br> match, game
match, game	<b>回戦<b> <br> かいせん <br>[sound:k-0778_回戦.mp3]
[sound:k-0778_回戦.mp3]	match, game<br> <b>回戦</b> <br> (かいせん)
(<b>現行</b>) 現行の法律に従ってください。	[sound:s-0779_彼の行為は非常に賢明でした。.mp3] <br> げんこうのほうりつにしたがってください。 <br> Please abide by the current laws.
[sound:s-0769_自分の意見を持つことが大切です。.mp3]	<b>行方</b> <br> 彼の行方がわかりません。<br> かれの<b>ゆくえ</b>がわかりません <br>His <b>whereabouts</b>&nbsp;are unknown.	
挑戦	[sound:k-0779_挑戦.mp3]<br>ちょうせん <br> challenge, defiance
challenge, defiance	<b>挑戦<b> <br> ちょうせん <br>[sound:k-0779_挑戦.mp3]
[sound:k-0779_挑戦.mp3]	challenge, defiance<br> <b>挑戦</b> <br> (ちょうせん)
(<b>行為</b>) 彼の行為は非常に賢明でした。	[sound:s-0780_彼の行方がわかりません。.mp3] <br> かれのこういはひじょうにけんめいでした。 <br> His actions were very wise.
[sound:s-0770_彼は自由な時間を楽しんでいます。.mp3]	(<b>立法府</b>) 立法府は国の法律を作る役割を果たしています。<br><b>りっぽうふ</b> は くに の ほうりつ を つくる やくわり を はたしています.<br>The legislative body plays a role in making the country's laws.	
経	[sound:k-0780_経.mp3]<br>きょう <br> sutra, Buddhist scriptures
sutra, Buddhist scriptures	<b>経<b> <br> きょう <br>[sound:k-0780_経.mp3]
[sound:k-0780_経.mp3]	sutra, Buddhist scriptures<br> <b>経</b> <br> (きょう)
(<b>行方</b>) 彼の行方がわかりません。	[sound:s-0781_新聞は毎日発行されます。.mp3] <br> かれのゆくえがわかりません。 <br> His whereabouts are unknown.
[sound:s-0771_自民党は政権を維持しました。.mp3]	(<b>活動</b>) 毎日、彼は活動的な生活を送っています。<br>まいにち、 かれ は <b>かつどう</b>てき な せいかつ を おくっています.<br>Every day, he leads an <b>active</b> life.	
経営	[sound:k-0781_経営.mp3]<br>けいえい <br> management, administration
management, administration	<b>経営<b> <br> けいえい <br>[sound:k-0781_経営.mp3]
[sound:k-0781_経営.mp3]	management, administration<br> <b>経営</b> <br> (けいえい)
(<b>発行</b>) 新聞は毎日発行されます。	[sound:s-0782_立法府は国の法律を作る役割を果たしています。.mp3] <br> しんぶんはまいにちはっこうされます。 <br> Newspapers are published daily.
[sound:s-0772_自民党は国政に影響を与えています。.mp3]	<b>活性<br></b>この化学反応は活性が高いです.<br>この かがく はんのう は <b>かっせい</b> が たかい です.<br>This chemical reaction is highly <b>active</b>.	
経済	[sound:k-0782_経済.mp3]<br>けいざい <br> economics, business, finance, economy
economics, business, finance, economy	<b>経済<b> <br> けいざい <br>[sound:k-0782_経済.mp3]
[sound:k-0782_経済.mp3]	economics, business, finance, economy<br> <b>経済</b> <br> (けいざい)
(<b>立法府</b>) 立法府は国の法律を作る役割を果たしています。	[sound:s-0783_毎日、彼は活動的な生活を送っています。.mp3] <br> The legislative body plays a role in making the country's laws.
[sound:s-0773_彼らは毎年フェスティバルを行います。.mp3]	彼はスポーツの世界で<b>活躍</b>しています。<br>He is active in the world of sports.<br><b>活躍</b>:&nbsp;かつやく (esp. energetic), great efforts, conspicuous service<br><br>	
経験	[sound:k-0783_経験.mp3]<br>けいけん <br> experience
experience	<b>経験<b> <br> けいけん <br>[sound:k-0783_経験.mp3]
[sound:k-0783_経験.mp3]	experience<br> <b>経験</b> <br> (けいけん)
(<b>活動</b>) 毎日、彼は活動的な生活を送っています。	[sound:s-0784_私たちの生活は忙しいですが、充実しています。.mp3] <br> "Every day, he leads an active life."
[sound:s-0774_駅まで行くのに電車を利用します。.mp3]	春は新しい生命の<b>復活</b>の季節です。<br>はる は あたらしい せいめい の <b>ふっかつ </b>の きせつ です.<br>Spring is the season of the <b>revival</b> of new life.	
経営者	[sound:k-0784_経営者.mp3]<br>けいえいしゃ <br> manager, proprietor
manager, proprietor	<b>経営者<b> <br> けいえいしゃ <br>[sound:k-0784_経営者.mp3]
[sound:k-0784_経営者.mp3]	manager, proprietor<br> <b>経営者</b> <br> (けいえいしゃ)
(<b>生活</b>) 私たちの生活は忙しいですが、充実しています。	[sound:s-0785_彼女はとても活発で、常に何かをしています。.mp3] <br> Our life is busy but fulfilling.
[sound:s-0775_彼は銀行で働いています。.mp3]	<b>活用</b><br>彼は新しい技術を活用しています。<br>かれ は あたらしい ぎじゅつ を <b>かつよう</b> しています.<br>He is <b>utilizing</b> new technology.	
経団連	[sound:k-0785_経団連.mp3]<br>けいだんれん <br> Federation of Economic Organizations (Organisation)
Federation of Economic Organizations (Organisation)	<b>経団連<b> <br> けいだんれん <br>[sound:k-0785_経団連.mp3]
[sound:k-0785_経団連.mp3]	Federation of Economic Organizations<br> <b>Organisation) (経団連</b> <br> (けいだんれん)
(<b>活発</b>) 彼女はとても活発で、常に何かをしています。	[sound:s-0786_この化学反応は活性が高いです。.mp3] <br> She is very lively and always doing something.
[sound:s-0776_行政手続きはオンラインで行われます。.mp3]	(<b>活用</b>) 彼は新しい技術を活用しています。<br>かれ は あたらしい ぎじゅつ を <b>かつよう</b> しています.<br>He is <b>utilizing</b> new technology. <br>	
経費	[sound:k-0786_経費.mp3]<br>けいひ <br> expenses, cost, outlay
expenses, cost, outlay	<b>経費<b> <br> けいひ <br>[sound:k-0786_経費.mp3]
[sound:k-0786_経費.mp3]	expenses, cost, outlay<br> <b>経費</b> <br> (けいひ)
(<b>活性</b>) この化学反応は活性が高いです。	[sound:s-0787_彼はスポーツの世界で活躍しています。.mp3] <br> This chemical reaction is highly active.
[sound:s-0777_彼の行動は周囲に影響を与えます。.mp3]	<b>活動家<br>かつどうか</b><br>彼は<i>環境</i><b>活動家</b>として知られています。<br>かれ は <i>かんきょう</i> <b>かつどうか </b>として しられています.<br>He is known as an <i>environmental</i> <b>activist</b>.	
経緯	[sound:k-0787_経緯.mp3]<br>けいい, いきさつ <br> details, whole story, sequence of events, chronology, particulars, how it started, how things got this way; complications, position
details, whole story, sequence of events, chronology, particulars, how it started, how things got this way; complications, position	<b>経緯<b> <br> けいい, いきさつ <br>[sound:k-0787_経緯.mp3]
[sound:k-0787_経緯.mp3]	details, whole story, sequence of events, chronology, particulars, how it started, how things got this way; complications, position<br> <b>経緯</b> <br> (けいい, いきさつ)
(<b>活躍</b>) 彼はスポーツの世界で活躍しています。	[sound:s-0788_春は新しい生命の復活の季節です。.mp3] <br> He is active in the world of sports.
[sound:s-0778_現行の法律に従ってください。.mp3]	(<b>活動家</b>) 彼は環境活動家として知られています。 <br>He is known as an environmental <b>activist</b>. <br>	
経済的	[sound:k-0788_経済的.mp3]<br>けいざいてき <br> economic, economical
economic, economical	<b>経済的<b> <br> けいざいてき <br>[sound:k-0788_経済的.mp3]
[sound:k-0788_経済的.mp3]	economic, economical<br> <b>経済的</b> <br> (けいざいてき)
(<b>復活</b>) 春は新しい生命の復活の季節です。	[sound:s-0789_彼は新しい技術を活用しています。.mp3] <br> Spring is the season of the revival of new life.
[sound:s-0779_彼の行為は非常に賢明でした。.mp3]	(<b>食生活</b>) 健康的な食生活を送ることは重要です。<br>けんこうてきな<b>しょくせいかつ</b>をおくることはじゅうようです<br>It is important to maintain a healthy <b>diet</b>. <br>	
経常	[sound:k-0789_経常.mp3]<br>けいじょう <br> ordinary
ordinary	<b>経常<b> <br> けいじょう <br>[sound:k-0789_経常.mp3]
[sound:k-0789_経常.mp3]	ordinary<br> <b>経常</b> <br> (けいじょう)
(<b>活用</b>) 彼は新しい技術を活用しています。	[sound:s-0790_運動は身体に活力を与えます。.mp3] <br> He is utilizing new technology.
[sound:s-0780_彼の行方がわかりません。.mp3]	(<b>原因</b>) 事故の原因はまだ調査中です。<br>じこの<b>げんいん</b>はまだちょうさちゅうです<br>The <b>cause</b> of the accident is still under investigation. <br>	
通り	[sound:k-0790_通り.mp3]<br>どおり <br> in accordance with ..., following ...; .. Street, .. Avenue
in accordance with ..., following ...; .. Street, .. Avenue	<b>通り<b> <br> どおり <br>[sound:k-0790_通り.mp3]
[sound:k-0790_通り.mp3]	in accordance with ..., following ...; .. Street, .. Avenue<br> <b>通り</b> <br> (どおり)
(<b>活力</b>) 運動は身体に活力を与えます。	[sound:s-0791_彼は環境活動家として知られています。.mp3] <br> Exercise gives vitality to the body.
[sound:s-0781_新聞は毎日発行されます。.mp3]	(<b>原則</b>) 彼は常に正しい原則に従って行動します。<br>かれはつねにただしい<b>げんそく</b>にしたがってこうどうします<br>He always acts according to the right <b>principles</b>. <br>	
通信	[sound:k-0791_通信.mp3]<br>つうしん <br> correspondence, communication, transmission, news, signal
correspondence, communication, transmission, news, signal	<b>通信<b> <br> つうしん <br>[sound:k-0791_通信.mp3]
[sound:k-0791_通信.mp3]	correspondence, communication, transmission, news, signal<br> <b>通信</b> <br> (つうしん)
(<b>活動家</b>) 彼は環境活動家として知られています。	[sound:s-0792_健康的な食生活を送ることは重要です。.mp3] <br> He is known as an environmental activist.
[sound:s-0782_立法府は国の法律を作る役割を果たしています。.mp3]	(<b>原子力</b>) 原子力はエネルギー源として使われています。<br><b>げんしりょく</b>はエネルギーげんとしてつかわれています<br><b>Nuclear power</b> is used as an energy source. <br>	
見通し	[sound:k-0792_見通し.mp3]<br>みとおし <br> perspective, unobstructed view, outlook, forecast, prospect, insight, foresight, visibility
perspective, unobstructed view, outlook, forecast, prospect, insight, foresight, visibility	<b>見通し<b> <br> みとおし <br>[sound:k-0792_見通し.mp3]
[sound:k-0792_見通し.mp3]	perspective, unobstructed view, outlook, forecast, prospect, insight, foresight, visibility<br> <b>見通し</b> <br> (みとおし)
(<b>食生活</b>) 健康的な食生活を送ることは重要です。	[sound:s-0793_事故の原因はまだ調査中です。.mp3] <br> It is important to maintain a healthy diet.
[sound:s-0783_毎日、彼は活動的な生活を送っています。.mp3]	(<b>原告</b>) 原告は裁判所に訴えを提出しました。<br><b>げんこく</b>はさいばんしょにうったえをていしゅつしました<br>The <b>plaintiff</b> filed a lawsuit in court. <br>	
共通	[sound:k-0793_共通.mp3]<br>きょうつう <br> commonness, community
commonness, community	<b>共通<b> <br> きょうつう <br>[sound:k-0793_共通.mp3]
[sound:k-0793_共通.mp3]	commonness, community<br> <b>共通</b> <br> (きょうつう)
(<b>原因</b>) 事故の原因はまだ調査中です。	[sound:s-0794_彼は常に正しい原則に従って行動します。.mp3] <br> The cause of the accident is still under investigation.
[sound:s-0784_私たちの生活は忙しいですが、充実しています。.mp3]	(<b>原発</b>) 原発の安全性に関する議論が続いています。<br><b>げんぱつ</b>のあんぜんせいにかんするぎろんがつづいています<br>Debate over the safety of <b>nuclear power plants</b> continues. <br>	
交通	[sound:k-0794_交通.mp3]<br>こうつう <br> communication, transportation, traffic, intercourse
communication, transportation, traffic, intercourse	<b>交通<b> <br> こうつう <br>[sound:k-0794_交通.mp3]
[sound:k-0794_交通.mp3]	communication, transportation, traffic, intercourse<br> <b>交通</b> <br> (こうつう)
(<b>原則</b>) 彼は常に正しい原則に従って行動します。	[sound:s-0795_原子力はエネルギー源として使われています。.mp3] <br> He always acts according to the right principles.
[sound:s-0785_彼女はとても活発で、常に何かをしています。.mp3]	(<b>原油</b>) <br>原油の価格が上昇しています。<br><b>げんゆ</b> の かかく が じょうしょう しています<br>The price of <b>crude oil</b> is rising. <br>	
通貨	[sound:k-0795_通貨.mp3]<br>つうか <br> currency
currency	<b>通貨<b> <br> つうか <br>[sound:k-0795_通貨.mp3]
[sound:k-0795_通貨.mp3]	currency<br> <b>通貨</b> <br> (つうか)
(<b>原子力</b>) 原子力はエネルギー源として使われています。	[sound:s-0796_原告は裁判所に訴えを提出しました。.mp3] <br> Nuclear power is used as an energy source.
[sound:s-0786_この化学反応は活性が高いです。.mp3]	(<b>原理</b>) その機械の動作<b>原理</b>を理解するのは難しいです。<br><b>げんり</b><br>そのきかい の どうさ <b>げんり</b> を りかい する の は むずかしい です。<br>Understanding the operating <b>principles</b> of that machine is difficult. <br>	
通常	[sound:k-0796_通常.mp3]<br>つうじょう <br> common, general, normal, usual
common, general, normal, usual	<b>通常<b> <br> つうじょう <br>[sound:k-0796_通常.mp3]
[sound:k-0796_通常.mp3]	common, general, normal, usual<br> <b>通常</b> <br> (つうじょう)
(<b>原告</b>) 原告は裁判所に訴えを提出しました。	[sound:s-0797_原発の安全性に関する議論が続いています。.mp3] <br> The plaintiff filed a lawsuit in court.
[sound:s-0787_彼はスポーツの世界で活躍しています。.mp3]	(<b>原点</b>) <br>問題の<b>原点</b>を見つけることが重要です。<br>もんだい の <b>げんてん</b> を みつける こと が じゅうよう です。<br>It is important to find the root of the problem. <br>	
普通	[sound:k-0797_普通.mp3]<br>ふつう <br> general, ordinary, usual; normally, generally, usually; train that stops at every station
general, ordinary, usual; normally, generally, usually; train that stops at every station	<b>普通<b> <br> ふつう <br>[sound:k-0797_普通.mp3]
[sound:k-0797_普通.mp3]	general, ordinary, usual; normally, generally, usually; train that stops at every station<br> <b>普通</b> <br> (ふつう)
(<b>原発</b>) 原発の安全性に関する議論が続いています。	[sound:s-0798_原油の価格が上昇しています。.mp3] <br> Debate over the safety of nuclear power plants continues.
[sound:s-0788_春は新しい生命の復活の季節です。.mp3]	(<b>原爆</b>) <br>広島と長崎に<b>原爆</b>が投下されました。<br>ひろしま と ながさき に <b>げんばく</b> が とうかされました<br><b>Atomic bombs</b> were dropped on Hiroshima and Nagasaki. <br>	
通産省	[sound:k-0798_通産省.mp3]<br>つうさんしょう <br> (former) Ministry of International Trade and Industry (now Ministry of Economy, Trade and Industry), MITI
(former) Ministry of International Trade and Industry (now Ministry of Economy, Trade and Industry), MITI	<b>通産省<b> <br> つうさんしょう <br>[sound:k-0798_通産省.mp3]
[sound:k-0798_通産省.mp3]	(former) Ministry of International Trade and Industry<br> <b>now Ministry of Economy, Trade and Industry), MITI (通産省</b> <br> (つうさんしょう)
(<b>原油</b>) 原油の価格が上昇しています。	[sound:s-0799_その機械の動作原理を理解するのは難しいです。.mp3] <br> The price of crude oil is rising.
[sound:s-0789_彼は新しい技術を活用しています。.mp3]	(<b>原案</b>) <br>新しい法案の<b>原案</b>を作成しています。<br>あたらしい ほうあん の <b>げんあん</b> を さくせい しています。<br>We are drafting the <b>original plan</b> for a new bill. <br>	
通算	[sound:k-0799_通算.mp3]<br>つうさん <br> total
total	<b>通算<b> <br> つうさん <br>[sound:k-0799_通算.mp3]
[sound:k-0799_通算.mp3]	total<br> <b>通算</b> <br> (つうさん)
(<b>原理</b>) その機械の動作原理を理解するのは難しいです。	[sound:s-0800_問題の原点を見つけることが重要です。.mp3] <br> Understanding the operating principles of that machine is difficult.
[sound:s-0790_運動は身体に活力を与えます。.mp3]	(<b>先に</b>) <br>彼は私たちよりも<b>先に</b>到着しました。<br>かれ は わたしたち より も <b>さき に</b> とうちゃく しました。<br>He arrived before us. <br>	
外	[sound:k-0800_外.mp3]<br>ほか <br> other (esp. places and things), the rest
other (esp. places and things), the rest	<b>外<b> <br> ほか <br>[sound:k-0800_外.mp3]
[sound:k-0800_外.mp3]	other<br> <b>esp. places and things), the rest (外</b> <br> (ほか)
(<b>原点</b>) 問題の原点を見つけることが重要です。	[sound:s-0801_広島と長崎に原爆が投下されました。.mp3] <br> It is important to find the root of the problem.
[sound:s-0791_彼は環境活動家として知られています。.mp3]	(<b>先月</b>) <br><b>先月</b>は忙しい月でした。<br><b>せんげつ</b> は いそがしい つき でした。<br><b>Last month</b> was a busy month. <br>	
海外	[sound:k-0801_海外.mp3]<br>かいがい <br> foreign, abroad, overseas
foreign, abroad, overseas	<b>海外<b> <br> かいがい <br>[sound:k-0801_海外.mp3]
[sound:k-0801_海外.mp3]	foreign, abroad, overseas<br> <b>海外</b> <br> (かいがい)
(<b>原爆</b>) 広島と長崎に原爆が投下されました。	[sound:s-0802_新しい法案の原案を作成しています。.mp3] <br> Atomic bombs were dropped on Hiroshima and Nagasaki.
[sound:s-0792_健康的な食生活を送ることは重要です。.mp3]	(<b>先進国</b>) <br>日本は<b>先進国</b>の一つです。<br>にほんは<b>せんしんこく</b>のひとつです<br>Japan is one of the <b>advanced countries</b>. <br>	
外交	[sound:k-0802_外交.mp3]<br>がいこう <br> diplomacy
diplomacy	<b>外交<b> <br> がいこう <br>[sound:k-0802_外交.mp3]
[sound:k-0802_外交.mp3]	diplomacy<br> <b>外交</b> <br> (がいこう)
(<b>原案</b>) 新しい法案の原案を作成しています。	[sound:s-0803_彼は私たちよりも先に到着しました。.mp3] <br> We are drafting the original plan for a new bill.
[sound:s-0793_事故の原因はまだ調査中です。.mp3]	(<b>先生</b>) 先生、質問があります。<br>せんせい、しつもんがあります。<br>Teacher, I have a question. <br>	
外国	[sound:k-0803_外国.mp3]<br>がいこく <br> foreign country
foreign country	<b>外国<b> <br> がいこく <br>[sound:k-0803_外国.mp3]
[sound:k-0803_外国.mp3]	foreign country<br> <b>外国</b> <br> (がいこく)
(<b>先に</b>) 彼は私たちよりも先に到着しました。	[sound:s-0804_先月は忙しい月でした。.mp3] <br> He arrived before us.
[sound:s-0794_彼は常に正しい原則に従って行動します。.mp3]	(<b>先発</b>) この薬は先発品です。<br>このくすりは<b>せんぱつ</b>ひんです。<br>This medicine is a <b>brand-name</b> product. <br>	
外国人	[sound:k-0804_外国人.mp3]<br>がいこくじん <br> foreigner
foreigner	<b>外国人<b> <br> がいこくじん <br>[sound:k-0804_外国人.mp3]
[sound:k-0804_外国人.mp3]	foreigner<br> <b>外国人</b> <br> (がいこくじん)
(<b>先月</b>) 先月は忙しい月でした。	[sound:s-0805_日本は先進国の一つです。.mp3] <br> Last month was a busy month.
[sound:s-0795_原子力はエネルギー源として使われています。.mp3]	(<b>優先</b>) <br>安全は<b>優先</b>事項です。<br>あんぜんは<b>ゆうせん</b>じこうです。<br>Safety is a top <b>priority</b>. <br>	
外相	[sound:k-0805_外相.mp3]<br>がいしょう <br> Foreign Minister
Foreign Minister	<b>外相<b> <br> がいしょう <br>[sound:k-0805_外相.mp3]
[sound:k-0805_外相.mp3]	Foreign Minister<br> <b>外相</b> <br> (がいしょう)
(<b>先進国</b>) 日本は先進国の一つです。	[sound:s-0806_先生、質問があります。.mp3] <br> Japan is one of the advanced countries.
[sound:s-0796_原告は裁判所に訴えを提出しました。.mp3]	(<b>先進</b>) <br>彼の国は<b>先進</b>技術を活用しています。<br>かれのくには<b>せんしん</b>ぎじゅつをかつようしています。<br>His country is utilizing <b>advanced</b> technology. <br>	
外務省	[sound:k-0806_外務省.mp3]<br>がいむしょう <br> Ministry of Foreign Affairs
Ministry of Foreign Affairs	<b>外務省<b> <br> がいむしょう <br>[sound:k-0806_外務省.mp3]
[sound:k-0806_外務省.mp3]	Ministry of Foreign Affairs<br> <b>外務省</b> <br> (がいむしょう)
(<b>先生</b>) 先生、質問があります。	[sound:s-0807_この薬は先発品です。.mp3] <br> "Teacher, I have a question."
[sound:s-0797_原発の安全性に関する議論が続いています。.mp3]	(<b>先頭</b>) <br>彼は行列の先頭に立っていました。<br>かれはぎょうれつの<b>せんとう</b>にたっていました。<br>He was at the <b>front</b> of the line. <br>	
外務	[sound:k-0807_外務.mp3]<br>がいむ <br> foreign affairs
foreign affairs	<b>外務<b> <br> がいむ <br>[sound:k-0807_外務.mp3]
[sound:k-0807_外務.mp3]	foreign affairs<br> <b>外務</b> <br> (がいむ)
(<b>先発</b>) この薬は先発品です。	[sound:s-0808_安全は優先事項です。.mp3] <br> This medicine is a brand-name product.
[sound:s-0798_原油の価格が上昇しています。.mp3]	(<b>先行</b>) <br>このプロジェクトは<b>先行</b>しています。<br>このぷろじぇくとは<b>せんこう</b>しています。<br>This project is <b>ahead</b> of schedule. <br>	
内外	[sound:k-0808_内外.mp3]<br>ないがい, うちそと <br> inside and outside, domestic and foreign, approximately, interior and exterior
inside and outside, domestic and foreign, approximately, interior and exterior	<b>内外<b> <br> ないがい, うちそと <br>[sound:k-0808_内外.mp3]
[sound:k-0808_内外.mp3]	inside and outside, domestic and foreign, approximately, interior and exterior<br> <b>内外</b> <br> (ないがい, うちそと)
(<b>優先</b>) 安全は優先事項です。	[sound:s-0809_彼の国は先進技術を活用しています。.mp3] <br> Safety is a top priority.
[sound:s-0799_その機械の動作原理を理解するのは難しいです。.mp3]	(<b>先週</b>) <br><b>先週</b>は忙しかったです。<br><b>せんしゅう</b>は いそがしかった です<br><b>Last week</b> was busy. <br>	
意外	[sound:k-0809_意外.mp3]<br>いがい <br> unexpected, surprising
unexpected, surprising	<b>意外<b> <br> いがい <br>[sound:k-0809_意外.mp3]
[sound:k-0809_意外.mp3]	unexpected, surprising<br> <b>意外</b> <br> (いがい)
(<b>先進</b>) 彼の国は先進技術を活用しています。	[sound:s-0810_彼は行列の先頭に立っていました。.mp3] <br> His country is utilizing advanced technology.
[sound:s-0800_問題の原点を見つけることが重要です。.mp3]	(<b>共産党</b>) <br>その国には<b>共産党</b>があります。<br>そのくには <b>きょうさんとう</b>が あります。<br>There is a <b>communist party</b> in that country. <br>	
最も	[sound:k-0810_最も.mp3]<br>もっとも <br> most, extremely
most, extremely	<b>最も<b> <br> もっとも <br>[sound:k-0810_最も.mp3]
[sound:k-0810_最も.mp3]	most, extremely<br> <b>最も</b> <br> (もっとも)
(<b>先頭</b>) 彼は行列の先頭に立っていました。	[sound:s-0811_このプロジェクトは先行しています。.mp3] <br> He was at the front of the line.
[sound:s-0801_広島と長崎に原爆が投下されました。.mp3]	(<b>共同</b>) <br>彼らは<b>共同</b>でプロジェクトを進めています。<br>かれらは <b>きょうどうで </b>プロジェクトを すすめています。<br>They are working on the project <b>together</b>. <br>	
最近	[sound:k-0811_最近.mp3]<br>さいきん <br> latest, most recent, nowadays
latest, most recent, nowadays	<b>最近<b> <br> さいきん <br>[sound:k-0811_最近.mp3]
[sound:k-0811_最近.mp3]	latest, most recent, nowadays<br> <b>最近</b> <br> (さいきん)
(<b>先行</b>) このプロジェクトは先行しています。	[sound:s-0812_先週は忙しかったです。.mp3] <br> This project is ahead of schedule.
[sound:s-0802_新しい法案の原案を作成しています。.mp3]	(<b>グアテマラ共和国</b>) <br>グアテマラ<b>共和国</b>は中央アメリカに位置しています。<br>ぐあてまら<b>きょうわこく</b>は ちゅうおうあめりかに いちしています。<br>The <b>Republic</b> of Guatemala is located in Central America. <br>	
最後	[sound:k-0812_最後.mp3]<br>さいご <br> last, end, conclusion; (after -tara form or -ta form followed by "ga") no sooner than, right after (often having negative consequences); one's final moments
last, end, conclusion; (after -tara form or -ta form followed by "ga") no sooner than, right after (often having negative consequences); one's final moments	<b>最後<b> <br> さいご <br>[sound:k-0812_最後.mp3]
[sound:k-0812_最後.mp3]	last, end, conclusion;<br> <b>after -tara form or -ta form followed by "ga") no sooner than, right after (often having negative consequences); one's final moments (最後</b> <br> (さいご)
(<b>先週</b>) 先週は忙しかったです。	[sound:s-0813_その国には共産党があります。.mp3] <br> Last week was busy.
[sound:s-0803_彼は私たちよりも先に到着しました。.mp3]	(<b>共に</b>) <br>彼は友人と<b>共に</b>旅行に行きました。<br>かれは ゆうじんと <b>ともに</b> りょこうに いきました。<br>He went on a trip <b>with</b> friends. <br>	
最高	[sound:k-0813_最高.mp3]<br>さいこう <br> highest, supreme, the most
highest, supreme, the most	<b>最高<b> <br> さいこう <br>[sound:k-0813_最高.mp3]
[sound:k-0813_最高.mp3]	highest, supreme, the most<br> <b>最高</b> <br> (さいこう)
(<b>共産党</b>) その国には共産党があります。	[sound:s-0814_彼らは共同でプロジェクトを進めています。.mp3] <br> There is a communist party in that country.
[sound:s-0804_先月は忙しい月でした。.mp3]	(<b>共通</b>) <br>両者の間に共通点が見つかりました。<br>りょうしゃの あいだに <b>きょうつう</b><i>てん</i>が みつかりました。<br><b>Common</b> <i>ground</i> was found between both parties. <br>	
最終	[sound:k-0814_最終.mp3]<br>さいしゅう <br> last, final, closing
last, final, closing	<b>最終<b> <br> さいしゅう <br>[sound:k-0814_最終.mp3]
[sound:k-0814_最終.mp3]	last, final, closing<br> <b>最終</b> <br> (さいしゅう)
(<b>共同</b>) 彼らは共同でプロジェクトを進めています。	[sound:s-0815_グアテマラ共和国は中央アメリカに位置しています。.mp3] <br> They are working on the project together.
[sound:s-0805_日本は先進国の一つです。.mp3]	(<b>共同体</b>) <br>私たちは<b>共同体</b>として協力し合うべきです。<br>わたしたちは<b>きょうどうたい</b>としてきょうりょくしあうべきです。<br>We should cooperate as a <b>community</b>. <br>	
最初	[sound:k-0815_最初.mp3]<br>さいしょ <br> beginning, outset, first, onset
beginning, outset, first, onset	<b>最初<b> <br> さいしょ <br>[sound:k-0815_最初.mp3]
[sound:k-0815_最初.mp3]	beginning, outset, first, onset<br> <b>最初</b> <br> (さいしょ)
(<b>グアテマラ共和国</b>) グアテマラ共和国は中央アメリカに位置しています。	[sound:s-0816_彼は友人と共に旅行に行きました。.mp3] <br> The Republic of Guatemala is located in Central America.
[sound:s-0806_先生、質問があります。.mp3]	(<b>公共</b>) <br><b>公共</b>の場でマナーを守ることが大切です。<br><b>こうきょう</b>のばでまなーをまもることがたいせつです。<br>It's important to observe etiquette in <b>public</b> places. <br>	
最大	[sound:k-0816_最大.mp3]<br>さいだい <br> greatest, largest, maximum
greatest, largest, maximum	<b>最大<b> <br> さいだい <br>[sound:k-0816_最大.mp3]
[sound:k-0816_最大.mp3]	greatest, largest, maximum<br> <b>最大</b> <br> (さいだい)
(<b>共に</b>) 彼は友人と共に旅行に行きました。	[sound:s-0817_両者の間に共通点が見つかりました。.mp3] <br> He went on a trip with friends.
[sound:s-0807_この薬は先発品です。.mp3]	(<b>共和</b>) <br><b>共和</b>国は市民の平等な権利を保障します。<br><b>きょうわ</b>こくはしみんのびょうどうなけんりをほしょうします。<br>A <b>republic</b> guarantees equal rights for its citizens. <br>	
最高裁	[sound:k-0817_最高裁.mp3]<br>さいこうさい <br> Supreme Court
Supreme Court	<b>最高裁<b> <br> さいこうさい <br>[sound:k-0817_最高裁.mp3]
[sound:k-0817_最高裁.mp3]	Supreme Court<br> <b>最高裁</b> <br> (さいこうさい)
(<b>共通</b>) 両者の間に共通点が見つかりました。	[sound:s-0818_私たちは共同体として協力し合うべきです。.mp3] <br> Common ground was found between both parties.
[sound:s-0808_安全は優先事項です。.mp3]	(<b>共産</b>) <br>彼は<b>共産</b>主義者として有名です。<br>かれは<b>きょうさん</b>しゅぎしゃとしてゆうめいです。<br>He is famous as a <b>communist</b>. <br>	
最低	[sound:k-0818_最低.mp3]<br>さいてい <br> least, lowest, worst; nasty, disgusting, horrible, yuck!
least, lowest, worst; nasty, disgusting, horrible, yuck!	<b>最低<b> <br> さいてい <br>[sound:k-0818_最低.mp3]
[sound:k-0818_最低.mp3]	least, lowest, worst; nasty, disgusting, horrible, yuck!<br> <b>最低</b> <br> (さいてい)
(<b>共同体</b>) 私たちは共同体として協力し合うべきです。	[sound:s-0819_公共の場でマナーを守ることが大切です。.mp3] <br> We should cooperate as a community.
[sound:s-0809_彼の国は先進技術を活用しています。.mp3]	(<b>所得</b>) <br>年間<b>所得</b>を確認する必要があります。<br>ねんかん<b>しょとく</b>をかくにんするひつようがあります<br>It is necessary to verify annual <b>income</b>. <br>	
最終的	[sound:k-0819_最終的.mp3]<br>さいしゅうてき <br> finally
finally	<b>最終的<b> <br> さいしゅうてき <br>[sound:k-0819_最終的.mp3]
[sound:k-0819_最終的.mp3]	finally<br> <b>最終的</b> <br> (さいしゅうてき)
(<b>公共</b>) 公共の場でマナーを守ることが大切です。	[sound:s-0820_朝鮮民主主義人民共和国は通常北朝鮮として知られています。.mp3] <br> It's important to observe etiquette in public places.
[sound:s-0810_彼は行列の先頭に立っていました。.mp3]	(<b>得</b>) <br>彼は仕事で多くの経験を<b>得</b>ました。<br>かれはしごとでおおくのけいけんを<b>え</b>ました。<br>He <b>gained</b> a lot of experience at work. <br>	
言わば	[sound:k-0820_言わば.mp3]<br>いわば <br> so to speak, so to call it, as it were
so to speak, so to call it, as it were	<b>言わば<b> <br> いわば <br>[sound:k-0820_言わば.mp3]
[sound:k-0820_言わば.mp3]	so to speak, so to call it, as it were<br> <b>言わば</b> <br> (いわば)
(<b>朝鮮民主主義人民共和国</b>) 	朝鮮民主主義人民共和国は通常北朝鮮として知られています。 <br> 	The Democratic People's Republic of Korea is commonly known as North Korea.
[sound:s-0811_このプロジェクトは先行しています。.mp3]	(<b>所得税</b>) 毎年、所得税を申告する必要があります。<br>まいねん、しょとくぜいをしんこくするひつようがあります。<br>Income tax must be declared every year. <br>	
言う	[sound:k-0821_言う.mp3]<br>いう, ゆう <br> to say; to call (i.e. to give a name)
to say; to call (i.e. to give a name)	<b>言う<b> <br> いう, ゆう <br>[sound:k-0821_言う.mp3]
[sound:k-0821_言う.mp3]	to say; to call<br> <b>i.e. to give a name) (言う</b> <br> (いう, ゆう)
(<b>共和</b>) 共和国は市民の平等な権利を保障します。	[sound:s-0821_共和国は市民の平等な権利を保障します。.mp3] <br> A republic guarantees equal rights for its citizens.
[sound:s-0812_先週は忙しかったです。.mp3]	(<b>得点</b>) 彼はその試合で高得点を獲得しました。<br><div>かれはそのしあいでこうとくてんをかくとくしました。</div>He scored a high point in the game. <br><br>	
言	[sound:k-0822_言.mp3]<br>げん, こと <br> word, remark, statement
word, remark, statement	<b>言<b> <br> げん, こと <br>[sound:k-0822_言.mp3]
[sound:k-0822_言.mp3]	word, remark, statement<br> <b>言</b> <br> (げん, こと)
(<b>共産</b>) 彼は共産主義者として有名です。	[sound:s-0822_彼は共産主義者として有名です。.mp3] <br> He is famous as a communist.
[sound:s-0813_その国には共産党があります。.mp3]	(<b>獲得</b>) 彼は多くの栄誉を獲得しました。<br>かれはおおくのえいよをかくとくしました。<br>He has gained many honors. <br>	
言葉	[sound:k-0823_言葉.mp3]<br>ことば, けとば <br> language, dialect; word, words, phrase, term, expression, remark; speech, (manner of) speaking
language, dialect; word, words, phrase, term, expression, remark; speech, (manner of) speaking	<b>言葉<b> <br> ことば, けとば <br>[sound:k-0823_言葉.mp3]
[sound:k-0823_言葉.mp3]	language, dialect; word, words, phrase, term, expression, remark; speech,<br> <b>manner of) speaking (言葉</b> <br> (ことば, けとば)
(<b>所得</b>) 年間所得を確認する必要があります。	[sound:s-0823_年間所得を確認する必要があります。.mp3] <br> It is necessary to verify annual income.
[sound:s-0814_彼らは共同でプロジェクトを進めています。.mp3]	(<b>説得</b>) 彼女は彼を説得しようとしましたが、うまくいかなかった。<br>かのじょはかれをせっとくしようとしましたが、うまくいかなかった。<br>She tried to persuade him, but it didn't work. <br>	
宣言	[sound:k-0824_宣言.mp3]<br>せんげん <br> declaration, proclamation, announcement
declaration, proclamation, announcement	<b>宣言<b> <br> せんげん <br>[sound:k-0824_宣言.mp3]
[sound:k-0824_宣言.mp3]	declaration, proclamation, announcement<br> <b>宣言</b> <br> (せんげん)
(<b>得</b>) 彼は仕事で多くの経験を得ました。	[sound:s-0824_彼は仕事で多くの経験を得ました。.mp3] <br> He gained a lot of experience at work.
[sound:s-0815_グアテマラ共和国は中央アメリカに位置しています。.mp3]	(<b>得票</b>) 彼は選挙で多くの得票を獲得しました。<br><div>かれはせんきょでおおくのとくひょうをかくとくしました。</div>He garnered many votes in the election. <br><br>	
発言	[sound:k-0825_発言.mp3]<br>はつげん <br> utterance, speech, proposal
utterance, speech, proposal	<b>発言<b> <br> はつげん <br>[sound:k-0825_発言.mp3]
[sound:k-0825_発言.mp3]	utterance, speech, proposal<br> <b>発言</b> <br> (はつげん)
(<b>所得税</b>) 毎年、所得税を申告する必要があります。	[sound:s-0825_毎年、所得税を申告する必要があります。.mp3] <br> まいねん、しょとくぜいをしんこくするひつようがあります。 <br> Income tax must be declared every year.
[sound:s-0816_彼は友人と共に旅行に行きました。.mp3]	(<b>取得</b>) 彼はその資格を取得するのに成功しました。<br>かれはそのしかくをしゅとくするのにせいこうしました。<br>He succeeded in obtaining the qualification. <br>	
証言	[sound:k-0826_証言.mp3]<br>しょうげん <br> evidence, testimony
evidence, testimony	<b>証言<b> <br> しょうげん <br>[sound:k-0826_証言.mp3]
[sound:k-0826_証言.mp3]	evidence, testimony<br> <b>証言</b> <br> (しょうげん)
(<b>得点</b>) 彼はその試合で高得点を獲得しました。	[sound:s-0826_彼はその試合で高得点を獲得しました。.mp3] <br> かれはそのしあいでこうとくてんをかくとくしました。 <br> He scored a high point in the game.
[sound:s-0817_両者の間に共通点が見つかりました。.mp3]	(<b>得意</b>) 彼は数学が得意です。<br>かれはすうがくがとくいです。<br>He is good at mathematics. <br>	
提言	[sound:k-0827_提言.mp3]<br>ていげん <br> proposal, motion
proposal, motion	<b>提言<b> <br> ていげん <br>[sound:k-0827_提言.mp3]
[sound:k-0827_提言.mp3]	proposal, motion<br> <b>提言</b> <br> (ていげん)
(<b>獲得</b>) 彼は多くの栄誉を獲得しました。	[sound:s-0827_彼は多くの栄誉を獲得しました。.mp3] <br> かれはおおくのえいよをかくとくしました。 <br> He has gained many honors.
[sound:s-0818_私たちは共同体として協力し合うべきです。.mp3]	(<b>納得</b>) 彼は最終的に私の提案に納得しました。<br>かれはさいしゅうてきにわたしのていあんになっとくしました。<br>He finally agreed to my proposal. <br>	
言語	[sound:k-0828_言語.mp3]<br>げんご, ごんご <br> language
language	<b>言語<b> <br> げんご, ごんご <br>[sound:k-0828_言語.mp3]
[sound:k-0828_言語.mp3]	language<br> <b>言語</b> <br> (げんご, ごんご)
(<b>説得</b>) 彼女は彼を説得しようとしましたが、うまくいかなかった。	[sound:s-0828_彼女は彼を説得しようとしましたが、うまくいかなかった。.mp3] <br> かのじょはかれをせっとくしようとしましたが、うまくいかなかった。 <br> She tried to persuade him, but it didn't work.
[sound:s-0819_公共の場でマナーを守ることが大切です。.mp3]	(<b>解決</b>) 問題の解決には時間がかかるかもしれません。<br>もんだいのかいけつにはじかんがかかるかもしれません。<br>It may take time to resolve the problem. <br>	
一言	[sound:k-0829_一言.mp3]<br>ひとこと, いちげん, いちごん <br> single word
single word	<b>一言<b> <br> ひとこと, いちげん, いちごん <br>[sound:k-0829_一言.mp3]
[sound:k-0829_一言.mp3]	single word<br> <b>一言</b> <br> (ひとこと, いちげん, いちごん)
(<b>得票</b>) 彼は選挙で多くの得票を獲得しました。	[sound:s-0829_彼は選挙で多くの得票を獲得しました。.mp3] <br> かれはせんきょでおおくのとくひょうをかくとくしました。 <br> He garnered many votes in the election.
[sound:s-0820_朝鮮民主主義人民共和国は通常北朝鮮として知られています。.mp3]	(<b>解散</b>) 国会は解散され、新しい選挙が実施されます。<br>こっかいはかいさんされ、あたらしいせんきょがじっしされます。<br>The parliament is dissolved, and new elections will be held. <br>	
氏	[sound:k-0830_氏.mp3]<br>うじ <br> family name, lineage, birth
family name, lineage, birth	<b>氏<b> <br> うじ <br>[sound:k-0830_氏.mp3]
[sound:k-0830_氏.mp3]	family name, lineage, birth<br> <b>氏</b> <br> (うじ)
(<b>取得</b>) 彼はその資格を取得するのに成功しました。	[sound:s-0830_彼はその資格を取得するのに成功しました。.mp3] <br> かれはそのしかくをしゅとくするのにせいこうしました。 <br> He succeeded in obtaining the qualification.
	(<b>見解</b>) 彼の見解は非常に興味深いです。<br>かれのけんかいはひじょうにきょうみぶかいです<br>His viewpoint is very interesting. <br>	朝鮮民主主義人民共和国は通常北朝鮮として知られています。<br> The Democratic People's Republic of Korea is commonly known as North Korea.
氏名	[sound:k-0831_氏名.mp3]<br>しめい <br> full name, identity
full name, identity	<b>氏名<b> <br> しめい <br>[sound:k-0831_氏名.mp3]
[sound:k-0831_氏名.mp3]	full name, identity<br> <b>氏名</b> <br> (しめい)
(<b>得意</b>) 彼は数学が得意です。	[sound:s-0831_彼は数学が得意です。.mp3] <br> かれはすうがくがとくいです。 <br> He is good at mathematics.
[sound:s-0821_共和国は市民の平等な権利を保障します。.mp3]	(<b>理解</b>) 私たちは互いを理解し合う必要があります。<br>わたしたちはたがいをりかいしあうひつようがあります。<br>We need to understand each other. <br>	
同氏	[sound:k-0832_同氏.mp3]<br>どうし <br> the said person, he, she, same person
the said person, he, she, same person	<b>同氏<b> <br> どうし <br>[sound:k-0832_同氏.mp3]
[sound:k-0832_同氏.mp3]	the said person, he, she, same person<br> <b>同氏</b> <br> (どうし)
(<b>納得</b>) 彼は最終的に私の提案に納得しました。	[sound:s-0832_彼は最終的に私の提案に納得しました。.mp3] <br> かれはさいしゅうてきにわたしのていあんになっとくしました。 <br> He finally agreed to my proposal.
[sound:s-0822_彼は共産主義者として有名です。.mp3]	(<b>解除</b>) 契約が解除されました。<br>けいやくがかいじょされました。<br>The contract has been terminated. <br>	
両氏	[sound:k-0833_両氏.mp3]<br>りょうし <br> both persons
both persons	<b>両氏<b> <br> りょうし <br>[sound:k-0833_両氏.mp3]
[sound:k-0833_両氏.mp3]	both persons<br> <b>両氏</b> <br> (りょうし)
(<b>解決</b>) 問題の解決には時間がかかるかもしれません。	[sound:s-0833_問題の解決には時間がかかるかもしれません。.mp3] <br> もんだいのかいけつにはじかんがかかるかもしれません。 <br> It may take time to resolve the problem.
[sound:s-0823_年間所得を確認する必要があります。.mp3]	(<b>解放</b>) 彼は捕虜としての身分を解放されました。<br>かれはほりょとしてのみぶんをかいほうされました。<br>He was released from captivity. <br>	
源氏	[sound:k-0834_源氏.mp3]<br>げんじ <br> Genji (the character in the Genji Monogatari); the Minamoto family
Genji (the character in the Genji Monogatari); the Minamoto family	<b>源氏<b> <br> げんじ <br>[sound:k-0834_源氏.mp3]
[sound:k-0834_源氏.mp3]	Genji<br> <b>the character in the Genji Monogatari); the Minamoto family (源氏</b> <br> (げんじ)
(<b>解散</b>) 国会は解散され、新しい選挙が実施されます。	[sound:s-0834_国会は解散され、新しい選挙が実施されます。.mp3] <br> こっかいはかいさんされ、あたらしいせんきょがじっしされます。 <br> The parliament is dissolved, and new elections will be held.
[sound:s-0824_彼は仕事で多くの経験を得ました。.mp3]	(<b>解明</b>) 事件の真相を解明するために捜査が行われました。<br>じけんのしんそうをかいめいするためにそうさがおこなわれました。Investigation was conducted to clarify the truth of the incident. <br>	
氏族	[sound:k-0835_氏族.mp3]<br>しぞく <br> clan, family
clan, family	<b>氏族<b> <br> しぞく <br>[sound:k-0835_氏族.mp3]
[sound:k-0835_氏族.mp3]	clan, family<br> <b>氏族</b> <br> (しぞく)
(<b>見解</b>) 彼の見解は非常に興味深いです。	[sound:s-0835_彼の見解は非常に興味深いです。.mp3] <br> かれのけんかいはひじょうにきょうみぶかいです。 <br> His viewpoint is very interesting.
[sound:s-0825_毎年、所得税を申告する必要があります。.mp3]	(<b>和解</b>) 双方は和解に達しました。<br>そうほうはわかいにたっしました。<br>Both parties reached a settlement. <br>	
氏子	[sound:k-0836_氏子.mp3]<br>うじこ <br> shrine parishioner
shrine parishioner	<b>氏子<b> <br> うじこ <br>[sound:k-0836_氏子.mp3]
[sound:k-0836_氏子.mp3]	shrine parishioner<br> <b>氏子</b> <br> (うじこ)
(<b>理解</b>) 私たちは互いを理解し合う必要があります。	[sound:s-0836_私たちは互いを理解し合う必要があります。.mp3] <br> わたしたちはたがいをりかいしあうひつようがあります。 <br> We need to understand each other.
[sound:s-0826_彼はその試合で高得点を獲得しました。.mp3]	(<b>解消</b>) この問題は早急に解消しなければなりません。<br>このもんだいはそうきゅうにかいしょうしなければなりません。<br>This issue must be resolved promptly. <br>	
彼氏	[sound:k-0837_彼氏.mp3]<br>かれし <br> boyfriend
boyfriend	<b>彼氏<b> <br> かれし <br>[sound:k-0837_彼氏.mp3]
[sound:k-0837_彼氏.mp3]	boyfriend<br> <b>彼氏</b> <br> (かれし)
(<b>解除</b>) 契約が解除されました。	[sound:s-0837_契約が解除されました。.mp3] <br> けいやくがかいじょされました。 <br> The contract has been terminated.
[sound:s-0827_彼は多くの栄誉を獲得しました。.mp3]	(<b>解説</b>) 彼は新製品の解説を行いました。<br>かれはしんせいひんのかいせつをおこないました。<br>He provided an explanation of the new product. <br>	
氏	[sound:k-0838_氏.mp3]<br>し <br> Mr; clan; he, him; Mr; counter for people
Mr; clan; he, him; Mr; counter for people	<b>氏<b> <br> し <br>[sound:k-0838_氏.mp3]
[sound:k-0838_氏.mp3]	Mr; clan; he, him; Mr; counter for people<br> <b>氏</b> <br> (し)
(<b>解放</b>) 彼は捕虜としての身分を解放されました。	[sound:s-0838_彼は捕虜としての身分を解放されました。.mp3] <br> かれはほりょとしてのみぶんをかいほうされました。 <br> He was released from captivity.
[sound:s-0828_彼女は彼を説得しようとしましたが、うまくいかなかった。.mp3]	(<b>名</b>) 彼はその場所の有名な人物です。<br>かれはそのばしょのゆうめいなじんぶつです。<br>He is a famous figure in that place. <br>	
氏神	[sound:k-0839_氏神.mp3]<br>うじがみ <br> Shinto god, patron god
Shinto god, patron god	<b>氏神<b> <br> うじがみ <br>[sound:k-0839_氏神.mp3]
[sound:k-0839_氏神.mp3]	Shinto god, patron god<br> <b>氏神</b> <br> (うじがみ)
(<b>解明</b>) 事件の真相を解明するために捜査が行われました。	[sound:s-0839_事件の真相を解明するために捜査が行われました。.mp3] <br> じけんのしんそうをかいめいするためにそうさがおこなわれました。 <br> Investigation was conducted to clarify the truth of the incident.
[sound:s-0829_彼は選挙で多くの得票を獲得しました。.mp3]	(<b>名前</b>) 彼女の名前は花子です。<br>かのじょのなまえははなこです。<br>Her name is Hanako. <br>	
現在	[sound:k-0840_現在.mp3]<br>げんざい <br> now, current, present, present time, as of
now, current, present, present time, as of	<b>現在<b> <br> げんざい <br>[sound:k-0840_現在.mp3]
[sound:k-0840_現在.mp3]	now, current, present, present time, as of<br> <b>現在</b> <br> (げんざい)
(<b>和解</b>) 双方は和解に達しました。	[sound:s-0840_双方は和解に達しました。.mp3] <br> そうほうはわかいにたっしました。 <br> Both parties reached a settlement.
[sound:s-0830_彼はその資格を取得するのに成功しました。.mp3]	(<b>取得</b>) 彼はその資格を取得するのに成功しました。<br> かれはそのしかくをしゅとくするのにせいこうしました。  He succeeded in obtaining the qualification.	
現実	[sound:k-0841_現実.mp3]<br>げんじつ <br> reality
reality	<b>現実<b> <br> げんじつ <br>[sound:k-0841_現実.mp3]
[sound:k-0841_現実.mp3]	reality<br> <b>現実</b> <br> (げんじつ)
(<b>解消</b>) この問題は早急に解消しなければなりません。	[sound:s-0841_この問題は早急に解消しなければなりません。.mp3] <br> このもんだいはそうきゅうにかいしょうしなければなりません。 <br> This issue must be resolved promptly.
[sound:s-0831_彼は数学が得意です。.mp3]	(<b>得意</b>) 彼は数学が得意です。<br> かれはすうがくがとくいです。  He is good at mathematics.	
現場	[sound:k-0842_現場.mp3]<br>げんば, げんじょう <br> actual spot, scene, scene of the crime
actual spot, scene, scene of the crime	<b>現場<b> <br> げんば, げんじょう <br>[sound:k-0842_現場.mp3]
[sound:k-0842_現場.mp3]	actual spot, scene, scene of the crime<br> <b>現場</b> <br> (げんば, げんじょう)
(<b>解説</b>) 彼は新製品の解説を行いました。	[sound:s-0842_彼は新製品の解説を行いました。.mp3] <br> かれはしんせいひんのかいせつをおこないました。 <br> He provided an explanation of the new product.
[sound:s-0832_彼は最終的に私の提案に納得しました。.mp3]	(<b>納得</b>) 彼は最終的に私の提案に納得しました。<br> かれはさいしゅうてきにわたしのていあんになっとくしました。  He finally agreed to my proposal.	
現地	[sound:k-0843_現地.mp3]<br>げんち <br> actual place, local
actual place, local	<b>現地<b> <br> げんち <br>[sound:k-0843_現地.mp3]
[sound:k-0843_現地.mp3]	actual place, local<br> <b>現地</b> <br> (げんち)
(<b>名</b>) 彼はその場所の有名な人物です。	[sound:s-0843_彼はその場所の有名な人物です。.mp3] <br> かれはそのばしょのゆうめいなじんぶつです。 <br> He is a famous figure in that place.
[sound:s-0833_問題の解決には時間がかかるかもしれません。.mp3]	(<b>解決</b>) 問題の解決には時間がかかるかもしれません。<br> もんだいのかいけつにはじかんがかかるかもしれません。  It may take time to resolve the problem.	
現行	[sound:k-0844_現行.mp3]<br>げんこう <br> present, current, in operation
present, current, in operation	<b>現行<b> <br> げんこう <br>[sound:k-0844_現行.mp3]
[sound:k-0844_現行.mp3]	present, current, in operation<br> <b>現行</b> <br> (げんこう)
(<b>名前</b>) 彼女の名前は花子です。	[sound:s-0844_彼女の名前は花子です。.mp3] <br> かのじょのなまえははなこです。 <br> Her name is Hanako.
[sound:s-0834_国会は解散され、新しい選挙が実施されます。.mp3]	(<b>解散</b>) 国会は解散され、新しい選挙が実施されます。<br> こっかいはかいさんされ、あたらしいせんきょがじっしされます。  The parliament is dissolved	
現状	[sound:k-0845_現状.mp3]<br>げんじょう <br> present condition, existing state, status quo
present condition, existing state, status quo	<b>現状<b> <br> げんじょう <br>[sound:k-0845_現状.mp3]
