[sound:k-2254_昨春.mp3]	last spring, the spring of last year<br> <b>昨春</b> <br> (さくしゅん)
(<b>与党</b>) 与党は選挙に勝利した。	[sound:s-2254_与党は選挙に勝利した。.mp3] <br> よとうはせんきょにしょうりした。 <br> The ruling party won the election.
[sound:s-2244_この土は肥沃です。.mp3]	(<b>土</b>) この土は肥沃です。<br> このつちはひよくです。 <br>This soil is fertile.	
昨日	[sound:k-2255_昨日.mp3]<br>さくじつ, きのう <br> yesterday
yesterday	<b>昨日<b> <br> さくじつ, きのう <br>[sound:k-2255_昨日.mp3]
[sound:k-2255_昨日.mp3]	yesterday<br> <b>昨日</b> <br> (さくじつ, きのう)
(<b>与野党</b>) 与野党は意見を交わした。	[sound:s-2255_与野党は意見を交わした。.mp3] <br> よやとうはいけんをかわした。 <br> The ruling and opposition parties exchanged views.
[sound:s-2245_彼は自分の土地に家を建てた。.mp3]	(<b>土地</b>) 彼は自分の土地に家を建てた。<br> かれはじぶんのとちにいえをたてた。 <br>He built a house on his own land.	
昨今	[sound:k-2256_昨今.mp3]<br>さっこん, さくこん <br> nowadays, recently
nowadays, recently	<b>昨今<b> <br> さっこん, さくこん <br>[sound:k-2256_昨今.mp3]
[sound:k-2256_昨今.mp3]	nowadays, recently<br> <b>昨今</b> <br> (さっこん, さくこん)
(<b>関与</b>) 彼はその計画に関与している。	[sound:s-2256_彼はその計画に関与している。.mp3] <br> かれはそのけいかくにかんよしている。 <br> He is involved in the project.
[sound:s-2246_その国は領土を拡大した。.mp3]	(<b>領土</b>) その国は領土を拡大した。<br> そのくにはりょうどをかくだいした。 <br>The country expanded its territory.	
昨年来	[sound:k-2257_昨年来.mp3]<br>さくねんらい <br> since last year
since last year	<b>昨年来<b> <br> さくねんらい <br>[sound:k-2257_昨年来.mp3]
[sound:k-2257_昨年来.mp3]	since last year<br> <b>昨年来</b> <br> (さくねんらい)
(<b>給与</b>) その企業は給与水準が高い。	[sound:s-2257_その企業は給与水準が高い。.mp3] <br> そのきぎょうはきゅうよすいじゅんがたかい。 <br> The company has high salary levels.
[sound:s-2247_土曜日には友達と遊ぶ予定です。.mp3]	(<b>土曜</b>) 土曜日には友達と遊ぶ予定です。<br> どようびにはともだちとあそぶよていです。 <br>I have plans to hang out with friends on Saturday.	
昨夜	[sound:k-2258_昨夜.mp3]<br>ゆう, ゆうべ, さくや <br> evening; last night
evening; last night	<b>昨夜<b> <br> ゆう, ゆうべ, さくや <br>[sound:k-2258_昨夜.mp3]
[sound:k-2258_昨夜.mp3]	evening; last night<br> <b>昨夜</b> <br> (ゆう, ゆうべ, さくや)
(<b>供与</b>) その寄付は地域に多くの恩恵を供与した。	[sound:s-2258_その寄付は地域に多くの恩恵を供与した。.mp3] <br> そのきふはちいきにおおくのおんけいをきょうよした。 <br> The donation provided many benefits to the community.
[sound:s-2248_この国土は多様な文化で育まれてきた。.mp3]	(<b>国土</b>) この国土は多様な文化で育まれてきた。<br> このこくどはたようなぶんかではぐまれてきた。 <br>This homeland has been nurtured by diverse cultures.	
昨冬	[sound:k-2259_昨冬.mp3]<br>さくとう <br> last winter
last winter	<b>昨冬<b> <br> さくとう <br>[sound:k-2259_昨冬.mp3]
[sound:k-2259_昨冬.mp3]	last winter<br> <b>昨冬</b> <br> (さくとう)
(<b>投与</b>) 医師は患者に薬を投与した。	[sound:s-2259_医師は患者に薬を投与した。.mp3] <br> いしはかんじゃにくすりをとうよした。 <br> The doctor administered medicine to the patient.
[sound:s-2249_土俵の上で力士が激闘を繰り広げる。.mp3]	(<b>土俵</b>) 土俵の上で力士が激闘を繰り広げる。<br> どひょうのうえでりきしはげきとうをくりひろげる。 <br>Sumo wrestlers engage in fierce battles on the sumo ring.	
論議	[sound:k-2260_論議.mp3]<br>ろんぎ <br> discussion, argument, debate
discussion, argument, debate	<b>論議<b> <br> ろんぎ <br>[sound:k-2260_論議.mp3]
[sound:k-2260_論議.mp3]	discussion, argument, debate<br> <b>論議</b> <br> (ろんぎ)
(<b>付与</b>) 彼は栄誉を彼に付与された。	[sound:s-2260_彼は栄誉を彼に付与された。.mp3] <br> かれはえいよをかれにふよされた。 <br> He was granted an honor.
[sound:s-2250_彼は土木工学を専攻しています。.mp3]	(<b>土木</b>) 彼は土木工学を専攻しています。<br> かれはどぼくこうがくをせんこうしています。 <br>He is majoring in civil engineering.	
議論	[sound:k-2261_議論.mp3]<br>ぎろん <br> argument, discussion, dispute, controversy
argument, discussion, dispute, controversy	<b>議論<b> <br> ぎろん <br>[sound:k-2261_議論.mp3]
[sound:k-2261_議論.mp3]	argument, discussion, dispute, controversy<br> <b>議論</b> <br> (ぎろん)
(<b>参与</b>) 彼はプロジェクトに参与しています。	[sound:s-2261_彼はプロジェクトに参与しています。.mp3] <br> かれはぷろじぇくとにさんよしています。 <br> He is participating in the project.
[sound:s-2251_洪水が全土を覆った。.mp3]	(<b>全土</b>) 洪水が全土を覆った。<br> こうずいがぜんどをおおった。 <br>The flood covered the entire land.	
結論	[sound:k-2262_結論.mp3]<br>けつろん <br> conclusion
conclusion	<b>結論<b> <br> けつろん <br>[sound:k-2262_結論.mp3]
[sound:k-2262_結論.mp3]	conclusion<br> <b>結論</b> <br> (けつろん)
(<b>賞与</b>) その会社は毎年賞与を支給する。	[sound:s-2262_その会社は毎年賞与を支給する。.mp3] <br> そのかいしゃはまいとししょうよをしきゅうする。 <br> The company pays bonuses every year.
[sound:s-2252_土壌の状態が作物の収穫に影響する。.mp3]	(<b>土壌</b>) 土壌の状態が作物の収穫に影響する。<br> どじょうのじょうたいがさくもつのしゅうかくにえいきょうする。 <br>The condition of the soil affects the harvest of crops.	
世論	[sound:k-2263_世論.mp3]<br>せろん, よろん <br> public opinion
public opinion	<b>世論<b> <br> せろん, よろん <br>[sound:k-2263_世論.mp3]
[sound:k-2263_世論.mp3]	public opinion<br> <b>世論</b> <br> (せろん, よろん)
(<b>贈与</b>) 彼は富を子供に贈与した。	[sound:s-2263_彼は富を子供に贈与した。.mp3] <br> かれはとみをこどもにぞうよした。 <br> He bestowed wealth upon his children.
[sound:s-2253_この地域の風土は異なる。.mp3]	(<b>風土</b>) この地域の風土は異なる。<br> このちいきのふうどはことなる。 <br>The climate and culture of this region are different.	
評論家	[sound:k-2264_評論家.mp3]<br>ひょうろんか <br> critic
critic	<b>評論家<b> <br> ひょうろんか <br>[sound:k-2264_評論家.mp3]
[sound:k-2264_評論家.mp3]	critic<br> <b>評論家</b> <br> (ひょうろんか)
(<b>急</b>) 事故が急に起こった。	[sound:s-2264_事故が急に起こった。.mp3] <br> じこがきゅうにおこった。 <br> The accident happened suddenly.
[sound:s-2254_与党は選挙に勝利した。.mp3]	(<b>与党</b>) 与党は選挙に勝利した。<br> よとうはせんきょにしょうりした。 <br>The ruling party won the election.	
論文	[sound:k-2265_論文.mp3]<br>ろんぶん <br> thesis, essay, treatise, paper, article
thesis, essay, treatise, paper, article	<b>論文<b> <br> ろんぶん <br>[sound:k-2265_論文.mp3]
[sound:k-2265_論文.mp3]	thesis, essay, treatise, paper, article<br> <b>論文</b> <br> (ろんぶん)
(<b>急いで</b>) 彼は急いで駅に向かった。	[sound:s-2265_彼は急いで駅に向かった。.mp3] <br> かれはいそいでえきにむかった。 <br> He hurried to the station.
[sound:s-2255_与野党は意見を交わした。.mp3]	(<b>与野党</b>) 与野党は意見を交わした。<br> よやとうはいけんをかわした。 <br>The ruling and opposition parties exchanged views.	
討論	[sound:k-2266_討論.mp3]<br>とうろん <br> debate, discussion
debate, discussion	<b>討論<b> <br> とうろん <br>[sound:k-2266_討論.mp3]
[sound:k-2266_討論.mp3]	debate, discussion<br> <b>討論</b> <br> (とうろん)
(<b>急きょ</b>) 急きょ旅行をキャンセルした。	[sound:s-2266_急きょ旅行をキャンセルした。.mp3] <br> きゅうきょりょこうをきゃんせるした。 <br> I suddenly canceled the trip.
[sound:s-2256_彼はその計画に関与している。.mp3]	(<b>関与</b>) 彼はその計画に関与している。<br> かれはそのけいかくにかんよしている。 <br>He is involved in the project.	
理論	[sound:k-2267_理論.mp3]<br>りろん <br> theory
theory	<b>理論<b> <br> りろん <br>[sound:k-2267_理論.mp3]
[sound:k-2267_理論.mp3]	theory<br> <b>理論</b> <br> (りろん)
(<b>緊急</b>) 緊急の事態が発生した。	[sound:s-2267_緊急の事態が発生した。.mp3] <br> きんきゅうのじたいがはっせいした。 <br> An emergency situation occurred.
[sound:s-2257_その企業は給与水準が高い。.mp3]	(<b>給与</b>) その企業は給与水準が高い。<br> そのきぎょうはきゅうよすいじゅんがたかい。 <br>The company has high salary levels.	
論争	[sound:k-2268_論争.mp3]<br>ろんそう <br> controversy, dispute
controversy, dispute	<b>論争<b> <br> ろんそう <br>[sound:k-2268_論争.mp3]
[sound:k-2268_論争.mp3]	controversy, dispute<br> <b>論争</b> <br> (ろんそう)
(<b>急速</b>) 科学技術の発展は急速だ。	[sound:s-2268_科学技術の発展は急速だ。.mp3] <br> かがくぎじゅつのはってんはきゅうそくだ。 <br> The development of science and technology is rapid.
[sound:s-2258_その寄付は地域に多くの恩恵を供与した。.mp3]	(<b>供与</b>) その寄付は地域に多くの恩恵を供与した。<br> そのきふはちいきにおおくのおんけいをきょうよした。 <br>The donation provided many benefits to the community.	
論理	[sound:k-2269_論理.mp3]<br>ろんり <br> logic; logical
logic; logical	<b>論理<b> <br> ろんり <br>[sound:k-2269_論理.mp3]
[sound:k-2269_論理.mp3]	logic; logical<br> <b>論理</b> <br> (ろんり)
(<b>早急</b>) この問題には早急に対処する必要がある。	[sound:s-2269_この問題には早急に対処する必要がある。.mp3] <br> このもんだいにはさっきゅうにたいしょするひつようがある。 <br> It is urgent to address this issue promptly.
[sound:s-2259_医師は患者に薬を投与した。.mp3]	(<b>投与</b>) 医師は患者に薬を投与した。<br> いしはかんじゃにくすりをとうよした。 <br>The doctor administered medicine to the patient.	
計	[sound:k-2270_計.mp3]<br>けい <br> plan; meter, measuring device; (in) total, total (of)
plan; meter, measuring device; (in) total, total (of)	<b>計<b> <br> けい <br>[sound:k-2270_計.mp3]
[sound:k-2270_計.mp3]	plan; meter, measuring device;<br> <b>in) total, total (of) (計</b> <br> (けい)
(<b>急激</b>) その国では急激な変化が起こった。	[sound:s-2270_その国では急激な変化が起こった。.mp3] <br> そのくにではきゅうげきなへんかがおこった。 <br> Sudden changes occurred in that country.
[sound:s-2260_彼は栄誉を彼に付与された。.mp3]	(<b>付与</b>) 彼は栄誉を彼に付与された。<br> かれはえいよをかれにふよされた。 <br>He was granted an honor.	
計画	[sound:k-2271_計画.mp3]<br>けいかく <br> plan, project, schedule, scheme, program, programme
plan, project, schedule, scheme, program, programme	<b>計画<b> <br> けいかく <br>[sound:k-2271_計画.mp3]
[sound:k-2271_計画.mp3]	plan, project, schedule, scheme, program, programme<br> <b>計画</b> <br> (けいかく)
(<b>急性</b>) 彼は急性の病気にかかった。	[sound:s-2271_彼は急性の病気にかかった。.mp3] <br> かれはきゅうせいのびょうきにかかった。 <br> He contracted an acute illness.
[sound:s-2261_彼はプロジェクトに参与しています。.mp3]	(<b>参与</b>) 彼はプロジェクトに参与しています。<br> かれはぷろじぇくとにさんよしています。 <br>He is participating in the project.	
合計	[sound:k-2272_合計.mp3]<br>ごうけい <br> sum total, total amount
sum total, total amount	<b>合計<b> <br> ごうけい <br>[sound:k-2272_合計.mp3]
[sound:k-2272_合計.mp3]	sum total, total amount<br> <b>合計</b> <br> (ごうけい)
(<b>急進</b>) 彼は急進的な改革を提案した。	[sound:s-2272_彼は急進的な改革を提案した。.mp3] <br> かれはきゅうしんてきなかいかくをていあんした。 <br> He proposed radical reforms.
[sound:s-2262_その会社は毎年賞与を支給する。.mp3]	(<b>賞与</b>) その会社は毎年賞与を支給する。<br> そのかいしゃはまいとししょうよをしきゅうする。 <br>The company pays bonuses every year.	
設計	[sound:k-2273_設計.mp3]<br>せっけい <br> plan, design, layout
plan, design, layout	<b>設計<b> <br> せっけい <br>[sound:k-2273_設計.mp3]
[sound:k-2273_設計.mp3]	plan, design, layout<br> <b>設計</b> <br> (せっけい)
(<b>急増</b>) その地域で感染者が急増している。	[sound:s-2273_その地域で感染者が急増している。.mp3] <br> そのちいきでかんせんしゃがきゅうぞうしている。 <br> There is a rapid increase in infections in that area.
[sound:s-2263_彼は富を子供に贈与した。.mp3]	(<b>贈与</b>) 彼は富を子供に贈与した。<br> かれはとみをこどもにぞうよした。 <br>He bestowed wealth upon his children.	
計算	[sound:k-2274_計算.mp3]<br>けいさん <br> calculation, reckoning, count; forecast
calculation, reckoning, count; forecast	<b>計算<b> <br> けいさん <br>[sound:k-2274_計算.mp3]
[sound:k-2274_計算.mp3]	calculation, reckoning, count; forecast<br> <b>計算</b> <br> (けいさん)
(<b>禁止</b>) この公園では喫煙が禁止されています。	[sound:s-2274_この公園では喫煙が禁止されています。.mp3] <br> このこうえんではきつえんがきんしされています。 <br> Smoking is prohibited in this park.
[sound:s-2264_事故が急に起こった。.mp3]	(<b>急</b>) 事故が急に起こった。<br> じこがきゅうにおこった。 <br>The accident happened suddenly.	
統計	[sound:k-2275_統計.mp3]<br>とうけい <br> statistics
statistics	<b>統計<b> <br> とうけい <br>[sound:k-2275_統計.mp3]
[sound:k-2275_統計.mp3]	statistics<br> <b>統計</b> <br> (とうけい)
(<b>停止</b>) 電車が停止しています。	[sound:s-2275_電車が停止しています。.mp3] <br> でんしゃがていしています。 <br> The train is stopped.
[sound:s-2265_彼は急いで駅に向かった。.mp3]	(<b>急いで</b>) 彼は急いで駅に向かった。<br> かれはいそいでえきにむかった。 <br>He hurried to the station.	
会計	[sound:k-2276_会計.mp3]<br>かいけい <br> account, finance, accountant, treasurer, paymaster, reckoning, bill
account, finance, accountant, treasurer, paymaster, reckoning, bill	<b>会計<b> <br> かいけい <br>[sound:k-2276_会計.mp3]
[sound:k-2276_会計.mp3]	account, finance, accountant, treasurer, paymaster, reckoning, bill<br> <b>会計</b> <br> (かいけい)
(<b>防止</b>) 犯罪の防止に努める。	[sound:s-2276_犯罪の防止に努める。.mp3] <br> はんざいのぼうしにつとめる。 <br> Work to prevent crime.
[sound:s-2266_急きょ旅行をキャンセルした。.mp3]	(<b>急きょ</b>) 急きょ旅行をキャンセルした。<br> きゅうきょりょこうをきゃんせるした。 <br>I suddenly canceled the trip.	
時計	[sound:k-2277_時計.mp3]<br>とけい, ときはかり <br> watch, clock, timepiece
watch, clock, timepiece	<b>時計<b> <br> とけい, ときはかり <br>[sound:k-2277_時計.mp3]
[sound:k-2277_時計.mp3]	watch, clock, timepiece<br> <b>時計</b> <br> (とけい, ときはかり)
(<b>中止</b>) イベントが中止になった。	[sound:s-2277_イベントが中止になった。.mp3] <br> いべんとがちゅうしになった。 <br> The event was canceled.
[sound:s-2267_緊急の事態が発生した。.mp3]	(<b>緊急</b>) 緊急の事態が発生した。<br> きんきゅうのじたいがはっせいした。 <br>An emergency situation occurred.	
集計	[sound:k-2278_集計.mp3]<br>しゅうけい <br> totalization, totalisation, aggregate
totalization, totalisation, aggregate	<b>集計<b> <br> しゅうけい <br>[sound:k-2278_集計.mp3]
[sound:k-2278_集計.mp3]	totalization, totalisation, aggregate<br> <b>集計</b> <br> (しゅうけい)
(<b>廃止</b>) 制度の廃止が議論されている。	[sound:s-2278_制度の廃止が議論されている。.mp3] <br> せいどのはいしのぎろんされている。 <br> The abolition of the system is being discussed.
[sound:s-2268_科学技術の発展は急速だ。.mp3]	(<b>急速</b>) 科学技術の発展は急速だ。<br> かがくぎじゅつのはってんはきゅうそくだ。 <br>The development of science and technology is rapid.	
家計	[sound:k-2279_家計.mp3]<br>かけい <br> household economy, family finances
household economy, family finances	<b>家計<b> <br> かけい <br>[sound:k-2279_家計.mp3]
[sound:k-2279_家計.mp3]	household economy, family finances<br> <b>家計</b> <br> (かけい)
(<b>歯止め</b>) 犯罪を防ぐために歯止めが必要だ。	[sound:s-2279_犯罪を防ぐために歯止めが必要だ。.mp3] <br> はんざいをふせぐためにはどめがひつようだ。 <br> Brakes are necessary to prevent crime.
[sound:s-2269_この問題には早急に対処する必要がある。.mp3]	(<b>早急</b>) この問題には早急に対処する必要がある。<br> このもんだいにはさっきゅうにたいしょするひつようがある。 <br>It is urgent to address this issue promptly.	
死	[sound:k-2280_死.mp3]<br>し <br> death, decease; death penalty (by strangulation or decapitation)
death, decease; death penalty (by strangulation or decapitation)	<b>死<b> <br> し <br>[sound:k-2280_死.mp3]
[sound:k-2280_死.mp3]	death, decease; death penalty<br> <b>by strangulation or decapitation) (死</b> <br> (し)
(<b>受け止める</b>) 彼は批判を受け止めた。	[sound:s-2280_彼は批判を受け止めた。.mp3] <br> かれはひはんをうけとめた。 <br> He accepted the criticism.
[sound:s-2270_その国では急激な変化が起こった。.mp3]	(<b>急激</b>) その国では急激な変化が起こった。<br> そのくにではきゅうげきなへんかがおこった。 <br>Sudden changes occurred in that country.	
死者	[sound:k-2281_死者.mp3]<br>ししゃ <br> casualty, deceased
casualty, deceased	<b>死者<b> <br> ししゃ <br>[sound:k-2281_死者.mp3]
[sound:k-2281_死者.mp3]	casualty, deceased<br> <b>死者</b> <br> (ししゃ)
(<b>阻止</b>) 洪水を阻止するためにダムが建設された。	[sound:s-2281_洪水を阻止するためにダムが建設された。.mp3] <br> こうずいをそしするためにダムがけんせつされた。 <br> Dams were built to prevent floods.
[sound:s-2271_彼は急性の病気にかかった。.mp3]	(<b>急性</b>) 彼は急性の病気にかかった。<br> かれはきゅうせいのびょうきにかかった。 <br>He contracted an acute illness.	
脳死	[sound:k-2282_脳死.mp3]<br>のうし <br> brain death
brain death	<b>脳死<b> <br> のうし <br>[sound:k-2282_脳死.mp3]
[sound:k-2282_脳死.mp3]	brain death<br> <b>脳死</b> <br> (のうし)
(<b>止まる</b>) 雨が降ると列車が止まることがある。	[sound:s-2282_雨が降ると列車が止まることがある。.mp3] <br> あめがふるとれっしゃがとまることがある。 <br> Trains sometimes stop when it rains.
[sound:s-2272_彼は急進的な改革を提案した。.mp3]	(<b>急進</b>) 彼は急進的な改革を提案した。<br> かれはきゅうしんてきなかいかくをていあんした。 <br>He proposed radical reforms.	
死亡	[sound:k-2283_死亡.mp3]<br>しぼう <br> death, mortality
death, mortality	<b>死亡<b> <br> しぼう <br>[sound:k-2283_死亡.mp3]
[sound:k-2283_死亡.mp3]	death, mortality<br> <b>死亡</b> <br> (しぼう)
(<b>差し止め</b>) 裁判所は差し止め命令を出した。	[sound:s-2283_裁判所は差し止め命令を出した。.mp3] <br> さいばんしょはさしとめめいれいをだした。 <br> The court issued an injunction.
[sound:s-2273_その地域で感染者が急増している。.mp3]	(<b>急増</b>) その地域で感染者が急増している。<br> そのちいきでかんせんしゃがきゅうぞうしている。 <br>There is a rapid increase in infections in that area.	
二死	[sound:k-2284_二死.mp3]<br>にし <br> two out (e.g. in baseball), two down (and one to go)
two out (e.g. in baseball), two down (and one to go)	<b>二死<b> <br> にし <br>[sound:k-2284_二死.mp3]
[sound:k-2284_二死.mp3]	two out<br> <b>e.g. in baseball), two down (and one to go) (二死</b> <br> (にし)
(<b>一連</b>) 彼の行動は一連の出来事につながっています。	[sound:s-2284_彼の行動は一連の出来事につながっています。.mp3] <br> かれのこうどうはいちれんのできごとにつながっています。 <br> His actions are connected to a series of events.
[sound:s-2274_この公園では喫煙が禁止されています。.mp3]	(<b>禁止</b>) この公園では喫煙が禁止されています。<br> このこうえんではきつえんがきんしされています。 <br>Smoking is prohibited in this park.	
死去	[sound:k-2285_死去.mp3]<br>しきょ <br> death
death	<b>死去<b> <br> しきょ <br>[sound:k-2285_死去.mp3]
[sound:k-2285_死去.mp3]	death<br> <b>死去</b> <br> (しきょ)
(<b>五</b>) 彼の誕生日は五月五日です。	[sound:s-2285_彼の誕生日は五月五日です。.mp3] <br> かれのたんじょうびはごがついつかです。 <br> His birthday is on May fifth.
[sound:s-2275_電車が停止しています。.mp3]	(<b>停止</b>) 電車が停止しています。<br> でんしゃがていしています。 <br>The train is stopped.	
死刑	[sound:k-2286_死刑.mp3]<br>しけい <br> death penalty, capital punishment
death penalty, capital punishment	<b>死刑<b> <br> しけい <br>[sound:k-2286_死刑.mp3]
[sound:k-2286_死刑.mp3]	death penalty, capital punishment<br> <b>死刑</b> <br> (しけい)
(<b>五月</b>) 五月には多くの祭りが開催されます。	[sound:s-2286_五月には多くの祭りが開催されます。.mp3] <br> ごがつにはおおくのまつりがかいさいされます。 <br> Many festivals are held in May.
[sound:s-2276_犯罪の防止に努める。.mp3]	(<b>防止</b>) 犯罪の防止に努める。<br> はんざいのぼうしにつとめる。 <br>Work to prevent crime.	
必死	[sound:k-2287_必死.mp3]<br>ひっし <br> frantic, desperate; inevitable death; brinkmate (inevitable checkmate) (shogi)
frantic, desperate; inevitable death; brinkmate (inevitable checkmate) (shogi)	<b>必死<b> <br> ひっし <br>[sound:k-2287_必死.mp3]
[sound:k-2287_必死.mp3]	frantic, desperate; inevitable death; brinkmate<br> <b>inevitable checkmate) (shogi) (必死</b> <br> (ひっし)
(<b>十五</b>) 今月の十五日に会議があります。	[sound:s-2287_今月の十五日に会議があります。.mp3] <br> こんげつのじゅうごにちにかいぎがあります。 <br> There is a meeting on the fifteenth of this month.
[sound:s-2277_イベントが中止になった。.mp3]	(<b>中止</b>) イベントが中止になった。<br> いべんとがちゅうしになった。 <br>The event was canceled.	
死後	[sound:k-2288_死後.mp3]<br>しご <br> after death
after death	<b>死後<b> <br> しご <br>[sound:k-2288_死後.mp3]
[sound:k-2288_死後.mp3]	after death<br> <b>死後</b> <br> (しご)
(<b>五輪</b>) オリンピックは五輪から成り立っています。	[sound:s-2288_オリンピックは五輪から成り立っています。.mp3] <br> おりんぴっくはごりんからなりたっています。 <br> The Olympics consist of five rings.
[sound:s-2278_制度の廃止が議論されている。.mp3]	(<b>廃止</b>) 制度の廃止が議論されている。<br> せいどのはいしのぎろんされている。 <br>The abolition of the system is being discussed.	
死体	[sound:k-2289_死体.mp3]<br>したい <br> dead body, corpse, cadaver
dead body, corpse, cadaver	<b>死体<b> <br> したい <br>[sound:k-2289_死体.mp3]
[sound:k-2289_死体.mp3]	dead body, corpse, cadaver<br> <b>死体</b> <br> (したい)
(<b>五十</b>) 彼の誕生日は五十歳になります。	[sound:s-2289_彼の誕生日は五十歳になります。.mp3] <br> かれのたんじょうびはごじゅっさいになります。 <br> He will turn fifty on his birthday.
[sound:s-2279_犯罪を防ぐために歯止めが必要だ。.mp3]	(<b>歯止め</b>) 犯罪を防ぐために歯止めが必要だ。<br> はんざいをふせぐためにはどめがひつようだ。 <br>Brakes are necessary to prevent crime.	
長官	[sound:k-2290_長官.mp3]<br>ちょうかん <br> secretary (government), director, chief
secretary (government), director, chief	<b>長官<b> <br> ちょうかん <br>[sound:k-2290_長官.mp3]
[sound:k-2290_長官.mp3]	secretary<br> <b>government), director, chief (長官</b> <br> (ちょうかん)
(<b>五つ</b>) この箱には五つのリンゴが入っています。	[sound:s-2290_この箱には五つのリンゴが入っています。.mp3] <br> このはこにはいつつのりんごがはいっています。 <br> There are five apples in this box.
[sound:s-2280_彼は批判を受け止めた。.mp3]	(<b>受け止める</b>) 彼は批判を受け止めた。<br> かれはひはんをうけとめた。 <br>He accepted the criticism.	
官邸	[sound:k-2291_官邸.mp3]<br>かんてい <br> official residence
official residence	<b>官邸<b> <br> かんてい <br>[sound:k-2291_官邸.mp3]
[sound:k-2291_官邸.mp3]	official residence<br> <b>官邸</b> <br> (かんてい)
(<b>五分</b>) 彼の計画には五分ほどで到着する予定です。	[sound:s-2291_彼の計画には五分ほどで到着する予定です。.mp3] <br> かれのけいかくにはごぶんほどでとうちゃくするよていです。 <br> He is expected to arrive in about five minutes according to his plan.
[sound:s-2281_洪水を阻止するためにダムが建設された。.mp3]	(<b>阻止</b>) 洪水を阻止するためにダムが建設された。<br> こうずいをそしするためにダムがけんせつされた。 <br>Dams were built to prevent floods.	
官房長官	[sound:k-2292_官房長官.mp3]<br>かんぼうちょうかん <br> Chief Cabinet Secretary
Chief Cabinet Secretary	<b>官房長官<b> <br> かんぼうちょうかん <br>[sound:k-2292_官房長官.mp3]
[sound:k-2292_官房長官.mp3]	Chief Cabinet Secretary<br> <b>官房長官</b> <br> (かんぼうちょうかん)
(<b>五十三次</b>) 五十三次の旅は彼にとって忘れられないものだった。	[sound:s-2292_五十三次の旅は彼にとって忘れられないものだった。.mp3] <br> ごじゅうさんじのたびはかれにとってわすれられないものだった。 <br> The fifty-three trips were unforgettable for him.
[sound:s-2282_雨が降ると列車が止まることがある。.mp3]	(<b>止まる</b>) 雨が降ると列車が止まることがある。<br> あめがふるとれっしゃがとまることがある。 <br>Trains sometimes stop when it rains.	
官僚	[sound:k-2293_官僚.mp3]<br>かんりょう <br> bureaucrat, bureaucracy
bureaucrat, bureaucracy	<b>官僚<b> <br> かんりょう <br>[sound:k-2293_官僚.mp3]
[sound:k-2293_官僚.mp3]	bureaucrat, bureaucracy<br> <b>官僚</b> <br> (かんりょう)
(<b>五感</b>) 五感を使ってこの世界を感じることができます。	[sound:s-2293_五感を使ってこの世界を感じることができます。.mp3] <br> ごかんをつかってこのせかいをかんじることができます。 <br> You can feel the world using your five senses.
[sound:s-2283_裁判所は差し止め命令を出した。.mp3]	(<b>差し止め</b>) 裁判所は差し止め命令を出した。<br> さいばんしょはさしとめめいれいをだした。 <br>The court issued an injunction.	
次官	[sound:k-2294_次官.mp3]<br>じかん <br> vice-minister, undersecretary
vice-minister, undersecretary	<b>次官<b> <br> じかん <br>[sound:k-2294_次官.mp3]
[sound:k-2294_次官.mp3]	vice-minister, undersecretary<br> <b>次官</b> <br> (じかん)
(<b>五十音</b>) 日本語の五十音はひらがなとカタカナで表されます。	[sound:s-2294_日本語の五十音はひらがなとカタカナで表されます。.mp3] <br> にほんごのごじゅうおんはひらがなとカタカナであらわされます。 <br> The Japanese syllabary is represented by Hiragana and Katakana.
[sound:s-2284_彼の行動は一連の出来事につながっています。.mp3]	(<b>一連</b>) 彼の行動は一連の出来事につながっています。<br> かれのこうどうはいちれんのできごとにつながっています。 <br>His actions are connected to a series of events.	
高官	[sound:k-2295_高官.mp3]<br>こうかん <br> high official
high official	<b>高官<b> <br> こうかん <br>[sound:k-2295_高官.mp3]
[sound:k-2295_高官.mp3]	high official<br> <b>高官</b> <br> (こうかん)
(<b>発</b>) 彼の発言には重要な意味があります。	[sound:s-2295_彼の発言には重要な意味があります。.mp3] <br> かれのはつげんにはじゅうようないみがあります。 <br> His statement carries significant meaning.
[sound:s-2285_彼の誕生日は五月五日です。.mp3]	(<b>五</b>) 彼の誕生日は五月五日です。<br> かれのたんじょうびはごがついつかです。 <br>His birthday is on May fifth.	
司令官	[sound:k-2296_司令官.mp3]<br>しれいかん <br> commandant, commanding officer, general
commandant, commanding officer, general	<b>司令官<b> <br> しれいかん <br>[sound:k-2296_司令官.mp3]
[sound:k-2296_司令官.mp3]	commandant, commanding officer, general<br> <b>司令官</b> <br> (しれいかん)
(<b>開発</b>) その地域の開発に多くの資金が投入されました。	[sound:s-2296_その地域の開発に多くの資金が投入されました。.mp3] <br> そのちいきのかいはつにおおくのしきんがとうにゅうされました。 <br> A lot of funds have been invested in the development of that area.
[sound:s-2286_五月には多くの祭りが開催されます。.mp3]	(<b>五月</b>) 五月には多くの祭りが開催されます。<br> ごがつにはおおくのまつりがかいさいされます。 <br>Many festivals are held in May.	
事務次官	[sound:k-2297_事務次官.mp3]<br>じむじかん <br> permanent vice-president, undersecretary, vice-minister
permanent vice-president, undersecretary, vice-minister	<b>事務次官<b> <br> じむじかん <br>[sound:k-2297_事務次官.mp3]
[sound:k-2297_事務次官.mp3]	permanent vice-president, undersecretary, vice-minister<br> <b>事務次官</b> <br> (じむじかん)
(<b>発言</b>) 彼の発言は多くの議論を巻き起こしました。	[sound:s-2297_彼の発言は多くの議論を巻き起こしました。.mp3] <br> かれのはつげんはおおくのぎろんをまきおこしました。 <br> His statement sparked much debate.
[sound:s-2287_今月の十五日に会議があります。.mp3]	(<b>十五</b>) 今月の十五日に会議があります。<br> こんげつのじゅうごにちにかいぎがあります。 <br>There is a meeting on the fifteenth of this month.	
官房	[sound:k-2298_官房.mp3]<br>かんぼう <br> government secretariat
government secretariat	<b>官房<b> <br> かんぼう <br>[sound:k-2298_官房.mp3]
[sound:k-2298_官房.mp3]	government secretariat<br> <b>官房</b> <br> (かんぼう)
(<b>発行</b>) その新聞社は毎日新聞を発行しています。	[sound:s-2298_その新聞社は毎日新聞を発行しています。.mp3] <br> そのしんぶんしゃはまいにちしんぶんをはっこうしています。 <br> The newspaper company publishes a daily newspaper.
[sound:s-2288_オリンピックは五輪から成り立っています。.mp3]	(<b>五輪</b>) オリンピックは五輪から成り立っています。<br> おりんぴっくはごりんからなりたっています。 <br>The Olympics consist of five rings.	
国務長官	[sound:k-2299_国務長官.mp3]<br>こくむちょうかん <br> Secretary of State
Secretary of State	<b>国務長官<b> <br> こくむちょうかん <br>[sound:k-2299_国務長官.mp3]
[sound:k-2299_国務長官.mp3]	Secretary of State<br> <b>国務長官</b> <br> (こくむちょうかん)
(<b>発展</b>) 科学技術の発展は人類の生活を変えました。	[sound:s-2299_科学技術の発展は人類の生活を変えました。.mp3] <br> かがくぎじゅつのはってんはじんるいのせいかつをかえました。 <br> The development of science and technology has changed human life.
[sound:s-2289_彼の誕生日は五十歳になります。.mp3]	(<b>五十</b>) 彼の誕生日は五十歳になります。<br> かれのたんじょうびはごじゅっさいになります。 <br>He will turn fifty on his birthday.	
増加	[sound:k-2300_増加.mp3]<br>ぞうか <br> increase, increment, addition
increase, increment, addition	<b>増加<b> <br> ぞうか <br>[sound:k-2300_増加.mp3]
[sound:k-2300_増加.mp3]	increase, increment, addition<br> <b>増加</b> <br> (ぞうか)
(<b>発表</b>) 彼の発表は会議で称賛されました。	[sound:s-2300_彼の発表は会議で称賛されました。.mp3] <br> かれのはっぴょうはかいぎでしょうさんされました。 <br> His presentation was praised at the meeting.
[sound:s-2290_この箱には五つのリンゴが入っています。.mp3]	(<b>五つ</b>) この箱には五つのリンゴが入っています。<br> このはこにはいつつのりんごがはいっています。 <br>There are five apples in this box.	
増税	[sound:k-2301_増税.mp3]<br>ぞうぜい <br> tax increase
tax increase	<b>増税<b> <br> ぞうぜい <br>[sound:k-2301_増税.mp3]
[sound:k-2301_増税.mp3]	tax increase<br> <b>増税</b> <br> (ぞうぜい)
(<b>反発</b>) 彼の提案には多くの反発がありました。	[sound:s-2301_彼の提案には多くの反発がありました。.mp3] <br> かれのていあんにはおおくのはんぱつがありました。 <br> There was a lot of resistance to his proposal.
[sound:s-2291_彼の計画には五分ほどで到着する予定です。.mp3]	(<b>五分</b>) 彼の計画には五分ほどで到着する予定です。<br> かれのけいかくにはごぶんほどでとうちゃくするよていです。 <br>He is expected to arrive in about five minutes according to his plan.	
増殖	[sound:k-2302_増殖.mp3]<br>ぞうしょく <br> increase, multiplication, propagation
increase, multiplication, propagation	<b>増殖<b> <br> ぞうしょく <br>[sound:k-2302_増殖.mp3]
[sound:k-2302_増殖.mp3]	increase, multiplication, propagation<br> <b>増殖</b> <br> (ぞうしょく)
(<b>活発</b>) 彼は学校でとても活発です。	[sound:s-2302_彼は学校でとても活発です。.mp3] <br> かれはがっこうでとてもかっぱつです。 <br> He is very active at school.
[sound:s-2292_五十三次の旅は彼にとって忘れられないものだった。.mp3]	(<b>五十三次</b>) 五十三次の旅は彼にとって忘れられないものだった。<br> ごじゅうさんじのたびはかれにとってわすれられないものだった。 <br>The fifty-three trips were unforgettable for him.	
急増	[sound:k-2303_急増.mp3]<br>きゅうぞう <br> explosion, proliferation, surge
explosion, proliferation, surge	<b>急増<b> <br> きゅうぞう <br>[sound:k-2303_急増.mp3]
[sound:k-2303_急増.mp3]	explosion, proliferation, surge<br> <b>急増</b> <br> (きゅうぞう)
(<b>原発</b>) 原発事故の影響は深刻でした。	[sound:s-2303_原発事故の影響は深刻でした。.mp3] <br> げんぱつじこのえいきょうはしんこくでした。 <br> The effects of the nuclear accident were serious.
[sound:s-2293_五感を使ってこの世界を感じることができます。.mp3]	(<b>五感</b>) 五感を使ってこの世界を感じることができます。<br> ごかんをつかってこのせかいをかんじることができます。 <br>You can feel the world using your five senses.	
増大	[sound:k-2304_増大.mp3]<br>ぞうだい <br> enlargement, increase
enlargement, increase	<b>増大<b> <br> ぞうだい <br>[sound:k-2304_増大.mp3]
[sound:k-2304_増大.mp3]	enlargement, increase<br> <b>増大</b> <br> (ぞうだい)
(<b>先発</b>) 彼は今季の先発ピッチャーです。	[sound:s-2304_彼は今季の先発ピッチャーです。.mp3] <br> かれはこんきのせんぱつぴっちゃーです。 <br> He is the starting pitcher for this season.
[sound:s-2294_日本語の五十音はひらがなとカタカナで表されます。.mp3]	(<b>五十音</b>) 日本語の五十音はひらがなとカタカナで表されます。<br> にほんごのごじゅうおんはひらがなとカタカナであらわされます。 <br>The Japanese syllabary is represented by Hiragana and Katakana.	
増強	[sound:k-2305_増強.mp3]<br>ぞうきょう <br> augment, reinforce, increase
augment, reinforce, increase	<b>増強<b> <br> ぞうきょう <br>[sound:k-2305_増強.mp3]
[sound:k-2305_増強.mp3]	augment, reinforce, increase<br> <b>増強</b> <br> (ぞうきょう)
(<b>間</b>) 二人の間には深い絆がある。	[sound:s-2305_二人の間には深い絆がある。.mp3] <br> ふたりのあいだにはふかいきずながある。 <br> There is a deep bond between the two people.
[sound:s-2295_彼の発言には重要な意味があります。.mp3]	(<b>発</b>) 彼の発言には重要な意味があります。<br> かれのはつげんにはじゅうようないみがあります。 <br>His statement carries significant meaning.	
増し	[sound:k-2306_増し.mp3]<br>まし, マシ <br> better, less objectionable, preferable; more, increase, extra; increase, growth
better, less objectionable, preferable; more, increase, extra; increase, growth	<b>増し<b> <br> まし, マシ <br>[sound:k-2306_増し.mp3]
[sound:k-2306_増し.mp3]	better, less objectionable, preferable; more, increase, extra; increase, growth<br> <b>増し</b> <br> (まし, マシ)
(<b>間もなく</b>) 飛行機が離陸する間もなく、携帯電話をオフにしてください。	[sound:s-2306_飛行機が離陸する間もなく、携帯電話をオフにしてください。.mp3] <br> ひこうきがりりくするまもなく、けいたいでんわをオフにしてください。 <br> Please turn off your mobile phones shortly before takeoff.
[sound:s-2296_その地域の開発に多くの資金が投入されました。.mp3]	(<b>開発</b>) その地域の開発に多くの資金が投入されました。<br> そのちいきのかいはつにおおくのしきんがとうにゅうされました。 <br>A lot of funds have been invested in the development of that area.	
増収	[sound:k-2307_増収.mp3]<br>ぞうしゅう <br> increase in yield
increase in yield	<b>増収<b> <br> ぞうしゅう <br>[sound:k-2307_増収.mp3]
[sound:k-2307_増収.mp3]	increase in yield<br> <b>増収</b> <br> (ぞうしゅう)
(<b>期間</b>) プロジェクトの期間は一年です。	[sound:s-2307_プロジェクトの期間は一年です。.mp3] <br> プロジェクトのきかんはいちねんです。 <br> The project duration is one year.
[sound:s-2297_彼の発言は多くの議論を巻き起こしました。.mp3]	(<b>発言</b>) 彼の発言は多くの議論を巻き起こしました。<br> かれのはつげんはおおくのぎろんをまきおこしました。 <br>His statement sparked much debate.	
増益	[sound:k-2308_増益.mp3]<br>ぞうえき <br> increased (profit)
increased (profit)	<b>増益<b> <br> ぞうえき <br>[sound:k-2308_増益.mp3]
[sound:k-2308_増益.mp3]	increased<br> <b>profit) (増益</b> <br> (ぞうえき)
(<b>時間</b>) この仕事には多くの時間が必要です。	[sound:s-2308_この仕事には多くの時間が必要です。.mp3] <br> このしごとにはおおくのじかんがひつようです。 <br> This job requires a lot of time.
[sound:s-2298_その新聞社は毎日新聞を発行しています。.mp3]	(<b>発行</b>) その新聞社は毎日新聞を発行しています。<br> そのしんぶんしゃはまいにちしんぶんをはっこうしています。 <br>The newspaper company publishes a daily newspaper.	
増額	[sound:k-2309_増額.mp3]<br>ぞうがく <br> increased amount
increased amount	<b>増額<b> <br> ぞうがく <br>[sound:k-2309_増額.mp3]
[sound:k-2309_増額.mp3]	increased amount<br> <b>増額</b> <br> (ぞうがく)
(<b>人間</b>) 人間は自然と調和しなければなりません。	[sound:s-2309_人間は自然と調和しなければなりません。.mp3] <br> にんげんはしぜんとちょうわしなければなりません。 <br> Humans must harmonize with nature.
[sound:s-2299_科学技術の発展は人類の生活を変えました。.mp3]	(<b>発展</b>) 科学技術の発展は人類の生活を変えました。<br> かがくぎじゅつのはってんはじんるいのせいかつをかえました。 <br>The development of science and technology has changed human life.	
係	[sound:k-2310_係.mp3]<br>かかり <br> official, duty, person in charge
official, duty, person in charge	<b>係<b> <br> かかり <br>[sound:k-2310_係.mp3]
[sound:k-2310_係.mp3]	official, duty, person in charge<br> <b>係</b> <br> (かかり)
(<b>年間</b>) 年間を通して彼は多くの成果を上げました。	[sound:s-2310_年間を通して彼は多くの成果を上げました。.mp3] <br> ねんかんをつうしてかれはおおくのせいかをあげました。 <br> He achieved many successes throughout the year.
[sound:s-2300_彼の発表は会議で称賛されました。.mp3]	(<b>発表</b>) 彼の発表は会議で称賛されました。<br> かれのはっぴょうはかいぎでしょうさんされました。 <br>His presentation was praised at the meeting.	
関係	[sound:k-2311_関係.mp3]<br>かんけい <br> relation, connection
relation, connection	<b>関係<b> <br> かんけい <br>[sound:k-2311_関係.mp3]
[sound:k-2311_関係.mp3]	relation, connection<br> <b>関係</b> <br> (かんけい)
(<b>民間</b>) その企業は民間の投資家から資金を調達しました。	[sound:s-2311_その企業は民間の投資家から資金を調達しました。.mp3] <br> そのきぎょうはみんかんのとうしかからしきんをちょうたつしました。 <br> The company raised funds from private investors.
[sound:s-2301_彼の提案には多くの反発がありました。.mp3]	(<b>反発</b>) 彼の提案には多くの反発がありました。<br> かれのていあんにはおおくのはんぱつがありました。 <br>There was a lot of resistance to his proposal.	
関係者	[sound:k-2312_関係者.mp3]<br>かんけいしゃ <br> authorized people, authorised people, person(s) concerned
authorized people, authorised people, person(s) concerned	<b>関係者<b> <br> かんけいしゃ <br>[sound:k-2312_関係者.mp3]
[sound:k-2312_関係者.mp3]	authorized people, authorised people, person(s) concerned<br> <b>関係者</b> <br> (かんけいしゃ)
(<b>中間</b>) 彼は中間テストで高い成績を取りました。	[sound:s-2312_彼は中間テストで高い成績を取りました。.mp3] <br> かれはちゅうかんテストでたかいせいせきをとりました。 <br> He scored high marks in the midterm test.
[sound:s-2302_彼は学校でとても活発です。.mp3]	(<b>活発</b>) 彼は学校でとても活発です。<br> かれはがっこうでとてもかっぱつです。 <br>He is very active at school.	
人間関係	[sound:k-2313_人間関係.mp3]<br>にんげんかんけい <br> human relations
human relations	<b>人間関係<b> <br> にんげんかんけい <br>[sound:k-2313_人間関係.mp3]
[sound:k-2313_人間関係.mp3]	human relations<br> <b>人間関係</b> <br> (にんげんかんけい)
(<b>仲間</b>) 彼は仲間と一緒にプロジェクトを進めています。	[sound:s-2313_彼は仲間と一緒にプロジェクトを進めています。.mp3] <br> かれはなかまといっしょにプロジェクトをすすめています。 <br> He is progressing the project with his colleagues.
[sound:s-2303_原発事故の影響は深刻でした。.mp3]	(<b>原発</b>) 原発事故の影響は深刻でした。<br> げんぱつじこのえいきょうはしんこくでした。 <br>The effects of the nuclear accident were serious.	
係長	[sound:k-2314_係長.mp3]<br>かかりちょう <br> chief clerk
chief clerk	<b>係長<b> <br> かかりちょう <br>[sound:k-2314_係長.mp3]
[sound:k-2314_係長.mp3]	chief clerk<br> <b>係長</b> <br> (かかりちょう)
(<b>空間</b>) 彼女の部屋はとても広い空間です。	[sound:s-2314_彼女の部屋はとても広い空間です。.mp3] <br> かのじょのへやはとてもひろいくうかんです。 <br> Her room is a very spacious area.
[sound:s-2304_彼は今季の先発ピッチャーです。.mp3]	(<b>先発</b>) 彼は今季の先発ピッチャーです。<br> かれはこんきのせんぱつぴっちゃーです。 <br>He is the starting pitcher for this season.	
無関係	[sound:k-2315_無関係.mp3]<br>むかんけい <br> unrelated
unrelated	<b>無関係<b> <br> むかんけい <br>[sound:k-2315_無関係.mp3]
[sound:k-2315_無関係.mp3]	unrelated<br> <b>無関係</b> <br> (むかんけい)
(<b>対応</b>) その会社は顧客の要求に迅速に対応しています。	[sound:s-2315_その会社は顧客の要求に迅速に対応しています。.mp3] <br> そのかいしゃはこきゃくのようきゅうにじんそくにたいおうしています。 <br> The company responds promptly to customer demands.
[sound:s-2305_二人の間には深い絆がある。.mp3]	(<b>間</b>) 二人の間には深い絆がある。<br> ふたりのあいだにはふかいきずながある。 <br>There is a deep bond between the two people.	
係官	[sound:k-2316_係官.mp3]<br>かかりかん <br> official in charge
official in charge	<b>係官<b> <br> かかりかん <br>[sound:k-2316_係官.mp3]
[sound:k-2316_係官.mp3]	official in charge<br> <b>係官</b> <br> (かかりかん)
(<b>対策</b>) 地震対策のために建物が補強されました。	[sound:s-2316_地震対策のために建物が補強されました。.mp3] <br> じしんたいさくのためにたてものがほきょうされました。 <br> Buildings were reinforced for earthquake preparedness.
[sound:s-2306_飛行機が離陸する間もなく、携帯電話をオフにしてください。.mp3]	(<b>間もなく</b>) 飛行機が離陸する間もなく、携帯電話をオフにしてください。<br> ひこうきがりりくするまもなく、けいたいでんわをオフにしてください。 <br>Please turn off your mobile phones shortly before takeoff.	
係員	[sound:k-2317_係員.mp3]<br>かかりいん <br> official (e.g. customs), clerk in charge
official (e.g. customs), clerk in charge	<b>係員<b> <br> かかりいん <br>[sound:k-2317_係員.mp3]
[sound:k-2317_係員.mp3]	official<br> <b>e.g. customs), clerk in charge (係員</b> <br> (かかりいん)
(<b>対象</b>) このプログラムは子供たちを対象にしています。	[sound:s-2317_このプログラムは子供たちを対象にしています。.mp3] <br> このプログラムはこどもたちをたいしょうにしています。 <br> This program targets children.
[sound:s-2307_プロジェクトの期間は一年です。.mp3]	(<b>期間</b>) プロジェクトの期間は一年です。<br> プロジェクトのきかんはいちねんです。 <br>The project duration is one year.	
係争	[sound:k-2318_係争.mp3]<br>けいそう <br> contention, dispute
contention, dispute	<b>係争<b> <br> けいそう <br>[sound:k-2318_係争.mp3]
[sound:k-2318_係争.mp3]	contention, dispute<br> <b>係争</b> <br> (けいそう)
(<b>反対</b>) 彼は私の提案に反対しています。	[sound:s-2318_彼は私の提案に反対しています。.mp3] <br> かれはわたしのていあんにはんたいしています。 <br> He opposes my proposal.
[sound:s-2308_この仕事には多くの時間が必要です。.mp3]	(<b>時間</b>) この仕事には多くの時間が必要です。<br> このしごとにはおおくのじかんがひつようです。 <br>This job requires a lot of time.	
連係プレー	[sound:k-2319_連係プレー.mp3]<br>れんけいプレー <br> good teamwork play (baseball)
good teamwork play (baseball)	<b>連係プレー<b> <br> れんけいプレー <br>[sound:k-2319_連係プレー.mp3]
[sound:k-2319_連係プレー.mp3]	good teamwork play<br> <b>baseball) (連係プレー</b> <br> (れんけいプレー)
(<b>対立</b>) 両者の意見の対立が明らかになりました。	[sound:s-2319_両者の意見の対立が明らかになりました。.mp3] <br> りょうしゃのいけんのたいりつがあきらかになりました。 <br> The opposition of opinions between the two parties became clear.
[sound:s-2309_人間は自然と調和しなければなりません。.mp3]	(<b>人間</b>) 人間は自然と調和しなければなりません。<br> にんげんはしぜんとちょうわしなければなりません。 <br>Humans must harmonize with nature.	
感じ	[sound:k-2320_感じ.mp3]<br>かんじ <br> feeling, sense, impression
feeling, sense, impression	<b>感じ<b> <br> かんじ <br>[sound:k-2320_感じ.mp3]
[sound:k-2320_感じ.mp3]	feeling, sense, impression<br> <b>感じ</b> <br> (かんじ)
(<b>対話</b>) 平和を目指すためには対話が重要です。	[sound:s-2320_平和を目指すためには対話が重要です。.mp3] <br> へいわをめざすためにはたいわがじゅうようです。 <br> Dialogue is crucial for achieving peace.
[sound:s-2310_年間を通して彼は多くの成果を上げました。.mp3]	(<b>年間</b>) 年間を通して彼は多くの成果を上げました。<br> ねんかんをつうしてかれはおおくのせいかをあげました。 <br>He achieved many successes throughout the year.	
感覚	[sound:k-2321_感覚.mp3]<br>かんかく <br> sense, sensation, feeling
sense, sensation, feeling	<b>感覚<b> <br> かんかく <br>[sound:k-2321_感覚.mp3]
[sound:k-2321_感覚.mp3]	sense, sensation, feeling<br> <b>感覚</b> <br> (かんかく)
(<b>対日</b>) その国は対日貿易を拡大したいと考えています。	[sound:s-2321_その国は対日貿易を拡大したいと考えています。.mp3] <br> そのくにはたいにちぼうえきをかくだいしたいとかんがえています。 <br> The country wishes to expand its trade with Japan.
[sound:s-2311_その企業は民間の投資家から資金を調達しました。.mp3]	(<b>民間</b>) その企業は民間の投資家から資金を調達しました。<br> そのきぎょうはみんかんのとうしかからしきんをちょうたつしました。 <br>The company raised funds from private investors.	
感染	[sound:k-2322_感染.mp3]<br>かんせん <br> infection, contagion
infection, contagion	<b>感染<b> <br> かんせん <br>[sound:k-2322_感染.mp3]
[sound:k-2322_感染.mp3]	infection, contagion<br> <b>感染</b> <br> (かんせん)
(<b>国対</b>) 国対戦は国内外で大きな注目を集めています。	[sound:s-2322_国対戦は国内外で大きな注目を集めています。.mp3] <br> こくたいせんはこくないがいでおおきなちゅうもくをあつめています。 <br> The national competition is attracting significant attention domestically and internationally.
[sound:s-2312_彼は中間テストで高い成績を取りました。.mp3]	(<b>中間</b>) 彼は中間テストで高い成績を取りました。<br> かれはちゅうかんテストでたかいせいせきをとりました。 <br>He scored high marks in the midterm test.	
感じる	[sound:k-2323_感じる.mp3]<br>かんじる <br> to feel, to sense, to experience
to feel, to sense, to experience	<b>感じる<b> <br> かんじる <br>[sound:k-2323_感じる.mp3]
[sound:k-2323_感じる.mp3]	to feel, to sense, to experience<br> <b>感じる</b> <br> (かんじる)
(<b>絶対</b>) 彼の成功は努力と絶対の信念によるものです。	[sound:s-2323_彼の成功は努力と絶対の信念によるものです。.mp3] <br> かれのせいこうはどりょくとぜったいのしんねんによるものです。 <br> His success is due to effort and unwavering belief.
[sound:s-2313_彼は仲間と一緒にプロジェクトを進めています。.mp3]	(<b>仲間</b>) 彼は仲間と一緒にプロジェクトを進めています。<br> かれはなかまといっしょにプロジェクトをすすめています。 <br>He is progressing the project with his colleagues.	
感情	[sound:k-2324_感情.mp3]<br>かんじょう <br> emotion, feeling, feelings, sentiment
emotion, feeling, feelings, sentiment	<b>感情<b> <br> かんじょう <br>[sound:k-2324_感情.mp3]
[sound:k-2324_感情.mp3]	emotion, feeling, feelings, sentiment<br> <b>感情</b> <br> (かんじょう)
(<b>対外</b>) 彼は対外交渉でその国の利益を守ります。	[sound:s-2324_彼は対外交渉でその国の利益を守ります。.mp3] <br> かれはたいがいこうしょうでそのくにのりえきをまもります。 <br> He protects the interests of his country in foreign negotiations.
[sound:s-2314_彼女の部屋はとても広い空間です。.mp3]	(<b>空間</b>) 彼女の部屋はとても広い空間です。<br> かのじょのへやはとてもひろいくうかんです。 <br>Her room is a very spacious area.	
感想	[sound:k-2325_感想.mp3]<br>かんそう <br> impressions, thoughts
impressions, thoughts	<b>感想<b> <br> かんそう <br>[sound:k-2325_感想.mp3]
[sound:k-2325_感想.mp3]	impressions, thoughts<br> <b>感想</b> <br> (かんそう)
(<b>上がったり</b>) 気温が上がったり下がったりしています。	[sound:s-2325_気温が上がったり下がったりしています。.mp3] <br> きおんがあがったりさがったりしています。 <br> The temperature is fluctuating up and down.
[sound:s-2315_その会社は顧客の要求に迅速に対応しています。.mp3]	(<b>対応</b>) その会社は顧客の要求に迅速に対応しています。<br> そのかいしゃはこきゃくのようきゅうにじんそくにたいおうしています。 <br>The company responds promptly to customer demands.	
感動	[sound:k-2326_感動.mp3]<br>かんどう <br> being deeply moved emotionally, excitement, passion, deep emotion, impression
being deeply moved emotionally, excitement, passion, deep emotion, impression	<b>感動<b> <br> かんどう <br>[sound:k-2326_感動.mp3]
[sound:k-2326_感動.mp3]	being deeply moved emotionally, excitement, passion, deep emotion, impression<br> <b>感動</b> <br> (かんどう)
(<b>史上</b>) この大会は史上最高の記録を生み出しました。	[sound:s-2326_この大会は史上最高の記録を生み出しました。.mp3] <br> このたいかいはしじょうさいこうのきろくをうみだしました。 <br> This tournament produced the best records in history.
[sound:s-2316_地震対策のために建物が補強されました。.mp3]	(<b>対策</b>) 地震対策のために建物が補強されました。<br> じしんたいさくのためにたてものがほきょうされました。 <br>Buildings were reinforced for earthquake preparedness.	
感謝	[sound:k-2327_感謝.mp3]<br>かんしゃ <br> thanks, gratitude
thanks, gratitude	<b>感謝<b> <br> かんしゃ <br>[sound:k-2327_感謝.mp3]
[sound:k-2327_感謝.mp3]	thanks, gratitude<br> <b>感謝</b> <br> (かんしゃ)
(<b>事実上</b>) 事実上、彼がそのプロジェクトのリーダーです。	[sound:s-2327_事実上、彼がそのプロジェクトのリーダーです。.mp3] <br> じじつじょう、かれがそのプロジェクトのリーダーです。 <br> In fact, he is the leader of the project.
[sound:s-2317_このプログラムは子供たちを対象にしています。.mp3]	(<b>対象</b>) このプログラムは子供たちを対象にしています。<br> このプログラムはこどもたちをたいしょうにしています。 <br>This program targets children.	
感性	[sound:k-2328_感性.mp3]<br>かんせい <br> sensitivity, sensitiveness, sense
sensitivity, sensitiveness, sense	<b>感性<b> <br> かんせい <br>[sound:k-2328_感性.mp3]
[sound:k-2328_感性.mp3]	sensitivity, sensitiveness, sense<br> <b>感性</b> <br> (かんせい)
(<b>上げ</b>) 彼の言葉には多くの人々が手を上げました。	[sound:s-2328_彼の言葉には多くの人々が手を上げました。.mp3] <br> かれのことばにはおおくのひとびとがてをあげました。 <br> Many people raised their hands to his words.
[sound:s-2318_彼は私の提案に反対しています。.mp3]	(<b>反対</b>) 彼は私の提案に反対しています。<br> かれはわたしのていあんにはんたいしています。 <br>He opposes my proposal.	
実感	[sound:k-2329_実感.mp3]<br>じっかん <br> feelings (actual, true)
feelings (actual, true)	<b>実感<b> <br> じっかん <br>[sound:k-2329_実感.mp3]
[sound:k-2329_実感.mp3]	feelings<br> <b>actual, true) (実感</b> <br> (じっかん)
(<b>上昇</b>) 株価は急速に上昇しています。	[sound:s-2329_株価は急速に上昇しています。.mp3] <br> かぶかはきゅうそくにじょうしょうしています。 <br> Stock prices are rising rapidly.
[sound:s-2319_両者の意見の対立が明らかになりました。.mp3]	(<b>対立</b>) 両者の意見の対立が明らかになりました。<br> りょうしゃのいけんのたいりつがあきらかになりました。 <br>The opposition of opinions between the two parties became clear.	
特に	[sound:k-2330_特に.mp3]<br>とくに <br> particularly, especially
particularly, especially	<b>特に<b> <br> とくに <br>[sound:k-2330_特に.mp3]
[sound:k-2330_特に.mp3]	particularly, especially<br> <b>特に</b> <br> (とくに)
(<b>向上</b>) 教育は人々の生活水準を向上させます。	[sound:s-2330_教育は人々の生活水準を向上させます。.mp3] <br> きょういくはひとびとのせいかつすいじゅんをこうじょうさせます。 <br> Education improves people's living standards.
[sound:s-2320_平和を目指すためには対話が重要です。.mp3]	(<b>対話</b>) 平和を目指すためには対話が重要です。<br> へいわをめざすためにはたいわがじゅうようです。 <br>Dialogue is crucial for achieving peace.	
特別	[sound:k-2331_特別.mp3]<br>とくべつ <br> special
special	<b>特別<b> <br> とくべつ <br>[sound:k-2331_特別.mp3]
[sound:k-2331_特別.mp3]	special<br> <b>特別</b> <br> (とくべつ)
(<b>上がり</b>) 売上がりは前年と比べて増加しました。	[sound:s-2331_売上がりは前年と比べて増加しました。.mp3] <br> うりあがりはぜんねんとくらべてぞうかしました。 <br> Sales revenue increased compared to the previous year.
[sound:s-2321_その国は対日貿易を拡大したいと考えています。.mp3]	(<b>対日</b>) その国は対日貿易を拡大したいと考えています。<br> そのくにはたいにちぼうえきをかくだいしたいとかんがえています。 <br>The country wishes to expand its trade with Japan.	
特徴	[sound:k-2332_特徴.mp3]<br>とくちょう <br> feature, trait, characteristic, pecularity
feature, trait, characteristic, pecularity	<b>特徴<b> <br> とくちょう <br>[sound:k-2332_特徴.mp3]
[sound:k-2332_特徴.mp3]	feature, trait, characteristic, pecularity<br> <b>特徴</b> <br> (とくちょう)
(<b>上位</b>) 彼は大会で上位に入ることができました。	[sound:s-2332_彼は大会で上位に入ることができました。.mp3] <br> かれはたいかいでじょういにはいることができました。 <br> He was able to rank high in the competition.
[sound:s-2322_国対戦は国内外で大きな注目を集めています。.mp3]	(<b>国対</b>) 国対戦は国内外で大きな注目を集めています。<br> こくたいせんはこくないがいでおおきなちゅうもくをあつめています。 <br>The national competition is attracting significant attention domestically and internationally.	
特定	[sound:k-2333_特定.mp3]<br>とくてい <br> specific, special, particular
specific, special, particular	<b>特定<b> <br> とくてい <br>[sound:k-2333_特定.mp3]
[sound:k-2333_特定.mp3]	specific, special, particular<br> <b>特定</b> <br> (とくてい)
(<b>地上</b>) 地上から見た夜空は美しいです。	[sound:s-2333_地上から見た夜空は美しいです。.mp3] <br> ちじょうからみたよぞらはうつくしいです。 <br> The night sky seen from the ground is beautiful.
[sound:s-2323_彼の成功は努力と絶対の信念によるものです。.mp3]	(<b>絶対</b>) 彼の成功は努力と絶対の信念によるものです。<br> かれのせいこうはどりょくとぜったいのしんねんによるものです。 <br>His success is due to effort and unwavering belief.	
特捜	[sound:k-2334_特捜.mp3]<br>とくそう <br> special investigation
special investigation	<b>特捜<b> <br> とくそう <br>[sound:k-2334_特捜.mp3]
[sound:k-2334_特捜.mp3]	special investigation<br> <b>特捜</b> <br> (とくそう)
(<b>途上国</b>) 途上国は貧困と闘っています。	[sound:s-2334_途上国は貧困と闘っています。.mp3] <br> とじょうこくはひんこんとたたかっています。 <br> Developing countries are fighting against poverty.
[sound:s-2324_彼は対外交渉でその国の利益を守ります。.mp3]	(<b>対外</b>) 彼は対外交渉でその国の利益を守ります。<br> かれはたいがいこうしょうでそのくにのりえきをまもります。 <br>He protects the interests of his country in foreign negotiations.	
特殊	[sound:k-2335_特殊.mp3]<br>とくしゅ <br> special, unique
special, unique	<b>特殊<b> <br> とくしゅ <br>[sound:k-2335_特殊.mp3]
[sound:k-2335_特殊.mp3]	special, unique<br> <b>特殊</b> <br> (とくしゅ)
(<b>一部</b>) 彼の意見は一部の人々にしか受け入れられません。	[sound:s-2335_彼の意見は一部の人々にしか受け入れられません。.mp3] <br> かれのいけんはいちぶのひとびとにしかうけいれられません。 <br> His opinion is accepted only by some people.
[sound:s-2325_気温が上がったり下がったりしています。.mp3]	(<b>上がったり</b>) 気温が上がったり下がったりしています。<br> きおんがあがったりさがったりしています。 <br>The temperature is fluctuating up and down.	
特例	[sound:k-2336_特例.mp3]<br>とくれい <br> special case, exception
special case, exception	<b>特例<b> <br> とくれい <br>[sound:k-2336_特例.mp3]
[sound:k-2336_特例.mp3]	special case, exception<br> <b>特例</b> <br> (とくれい)
(<b>幹部</b>) 会社の幹部は新しい方針を発表しました。	[sound:s-2336_会社の幹部は新しい方針を発表しました。.mp3] <br> かいしゃのかんぶはあたらしいほうしんをはっぴょうしました。 <br> The company executives announced a new policy.
[sound:s-2326_この大会は史上最高の記録を生み出しました。.mp3]	(<b>史上</b>) この大会は史上最高の記録を生み出しました。<br> このたいかいはしじょうさいこうのきろくをうみだしました。 <br>This tournament produced the best records in history.	
独特	[sound:k-2337_独特.mp3]<br>どくとく <br> peculiarity, uniqueness, characteristic
peculiarity, uniqueness, characteristic	<b>独特<b> <br> どくとく <br>[sound:k-2337_独特.mp3]
[sound:k-2337_独特.mp3]	peculiarity, uniqueness, characteristic<br> <b>独特</b> <br> (どくとく)
(<b>部長</b>) 部長は部署の運営を担当しています。	[sound:s-2337_部長は部署の運営を担当しています。.mp3] <br> ぶちょうはぶしょのうんえいをたんとうしています。 <br> The department head is in charge of department operations.
[sound:s-2327_事実上、彼がそのプロジェクトのリーダーです。.mp3]	(<b>事実上</b>) 事実上、彼がそのプロジェクトのリーダーです。<br> じじつじょう、かれがそのプロジェクトのリーダーです。 <br>In fact, he is the leader of the project.	
特使	[sound:k-2338_特使.mp3]<br>とくし <br> special envoy
special envoy	<b>特使<b> <br> とくし <br>[sound:k-2338_特使.mp3]
[sound:k-2338_特使.mp3]	special envoy<br> <b>特使</b> <br> (とくし)
(<b>部分</b>) 彼の話の一部分を理解できませんでした。	[sound:s-2338_彼の話の一部分を理解できませんでした。.mp3] <br> かれのはなしのいちぶぶんをりかいできませんでした。 <br> I couldn't understand part of his story.
[sound:s-2328_彼の言葉には多くの人々が手を上げました。.mp3]	(<b>上げ</b>) 彼の言葉には多くの人々が手を上げました。<br> かれのことばにはおおくのひとびとがてをあげました。 <br>Many people raised their hands to his words.	
特集	[sound:k-2339_特集.mp3]<br>とくしゅう <br> feature (e.g. newspaper), special edition, report
feature (e.g. newspaper), special edition, report	<b>特集<b> <br> とくしゅう <br>[sound:k-2339_特集.mp3]
[sound:k-2339_特集.mp3]	feature<br> <b>e.g. newspaper), special edition, report (特集</b> <br> (とくしゅう)
(<b>部門</b>) その会社はいくつかの部門に分かれています。	[sound:s-2339_その会社はいくつかの部門に分かれています。.mp3] <br> そのかいしゃはいくつかのぶもんにわかれています。 <br> The company is divided into several departments.
[sound:s-2329_株価は急速に上昇しています。.mp3]	(<b>上昇</b>) 株価は急速に上昇しています。<br> かぶかはきゅうそくにじょうしょうしています。 <br>Stock prices are rising rapidly.	
情	[sound:k-2340_情.mp3]<br>じょう <br> feelings, emotion, passion
feelings, emotion, passion	<b>情<b> <br> じょう <br>[sound:k-2340_情.mp3]
[sound:k-2340_情.mp3]	feelings, emotion, passion<br> <b>情</b> <br> (じょう)
(<b>本部</b>) 本部は全国にいくつかの支社を持っています。	[sound:s-2340_本部は全国にいくつかの支社を持っています。.mp3] <br> ほんぶはぜんこくにいくつかのししゃをもっています。 <br> The headquarters has several branch offices nationwide.
[sound:s-2330_教育は人々の生活水準を向上させます。.mp3]	(<b>向上</b>) 教育は人々の生活水準を向上させます。<br> きょういくはひとびとのせいかつすいじゅんをこうじょうさせます。 <br>Education improves people's living standards.	
事情	[sound:k-2341_事情.mp3]<br>じじょう <br> circumstances, consideration, conditions, situation, reasons
circumstances, consideration, conditions, situation, reasons	<b>事情<b> <br> じじょう <br>[sound:k-2341_事情.mp3]
[sound:k-2341_事情.mp3]	circumstances, consideration, conditions, situation, reasons<br> <b>事情</b> <br> (じじょう)
(<b>学部</b>) 彼女は大学で心理学部に在籍しています。	[sound:s-2341_彼女は大学で心理学部に在籍しています。.mp3] <br> かのじょはだいがくでしんりがくぶにざいせきしています。 <br> She is enrolled in the psychology department at the university.
[sound:s-2331_売上がりは前年と比べて増加しました。.mp3]	(<b>上がり</b>) 売上がりは前年と比べて増加しました。<br> うりあがりはぜんねんとくらべてぞうかしました。 <br>Sales revenue increased compared to the previous year.	
情勢	[sound:k-2342_情勢.mp3]<br>じょうせい <br> state of things, state of affairs, condition, situation, circumstances
state of things, state of affairs, condition, situation, circumstances	<b>情勢<b> <br> じょうせい <br>[sound:k-2342_情勢.mp3]
[sound:k-2342_情勢.mp3]	state of things, state of affairs, condition, situation, circumstances<br> <b>情勢</b> <br> (じょうせい)
(<b>内部</b>) その問題は会社の内部で解決されます。	[sound:s-2342_その問題は会社の内部で解決されます。.mp3] <br> そのもんだいはかいしゃのないぶでかいけつされます。 <br> The issue will be resolved within the company.
[sound:s-2332_彼は大会で上位に入ることができました。.mp3]	(<b>上位</b>) 彼は大会で上位に入ることができました。<br> かれはたいかいでじょういにはいることができました。 <br>He was able to rank high in the competition.	
情報	[sound:k-2343_情報.mp3]<br>じょうほう <br> news, gossip, (military) intelligence; information (data contained in characters, signals, code, etc.)
news, gossip, (military) intelligence; information (data contained in characters, signals, code, etc.)	<b>情報<b> <br> じょうほう <br>[sound:k-2343_情報.mp3]
[sound:k-2343_情報.mp3]	news, gossip,<br> <b>military) intelligence; information (data contained in characters, signals, code, etc.) (情報</b> <br> (じょうほう)
(<b>部屋</b>) 彼の部屋はとても整頓されています。	[sound:s-2343_彼の部屋はとても整頓されています。.mp3] <br> かれのへやはとてもせいとんされています。 <br> His room is very tidy.
[sound:s-2333_地上から見た夜空は美しいです。.mp3]	(<b>地上</b>) 地上から見た夜空は美しいです。<br> ちじょうからみたよぞらはうつくしいです。 <br>The night sky seen from the ground is beautiful.	
表情	[sound:k-2344_表情.mp3]<br>ひょうじょう <br> facial expression
facial expression	<b>表情<b> <br> ひょうじょう <br>[sound:k-2344_表情.mp3]
[sound:k-2344_表情.mp3]	facial expression<br> <b>表情</b> <br> (ひょうじょう)
(<b>部隊</b>) その部隊は敵に奇襲攻撃を仕掛けた。	[sound:s-2344_その部隊は敵に奇襲攻撃を仕掛けた。.mp3] <br> そのぶたいはてきにきしゅうこうげきをしかけた。 <br> The unit launched a surprise attack on the enemy.
[sound:s-2334_途上国は貧困と闘っています。.mp3]	(<b>途上国</b>) 途上国は貧困と闘っています。<br> とじょうこくはひんこんとたたかっています。 <br>Developing countries are fighting against poverty.	
感情	[sound:k-2345_感情.mp3]<br>かんじょう <br> emotion, feeling, feelings, sentiment
emotion, feeling, feelings, sentiment	<b>感情<b> <br> かんじょう <br>[sound:k-2345_感情.mp3]
[sound:k-2345_感情.mp3]	emotion, feeling, feelings, sentiment<br> <b>感情</b> <br> (かんじょう)
(<b>東</b>) 東の空に朝日が昇っている。	[sound:s-2345_東の空に朝日が昇っている。.mp3] <br> ひがしのそらにあさひがのぼっている。 <br> The morning sun is rising in the east sky.
[sound:s-2335_彼の意見は一部の人々にしか受け入れられません。.mp3]	(<b>一部</b>) 彼の意見は一部の人々にしか受け入れられません。<br> かれのいけんはいちぶのひとびとにしかうけいれられません。 <br>His opinion is accepted only by some people.	
実情	[sound:k-2346_実情.mp3]<br>じつじょう <br> real condition, actual circumstances, actual state of affairs
real condition, actual circumstances, actual state of affairs	<b>実情<b> <br> じつじょう <br>[sound:k-2346_実情.mp3]
[sound:k-2346_実情.mp3]	real condition, actual circumstances, actual state of affairs<br> <b>実情</b> <br> (じつじょう)
(<b>東京</b>) 東京は日本の首都です。	[sound:s-2346_東京は日本の首都です。.mp3] <br> とうきょうはにほんのしゅとです。 <br> Tokyo is the capital of Japan.
[sound:s-2336_会社の幹部は新しい方針を発表しました。.mp3]	(<b>幹部</b>) 会社の幹部は新しい方針を発表しました。<br> かいしゃのかんぶはあたらしいほうしんをはっぴょうしました。 <br>The company executives announced a new policy.	
苦情	[sound:k-2347_苦情.mp3]<br>くじょう <br> complaint, troubles, objection, grievance
complaint, troubles, objection, grievance	<b>苦情<b> <br> くじょう <br>[sound:k-2347_苦情.mp3]
[sound:k-2347_苦情.mp3]	complaint, troubles, objection, grievance<br> <b>苦情</b> <br> (くじょう)
(<b>中東</b>) 中東地域では石油が豊富に産出されている。	[sound:s-2347_中東地域では石油が豊富に産出されている。.mp3] <br> ちゅうとうちいきではせきゆがほうふにさんしゅつされている。 <br> Oil is abundantly produced in the Middle East region.
[sound:s-2337_部長は部署の運営を担当しています。.mp3]	(<b>部長</b>) 部長は部署の運営を担当しています。<br> ぶちょうはぶしょのうんえいをたんとうしています。 <br>The department head is in charge of department operations.	
情熱	[sound:k-2348_情熱.mp3]<br>じょうねつ <br> passion, enthusiasm, zeal
passion, enthusiasm, zeal	<b>情熱<b> <br> じょうねつ <br>[sound:k-2348_情熱.mp3]
[sound:k-2348_情熱.mp3]	passion, enthusiasm, zeal<br> <b>情熱</b> <br> (じょうねつ)
(<b>東海</b>) 東海地域には美しいビーチがたくさんあります。	[sound:s-2348_東海地域には美しいビーチがたくさんあります。.mp3] <br> とうかいちいきにはうつくしいビーチがたくさんあります。 <br> The Tokai region has many beautiful beaches.
[sound:s-2338_彼の話の一部分を理解できませんでした。.mp3]	(<b>部分</b>) 彼の話の一部分を理解できませんでした。<br> かれのはなしのいちぶぶんをりかいできませんでした。 <br>I couldn't understand part of his story.	
愛情	[sound:k-2349_愛情.mp3]<br>あいじょう <br> love, affection
love, affection	<b>愛情<b> <br> あいじょう <br>[sound:k-2349_愛情.mp3]
[sound:k-2349_愛情.mp3]	love, affection<br> <b>愛情</b> <br> (あいじょう)
(<b>東北</b>) 東北地方では冬には雪がよく降ります。	[sound:s-2349_東北地方では冬には雪がよく降ります。.mp3] <br> とうほくちほうではふゆにはゆきがよくふります。 <br> Snowfall is frequent in winter in the Tohoku region.
[sound:s-2339_その会社はいくつかの部門に分かれています。.mp3]	(<b>部門</b>) その会社はいくつかの部門に分かれています。<br> そのかいしゃはいくつかのぶもんにわかれています。 <br>The company is divided into several departments.	
投資	[sound:k-2350_投資.mp3]<br>とうし <br> investment
investment	<b>投資<b> <br> とうし <br>[sound:k-2350_投資.mp3]
[sound:k-2350_投資.mp3]	investment<br> <b>投資</b> <br> (とうし)
(<b>東欧</b>) 東欧諸国の文化は多様で豊かです。	[sound:s-2350_東欧諸国の文化は多様で豊かです。.mp3] <br> とうおうしょこくのぶんかはたようでゆたかです。 <br> The culture of Eastern European countries is diverse and rich.
[sound:s-2340_本部は全国にいくつかの支社を持っています。.mp3]	(<b>本部</b>) 本部は全国にいくつかの支社を持っています。<br> ほんぶはぜんこくにいくつかのししゃをもっています。 <br>The headquarters has several branch offices nationwide.	
投手	[sound:k-2351_投手.mp3]<br>とうしゅ <br> (baseball) pitcher
(baseball) pitcher	<b>投手<b> <br> とうしゅ <br>[sound:k-2351_投手.mp3]
[sound:k-2351_投手.mp3]	(baseball) pitcher<br> <b>投手</b> <br> (とうしゅ)
(<b>東西</b>) 東西の文化の違いを研究しています。	[sound:s-2351_東西の文化の違いを研究しています。.mp3] <br> とうざいのぶんかのちがいをけんきゅうしています。 <br> I am researching the differences between Eastern and Western cultures.
[sound:s-2341_彼女は大学で心理学部に在籍しています。.mp3]	(<b>学部</b>) 彼女は大学で心理学部に在籍しています。<br> かのじょはだいがくでしんりがくぶにざいせきしています。 <br>She is enrolled in the psychology department at the university.	
投票	[sound:k-2352_投票.mp3]<br>とうひょう <br> voting, poll
voting, poll	<b>投票<b> <br> とうひょう <br>[sound:k-2352_投票.mp3]
[sound:k-2352_投票.mp3]	voting, poll<br> <b>投票</b> <br> (とうひょう)
(<b>東南</b>) その国は東南アジアに位置しています。	[sound:s-2352_その国は東南アジアに位置しています。.mp3] <br> そのくにはとうなんアジアにいちしています。 <br> The country is located in Southeast Asia.
[sound:s-2342_その問題は会社の内部で解決されます。.mp3]	(<b>内部</b>) その問題は会社の内部で解決されます。<br> そのもんだいはかいしゃのないぶでかいけつされます。 <br>The issue will be resolved within the company.	
国民投票	[sound:k-2353_国民投票.mp3]<br>こくみんとうひょう <br> national referendum
national referendum	<b>国民投票<b> <br> こくみんとうひょう <br>[sound:k-2353_国民投票.mp3]
[sound:k-2353_国民投票.mp3]	national referendum<br> <b>国民投票</b> <br> (こくみんとうひょう)
(<b>東芝</b>) 東芝は電化製品の製造で有名です。	[sound:s-2353_東芝は電化製品の製造で有名です。.mp3] <br> とうしばはでんかせいひんのせいぞうでゆうめいです。 <br> Toshiba is famous for manufacturing electrical appliances.
[sound:s-2343_彼の部屋はとても整頓されています。.mp3]	(<b>部屋</b>) 彼の部屋はとても整頓されています。<br> かれのへやはとてもせいとんされています。 <br>His room is very tidy.	
投球	[sound:k-2354_投球.mp3]<br>とうきゅう <br> pitching, throwing a ball, bowling (in cricket), pitched ball
pitching, throwing a ball, bowling (in cricket), pitched ball	<b>投球<b> <br> とうきゅう <br>[sound:k-2354_投球.mp3]
[sound:k-2354_投球.mp3]	pitching, throwing a ball, bowling<br> <b>in cricket), pitched ball (投球</b> <br> (とうきゅう)
(<b>東洋</b>) 東洋の文化には古い伝統が根付いています。	[sound:s-2354_東洋の文化には古い伝統が根付いています。.mp3] <br> とうようのぶんかにはふるいでんとうがねづいています。 <br> Eastern culture is rooted in ancient traditions.
[sound:s-2344_その部隊は敵に奇襲攻撃を仕掛けた。.mp3]	(<b>部隊</b>) その部隊は敵に奇襲攻撃を仕掛けた。<br> そのぶたいはてきにきしゅうこうげきをしかけた。 <br>The unit launched a surprise attack on the enemy.	
完投	[sound:k-2355_完投.mp3]<br>かんとう <br> going the whole distance, pitching a whole game
going the whole distance, pitching a whole game	<b>完投<b> <br> かんとう <br>[sound:k-2355_完投.mp3]
[sound:k-2355_完投.mp3]	going the whole distance, pitching a whole game<br> <b>完投</b> <br> (かんとう)
(<b>患者</b>) 病院にはたくさんの患者がいる。	[sound:s-2355_病院にはたくさんの患者がいる。.mp3] <br> びょういんにはたくさんのかんじゃがいる。 <br> There are many patients in the hospital.
[sound:s-2345_東の空に朝日が昇っている。.mp3]	(<b>東</b>) 東の空に朝日が昇っている。<br> ひがしのそらにあさひがのぼっている。 <br>The morning sun is rising in the east sky.	
継投	[sound:k-2356_継投.mp3]<br>けいとう <br> relieving the (starting) pitcher
relieving the (starting) pitcher	<b>継投<b> <br> けいとう <br>[sound:k-2356_継投.mp3]
[sound:k-2356_継投.mp3]	relieving the<br> <b>starting) pitcher (継投</b> <br> (けいとう)
(<b>関係者</b>) 会議には関係者だけが参加できます。	[sound:s-2356_会議には関係者だけが参加できます。.mp3] <br> かいぎにはかんけいしゃだけがさんかできます。 <br> Only stakeholders can participate in the meeting.
[sound:s-2346_東京は日本の首都です。.mp3]	(<b>東京</b>) 東京は日本の首都です。<br> とうきょうはにほんのしゅとです。 <br>Tokyo is the capital of Japan.	
好投	[sound:k-2357_好投.mp3]<br>こうとう <br> good (nice) pitching
good (nice) pitching	<b>好投<b> <br> こうとう <br>[sound:k-2357_好投.mp3]
[sound:k-2357_好投.mp3]	good<br> <b>nice) pitching (好投</b> <br> (こうとう)
(<b>記者</b>) 彼は新聞社の記者です。	[sound:s-2357_彼は新聞社の記者です。.mp3] <br> かれはしんぶんしゃのきしゃです。 <br> He is a journalist for a newspaper company.
[sound:s-2347_中東地域では石油が豊富に産出されている。.mp3]	(<b>中東</b>) 中東地域では石油が豊富に産出されている。<br> ちゅうとうちいきではせきゆがほうふにさんしゅつされている。 <br>Oil is abundantly produced in the Middle East region.	
投機	[sound:k-2358_投機.mp3]<br>とうき <br> speculation, venture, stockjobbing, gambling (on stocks)
speculation, venture, stockjobbing, gambling (on stocks)	<b>投機<b> <br> とうき <br>[sound:k-2358_投機.mp3]
[sound:k-2358_投機.mp3]	speculation, venture, stockjobbing, gambling<br> <b>on stocks) (投機</b> <br> (とうき)
(<b>業者</b>) 彼は地元の業者と取引しています。	[sound:s-2358_彼は地元の業者と取引しています。.mp3] <br> かれはじもとのぎょうしゃととりひきしています。 <br> He is doing business with local vendors.
[sound:s-2348_東海地域には美しいビーチがたくさんあります。.mp3]	(<b>東海</b>) 東海地域には美しいビーチがたくさんあります。<br> とうかいちいきにはうつくしいビーチがたくさんあります。 <br>The Tokai region has many beautiful beaches.	
投棄	[sound:k-2359_投棄.mp3]<br>とうき <br> abandonment, giving up, throwing away
abandonment, giving up, throwing away	<b>投棄<b> <br> とうき <br>[sound:k-2359_投棄.mp3]
[sound:k-2359_投棄.mp3]	abandonment, giving up, throwing away<br> <b>投棄</b> <br> (とうき)
(<b>容疑者</b>) 彼は殺人容疑で逮捕されました。	[sound:s-2359_彼は殺人容疑で逮捕されました。.mp3] <br> かれはさつじんようぎでたいほされました。 <br> He was arrested on suspicion of murder.
[sound:s-2349_東北地方では冬には雪がよく降ります。.mp3]	(<b>東北</b>) 東北地方では冬には雪がよく降ります。<br> とうほくちほうではふゆにはゆきがよくふります。 <br>Snowfall is frequent in winter in the Tohoku region.	
示す	[sound:k-2360_示す.mp3]<br>しめす <br> to denote, to show, to point out, to indicate, to exemplify
to denote, to show, to point out, to indicate, to exemplify	<b>示す<b> <br> しめす <br>[sound:k-2360_示す.mp3]
[sound:k-2360_示す.mp3]	to denote, to show, to point out, to indicate, to exemplify<br> <b>示す</b> <br> (しめす)
(<b>若者</b>) 若者たちは将来に希望を持っています。	[sound:s-2360_若者たちは将来に希望を持っています。.mp3] <br> わかものたちはしょうらいにきぼうをもっています。 <br> Young people have hope for the future.
[sound:s-2350_東欧諸国の文化は多様で豊かです。.mp3]	(<b>東欧</b>) 東欧諸国の文化は多様で豊かです。<br> とうおうしょこくのぶんかはたようでゆたかです。 <br>The culture of Eastern European countries is diverse and rich.	
指示	[sound:k-2361_指示.mp3]<br>しじ <br> indication, instruction, designation, directions
indication, instruction, designation, directions	<b>指示<b> <br> しじ <br>[sound:k-2361_指示.mp3]
[sound:k-2361_指示.mp3]	indication, instruction, designation, directions<br> <b>指示</b> <br> (しじ)
(<b>消費者</b>) 消費者は製品の品質を求めます。	[sound:s-2361_消費者は製品の品質を求めます。.mp3] <br> しょうひしゃはせいひんのひんしつをもとめます。 <br> Consumers seek product quality.
[sound:s-2351_東西の文化の違いを研究しています。.mp3]	(<b>東西</b>) 東西の文化の違いを研究しています。<br> とうざいのぶんかのちがいをけんきゅうしています。 <br>I am researching the differences between Eastern and Western cultures.	
表示	[sound:k-2362_表示.mp3]<br>ひょうじ <br> indication, expression, display, presentation
indication, expression, display, presentation	<b>表示<b> <br> ひょうじ <br>[sound:k-2362_表示.mp3]
[sound:k-2362_表示.mp3]	indication, expression, display, presentation<br> <b>表示</b> <br> (ひょうじ)
(<b>労働者</b>) 労働者は労働条件の改善を要求しています。	[sound:s-2362_労働者は労働条件の改善を要求しています。.mp3] <br> ろうどうしゃはろうどうじょうけんのかいぜんをようきゅうしています。 <br> Workers are demanding improvements in working conditions.
[sound:s-2352_その国は東南アジアに位置しています。.mp3]	(<b>東南</b>) その国は東南アジアに位置しています。<br> そのくにはとうなんアジアにいちしています。 <br>The country is located in Southeast Asia.	
展示	[sound:k-2363_展示.mp3]<br>てんじ <br> exhibition, display
exhibition, display	<b>展示<b> <br> てんじ <br>[sound:k-2363_展示.mp3]
[sound:k-2363_展示.mp3]	exhibition, display<br> <b>展示</b> <br> (てんじ)
(<b>学者</b>) 彼は著名な歴史学者です。	[sound:s-2363_彼は著名な歴史学者です。.mp3] <br> かれはちょめいなれきしかがくしゃです。 <br> He is a prominent historian.
[sound:s-2353_東芝は電化製品の製造で有名です。.mp3]	(<b>東芝</b>) 東芝は電化製品の製造で有名です。<br> とうしばはでんかせいひんのせいぞうでゆうめいです。 <br>Toshiba is famous for manufacturing electrical appliances.	
開示	[sound:k-2364_開示.mp3]<br>かいじ <br> disclosure (legal)
disclosure (legal)	<b>開示<b> <br> かいじ <br>[sound:k-2364_開示.mp3]
[sound:k-2364_開示.mp3]	disclosure<br> <b>legal) (開示</b> <br> (かいじ)
(<b>経営者</b>) 彼は会社の経営者です。	[sound:s-2364_彼は会社の経営者です。.mp3] <br> かれはかいしゃのけいえいしゃです。 <br> He is the manager of the company.
[sound:s-2354_東洋の文化には古い伝統が根付いています。.mp3]	(<b>東洋</b>) 東洋の文化には古い伝統が根付いています。<br> とうようのぶんかにはふるいでんとうがねづいています。 <br>Eastern culture is rooted in ancient traditions.	
告示	[sound:k-2365_告示.mp3]<br>こくじ <br> notice, bulletin
notice, bulletin	<b>告示<b> <br> こくじ <br>[sound:k-2365_告示.mp3]
[sound:k-2365_告示.mp3]	notice, bulletin<br> <b>告示</b> <br> (こくじ)
(<b>党</b>) 彼は政治党に所属しています。	[sound:s-2365_彼は政治党に所属しています。.mp3] <br> かれはせいじとうにしょぞくしています。 <br> He belongs to a political party.
[sound:s-2355_病院にはたくさんの患者がいる。.mp3]	(<b>患者</b>) 病院にはたくさんの患者がいる。<br> びょういんにはたくさんのかんじゃがいる。 <br>There are many patients in the hospital.	
公示	[sound:k-2366_公示.mp3]<br>こうじ, こうし <br> edict, public announcement
edict, public announcement	<b>公示<b> <br> こうじ, こうし <br>[sound:k-2366_公示.mp3]
[sound:k-2366_公示.mp3]	edict, public announcement<br> <b>公示</b> <br> (こうじ, こうし)
(<b>共産党</b>) その国には共産党が存在します。	[sound:s-2366_その国には共産党が存在します。.mp3] <br> そのくににはきょうさんとうがそんざいします。 <br> There is a communist party in that country.
[sound:s-2356_会議には関係者だけが参加できます。.mp3]	(<b>関係者</b>) 会議には関係者だけが参加できます。<br> かいぎにはかんけいしゃだけがさんかできます。 <br>Only stakeholders can participate in the meeting.	
示し	[sound:k-2367_示し.mp3]<br>しめし <br> discipline, revelation
discipline, revelation	<b>示し<b> <br> しめし <br>[sound:k-2367_示し.mp3]
[sound:k-2367_示し.mp3]	discipline, revelation<br> <b>示し</b> <br> (しめし)
(<b>社会党</b>) 昔は社会党が政権を握っていました。	[sound:s-2367_昔は社会党が政権を握っていました。.mp3] <br> むかしはしゃかいとうがせいけんをにぎっていました。 <br> The socialist party used to hold power in the past.
[sound:s-2357_彼は新聞社の記者です。.mp3]	(<b>記者</b>) 彼は新聞社の記者です。<br> かれはしんぶんしゃのきしゃです。 <br>He is a journalist for a newspaper company.	
提示	[sound:k-2368_提示.mp3]<br>ていじ <br> presentation, exhibit, suggest, citation
presentation, exhibit, suggest, citation	<b>提示<b> <br> ていじ <br>[sound:k-2368_提示.mp3]
[sound:k-2368_提示.mp3]	presentation, exhibit, suggest, citation<br> <b>提示</b> <br> (ていじ)
(<b>新党</b>) 新党が選挙で注目されています。	[sound:s-2368_新党が選挙で注目されています。.mp3] <br> しんとうがせんきょでちゅうもくされています。 <br> The new party is getting attention in the election.
[sound:s-2358_彼は地元の業者と取引しています。.mp3]	(<b>業者</b>) 彼は地元の業者と取引しています。<br> かれはじもとのぎょうしゃととりひきしています。 <br>He is doing business with local vendors.	
意思表示	[sound:k-2369_意思表示.mp3]<br>いしひょうじ <br> declaration of intention
declaration of intention	<b>意思表示<b> <br> いしひょうじ <br>[sound:k-2369_意思表示.mp3]
[sound:k-2369_意思表示.mp3]	declaration of intention<br> <b>意思表示</b> <br> (いしひょうじ)
(<b>政党</b>) 政党間の協力が必要です。	[sound:s-2369_政党間の協力が必要です。.mp3] <br> せいとうかんのきょうりょくがひつようです。 <br> Cooperation between political parties is necessary.
[sound:s-2359_彼は殺人容疑で逮捕されました。.mp3]	(<b>容疑者</b>) 彼は殺人容疑で逮捕されました。<br> かれはさつじんようぎでたいほされました。 <br>He was arrested on suspicion of murder.	
変わった	[sound:k-2370_変わった.mp3]<br>かわった <br> another, different, various, particular, unusual, novel, peculiar
another, different, various, particular, unusual, novel, peculiar	<b>変わった<b> <br> かわった <br>[sound:k-2370_変わった.mp3]
[sound:k-2370_変わった.mp3]	another, different, various, particular, unusual, novel, peculiar<br> <b>変わった</b> <br> (かわった)
(<b>野党</b>) 野党は政府の政策に批判的です。	[sound:s-2370_野党は政府の政策に批判的です。.mp3] <br> やとうはせいふのせいさくにひはんてきです。 <br> The opposition party is critical of the government's policies.
[sound:s-2360_若者たちは将来に希望を持っています。.mp3]	(<b>若者</b>) 若者たちは将来に希望を持っています。<br> わかものたちはしょうらいにきぼうをもっています。 <br>Young people have hope for the future.	
変わらない	[sound:k-2371_変わらない.mp3]<br>かわらない <br> constant, invariant
constant, invariant	<b>変わらない<b> <br> かわらない <br>[sound:k-2371_変わらない.mp3]
[sound:k-2371_変わらない.mp3]	constant, invariant<br> <b>変わらない</b> <br> (かわらない)
(<b>与党</b>) 与党は議会で多数派を占めています。	[sound:s-2371_与党は議会で多数派を占めています。.mp3] <br> よとうはぎかいでたすうはをしめています。 <br> The ruling party holds the majority in parliament.
[sound:s-2361_消費者は製品の品質を求めます。.mp3]	(<b>消費者</b>) 消費者は製品の品質を求めます。<br> しょうひしゃはせいひんのひんしつをもとめます。 <br>Consumers seek product quality.	
変わる	[sound:k-2372_変わる.mp3]<br>かわる <br> to change, to be transformed, to vary, to be revised, to be different, to move location
to change, to be transformed, to vary, to be revised, to be different, to move location	<b>変わる<b> <br> かわる <br>[sound:k-2372_変わる.mp3]
[sound:k-2372_変わる.mp3]	to change, to be transformed, to vary, to be revised, to be different, to move location<br> <b>変わる</b> <br> (かわる)
(<b>自民党</b>) 自民党は日本の主要な政党の一つです。	[sound:s-2372_自民党は日本の主要な政党の一つです。.mp3] <br> じみんとうはにほんのしゅようなせいとうのひとつです。 <br> The Liberal Democratic Party is one of the major political parties in Japan.
[sound:s-2362_労働者は労働条件の改善を要求しています。.mp3]	(<b>労働者</b>) 労働者は労働条件の改善を要求しています。<br> ろうどうしゃはろうどうじょうけんのかいぜんをようきゅうしています。 <br>Workers are demanding improvements in working conditions.	
変わり	[sound:k-2373_変わり.mp3]<br>かわり <br> change, alteration; unusual state or event, accident, abnormality; difference, distinction
change, alteration; unusual state or event, accident, abnormality; difference, distinction	<b>変わり<b> <br> かわり <br>[sound:k-2373_変わり.mp3]
[sound:k-2373_変わり.mp3]	change, alteration; unusual state or event, accident, abnormality; difference, distinction<br> <b>変わり</b> <br> (かわり)
(<b>党首</b>) 彼は党首としてのリーダーシップを発揮している。	[sound:s-2373_彼は党首としてのリーダーシップを発揮している。.mp3] <br> かれはとうしゅとしてのリーダーシップをはっきしている。 <br> He is demonstrating leadership as the party leader.
[sound:s-2363_彼は著名な歴史学者です。.mp3]	(<b>学者</b>) 彼は著名な歴史学者です。<br> かれはちょめいなれきしかがくしゃです。 <br>He is a prominent historian.	
変化	[sound:k-2374_変化.mp3]<br>へんか <br> change, variation, alteration, mutation, transition, transformation, transfiguration, metamorphosis; variety, diversity; inflection, declension, conjugation; sidestepping (sumo)
change, variation, alteration, mutation, transition, transformation, transfiguration, metamorphosis; variety, diversity; inflection, declension, conjugation; sidestepping (sumo)	<b>変化<b> <br> へんか <br>[sound:k-2374_変化.mp3]
[sound:k-2374_変化.mp3]	change, variation, alteration, mutation, transition, transformation, transfiguration, metamorphosis; variety, diversity; inflection, declension, conjugation; sidestepping<br> <b>sumo) (変化</b> <br> (へんか)
(<b>党内</b>) 党内での意見の相違が問題となった。	[sound:s-2374_党内での意見の相違が問題となった。.mp3] <br> とうないでのいけんのそうちがもんだいとなった。 <br> Differences of opinion within the party became an issue.
[sound:s-2364_彼は会社の経営者です。.mp3]	(<b>経営者</b>) 彼は会社の経営者です。<br> かれはかいしゃのけいえいしゃです。 <br>He is the manager of the company.	
大変	[sound:k-2375_大変.mp3]<br>たいへん <br> very, greatly; immense, enormous, great; serious, grave, dreadful, terrible; difficult, hard; major incident, disaster
very, greatly; immense, enormous, great; serious, grave, dreadful, terrible; difficult, hard; major incident, disaster	<b>大変<b> <br> たいへん <br>[sound:k-2375_大変.mp3]
[sound:k-2375_大変.mp3]	very, greatly; immense, enormous, great; serious, grave, dreadful, terrible; difficult, hard; major incident, disaster<br> <b>大変</b> <br> (たいへん)
(<b>地</b>) その地には美しい景色が広がっている。	[sound:s-2375_その地には美しい景色が広がっている。.mp3] <br> そのちにはうつくしいけしきがひろがっている。 <br> Beautiful scenery spreads across that land.
[sound:s-2365_彼は政治党に所属しています。.mp3]	(<b>党</b>) 彼は政治党に所属しています。<br> かれはせいじとうにしょぞくしています。 <br>He belongs to a political party.	
変更	[sound:k-2376_変更.mp3]<br>へんこう <br> change, modification, alteration, revision, amendment
change, modification, alteration, revision, amendment	<b>変更<b> <br> へんこう <br>[sound:k-2376_変更.mp3]
[sound:k-2376_変更.mp3]	change, modification, alteration, revision, amendment<br> <b>変更</b> <br> (へんこう)
(<b>現地</b>) 現地の状況を確認するために訪問しました。	[sound:s-2376_現地の状況を確認するために訪問しました。.mp3] <br> げんちのじょうきょうをかくにんするためにほうもんしました。 <br> I visited to confirm the situation on the ground.
[sound:s-2366_その国には共産党が存在します。.mp3]	(<b>共産党</b>) その国には共産党が存在します。<br> そのくににはきょうさんとうがそんざいします。 <br>There is a communist party in that country.	
変動	[sound:k-2377_変動.mp3]<br>へんどう <br> change, fluctuation
change, fluctuation	<b>変動<b> <br> へんどう <br>[sound:k-2377_変動.mp3]
[sound:k-2377_変動.mp3]	change, fluctuation<br> <b>変動</b> <br> (へんどう)
(<b>地域</b>) その地域では伝統的な祭りが行われています。	[sound:s-2377_その地域では伝統的な祭りが行われています。.mp3] <br> そのちいきではでんとうてきなまつりがおこなわれています。 <br> Traditional festivals are held in that region.
[sound:s-2367_昔は社会党が政権を握っていました。.mp3]	(<b>社会党</b>) 昔は社会党が政権を握っていました。<br> むかしはしゃかいとうがせいけんをにぎっていました。 <br>The socialist party used to hold power in the past.	
変	[sound:k-2378_変.mp3]<br>へん <br> strange, odd, peculiar, weird, curious, queer, eccentric, funny, suspicious, fishy; unexpected; change; incident, disturbance, disaster, accident; flat (music)
strange, odd, peculiar, weird, curious, queer, eccentric, funny, suspicious, fishy; unexpected; change; incident, disturbance, disaster, accident; flat (music)	<b>変<b> <br> へん <br>[sound:k-2378_変.mp3]
[sound:k-2378_変.mp3]	strange, odd, peculiar, weird, curious, queer, eccentric, funny, suspicious, fishy; unexpected; change; incident, disturbance, disaster, accident; flat<br> <b>music) (変</b> <br> (へん)
(<b>地球</b>) 地球は私たちの唯一の家です。	[sound:s-2378_地球は私たちの唯一の家です。.mp3] <br> ちきゅうはわたしたちのゆいつのいえです。 <br> The Earth is our only home.
[sound:s-2368_新党が選挙で注目されています。.mp3]	(<b>新党</b>) 新党が選挙で注目されています。<br> しんとうがせんきょでちゅうもくされています。 <br>The new party is getting attention in the election.	
変革	[sound:k-2379_変革.mp3]<br>へんかく <br> change, reform, revolution, upheaval; Reformation
change, reform, revolution, upheaval; Reformation	<b>変革<b> <br> へんかく <br>[sound:k-2379_変革.mp3]
[sound:k-2379_変革.mp3]	change, reform, revolution, upheaval; Reformation<br> <b>変革</b> <br> (へんかく)
(<b>地区</b>) この地区は治安が良い。	[sound:s-2379_この地区は治安が良い。.mp3] <br> このちくはちあんがよい。 <br> This district has good public safety.
[sound:s-2369_政党間の協力が必要です。.mp3]	(<b>政党</b>) 政党間の協力が必要です。<br> せいとうかんのきょうりょくがひつようです。 <br>Cooperation between political parties is necessary.	
打つ	[sound:k-2380_打つ.mp3]<br>うつ <br> to hit (something inanimate), to strike, to beat (on something); to type, to tap (e.g. a key); to inject; to indulge in gambling; to visit (on a pilgrimage)
to hit (something inanimate), to strike, to beat (on something); to type, to tap (e.g. a key); to inject; to indulge in gambling; to visit (on a pilgrimage)	<b>打つ<b> <br> うつ <br>[sound:k-2380_打つ.mp3]
[sound:k-2380_打つ.mp3]	to hit<br> <b>something inanimate), to strike, to beat (on something); to type, to tap (e.g. a key); to inject; to indulge in gambling; to visit (on a pilgrimage) (打つ</b> <br> (うつ)
(<b>地元</b>) 彼女は地元の新聞で有名なジャーナリストです。	[sound:s-2380_彼女は地元の新聞で有名なジャーナリストです。.mp3] <br> かのじょはじもとのしんぶんでゆうめいなジャーナリストです。 <br> She is a famous journalist in the local newspaper.
[sound:s-2370_野党は政府の政策に批判的です。.mp3]	(<b>野党</b>) 野党は政府の政策に批判的です。<br> やとうはせいふのせいさくにひはんてきです。 <br>The opposition party is critical of the government's policies.	
本塁打	[sound:k-2381_本塁打.mp3]<br>ほんるいだ <br> home run (baseball)
home run (baseball)	<b>本塁打<b> <br> ほんるいだ <br>[sound:k-2381_本塁打.mp3]
[sound:k-2381_本塁打.mp3]	home run<br> <b>baseball) (本塁打</b> <br> (ほんるいだ)
(<b>地方</b>) 田舎の地方ではのどかな生活が送れます。	[sound:s-2381_田舎の地方ではのどかな生活が送れます。.mp3] <br> いなかのちほうではのどかなせいかつがおくれます。 <br> You can lead a peaceful life in rural areas.
[sound:s-2371_与党は議会で多数派を占めています。.mp3]	(<b>与党</b>) 与党は議会で多数派を占めています。<br> よとうはぎかいでたすうはをしめています。 <br>The ruling party holds the majority in parliament.	
打撃	[sound:k-2382_打撃.mp3]<br>だげき <br> blow, shock, strike, damage; batting (baseball)
blow, shock, strike, damage; batting (baseball)	<b>打撃<b> <br> だげき <br>[sound:k-2382_打撃.mp3]
[sound:k-2382_打撃.mp3]	blow, shock, strike, damage; batting<br> <b>baseball) (打撃</b> <br> (だげき)
(<b>土地</b>) 彼は新しい土地に家を建てる予定です。	[sound:s-2382_彼は新しい土地に家を建てる予定です。.mp3] <br> かれはあたらしいとちにいえをたてるよていです。 <br> He plans to build a house on the new land.
[sound:s-2372_自民党は日本の主要な政党の一つです。.mp3]	(<b>自民党</b>) 自民党は日本の主要な政党の一つです。<br> じみんとうはにほんのしゅようなせいとうのひとつです。 <br>The Liberal Democratic Party is one of the major political parties in Japan.	
打線	[sound:k-2383_打線.mp3]<br>だせん <br> baseball lineup
baseball lineup	<b>打線<b> <br> だせん <br>[sound:k-2383_打線.mp3]
[sound:k-2383_打線.mp3]	baseball lineup<br> <b>打線</b> <br> (だせん)
(<b>基地</b>) その地域には軍事基地があります。	[sound:s-2383_その地域には軍事基地があります。.mp3] <br> そのちいきにはぐんじきちがあります。 <br> There are military bases in the region.
[sound:s-2373_彼は党首としてのリーダーシップを発揮している。.mp3]	(<b>党首</b>) 彼は党首としてのリーダーシップを発揮している。<br> かれはとうしゅとしてのリーダーシップをはっきしている。 <br>He is demonstrating leadership as the party leader.	
安打	[sound:k-2384_安打.mp3]<br>あんだ <br> safe hit (baseball)
safe hit (baseball)	<b>安打<b> <br> あんだ <br>[sound:k-2384_安打.mp3]
[sound:k-2384_安打.mp3]	safe hit<br> <b>baseball) (安打</b> <br> (あんだ)
(<b>送る</b>) 彼は手紙を送った。	[sound:s-2384_彼は手紙を送った。.mp3] <br> かれはてがみをおくった。 <br> He sent a letter.
[sound:s-2374_党内での意見の相違が問題となった。.mp3]	(<b>党内</b>) 党内での意見の相違が問題となった。<br> とうないでのいけんのそうちがもんだいとなった。 <br>Differences of opinion within the party became an issue.	
打者	[sound:k-2385_打者.mp3]<br>だしゃ <br> batter (baseball)
batter (baseball)	<b>打者<b> <br> だしゃ <br>[sound:k-2385_打者.mp3]
[sound:k-2385_打者.mp3]	batter<br> <b>baseball) (打者</b> <br> (だしゃ)
(<b>放送</b>) テレビでニュースが放送される。	[sound:s-2385_テレビでニュースが放送される。.mp3] <br> てれびでニュースがほうそうされる。 <br> The news is broadcasted on TV.
[sound:s-2375_その地には美しい景色が広がっている。.mp3]	(<b>地</b>) その地には美しい景色が広がっている。<br> そのちにはうつくしいけしきがひろがっている。 <br>Beautiful scenery spreads across that land.	
二塁打	[sound:k-2386_二塁打.mp3]<br>にるいだ <br> two-base hit, double
two-base hit, double	<b>二塁打<b> <br> にるいだ <br>[sound:k-2386_二塁打.mp3]
[sound:k-2386_二塁打.mp3]	two-base hit, double<br> <b>二塁打</b> <br> (にるいだ)
(<b>輸送</b>) 車は貨物を輸送する。	[sound:s-2386_車は貨物を輸送する。.mp3] <br> くるまはかもつをゆそうする。 <br> The car transports goods.
[sound:s-2376_現地の状況を確認するために訪問しました。.mp3]	(<b>現地</b>) 現地の状況を確認するために訪問しました。<br> げんちのじょうきょうをかくにんするためにほうもんしました。 <br>I visited to confirm the situation on the ground.	
打席	[sound:k-2387_打席.mp3]<br>だせき <br> batter's box (baseball), one's turn at bat
batter's box (baseball), one's turn at bat	<b>打席<b> <br> だせき <br>[sound:k-2387_打席.mp3]
[sound:k-2387_打席.mp3]	batter's box<br> <b>baseball), one's turn at bat (打席</b> <br> (だせき)
(<b>送り</b>) 彼は友人を空港まで送りました。	[sound:s-2387_彼は友人を空港まで送りました。.mp3] <br> かれはゆうじんをくうこうまでおくりました。 <br> He saw his friend off to the airport.
[sound:s-2377_その地域では伝統的な祭りが行われています。.mp3]	(<b>地域</b>) その地域では伝統的な祭りが行われています。<br> そのちいきではでんとうてきなまつりがおこなわれています。 <br>Traditional festivals are held in that region.	
打ち上げ	[sound:k-2388_打ち上げ.mp3]<br>うちあげ <br> launch
launch	<b>打ち上げ<b> <br> うちあげ <br>[sound:k-2388_打ち上げ.mp3]
[sound:k-2388_打ち上げ.mp3]	launch<br> <b>打ち上げ</b> <br> (うちあげ)
(<b>先送り</b>) 彼は仕事を先送りすることが多い。	[sound:s-2388_彼は仕事を先送りすることが多い。.mp3] <br> かれはしごとをさきおくりすることがおおい。 <br> He often postpones work.
[sound:s-2378_地球は私たちの唯一の家です。.mp3]	(<b>地球</b>) 地球は私たちの唯一の家です。<br> ちきゅうはわたしたちのゆいつのいえです。 <br>The Earth is our only home.	
打開	[sound:k-2389_打開.mp3]<br>だかい <br> break in the deadlock
break in the deadlock	<b>打開<b> <br> だかい <br>[sound:k-2389_打開.mp3]
[sound:k-2389_打開.mp3]	break in the deadlock<br> <b>打開</b> <br> (だかい)
(<b>見送り</b>) 彼女は彼を駅まで見送った。	[sound:s-2389_彼女は彼を駅まで見送った。.mp3] <br> かのじょはかれをえきまでみおくった。 <br> She saw him off at the station.
[sound:s-2379_この地区は治安が良い。.mp3]	(<b>地区</b>) この地区は治安が良い。<br> このちくはちあんがよい。 <br>This district has good public safety.	
男	[sound:k-2390_男.mp3]<br>おとこ <br> man
man	<b>男<b> <br> おとこ <br>[sound:k-2390_男.mp3]
[sound:k-2390_男.mp3]	man<br> <b>男</b> <br> (おとこ)
(<b>見送る</b>) 私は友人を見送るのが好きです。	[sound:s-2390_私は友人を見送るのが好きです。.mp3] <br> わたしはゆうじんをみおくるのがすきです。 <br> I like seeing off my friends.
[sound:s-2380_彼女は地元の新聞で有名なジャーナリストです。.mp3]	(<b>地元</b>) 彼女は地元の新聞で有名なジャーナリストです。<br> かのじょはじもとのしんぶんでゆうめいなジャーナリストです。 <br>She is a famous journalist in the local newspaper.	
男子	[sound:k-2391_男子.mp3]<br>だんし <br> youth, young man
youth, young man	<b>男子<b> <br> だんし <br>[sound:k-2391_男子.mp3]
[sound:k-2391_男子.mp3]	youth, young man<br> <b>男子</b> <br> (だんし)
(<b>運送</b>) 運送業者が荷物を配達する。	[sound:s-2391_運送業者が荷物を配達する。.mp3] <br> うんそうぎょうしゃがにもつをはいたつする。 <br> The transportation company delivers packages.
[sound:s-2381_田舎の地方ではのどかな生活が送れます。.mp3]	(<b>地方</b>) 田舎の地方ではのどかな生活が送れます。<br> いなかのちほうではのどかなせいかつがおくれます。 <br>You can lead a peaceful life in rural areas.	
男性	[sound:k-2392_男性.mp3]<br>だんせい <br> man, male; masculine gender
man, male; masculine gender	<b>男性<b> <br> だんせい <br>[sound:k-2392_男性.mp3]
[sound:k-2392_男性.mp3]	man, male; masculine gender<br> <b>男性</b> <br> (だんせい)
(<b>送金</b>) 銀行を通じて送金する。	[sound:s-2392_銀行を通じて送金する。.mp3] <br> ぎんこうをつうじてそうきんする。 <br> Transfer money through the bank.
[sound:s-2382_彼は新しい土地に家を建てる予定です。.mp3]	(<b>土地</b>) 彼は新しい土地に家を建てる予定です。<br> かれはあたらしいとちにいえをたてるよていです。 <br>He plans to build a house on the new land.	
長男	[sound:k-2393_長男.mp3]<br>ちょうなん <br> eldest son
eldest son	<b>長男<b> <br> ちょうなん <br>[sound:k-2393_長男.mp3]
[sound:k-2393_長男.mp3]	eldest son<br> <b>長男</b> <br> (ちょうなん)
(<b>郵送</b>) 書類を郵送で送る。	[sound:s-2393_書類を郵送で送る。.mp3] <br> しょるいをゆうそうでおくる。 <br> Send documents by mail.
[sound:s-2383_その地域には軍事基地があります。.mp3]	(<b>基地</b>) その地域には軍事基地があります。<br> そのちいきにはぐんじきちがあります。 <br>There are military bases in the region.	
男女	[sound:k-2394_男女.mp3]<br>だんじょ <br> man and woman, men and women
man and woman, men and women	<b>男女<b> <br> だんじょ <br>[sound:k-2394_男女.mp3]
[sound:k-2394_男女.mp3]	man and woman, men and women<br> <b>男女</b> <br> (だんじょ)
(<b>援助</b>) 被災者に援助を提供する。	[sound:s-2394_被災者に援助を提供する。.mp3] <br> ひさいしゃにえんじょをていきょうする。 <br> Provide assistance to the disaster victims.
[sound:s-2384_彼は手紙を送った。.mp3]	(<b>送る</b>) 彼は手紙を送った。<br> かれはてがみをおくった。 <br>He sent a letter.	
男の子	[sound:k-2395_男の子.mp3]<br>おとこのこ, おとこのコ <br> boy, male child, baby boy
boy, male child, baby boy	<b>男の子<b> <br> おとこのこ, おとこのコ <br>[sound:k-2395_男の子.mp3]
[sound:k-2395_男の子.mp3]	boy, male child, baby boy<br> <b>男の子</b> <br> (おとこのこ, おとこのコ)
(<b>支援</b>) 困っている人々に支援をする。	[sound:s-2395_困っている人々に支援をする。.mp3] <br> こまっているひとびとにしえんをする。 <br> Support people in need.
[sound:s-2385_テレビでニュースが放送される。.mp3]	(<b>放送</b>) テレビでニュースが放送される。<br> てれびでニュースがほうそうされる。 <br>The news is broadcasted on TV.	
三男	[sound:k-2396_三男.mp3]<br>さんなん <br> three men, third son
three men, third son	<b>三男<b> <br> さんなん <br>[sound:k-2396_三男.mp3]
[sound:k-2396_三男.mp3]	three men, third son<br> <b>三男</b> <br> (さんなん)
(<b>応援</b>) スポーツチームを応援する。	[sound:s-2396_スポーツチームを応援する。.mp3] <br> すぽーつちーむをおうえんする。 <br> Cheer for the sports team.
[sound:s-2386_車は貨物を輸送する。.mp3]	(<b>輸送</b>) 車は貨物を輸送する。<br> くるまはかもつをゆそうする。 <br>The car transports goods.	
男児	[sound:k-2397_男児.mp3]<br>だんじ <br> boy, son, man
boy, son, man	<b>男児<b> <br> だんじ <br>[sound:k-2397_男児.mp3]
[sound:k-2397_男児.mp3]	boy, son, man<br> <b>男児</b> <br> (だんじ)
(<b>救援</b>) 災害地域に救援物資を送る。	[sound:s-2397_災害地域に救援物資を送る。.mp3] <br> さいがいちいきにきゅうえんぶっしをおくる。 <br> Send relief supplies to the disaster area.
[sound:s-2387_彼は友人を空港まで送りました。.mp3]	(<b>送り</b>) 彼は友人を空港まで送りました。<br> かれはゆうじんをくうこうまでおくりました。 <br>He saw his friend off to the airport.	
一男	[sound:k-2398_一男.mp3]<br>いちなん <br> boy, eldest son
boy, eldest son	<b>一男<b> <br> いちなん <br>[sound:k-2398_一男.mp3]
[sound:k-2398_一男.mp3]	boy, eldest son<br> <b>一男</b> <br> (いちなん)
(<b>後援</b>) このプロジェクトは企業の後援を受けています。	[sound:s-2398_このプロジェクトは企業の後援を受けています。.mp3] <br> このプロジェクトはきぎょうのこうえんをうけています。 <br> This project is sponsored by the company.
[sound:s-2388_彼は仕事を先送りすることが多い。.mp3]	(<b>先送り</b>) 彼は仕事を先送りすることが多い。<br> かれはしごとをさきおくりすることがおおい。 <br>He often postpones work.	
男優	[sound:k-2399_男優.mp3]<br>だんゆう <br> actor
actor	<b>男優<b> <br> だんゆう <br>[sound:k-2399_男優.mp3]
[sound:k-2399_男優.mp3]	actor<br> <b>男優</b> <br> (だんゆう)
(<b>援護</b>) 老人施設では援護が提供されています。	[sound:s-2399_老人施設では援護が提供されています。.mp3] <br> ろうじんしせつではえんごがていきょうされています。 <br> Assistance is provided at the elderly care facility.
[sound:s-2389_彼女は彼を駅まで見送った。.mp3]	(<b>見送り</b>) 彼女は彼を駅まで見送った。<br> かのじょはかれをえきまでみおくった。 <br>She saw him off at the station.	
基本	[sound:k-2400_基本.mp3]<br>きほん <br> foundation, basis, standard
foundation, basis, standard	<b>基本<b> <br> きほん <br>[sound:k-2400_基本.mp3]
[sound:k-2400_基本.mp3]	foundation, basis, standard<br> <b>基本</b> <br> (きほん)
(<b>声援</b>) 彼は大歓声の中、選手たちに声援を送った。	[sound:s-2400_彼は大歓声の中、選手たちに声援を送った。.mp3] <br> かれはだいかんせいのなか、せんしゅたちにせいえんをおくった。 <br> Amidst the loud cheers, he cheered for the players.
[sound:s-2390_私は友人を見送るのが好きです。.mp3]	(<b>見送る</b>) 私は友人を見送るのが好きです。<br> わたしはゆうじんをみおくるのがすきです。 <br>I like seeing off my friends.	
基準	[sound:k-2401_基準.mp3]<br>きじゅん <br> standard, basis, criterion, norm, reference, datum
standard, basis, criterion, norm, reference, datum	<b>基準<b> <br> きじゅん <br>[sound:k-2401_基準.mp3]
[sound:k-2401_基準.mp3]	standard, basis, criterion, norm, reference, datum<br> <b>基準</b> <br> (きじゅん)
(<b>義援金</b>) 被災地に義援金を寄付する。	[sound:s-2401_被災地に義援金を寄付する。.mp3] <br> ひさいちにぎえんきんをきふする。 <br> Donate relief funds to the disaster area.
[sound:s-2391_運送業者が荷物を配達する。.mp3]	(<b>運送</b>) 運送業者が荷物を配達する。<br> うんそうぎょうしゃがにもつをはいたつする。 <br>The transportation company delivers packages.	
基金	[sound:k-2402_基金.mp3]<br>ききん <br> fund, foundation
fund, foundation	<b>基金<b> <br> ききん <br>[sound:k-2402_基金.mp3]
[sound:k-2402_基金.mp3]	fund, foundation<br> <b>基金</b> <br> (ききん)
(<b>援軍</b>) 戦場に援軍が到着した。	[sound:s-2402_戦場に援軍が到着した。.mp3] <br> せんじょうにえんぐんがとうちゃくした。 <br> Reinforcements have arrived at the battlefield.
[sound:s-2392_銀行を通じて送金する。.mp3]	(<b>送金</b>) 銀行を通じて送金する。<br> ぎんこうをつうじてそうきんする。 <br>Transfer money through the bank.	
基礎	[sound:k-2403_基礎.mp3]<br>きそ <br> foundation, basis
foundation, basis	<b>基礎<b> <br> きそ <br>[sound:k-2403_基礎.mp3]
[sound:k-2403_基礎.mp3]	foundation, basis<br> <b>基礎</b> <br> (きそ)
(<b>無援</b>) 彼は孤立して無援の状態にある。	[sound:s-2403_彼は孤立して無援の状態にある。.mp3] <br> かれはこりつしてむえんのじょうたいにある。 <br> He is in a state of isolation without support.
[sound:s-2393_書類を郵送で送る。.mp3]	(<b>郵送</b>) 書類を郵送で送る。<br> しょるいをゆうそうでおくる。 <br>Send documents by mail.	
基地	[sound:k-2404_基地.mp3]<br>きち <br> base
base	<b>基地<b> <br> きち <br>[sound:k-2404_基地.mp3]
[sound:k-2404_基地.mp3]	base<br> <b>基地</b> <br> (きち)
(<b>子供</b>) 彼女は二人の子供を育てています。	[sound:s-2404_彼女は二人の子供を育てています。.mp3] <br> かのじょはふたりのこどもをそだてています。 <br> She is raising two children.
[sound:s-2394_被災者に援助を提供する。.mp3]	(<b>援助</b>) 被災者に援助を提供する。<br> ひさいしゃにえんじょをていきょうする。 <br>Provide assistance to the disaster victims.	
基盤	[sound:k-2405_基盤.mp3]<br>きばん <br> foundation, basis, base, footing
foundation, basis, base, footing	<b>基盤<b> <br> きばん <br>[sound:k-2405_基盤.mp3]
[sound:k-2405_基盤.mp3]	foundation, basis, base, footing<br> <b>基盤</b> <br> (きばん)
(<b>供給</b>) 食料の供給が途絶えた。	[sound:s-2405_食料の供給が途絶えた。.mp3] <br> しょくりょうのきょうきゅうがとだえた。 <br> The supply of food has been cut off.
[sound:s-2395_困っている人々に支援をする。.mp3]	(<b>支援</b>) 困っている人々に支援をする。<br> こまっているひとびとにしえんをする。 <br>Support people in need.	
基本的	[sound:k-2406_基本的.mp3]<br>きほんてき <br> fundamental, standard, basic
fundamental, standard, basic	<b>基本的<b> <br> きほんてき <br>[sound:k-2406_基本的.mp3]
[sound:k-2406_基本的.mp3]	fundamental, standard, basic<br> <b>基本的</b> <br> (きほんてき)
(<b>提供</b>) 彼は無料でサービスを提供しています。	[sound:s-2406_彼は無料でサービスを提供しています。.mp3] <br> かれはむりょうでさーびすをていきょうしています。 <br> He provides services for free.
[sound:s-2396_スポーツチームを応援する。.mp3]	(<b>応援</b>) スポーツチームを応援する。<br> すぽーつちーむをおうえんする。 <br>Cheer for the sports team.	
基調	[sound:k-2407_基調.mp3]<br>きちょう <br> basis, keynote
basis, keynote	<b>基調<b> <br> きちょう <br>[sound:k-2407_基調.mp3]
[sound:k-2407_基調.mp3]	basis, keynote<br> <b>基調</b> <br> (きちょう)
(<b>供与</b>) 彼は彼の財産を慈善事業に供与した。	[sound:s-2407_彼は彼の財産を慈善事業に供与した。.mp3] <br> かれはかれのざいさんをじぜんじぎょうにきょうよした。 <br> He donated his property to charity.
[sound:s-2397_災害地域に救援物資を送る。.mp3]	(<b>救援</b>) 災害地域に救援物資を送る。<br> さいがいちいきにきゅうえんぶっしをおくる。 <br>Send relief supplies to the disaster area.	
基幹	[sound:k-2408_基幹.mp3]<br>きかん <br> mainstay, nucleus, key
mainstay, nucleus, key	<b>基幹<b> <br> きかん <br>[sound:k-2408_基幹.mp3]
[sound:k-2408_基幹.mp3]	mainstay, nucleus, key<br> <b>基幹</b> <br> (きかん)
(<b>供述</b>) 被告は事件の詳細を供述した。	[sound:s-2408_被告は事件の詳細を供述した。.mp3] <br> ひこくはじけんのしょうさいをきょうじゅつした。 <br> The defendant provided a detailed account of the incident.
[sound:s-2398_このプロジェクトは企業の後援を受けています。.mp3]	(<b>後援</b>) このプロジェクトは企業の後援を受けています。<br> このプロジェクトはきぎょうのこうえんをうけています。 <br>This project is sponsored by the company.	
基軸	[sound:k-2409_基軸.mp3]<br>きじく <br> key, yardstick, criterion, standard
key, yardstick, criterion, standard	<b>基軸<b> <br> きじく <br>[sound:k-2409_基軸.mp3]
[sound:k-2409_基軸.mp3]	key, yardstick, criterion, standard<br> <b>基軸</b> <br> (きじく)
(<b>供</b>) 彼は家族のために生活費を供給する。	[sound:s-2409_彼は家族のために生活費を供給する。.mp3] <br> かれはかぞくのためにせいかつひをきょうきゅうする。 <br> He provides living expenses for his family.
[sound:s-2399_老人施設では援護が提供されています。.mp3]	(<b>援護</b>) 老人施設では援護が提供されています。<br> ろうじんしせつではえんごがていきょうされています。 <br>Assistance is provided at the elderly care facility.	
私	[sound:k-2410_私.mp3]<br>わたし, わたくし <br> I, me; private affairs, personal matter, secrecy; selfishness
I, me; private affairs, personal matter, secrecy; selfishness	<b>私<b> <br> わたし, わたくし <br>[sound:k-2410_私.mp3]
[sound:k-2410_私.mp3]	I, me; private affairs, personal matter, secrecy; selfishness<br> <b>私</b> <br> (わたし, わたくし)
(<b>提供者</b>) 彼は地元の学校に寄付をする提供者です。	[sound:s-2410_彼は地元の学校に寄付をする提供者です。.mp3] <br> かれはじもとのがっこうにきふをするていきょうしゃです。 <br> He is a donor who contributes to the local school.
[sound:s-2400_彼は大歓声の中、選手たちに声援を送った。.mp3]	(<b>声援</b>) 彼は大歓声の中、選手たちに声援を送った。<br> かれはだいかんせいのなか、せんしゅたちにせいえんをおくった。 <br>Amidst the loud cheers, he cheered for the players.	
私立	[sound:k-2411_私立.mp3]<br>しりつ, わたくしりつ <br> private (establishment)
private (establishment)	<b>私立<b> <br> しりつ, わたくしりつ <br>[sound:k-2411_私立.mp3]
[sound:k-2411_私立.mp3]	private<br> <b>establishment) (私立</b> <br> (しりつ, わたくしりつ)
(<b>供養</b>) 亡くなった祖父母のために供養を行う。	[sound:s-2411_亡くなった祖父母のために供養を行う。.mp3] <br> なくなったそふぼのためにくようをおこなう。 <br> Perform a memorial service for deceased grandparents.
[sound:s-2401_被災地に義援金を寄付する。.mp3]	(<b>義援金</b>) 被災地に義援金を寄付する。<br> ひさいちにぎえんきんをきふする。 <br>Donate relief funds to the disaster area.	
私邸	[sound:k-2412_私邸.mp3]<br>してい <br> private residence
private residence	<b>私邸<b> <br> してい <br>[sound:k-2412_私邸.mp3]
[sound:k-2412_私邸.mp3]	private residence<br> <b>私邸</b> <br> (してい)
(<b>供給源</b>) 飲料水の供給源が枯渇しています。	[sound:s-2412_飲料水の供給源が枯渇しています。.mp3] <br> いんりょうすいのきょうきゅうげんがこかつしています。 <br> The source of drinking water is running dry.
[sound:s-2402_戦場に援軍が到着した。.mp3]	(<b>援軍</b>) 戦場に援軍が到着した。<br> せんじょうにえんぐんがとうちゃくした。 <br>Reinforcements have arrived at the battlefield.	
私的	[sound:k-2413_私的.mp3]<br>してき <br> personal, private, proprietary
personal, private, proprietary	<b>私的<b> <br> してき <br>[sound:k-2413_私的.mp3]
[sound:k-2413_私的.mp3]	personal, private, proprietary<br> <b>私的</b> <br> (してき)
(<b>自供</b>) 犯人は自供して罪を認めた。	[sound:s-2413_犯人は自供して罪を認めた。.mp3] <br> はんにんはじきょうしてつみをみとめた。 <br> The culprit confessed to the crime.
[sound:s-2403_彼は孤立して無援の状態にある。.mp3]	(<b>無援</b>) 彼は孤立して無援の状態にある。<br> かれはこりつしてむえんのじょうたいにある。 <br>He is in a state of isolation without support.	
私鉄	[sound:k-2414_私鉄.mp3]<br>してつ <br> private railway
private railway	<b>私鉄<b> <br> してつ <br>[sound:k-2414_私鉄.mp3]
[sound:k-2414_私鉄.mp3]	private railway<br> <b>私鉄</b> <br> (してつ)
(<b>可</b>) その計画は実行可能だ。	[sound:s-2414_その計画は実行可能だ。.mp3] <br> そのけいかくはじっこうかのうだ。 <br> The plan is feasible.
[sound:s-2404_彼女は二人の子供を育てています。.mp3]	(<b>子供</b>) 彼女は二人の子供を育てています。<br> かのじょはふたりのこどもをそだてています。 <br>She is raising two children.	
公私	[sound:k-2415_公私.mp3]<br>こうし <br> public and private, official and personal, government and people
public and private, official and personal, government and people	<b>公私<b> <br> こうし <br>[sound:k-2415_公私.mp3]
[sound:k-2415_公私.mp3]	public and private, official and personal, government and people<br> <b>公私</b> <br> (こうし)
(<b>可能</b>) 人間には驚くほどの可能性がある。	[sound:s-2415_人間には驚くほどの可能性がある。.mp3] <br> にんげんにはおどろくほどのかのうせいがある。 <br> Humans have incredible potential.
[sound:s-2405_食料の供給が途絶えた。.mp3]	(<b>供給</b>) 食料の供給が途絶えた。<br> しょくりょうのきょうきゅうがとだえた。 <br>The supply of food has been cut off.	
私有	[sound:k-2416_私有.mp3]<br>しゆう <br> private ownership
private ownership	<b>私有<b> <br> しゆう <br>[sound:k-2416_私有.mp3]
[sound:k-2416_私有.mp3]	private ownership<br> <b>私有</b> <br> (しゆう)
(<b>可能性</b>) 彼の成功の可能性は高い。	[sound:s-2416_彼の成功の可能性は高い。.mp3] <br> かれのせいこうのかのうせいはたかい。 <br> There is a high possibility of his success.
[sound:s-2406_彼は無料でサービスを提供しています。.mp3]	(<b>提供</b>) 彼は無料でサービスを提供しています。<br> かれはむりょうでさーびすをていきょうしています。 <br>He provides services for free.	
私学	[sound:k-2417_私学.mp3]<br>しがく <br> private (non-governmental) school (college, university)
private (non-governmental) school (college, university)	<b>私学<b> <br> しがく <br>[sound:k-2417_私学.mp3]
[sound:k-2417_私学.mp3]	private<br> <b>non-governmental) school (college, university) (私学</b> <br> (しがく)
(<b>許可</b>) 工事の許可を申請する。	[sound:s-2417_工事の許可を申請する。.mp3] <br> こうじのきょかをしんせいする。 <br> Apply for permission for construction.
[sound:s-2407_彼は彼の財産を慈善事業に供与した。.mp3]	(<b>供与</b>) 彼は彼の財産を慈善事業に供与した。<br> かれはかれのざいさんをじぜんじぎょうにきょうよした。 <br>He donated his property to charity.	
私文書	[sound:k-2418_私文書.mp3]<br>しぶんしょ <br> private document
private document	<b>私文書<b> <br> しぶんしょ <br>[sound:k-2418_私文書.mp3]
[sound:k-2418_私文書.mp3]	private document<br> <b>私文書</b> <br> (しぶんしょ)
(<b>可笑しい</b>) 彼の冗談はいつも可笑しい。	[sound:s-2418_彼の冗談はいつも可笑しい。.mp3] <br> かれのじょうだんはいつもおかしい。 <br> His jokes are always funny.
[sound:s-2408_被告は事件の詳細を供述した。.mp3]	(<b>供述</b>) 被告は事件の詳細を供述した。<br> ひこくはじけんのしょうさいをきょうじゅつした。 <br>The defendant provided a detailed account of the incident.	
私設	[sound:k-2419_私設.mp3]<br>しせつ <br> private
private	<b>私設<b> <br> しせつ <br>[sound:k-2419_私設.mp3]
[sound:k-2419_私設.mp3]	private<br> <b>私設</b> <br> (しせつ)
(<b>認可</b>) このアプリは利用が認可されています。	[sound:s-2419_このアプリは利用が認可されています。.mp3] <br> このアプリはりようがにんかされています。 <br> This app is approved for use.
[sound:s-2409_彼は家族のために生活費を供給する。.mp3]	(<b>供</b>) 彼は家族のために生活費を供給する。<br> かれはかぞくのためにせいかつひをきょうきゅうする。 <br>He provides living expenses for his family.	
各自	[sound:k-2420_各自.mp3]<br>かくじ <br> individual, each
individual, each	<b>各自<b> <br> かくじ <br>[sound:k-2420_各自.mp3]
[sound:k-2420_各自.mp3]	individual, each<br> <b>各自</b> <br> (かくじ)
(<b>不可欠</b>) 健康のために睡眠は不可欠だ。	[sound:s-2420_健康のために睡眠は不可欠だ。.mp3] <br> けんこうのためにすいみんはふかけつだ。 <br> Sleep is essential for health.
[sound:s-2410_彼は地元の学校に寄付をする提供者です。.mp3]	(<b>提供者</b>) 彼は地元の学校に寄付をする提供者です。<br> かれはじもとのがっこうにきふをするていきょうしゃです。 <br>He is a donor who contributes to the local school.	
各種学校	[sound:k-2421_各種学校.mp3]<br>かくしゅがっこう <br> vocational school
vocational school	<b>各種学校<b> <br> かくしゅがっこう <br>[sound:k-2421_各種学校.mp3]
[sound:k-2421_各種学校.mp3]	vocational school<br> <b>各種学校</b> <br> (かくしゅがっこう)
(<b>不可能</b>) その任務は不可能だと思われていた。	[sound:s-2421_その任務は不可能だと思われていた。.mp3] <br> そのにんむはふかのうだとおもわれていた。 <br> The task was thought to be impossible.
[sound:s-2411_亡くなった祖父母のために供養を行う。.mp3]	(<b>供養</b>) 亡くなった祖父母のために供養を行う。<br> なくなったそふぼのためにくようをおこなう。 <br>Perform a memorial service for deceased grandparents.	
各位	[sound:k-2422_各位.mp3]<br>かくい <br> everyone, ladies and gentlemen; attention media representatives (e.g. heading on a press release)
everyone, ladies and gentlemen; attention media representatives (e.g. heading on a press release)	<b>各位<b> <br> かくい <br>[sound:k-2422_各位.mp3]
[sound:k-2422_各位.mp3]	everyone, ladies and gentlemen; attention media representatives<br> <b>e.g. heading on a press release) (各位</b> <br> (かくい)
(<b>可決</b>) 法案が国会で可決された。	[sound:s-2422_法案が国会で可決された。.mp3] <br> ほうあんがこっかいでかけつされた。 <br> The bill was passed in parliament.
[sound:s-2412_飲料水の供給源が枯渇しています。.mp3]	(<b>供給源</b>) 飲料水の供給源が枯渇しています。<br> いんりょうすいのきょうきゅうげんがこかつしています。 <br>The source of drinking water is running dry.	
各々	[sound:k-2423_各々.mp3]<br>おのおの, それぞれ <br> each, every, either, respectively, severally
each, every, either, respectively, severally	<b>各々<b> <br> おのおの, それぞれ <br>[sound:k-2423_各々.mp3]
[sound:k-2423_各々.mp3]	each, every, either, respectively, severally<br> <b>各々</b> <br> (おのおの, それぞれ)
(<b>不可分</b>) その二人の結びつきは不可分だ。	[sound:s-2423_その二人の結びつきは不可分だ。.mp3] <br> そのふたりのむすびつきはふかぶんだ。 <br> Their bond is inseparable.
[sound:s-2413_犯人は自供して罪を認めた。.mp3]	(<b>自供</b>) 犯人は自供して罪を認めた。<br> はんにんはじきょうしてつみをみとめた。 <br>The culprit confessed to the crime.	
各面	[sound:k-2424_各面.mp3]<br>かくめん <br> all phases
all phases	<b>各面<b> <br> かくめん <br>[sound:k-2424_各面.mp3]
[sound:k-2424_各面.mp3]	all phases<br> <b>各面</b> <br> (かくめん)
(<b>役</b>) 彼は責任を果たすために役割を担っている。	[sound:s-2424_彼は責任を果たすために役割を担っている。.mp3] <br> かれはせきにんをはたすためにやくわりをになっている。 <br> He takes on roles to fulfill his responsibilities.
[sound:s-2414_その計画は実行可能だ。.mp3]	(<b>可</b>) その計画は実行可能だ。<br> そのけいかくはじっこうかのうだ。 <br>The plan is feasible.	
各	[sound:k-2425_各.mp3]<br>かく <br> each, every
each, every	<b>各<b> <br> かく <br>[sound:k-2425_各.mp3]
[sound:k-2425_各.mp3]	each, every<br> <b>各</b> <br> (かく)
(<b>役割</b>) 彼女は映画で重要な役割を演じた。	[sound:s-2425_彼女は映画で重要な役割を演じた。.mp3] <br> かのじょはえいがでじゅうようなやくわりをえんじた。 <br> She played an important role in the movie.
[sound:s-2415_人間には驚くほどの可能性がある。.mp3]	(<b>可能</b>) 人間には驚くほどの可能性がある。<br> にんげんにはおどろくほどのかのうせいがある。 <br>Humans have incredible potential.	
各	[sound:k-2426_各.mp3]<br>おのおの, それぞれ <br> each, every, either, respectively, severally
each, every, either, respectively, severally	<b>各<b> <br> おのおの, それぞれ <br>[sound:k-2426_各.mp3]
[sound:k-2426_各.mp3]	each, every, either, respectively, severally<br> <b>各</b> <br> (おのおの, それぞれ)
(<b>役員</b>) 彼は会社の役員です。	[sound:s-2426_彼は会社の役員です。.mp3] <br> かれはかいしゃのやくいんです。 <br> He is an executive of the company.
[sound:s-2416_彼の成功の可能性は高い。.mp3]	(<b>可能性</b>) 彼の成功の可能性は高い。<br> かれのせいこうのかのうせいはたかい。 <br>There is a high possibility of his success.	
各シェルフ	[sound:k-2427_各シェルフ.mp3]<br>かくシェルフ <br> each shelf, shelves (in practice, practise)
each shelf, shelves (in practice, practise)	<b>各シェルフ<b> <br> かくシェルフ <br>[sound:k-2427_各シェルフ.mp3]
[sound:k-2427_各シェルフ.mp3]	each shelf, shelves<br> <b>in practice, practise) (各シェルフ</b> <br> (かくシェルフ)
(<b>取締役</b>) 彼はその企業の取締役です。	[sound:s-2427_彼はその企業の取締役です。.mp3] <br> かれはそのきぎょうのとりしまりやくです。 <br> He is a director of the company.
[sound:s-2417_工事の許可を申請する。.mp3]	(<b>許可</b>) 工事の許可を申請する。<br> こうじのきょかをしんせいする。 <br>Apply for permission for construction.	
各員	[sound:k-2428_各員.mp3]<br>かくいん <br> each one
each one	<b>各員<b> <br> かくいん <br>[sound:k-2428_各員.mp3]
[sound:k-2428_各員.mp3]	each one<br> <b>各員</b> <br> (かくいん)
(<b>懲役</b>) 彼は懲役20年の刑を宣告された。	[sound:s-2428_彼は懲役20年の刑を宣告された。.mp3] <br> かれはちょうえき20ねんのけいをせんこくされた。 <br> He was sentenced to 20 years of imprisonment.
[sound:s-2418_彼の冗談はいつも可笑しい。.mp3]	(<b>可笑しい</b>) 彼の冗談はいつも可笑しい。<br> かれのじょうだんはいつもおかしい。 <br>His jokes are always funny.	
各駅	[sound:k-2429_各駅.mp3]<br>かくえき <br> every station
every station	<b>各駅<b> <br> かくえき <br>[sound:k-2429_各駅.mp3]
[sound:k-2429_各駅.mp3]	every station<br> <b>各駅</b> <br> (かくえき)
(<b>現役</b>) 彼はまだ現役で働いている。	[sound:s-2429_彼はまだ現役で働いている。.mp3] <br> かれはまだげんえきではたらいている。 <br> He is still working actively.
[sound:s-2419_このアプリは利用が認可されています。.mp3]	(<b>認可</b>) このアプリは利用が認可されています。<br> このアプリはりようがにんかされています。 <br>This app is approved for use.	
開始	[sound:k-2430_開始.mp3]<br>かいし <br> start, commencement, beginning, initiation
start, commencement, beginning, initiation	<b>開始<b> <br> かいし <br>[sound:k-2430_開始.mp3]
[sound:k-2430_開始.mp3]	start, commencement, beginning, initiation<br> <b>開始</b> <br> (かいし)
(<b>三役</b>) 彼はそのプロジェクトで三役をこなす。	[sound:s-2430_彼はそのプロジェクトで三役をこなす。.mp3] <br> かれはそのぷろじぇくとでさんやくをこなす。 <br> He performs three roles in the project.
[sound:s-2420_健康のために睡眠は不可欠だ。.mp3]	(<b>不可欠</b>) 健康のために睡眠は不可欠だ。<br> けんこうのためにすいみんはふかけつだ。 <br>Sleep is essential for health.	
始まり	[sound:k-2431_始まり.mp3]<br>はじまり <br> origin, beginning
origin, beginning	<b>始まり<b> <br> はじまり <br>[sound:k-2431_始まり.mp3]
[sound:k-2431_始まり.mp3]	origin, beginning<br> <b>始まり</b> <br> (はじまり)
(<b>主役</b>) 彼女はその映画の主役を演じた。	[sound:s-2431_彼女はその映画の主役を演じた。.mp3] <br> かのじょはそのえいがのしゅやくをえんじた。 <br> She played the leading role in the movie.
[sound:s-2421_その任務は不可能だと思われていた。.mp3]	(<b>不可能</b>) その任務は不可能だと思われていた。<br> そのにんむはふかのうだとおもわれていた。 <br>The task was thought to be impossible.	
終始	[sound:k-2432_終始.mp3]<br>しゅうし <br> beginning and end, from beginning to end, doing a thing from beginning to end; consistently, the whole time
beginning and end, from beginning to end, doing a thing from beginning to end; consistently, the whole time	<b>終始<b> <br> しゅうし <br>[sound:k-2432_終始.mp3]
[sound:k-2432_終始.mp3]	beginning and end, from beginning to end, doing a thing from beginning to end; consistently, the whole time<br> <b>終始</b> <br> (しゅうし)
(<b>取締役会</b>) 会社の取締役会が開催されました。	[sound:s-2432_会社の取締役会が開催されました。.mp3] <br> かいしゃのとりしまりやくかいがかいさいされました。 <br> The board of directors meeting was held.
[sound:s-2422_法案が国会で可決された。.mp3]	(<b>可決</b>) 法案が国会で可決された。<br> ほうあんがこっかいでかけつされた。 <br>The bill was passed in parliament.	
始める	[sound:k-2433_始める.mp3]<br>はじめる <br> to start, to begin, to commence, to initiate, to originate; to open (e.g. a store), to start up, to establish (business. etc.); to start (doing something), to begin to ...
to start, to begin, to commence, to initiate, to originate; to open (e.g. a store), to start up, to establish (business. etc.); to start (doing something), to begin to ...	<b>始める<b> <br> はじめる <br>[sound:k-2433_始める.mp3]
[sound:k-2433_始める.mp3]	to start, to begin, to commence, to initiate, to originate; to open<br> <b>e.g. a store), to start up, to establish (business. etc.); to start (doing something), to begin to ... (始める</b> <br> (はじめる)
(<b>役所</b>) 住民票は役所で取得できます。	[sound:s-2433_住民票は役所で取得できます。.mp3] <br> じゅうみんひょうはやくしょでしゅとくできます。 <br> You can obtain a resident certificate at the municipal office.
[sound:s-2423_その二人の結びつきは不可分だ。.mp3]	(<b>不可分</b>) その二人の結びつきは不可分だ。<br> そのふたりのむすびつきはふかぶんだ。 <br>Their bond is inseparable.	
始め	[sound:k-2434_始め.mp3]<br>はじめ <br> beginning, start, origin
beginning, start, origin	<b>始め<b> <br> はじめ <br>[sound:k-2434_始め.mp3]
[sound:k-2434_始め.mp3]	beginning, start, origin<br> <b>始め</b> <br> (はじめ)
(<b>機構</b>) この機構は効率的な仕組みを持っています。	[sound:s-2434_この機構は効率的な仕組みを持っています。.mp3] <br> このきこうはこうりつてきなしくみをもっています。 <br> This organization has an efficient mechanism.
[sound:s-2424_彼は責任を果たすために役割を担っている。.mp3]	(<b>役</b>) 彼は責任を果たすために役割を担っている。<br> かれはせきにんをはたすためにやくわりをになっている。 <br>He takes on roles to fulfill his responsibilities.	
年始	[sound:k-2435_年始.mp3]<br>ねんし <br> New Year's call, beginning of the year, New Year's greetings
New Year's call, beginning of the year, New Year's greetings	<b>年始<b> <br> ねんし <br>[sound:k-2435_年始.mp3]
[sound:k-2435_年始.mp3]	New Year's call, beginning of the year, New Year's greetings<br> <b>年始</b> <br> (ねんし)
(<b>構造</b>) この建物の構造は頑丈だ。	[sound:s-2435_この建物の構造は頑丈だ。.mp3] <br> このたてもののこうぞうはがんじょうだ。 <br> The structure of this building is sturdy.
[sound:s-2425_彼女は映画で重要な役割を演じた。.mp3]	(<b>役割</b>) 彼女は映画で重要な役割を演じた。<br> かのじょはえいがでじゅうようなやくわりをえんじた。 <br>She played an important role in the movie.	
始末	[sound:k-2436_始末.mp3]<br>しまつ <br> management, dealing, settlement; cleaning up, getting rid of; end result (usu. bad)
management, dealing, settlement; cleaning up, getting rid of; end result (usu. bad)	<b>始末<b> <br> しまつ <br>[sound:k-2436_始末.mp3]
[sound:k-2436_始末.mp3]	management, dealing, settlement; cleaning up, getting rid of; end result<br> <b>usu. bad) (始末</b> <br> (しまつ)
(<b>構想</b>) 新しいプロジェクトの構想を練る。	[sound:s-2436_新しいプロジェクトの構想を練る。.mp3] <br> あたらしいぷろじぇくとのこうそうをねる。 <br> Develop a plan for the new project.
[sound:s-2426_彼は会社の役員です。.mp3]	(<b>役員</b>) 彼は会社の役員です。<br> かれはかいしゃのやくいんです。 <br>He is an executive of the company.	
原始	[sound:k-2437_原始.mp3]<br>げんし <br> origin, primeval
origin, primeval	<b>原始<b> <br> げんし <br>[sound:k-2437_原始.mp3]
[sound:k-2437_原始.mp3]	origin, primeval<br> <b>原始</b> <br> (げんし)
(<b>構成</b>) この組織の構成を理解する。	[sound:s-2437_この組織の構成を理解する。.mp3] <br> このそしきのこうせいをりかいする。 <br> Understand the composition of this organization.
[sound:s-2427_彼はその企業の取締役です。.mp3]	(<b>取締役</b>) 彼はその企業の取締役です。<br> かれはそのきぎょうのとりしまりやくです。 <br>He is a director of the company.	
始発	[sound:k-2438_始発.mp3]<br>しはつ <br> first train
first train	<b>始発<b> <br> しはつ <br>[sound:k-2438_始発.mp3]
[sound:k-2438_始発.mp3]	first train<br> <b>始発</b> <br> (しはつ)
(<b>構築</b>) 新しい道路を構築する計画がある。	[sound:s-2438_新しい道路を構築する計画がある。.mp3] <br> あたらしいどうろをこうちくするけいかくがある。 <br> There is a plan to construct a new road.
[sound:s-2428_彼は懲役20年の刑を宣告された。.mp3]	(<b>懲役</b>) 彼は懲役20年の刑を宣告された。<br> かれはちょうえき20ねんのけいをせんこくされた。 <br>He was sentenced to 20 years of imprisonment.	
手始め	[sound:k-2439_手始め.mp3]<br>てはじめ <br> outset
outset	<b>手始め<b> <br> てはじめ <br>[sound:k-2439_手始め.mp3]
[sound:k-2439_手始め.mp3]	outset<br> <b>手始め</b> <br> (てはじめ)
(<b>構図</b>) その絵の構図が美しい。	[sound:s-2439_その絵の構図が美しい。.mp3] <br> そのえのこうずがうつくしい。 <br> The composition of the painting is beautiful.
[sound:s-2429_彼はまだ現役で働いている。.mp3]	(<b>現役</b>) 彼はまだ現役で働いている。<br> かれはまだげんえきではたらいている。 <br>He is still working actively.	
島	[sound:k-2440_島.mp3]<br>しま <br> island; territory (of a prostitute, organized crime gang, etc.), turf
island; territory (of a prostitute, organized crime gang, etc.), turf	<b>島<b> <br> しま <br>[sound:k-2440_島.mp3]
[sound:k-2440_島.mp3]	island; territory<br> <b>of a prostitute, organized crime gang, etc.), turf (島</b> <br> (しま)
(<b>結構</b>) ありがとう、結構です。	[sound:s-2440_ありがとう、結構です。.mp3] <br> ありがとう、けっこうです。 <br> Thank you, I'm fine.
[sound:s-2430_彼はそのプロジェクトで三役をこなす。.mp3]	(<b>三役</b>) 彼はそのプロジェクトで三役をこなす。<br> かれはそのぷろじぇくとでさんやくをこなす。 <br>He performs three roles in the project.	
朝鮮半島	[sound:k-2441_朝鮮半島.mp3]<br>ちょうせんはんとう <br> Korean peninsula
Korean peninsula	<b>朝鮮半島<b> <br> ちょうせんはんとう <br>[sound:k-2441_朝鮮半島.mp3]
[sound:k-2441_朝鮮半島.mp3]	Korean peninsula<br> <b>朝鮮半島</b> <br> (ちょうせんはんとう)
(<b>構う</b>) 彼女は他人の意見に構わない。	[sound:s-2441_彼女は他人の意見に構わない。.mp3] <br> かのじょはたにんのいけんにかまわない。 <br> She doesn't care about other people's opinions.
[sound:s-2431_彼女はその映画の主役を演じた。.mp3]	(<b>主役</b>) 彼女はその映画の主役を演じた。<br> かのじょはそのえいがのしゅやくをえんじた。 <br>She played the leading role in the movie.	
中島	[sound:k-2442_中島.mp3]<br>なかじま <br> island in a pond or river
island in a pond or river	<b>中島<b> <br> なかじま <br>[sound:k-2442_中島.mp3]
[sound:k-2442_中島.mp3]	island in a pond or river<br> <b>中島</b> <br> (なかじま)
(<b>構内</b>) この施設の構内には多くの施設がある。	[sound:s-2442_この施設の構内には多くの施設がある。.mp3] <br> このしせつのこうないにはおおくのしせつがある。 <br> There are many facilities within the premises of this facility.
[sound:s-2432_会社の取締役会が開催されました。.mp3]	(<b>取締役会</b>) 会社の取締役会が開催されました。<br> かいしゃのとりしまりやくかいがかいさいされました。 <br>The board of directors meeting was held.	
小島	[sound:k-2443_小島.mp3]<br>こじま <br> small island, islet
small island, islet	<b>小島<b> <br> こじま <br>[sound:k-2443_小島.mp3]
[sound:k-2443_小島.mp3]	small island, islet<br> <b>小島</b> <br> (こじま)
(<b>心構え</b>) 旅行に行く前に心構えをしておく。	[sound:s-2443_旅行に行く前に心構えをしておく。.mp3] <br> りょこうにいくまえにこころがまえをしておく。 <br> Prepare mentally before going on a trip.
[sound:s-2433_住民票は役所で取得できます。.mp3]	(<b>役所</b>) 住民票は役所で取得できます。<br> じゅうみんひょうはやくしょでしゅとくできます。 <br>You can obtain a resident certificate at the municipal office.	
半島	[sound:k-2444_半島.mp3]<br>はんとう <br> peninsula
peninsula	<b>半島<b> <br> はんとう <br>[sound:k-2444_半島.mp3]
[sound:k-2444_半島.mp3]	peninsula<br> <b>半島</b> <br> (はんとう)
(<b>木</b>) 公園にはたくさんの木があります。	[sound:s-2444_公園にはたくさんの木があります。.mp3] <br> こうえんにはたくさんのきがあります。 <br> There are many trees in the park.
[sound:s-2434_この機構は効率的な仕組みを持っています。.mp3]	(<b>機構</b>) この機構は効率的な仕組みを持っています。<br> このきこうはこうりつてきなしくみをもっています。 <br>This organization has an efficient mechanism.	
列島	[sound:k-2445_列島.mp3]<br>れっとう <br> archipelago, chain of islands
archipelago, chain of islands	<b>列島<b> <br> れっとう <br>[sound:k-2445_列島.mp3]
[sound:k-2445_列島.mp3]	archipelago, chain of islands<br> <b>列島</b> <br> (れっとう)
(<b>青木</b>) 彼の家の周りには青木がたくさんあります。	[sound:s-2445_彼の家の周りには青木がたくさんあります。.mp3] <br> かれのいえのまわりにはあおきがたくさんあります。 <br> There are many cypress trees around his house.
[sound:s-2435_この建物の構造は頑丈だ。.mp3]	(<b>構造</b>) この建物の構造は頑丈だ。<br> このたてもののこうぞうはがんじょうだ。 <br>The structure of this building is sturdy.	
島根	[sound:k-2446_島根.mp3]<br>しまね <br> island country
island country	<b>島根<b> <br> しまね <br>[sound:k-2446_島根.mp3]
[sound:k-2446_島根.mp3]	island country<br> <b>島根</b> <br> (しまね)
(<b>木造</b>) この家は木造です。	[sound:s-2446_この家は木造です。.mp3] <br> このいえはもくぞうです。 <br> This house is made of wood.
[sound:s-2436_新しいプロジェクトの構想を練る。.mp3]	(<b>構想</b>) 新しいプロジェクトの構想を練る。<br> あたらしいぷろじぇくとのこうそうをねる。 <br>Develop a plan for the new project.	
千島	[sound:k-2447_千島.mp3]<br>ちしま <br> Kurile Islands
Kurile Islands	<b>千島<b> <br> ちしま <br>[sound:k-2447_千島.mp3]
[sound:k-2447_千島.mp3]	Kurile Islands<br> <b>千島</b> <br> (ちしま)
(<b>土木</b>) 彼は土木工学を専攻しています。	[sound:s-2447_彼は土木工学を専攻しています。.mp3] <br> かれはどぼくこうがくをせんこうしています。 <br> He is majoring in civil engineering.
[sound:s-2437_この組織の構成を理解する。.mp3]	(<b>構成</b>) この組織の構成を理解する。<br> このそしきのこうせいをりかいする。 <br>Understand the composition of this organization.	
島国	[sound:k-2448_島国.mp3]<br>しまぐに, とうごく <br> island country (sometimes used as a metaphor for Japan)
island country (sometimes used as a metaphor for Japan)	<b>島国<b> <br> しまぐに, とうごく <br>[sound:k-2448_島国.mp3]
[sound:k-2448_島国.mp3]	island country<br> <b>sometimes used as a metaphor for Japan) (島国</b> <br> (しまぐに, とうごく)
(<b>木材</b>) 家具を作るために木材を購入する。	[sound:s-2448_家具を作るために木材を購入する。.mp3] <br> かぐをつくるためにもくざいをこうにゅうする。 <br> Purchase lumber to make furniture.
[sound:s-2438_新しい道路を構築する計画がある。.mp3]	(<b>構築</b>) 新しい道路を構築する計画がある。<br> あたらしいどうろをこうちくするけいかくがある。 <br>There is a plan to construct a new road.	
離島	[sound:k-2449_離島.mp3]<br>りとう <br> isolated (outlying) island, departure from an island
isolated (outlying) island, departure from an island	<b>離島<b> <br> りとう <br>[sound:k-2449_離島.mp3]
[sound:k-2449_離島.mp3]	isolated<br> <b>outlying) island, departure from an island (離島</b> <br> (りとう)
(<b>荒木</b>) その森は荒木に覆われている。	[sound:s-2449_その森は荒木に覆われている。.mp3] <br> そのもりはあらきにおおわれている。 <br> The forest is covered with rough trees.
[sound:s-2439_その絵の構図が美しい。.mp3]	(<b>構図</b>) その絵の構図が美しい。<br> そのえのこうずがうつくしい。 <br>The composition of the painting is beautiful.	
直	[sound:k-2450_直.mp3]<br>じき <br> soon, in a moment, before long, shortly; nearby, close; direct; spot transaction, cash transaction
soon, in a moment, before long, shortly; nearby, close; direct; spot transaction, cash transaction	<b>直<b> <br> じき <br>[sound:k-2450_直.mp3]
[sound:k-2450_直.mp3]	soon, in a moment, before long, shortly; nearby, close; direct; spot transaction, cash transaction<br> <b>直</b> <br> (じき)
(<b>樹木</b>) 公園には様々な樹木が植えられています。	[sound:s-2450_公園には様々な樹木が植えられています。.mp3] <br> こうえんにはさまざまなじゅもくがうえられています。 <br> Various trees are planted in the park.
[sound:s-2440_ありがとう、結構です。.mp3]	(<b>結構</b>) ありがとう、結構です。<br> ありがとう、けっこうです。 <br>Thank you, I'm fine.	
直ちに	[sound:k-2451_直ちに.mp3]<br>ただちに <br> at once, immediately, directly, in person
at once, immediately, directly, in person	<b>直ちに<b> <br> ただちに <br>[sound:k-2451_直ちに.mp3]
[sound:k-2451_直ちに.mp3]	at once, immediately, directly, in person<br> <b>直ちに</b> <br> (ただちに)
(<b>木曜</b>) 木曜日に会議があります。	[sound:s-2451_木曜日に会議があります。.mp3] <br> もくようびにかいぎがあります。 <br> There is a meeting on Thursday.
[sound:s-2441_彼女は他人の意見に構わない。.mp3]	(<b>構う</b>) 彼女は他人の意見に構わない。<br> かのじょはたにんのいけんにかまわない。 <br>She doesn't care about other people's opinions.	
見直し	[sound:k-2452_見直し.mp3]<br>みなおし <br> review, reconsideration, revision
review, reconsideration, revision	<b>見直し<b> <br> みなおし <br>[sound:k-2452_見直し.mp3]
[sound:k-2452_見直し.mp3]	review, reconsideration, revision<br> <b>見直し</b> <br> (みなおし)
(<b>木星</b>) 木星は太陽系で最大の惑星です。	[sound:s-2452_木星は太陽系で最大の惑星です。.mp3] <br> もくせいはたいようけいでさいだいのわくせいです。 <br> Jupiter is the largest planet in the solar system.
[sound:s-2442_この施設の構内には多くの施設がある。.mp3]	(<b>構内</b>) この施設の構内には多くの施設がある。<br> このしせつのこうないにはおおくのしせつがある。 <br>There are many facilities within the premises of this facility.	
直後	[sound:k-2453_直後.mp3]<br>ちょくご <br> immediately following
immediately following	<b>直後<b> <br> ちょくご <br>[sound:k-2453_直後.mp3]
[sound:k-2453_直後.mp3]	immediately following<br> <b>直後</b> <br> (ちょくご)
(<b>木製</b>) その椅子は木製です。	[sound:s-2453_その椅子は木製です。.mp3] <br> そのいすはもくせいです。 <br> The chair is made of wood.
[sound:s-2443_旅行に行く前に心構えをしておく。.mp3]	(<b>心構え</b>) 旅行に行く前に心構えをしておく。<br> りょこうにいくまえにこころがまえをしておく。 <br>Prepare mentally before going on a trip.	
直接	[sound:k-2454_直接.mp3]<br>ちょくせつ <br> direct, immediate, personal, firsthand
direct, immediate, personal, firsthand	<b>直接<b> <br> ちょくせつ <br>[sound:k-2454_直接.mp3]
[sound:k-2454_直接.mp3]	direct, immediate, personal, firsthand<br> <b>直接</b> <br> (ちょくせつ)
(<b>割り</b>) ケーキを割りますか？	[sound:s-2454_ケーキを割りますか？.mp3] <br> ケーキをわりますか？	Would you like to split the cake?
[sound:s-2444_公園にはたくさんの木があります。.mp3]	(<b>木</b>) 公園にはたくさんの木があります。<br> こうえんにはたくさんのきがあります。 <br>There are many trees in the park.	
直前	[sound:k-2455_直前.mp3]<br>ちょくぜん <br> just before
just before	<b>直前<b> <br> ちょくぜん <br>[sound:k-2455_直前.mp3]
[sound:k-2455_直前.mp3]	just before<br> <b>直前</b> <br> (ちょくぜん)
(<b>役割</b>) 彼はグループで重要な役割を果たしています。	[sound:s-2455_彼はグループで重要な役割を果たしています。.mp3] <br> かれはグループでじゅうようなやくわりをはたしています。 <br> He plays an important role in the group.
[sound:s-2445_彼の家の周りには青木がたくさんあります。.mp3]	(<b>青木</b>) 彼の家の周りには青木がたくさんあります。<br> かれのいえのまわりにはあおきがたくさんあります。 <br>There are many cypress trees around his house.	
直面	[sound:k-2456_直面.mp3]<br>ちょくめん <br> confrontation
confrontation	<b>直面<b> <br> ちょくめん <br>[sound:k-2456_直面.mp3]
[sound:k-2456_直面.mp3]	confrontation<br> <b>直面</b> <br> (ちょくめん)
(<b>割合</b>) その割合は非常に高いです。	[sound:s-2456_その割合は非常に高いです。.mp3] <br> そのわりあいはひじょうにたかいです。 <br> The proportion is very high.
[sound:s-2446_この家は木造です。.mp3]	(<b>木造</b>) この家は木造です。<br> このいえはもくぞうです。 <br>This house is made of wood.	
率直	[sound:k-2457_率直.mp3]<br>そっちょく <br> frankness, candour, candor, openheartedness
frankness, candour, candor, openheartedness	<b>率直<b> <br> そっちょく <br>[sound:k-2457_率直.mp3]
[sound:k-2457_率直.mp3]	frankness, candour, candor, openheartedness<br> <b>率直</b> <br> (そっちょく)
(<b>分割</b>) ファイルを分割して送信する。	[sound:s-2457_ファイルを分割して送信する。.mp3] <br> ファイルをぶんかつしてそうしんする。 <br> Split the file and send it.
[sound:s-2447_彼は土木工学を専攻しています。.mp3]	(<b>土木</b>) 彼は土木工学を専攻しています。<br> かれはどぼくこうがくをせんこうしています。 <br>He is majoring in civil engineering.	
正直	[sound:k-2458_正直.mp3]<br>しょうじき <br> honesty, integrity, frankness; honestly, frankly
honesty, integrity, frankness; honestly, frankly	<b>正直<b> <br> しょうじき <br>[sound:k-2458_正直.mp3]
[sound:k-2458_正直.mp3]	honesty, integrity, frankness; honestly, frankly<br> <b>正直</b> <br> (しょうじき)
(<b>割引</b>) このクーポンで10％の割引が適用されます。	[sound:s-2458_このクーポンで10％の割引が適用されます。.mp3] <br> このくーぽんで10％のわりびきがてきようされます。 <br> This coupon entitles you to a 10% discount.
[sound:s-2448_家具を作るために木材を購入する。.mp3]	(<b>木材</b>) 家具を作るために木材を購入する。<br> かぐをつくるためにもくざいをこうにゅうする。 <br>Purchase lumber to make furniture.	
素直	[sound:k-2459_素直.mp3]<br>すなお <br> obedient, meek, docile, unaffected; honest, frank
obedient, meek, docile, unaffected; honest, frank	<b>素直<b> <br> すなお <br>[sound:k-2459_素直.mp3]
[sound:k-2459_素直.mp3]	obedient, meek, docile, unaffected; honest, frank<br> <b>素直</b> <br> (すなお)
(<b>割高</b>) この商品は他の店よりも割高です。	[sound:s-2459_この商品は他の店よりも割高です。.mp3] <br> このしょうひんはほかのみせよりもわりだかです。 <br> This product is more expensive than in other stores.
[sound:s-2449_その森は荒木に覆われている。.mp3]	(<b>荒木</b>) その森は荒木に覆われている。<br> そのもりはあらきにおおわれている。 <br>The forest is covered with rough trees.	
両国	[sound:k-2460_両国.mp3]<br>りょうこく, りょうごく <br> both countries
both countries	<b>両国<b> <br> りょうこく, りょうごく <br>[sound:k-2460_両国.mp3]
[sound:k-2460_両国.mp3]	both countries<br> <b>両国</b> <br> (りょうこく, りょうごく)
(<b>割安</b>) この店では商品が割安に販売されています。	[sound:s-2460_この店では商品が割安に販売されています。.mp3] <br> このみせではしょうひんがわりやすにはんばいされています。 <br> Products are sold at low prices in this store.
[sound:s-2450_公園には様々な樹木が植えられています。.mp3]	(<b>樹木</b>) 公園には様々な樹木が植えられています。<br> こうえんにはさまざまなじゅもくがうえられています。 <br>Various trees are planted in the park.	
両党	[sound:k-2461_両党.mp3]<br>りょうとう <br> both political parties
both political parties	<b>両党<b> <br> りょうとう <br>[sound:k-2461_両党.mp3]
[sound:k-2461_両党.mp3]	both political parties<br> <b>両党</b> <br> (りょうとう)
(<b>割引債</b>) その企業は割引債を発行した。	[sound:s-2461_その企業は割引債を発行した。.mp3] <br> そのきぎょうはわりびきさいをはっこうした。 <br> The company issued discount bonds.
[sound:s-2451_木曜日に会議があります。.mp3]	(<b>木曜</b>) 木曜日に会議があります。<br> もくようびにかいぎがあります。 <br>There is a meeting on Thursday.	
両親	[sound:k-2462_両親.mp3]<br>りょうしん, ふたおや <br> parents, both parents
parents, both parents	<b>両親<b> <br> りょうしん, ふたおや <br>[sound:k-2462_両親.mp3]
[sound:k-2462_両親.mp3]	parents, both parents<br> <b>両親</b> <br> (りょうしん, ふたおや)
(<b>割り当て</b>) 各部署に予算が割り当てられる。	[sound:s-2462_各部署に予算が割り当てられる。.mp3] <br> かくぶしょによさんがわりあてられる。 <br> Budgets are allocated to each department.
[sound:s-2452_木星は太陽系で最大の惑星です。.mp3]	(<b>木星</b>) 木星は太陽系で最大の惑星です。<br> もくせいはたいようけいでさいだいのわくせいです。 <br>Jupiter is the largest planet in the solar system.	
車両	[sound:k-2463_車両.mp3]<br>しゃりょう <br> rolling stock, railroad cars, vehicles
rolling stock, railroad cars, vehicles	<b>車両<b> <br> しゃりょう <br>[sound:k-2463_車両.mp3]
[sound:k-2463_車両.mp3]	rolling stock, railroad cars, vehicles<br> <b>車両</b> <br> (しゃりょう)
(<b>割り出す</b>) 価格を割り出すために市場調査が行われた。	[sound:s-2463_価格を割り出すために市場調査が行われた。.mp3] <br> かかくをわりだすためにしじょうちょうさがおこなわれた。 <br> Market research was conducted to determine the price.
[sound:s-2453_その椅子は木製です。.mp3]	(<b>木製</b>) その椅子は木製です。<br> そのいすはもくせいです。 <br>The chair is made of wood.	
両院	[sound:k-2464_両院.mp3]<br>りょういん <br> both Houses of Parliament
both Houses of Parliament	<b>両院<b> <br> りょういん <br>[sound:k-2464_両院.mp3]
[sound:k-2464_両院.mp3]	both Houses of Parliament<br> <b>両院</b> <br> (りょういん)
(<b>聞かす</b>) 彼女はその話を聞かせてくれた。	[sound:s-2464_彼女はその話を聞かせてくれた。.mp3] <br> かのじょはそのはなしをきかせてくれた。 <br> She let me hear the story.
[sound:s-2454_ケーキを割りますか？.mp3]	(<b>割り</b>) ケーキを割りますか？	ケーキをわりますか？ <br>Would you like to split the cake?
両氏	[sound:k-2465_両氏.mp3]<br>りょうし <br> both persons
both persons	<b>両氏<b> <br> りょうし <br>[sound:k-2465_両氏.mp3]
[sound:k-2465_両氏.mp3]	both persons<br> <b>両氏</b> <br> (りょうし)
(<b>新聞</b>) 毎朝、新聞を読む習慣があります。	[sound:s-2465_毎朝、新聞を読む習慣があります。.mp3] <br> まいあさ、しんぶんをよむしゅうかんがあります。 <br> I have a habit of reading the newspaper every morning.
[sound:s-2455_彼はグループで重要な役割を果たしています。.mp3]	(<b>役割</b>) 彼はグループで重要な役割を果たしています。<br> かれはグループでじゅうようなやくわりをはたしています。 <br>He plays an important role in the group.	
両日	[sound:k-2466_両日.mp3]<br>りょうじつ <br> both days, two days
both days, two days	<b>両日<b> <br> りょうじつ <br>[sound:k-2466_両日.mp3]
[sound:k-2466_両日.mp3]	both days, two days<br> <b>両日</b> <br> (りょうじつ)
(<b>新聞社</b>) その記事は有名な新聞社によって報じられました。	[sound:s-2466_その記事は有名な新聞社によって報じられました。.mp3] <br> そのきじはゆうめいなしんぶんしゃによってほうじられました。 <br> The article was reported by a famous newspaper company.
[sound:s-2456_その割合は非常に高いです。.mp3]	(<b>割合</b>) その割合は非常に高いです。<br> そのわりあいはひじょうにたかいです。 <br>The proportion is very high.	
両者	[sound:k-2467_両者.mp3]<br>りょうしゃ <br> pair, the two, both persons, both things
pair, the two, both persons, both things	<b>両者<b> <br> りょうしゃ <br>[sound:k-2467_両者.mp3]
[sound:k-2467_両者.mp3]	pair, the two, both persons, both things<br> <b>両者</b> <br> (りょうしゃ)
(<b>聞き手</b>) 彼は良い聞き手です。	[sound:s-2467_彼は良い聞き手です。.mp3] <br> かれはいいききてです。 <br> He is a good listener.
[sound:s-2457_ファイルを分割して送信する。.mp3]	(<b>分割</b>) ファイルを分割して送信する。<br> ファイルをぶんかつしてそうしんする。 <br>Split the file and send it.	
両方	[sound:k-2468_両方.mp3]<br>りょうほう <br> both sides, both parties
both sides, both parties	<b>両方<b> <br> りょうほう <br>[sound:k-2468_両方.mp3]
[sound:k-2468_両方.mp3]	both sides, both parties<br> <b>両方</b> <br> (りょうほう)
(<b>新聞紙</b>) 新聞紙は再利用可能な資源です。	[sound:s-2468_新聞紙は再利用可能な資源です。.mp3] <br> しんぶんしはさいりようかのうなしげんです。 <br> Newspapers are a recyclable resource.
[sound:s-2458_このクーポンで10％の割引が適用されます。.mp3]	(<b>割引</b>) このクーポンで10％の割引が適用されます。<br> このくーぽんで10％のわりびきがてきようされます。 <br>This coupon entitles you to a 10% discount.	
両面	[sound:k-2469_両面.mp3]<br>りょうめん <br> both sides, two sides, double-sided
both sides, two sides, double-sided	<b>両面<b> <br> りょうめん <br>[sound:k-2469_両面.mp3]
[sound:k-2469_両面.mp3]	both sides, two sides, double-sided<br> <b>両面</b> <br> (りょうめん)
(<b>前代未聞</b>) これは前代未聞の事態です。	[sound:s-2469_これは前代未聞の事態です。.mp3] <br> これはぜんだいみもんのじたいです。 <br> This is an unprecedented situation.
[sound:s-2459_この商品は他の店よりも割高です。.mp3]	(<b>割高</b>) この商品は他の店よりも割高です。<br> このしょうひんはほかのみせよりもわりだかです。 <br>This product is more expensive than in other stores.	
朝	[sound:k-2470_朝.mp3]<br>あさ, あした <br> morning
morning	<b>朝<b> <br> あさ, あした <br>[sound:k-2470_朝.mp3]
[sound:k-2470_朝.mp3]	morning<br> <b>朝</b> <br> (あさ, あした)
(<b>新聞記事</b>) その新聞記事は多くの人々に影響を与えた。	[sound:s-2470_その新聞記事は多くの人々に影響を与えた。.mp3] <br> そのしんぶんきじはおおくのひとびとにえいきょうをあたえた。 <br> The newspaper article influenced many people.
[sound:s-2460_この店では商品が割安に販売されています。.mp3]	(<b>割安</b>) この店では商品が割安に販売されています。<br> このみせではしょうひんがわりやすにはんばいされています。 <br>Products are sold at low prices in this store.	
北朝鮮	[sound:k-2471_北朝鮮.mp3]<br>きたちょうせん <br> North Korea
North Korea	<b>北朝鮮<b> <br> きたちょうせん <br>[sound:k-2471_北朝鮮.mp3]
[sound:k-2471_北朝鮮.mp3]	North Korea<br> <b>北朝鮮</b> <br> (きたちょうせん)
(<b>聞き書き</b>) 日本語を勉強するために聞き書きをしています。	[sound:s-2471_日本語を勉強するために聞き書きをしています。.mp3] <br> にほんごをべんきょうするためにききがきをしています。 <br> I'm practicing listening and writing for studying Japanese.
[sound:s-2461_その企業は割引債を発行した。.mp3]	(<b>割引債</b>) その企業は割引債を発行した。<br> そのきぎょうはわりびきさいをはっこうした。 <br>The company issued discount bonds.	
朝鮮	[sound:k-2472_朝鮮.mp3]<br>ちょうせん <br> Korea
Korea	<b>朝鮮<b> <br> ちょうせん <br>[sound:k-2472_朝鮮.mp3]
[sound:k-2472_朝鮮.mp3]	Korea<br> <b>朝鮮</b> <br> (ちょうせん)
(<b>聞こえる</b>) その音は遠くから聞こえた。	[sound:s-2472_その音は遠くから聞こえた。.mp3] <br> そのおとはとおくからきこえた。 <br> The sound was heard from far away.
[sound:s-2462_各部署に予算が割り当てられる。.mp3]	(<b>割り当て</b>) 各部署に予算が割り当てられる。<br> かくぶしょによさんがわりあてられる。 <br>Budgets are allocated to each department.	
朝鮮民主主義人民共和国	[sound:k-2473_朝鮮民主主義人民共和国.mp3]<br>ちょうせんみんしゅしゅぎじんみんきょうわこく <br> Democratic People's Republic of Korea (North Korea), DPRK
Democratic People's Republic of Korea (North Korea), DPRK	<b>朝鮮民主主義人民共和国<b> <br> ちょうせんみんしゅしゅぎじんみんきょうわこく <br>[sound:k-2473_朝鮮民主主義人民共和国.mp3]
[sound:k-2473_朝鮮民主主義人民共和国.mp3]	Democratic People's Republic of Korea<br> <b>North Korea), DPRK (朝鮮民主主義人民共和国</b> <br> (ちょうせんみんしゅしゅぎじんみんきょうわこく)
(<b>聞き取り</b>) 彼の言葉を聞き取るのが難しい。	[sound:s-2473_彼の言葉を聞き取るのが難しい。.mp3] <br> かれのことばをききとるのがむずかしい。 <br> It's difficult to understand his words.
[sound:s-2463_価格を割り出すために市場調査が行われた。.mp3]	(<b>割り出す</b>) 価格を割り出すために市場調査が行われた。<br> かかくをわりだすためにしじょうちょうさがおこなわれた。 <br>Market research was conducted to determine the price.	
朝鮮半島	[sound:k-2474_朝鮮半島.mp3]<br>ちょうせんはんとう <br> Korean peninsula
Korean peninsula	<b>朝鮮半島<b> <br> ちょうせんはんとう <br>[sound:k-2474_朝鮮半島.mp3]
[sound:k-2474_朝鮮半島.mp3]	Korean peninsula<br> <b>朝鮮半島</b> <br> (ちょうせんはんとう)
(<b>身</b>) 身に覚えのない行動があった。	[sound:s-2474_身に覚えのない行動があった。.mp3] <br> みにおぼえのないこうどうがあった。 <br> There was an action I didn't remember doing.
[sound:s-2464_彼女はその話を聞かせてくれた。.mp3]	(<b>聞かす</b>) 彼女はその話を聞かせてくれた。<br> かのじょはそのはなしをきかせてくれた。 <br>She let me hear the story.	
早朝	[sound:k-2475_早朝.mp3]<br>そうちょう <br> early morning
early morning	<b>早朝<b> <br> そうちょう <br>[sound:k-2475_早朝.mp3]
[sound:k-2475_早朝.mp3]	early morning<br> <b>早朝</b> <br> (そうちょう)
(<b>自身</b>) 彼は自身の能力を信じている。	[sound:s-2475_彼は自身の能力を信じている。.mp3] <br> かれはじしんののうりょくをしんじている。 <br> He believes in his own abilities.
[sound:s-2465_毎朝、新聞を読む習慣があります。.mp3]	(<b>新聞</b>) 毎朝、新聞を読む習慣があります。<br> まいあさ、しんぶんをよむしゅうかんがあります。 <br>I have a habit of reading the newspaper every morning.	
朝日	[sound:k-2476_朝日.mp3]<br>あさひ <br> morning sun
morning sun	<b>朝日<b> <br> あさひ <br>[sound:k-2476_朝日.mp3]
[sound:k-2476_朝日.mp3]	morning sun<br> <b>朝日</b> <br> (あさひ)
(<b>出身</b>) 彼女は東京出身です。	[sound:s-2476_彼女は東京出身です。.mp3] <br> かのじょはとうきょうしゅっしんです。 <br> She is from Tokyo.
[sound:s-2466_その記事は有名な新聞社によって報じられました。.mp3]	(<b>新聞社</b>) その記事は有名な新聞社によって報じられました。<br> そのきじはゆうめいなしんぶんしゃによってほうじられました。 <br>The article was reported by a famous newspaper company.	
朝刊	[sound:k-2477_朝刊.mp3]<br>ちょうかん <br> morning newspaper
morning newspaper	<b>朝刊<b> <br> ちょうかん <br>[sound:k-2477_朝刊.mp3]
[sound:k-2477_朝刊.mp3]	morning newspaper<br> <b>朝刊</b> <br> (ちょうかん)
(<b>中身</b>) この箱の中身を確認してください。	[sound:s-2477_この箱の中身を確認してください。.mp3] <br> このはこのなかみをかくにんしてください。 <br> Please check the contents of this box.
[sound:s-2467_彼は良い聞き手です。.mp3]	(<b>聞き手</b>) 彼は良い聞き手です。<br> かれはいいききてです。 <br>He is a good listener.	
朝食	[sound:k-2478_朝食.mp3]<br>ちょうしょく <br> breakfast
breakfast	<b>朝食<b> <br> ちょうしょく <br>[sound:k-2478_朝食.mp3]
[sound:k-2478_朝食.mp3]	breakfast<br> <b>朝食</b> <br> (ちょうしょく)
(<b>身長</b>) 彼の身長は180センチです。	[sound:s-2478_彼の身長は180センチです。.mp3] <br> かれのしんちょうは180センチです。 <br> His height is 180 centimeters.
[sound:s-2468_新聞紙は再利用可能な資源です。.mp3]	(<b>新聞紙</b>) 新聞紙は再利用可能な資源です。<br> しんぶんしはさいりようかのうなしげんです。 <br>Newspapers are a recyclable resource.	
毎朝	[sound:k-2479_毎朝.mp3]<br>まいあさ, まいちょう <br> every morning
every morning	<b>毎朝<b> <br> まいあさ, まいちょう <br>[sound:k-2479_毎朝.mp3]
[sound:k-2479_毎朝.mp3]	every morning<br> <b>毎朝</b> <br> (まいあさ, まいちょう)
(<b>全身</b>) 彼女は全身をマッサージしてもらった。	[sound:s-2479_彼女は全身をマッサージしてもらった。.mp3] <br> かのじょはぜんしんをまっさーじしてもらった。 <br> She got a full-body massage.
[sound:s-2469_これは前代未聞の事態です。.mp3]	(<b>前代未聞</b>) これは前代未聞の事態です。<br> これはぜんだいみもんのじたいです。 <br>This is an unprecedented situation.	
革	[sound:k-2480_革.mp3]<br>かわ <br> skin, hide, leather, fur, pelt, bark, shell
skin, hide, leather, fur, pelt, bark, shell	<b>革<b> <br> かわ <br>[sound:k-2480_革.mp3]
[sound:k-2480_革.mp3]	skin, hide, leather, fur, pelt, bark, shell<br> <b>革</b> <br> (かわ)
(<b>出身者</b>) 彼は同じ町の出身者です。	[sound:s-2480_彼は同じ町の出身者です。.mp3] <br> かれはおなじまちのしゅっしんしゃです。 <br> He is a native of the same town.
[sound:s-2470_その新聞記事は多くの人々に影響を与えた。.mp3]	(<b>新聞記事</b>) その新聞記事は多くの人々に影響を与えた。<br> そのしんぶんきじはおおくのひとびとにえいきょうをあたえた。 <br>The newspaper article influenced many people.	
改革	[sound:k-2481_改革.mp3]<br>かいかく <br> reform, reformation, innovation
reform, reformation, innovation	<b>改革<b> <br> かいかく <br>[sound:k-2481_改革.mp3]
[sound:k-2481_改革.mp3]	reform, reformation, innovation<br> <b>改革</b> <br> (かいかく)
(<b>単身</b>) 彼は単身で海外に旅行した。	[sound:s-2481_彼は単身で海外に旅行した。.mp3] <br> かれはたんしんでかいがいにりょこうした。 <br> He traveled abroad alone.
[sound:s-2471_日本語を勉強するために聞き書きをしています。.mp3]	(<b>聞き書き</b>) 日本語を勉強するために聞き書きをしています。<br> にほんごをべんきょうするためにききがきをしています。 <br>I'm practicing listening and writing for studying Japanese.	
革命	[sound:k-2482_革命.mp3]<br>かくめい <br> revolution; 58th year of the sexagenary cycle (in onmyou-dou)
revolution; 58th year of the sexagenary cycle (in onmyou-dou)	<b>革命<b> <br> かくめい <br>[sound:k-2482_革命.mp3]
[sound:k-2482_革命.mp3]	revolution; 58th year of the sexagenary cycle<br> <b>in onmyou-dou) (革命</b> <br> (かくめい)
(<b>身元</b>) その男性の身元が特定されました。	[sound:s-2482_その男性の身元が特定されました。.mp3] <br> そのだんせいのみもとがとくていされました。 <br> The identity of the man has been determined.
[sound:s-2472_その音は遠くから聞こえた。.mp3]	(<b>聞こえる</b>) その音は遠くから聞こえた。<br> そのおとはとおくからきこえた。 <br>The sound was heard from far away.	
革新	[sound:k-2483_革新.mp3]<br>かくしん <br> reform, innovation
reform, innovation	<b>革新<b> <br> かくしん <br>[sound:k-2483_革新.mp3]
[sound:k-2483_革新.mp3]	reform, innovation<br> <b>革新</b> <br> (かくしん)
(<b>独身</b>) 彼はまだ独身です。	[sound:s-2483_彼はまだ独身です。.mp3] <br> かれはまだどくしんです。 <br> He is still single.
[sound:s-2473_彼の言葉を聞き取るのが難しい。.mp3]	(<b>聞き取り</b>) 彼の言葉を聞き取るのが難しい。<br> かれのことばをききとるのがむずかしい。 <br>It's difficult to understand his words.	
変革	[sound:k-2484_変革.mp3]<br>へんかく <br> change, reform, revolution, upheaval; Reformation
change, reform, revolution, upheaval; Reformation	<b>変革<b> <br> へんかく <br>[sound:k-2484_変革.mp3]
[sound:k-2484_変革.mp3]	change, reform, revolution, upheaval; Reformation<br> <b>変革</b> <br> (へんかく)
(<b>消費</b>) 消費者のニーズに応える製品を開発する。	[sound:s-2484_消費者のニーズに応える製品を開発する。.mp3] <br> しょうひしゃのニーズにこたえるせいひんをかいはつする。 <br> Develop products that meet consumer needs.
[sound:s-2474_身に覚えのない行動があった。.mp3]	(<b>身</b>) 身に覚えのない行動があった。<br> みにおぼえのないこうどうがあった。 <br>There was an action I didn't remember doing.	
行革	[sound:k-2485_行革.mp3]<br>ぎょうかく <br> administrative reform
administrative reform	<b>行革<b> <br> ぎょうかく <br>[sound:k-2485_行革.mp3]
[sound:k-2485_行革.mp3]	administrative reform<br> <b>行革</b> <br> (ぎょうかく)
(<b>消費者</b>) 消費者の声を聞いて商品を改良する。	[sound:s-2485_消費者の声を聞いて商品を改良する。.mp3] <br> しょうひしゃのこえをきいてしょうひんをかいりょうする。 <br> Improve products based on consumer feedback.
[sound:s-2475_彼は自身の能力を信じている。.mp3]	(<b>自身</b>) 彼は自身の能力を信じている。<br> かれはじしんののうりょくをしんじている。 <br>He believes in his own abilities.	
保革	[sound:k-2486_保革.mp3]<br>ほかく <br> conservatism and progressivism, conservatives and reformists
conservatism and progressivism, conservatives and reformists	<b>保革<b> <br> ほかく <br>[sound:k-2486_保革.mp3]
[sound:k-2486_保革.mp3]	conservatism and progressivism, conservatives and reformists<br> <b>保革</b> <br> (ほかく)
(<b>消費税</b>) 消費税率が上がった。	[sound:s-2486_消費税率が上がった。.mp3] <br> しょうひぜいりつがあがった。 <br> The consumption tax rate has increased.
[sound:s-2476_彼女は東京出身です。.mp3]	(<b>出身</b>) 彼女は東京出身です。<br> かのじょはとうきょうしゅっしんです。 <br>She is from Tokyo.	
皮革	[sound:k-2487_皮革.mp3]<br>ひかく <br> leather, hide
leather, hide	<b>皮革<b> <br> ひかく <br>[sound:k-2487_皮革.mp3]
[sound:k-2487_皮革.mp3]	leather, hide<br> <b>皮革</b> <br> (ひかく)
(<b>費用</b>) 旅行の費用を計算する。	[sound:s-2487_旅行の費用を計算する。.mp3] <br> りょこうのひようをけいさんする。 <br> Calculate the expenses for the trip.
[sound:s-2477_この箱の中身を確認してください。.mp3]	(<b>中身</b>) この箱の中身を確認してください。<br> このはこのなかみをかくにんしてください。 <br>Please check the contents of this box.	
農地改革	[sound:k-2488_農地改革.mp3]<br>のうちかいかく <br> agrarian reform
agrarian reform	<b>農地改革<b> <br> のうちかいかく <br>[sound:k-2488_農地改革.mp3]
[sound:k-2488_農地改革.mp3]	agrarian reform<br> <b>農地改革</b> <br> (のうちかいかく)
(<b>経費</b>) このプロジェクトの経費を削減する必要がある。	[sound:s-2488_このプロジェクトの経費を削減する必要がある。.mp3] <br> このぷろじぇくとのけいひをさくげんするひつようがある。 <br> It is necessary to reduce the expenses of this project.
[sound:s-2478_彼の身長は180センチです。.mp3]	(<b>身長</b>) 彼の身長は180センチです。<br> かれのしんちょうは180センチです。 <br>His height is 180 centimeters.	
革靴	[sound:k-2489_革靴.mp3]<br>かわぐつ <br> leather shoes
leather shoes	<b>革靴<b> <br> かわぐつ <br>[sound:k-2489_革靴.mp3]
[sound:k-2489_革靴.mp3]	leather shoes<br> <b>革靴</b> <br> (かわぐつ)
(<b>人件費</b>) 会社の人件費が上昇している。	[sound:s-2489_会社の人件費が上昇している。.mp3] <br> かいしゃのじんけんひがじょうしょうしている。 <br> The company's labor costs are rising.
[sound:s-2479_彼女は全身をマッサージしてもらった。.mp3]	(<b>全身</b>) 彼女は全身をマッサージしてもらった。<br> かのじょはぜんしんをまっさーじしてもらった。 <br>She got a full-body massage.	
価格	[sound:k-2490_価格.mp3]<br>かかく <br> price, value, cost
price, value, cost	<b>価格<b> <br> かかく <br>[sound:k-2490_価格.mp3]
[sound:k-2490_価格.mp3]	price, value, cost<br> <b>価格</b> <br> (かかく)
(<b>会費</b>) このクラブの年会費は高い。	[sound:s-2490_このクラブの年会費は高い。.mp3] <br> このくらぶのねんかいひはたかい。 <br> The annual membership fee for this club is high.
[sound:s-2480_彼は同じ町の出身者です。.mp3]	(<b>出身者</b>) 彼は同じ町の出身者です。<br> かれはおなじまちのしゅっしんしゃです。 <br>He is a native of the same town.	
株価	[sound:k-2491_株価.mp3]<br>かぶか <br> stock prices
stock prices	<b>株価<b> <br> かぶか <br>[sound:k-2491_株価.mp3]
[sound:k-2491_株価.mp3]	stock prices<br> <b>株価</b> <br> (かぶか)
(<b>公費</b>) 公費でプロジェクトを支援する。	[sound:s-2491_公費でプロジェクトを支援する。.mp3] <br> こうひでプロジェクトをしえんする。 <br> Support the project with public funds.
[sound:s-2481_彼は単身で海外に旅行した。.mp3]	(<b>単身</b>) 彼は単身で海外に旅行した。<br> かれはたんしんでかいがいにりょこうした。 <br>He traveled abroad alone.	
評価	[sound:k-2492_評価.mp3]<br>ひょうか <br> valuation, estimation, assessment, evaluation; to value, to assess, to estimate value; to appreciate, to value highly, to acknowledge the value (of something)
valuation, estimation, assessment, evaluation; to value, to assess, to estimate value; to appreciate, to value highly, to acknowledge the value (of something)	<b>評価<b> <br> ひょうか <br>[sound:k-2492_評価.mp3]
[sound:k-2492_評価.mp3]	valuation, estimation, assessment, evaluation; to value, to assess, to estimate value; to appreciate, to value highly, to acknowledge the value<br> <b>of something) (評価</b> <br> (ひょうか)
(<b>交際費</b>) この旅行の交際費を計算する。	[sound:s-2492_この旅行の交際費を計算する。.mp3] <br> このりょこうのこうさいひをけいさんする。 <br> Calculate the entertainment expenses for this trip.
[sound:s-2482_その男性の身元が特定されました。.mp3]	(<b>身元</b>) その男性の身元が特定されました。<br> そのだんせいのみもとがとくていされました。 <br>The identity of the man has been determined.	
価値	[sound:k-2493_価値.mp3]<br>かち <br> value, worth, merit
value, worth, merit	<b>価値<b> <br> かち <br>[sound:k-2493_価値.mp3]
[sound:k-2493_価値.mp3]	value, worth, merit<br> <b>価値</b> <br> (かち)
(<b>工費</b>) 工事の工費が予算を超えた。	[sound:s-2493_工事の工費が予算を超えた。.mp3] <br> こうじのこうひがよさんをこえた。 <br> The construction costs exceeded the budget.
[sound:s-2483_彼はまだ独身です。.mp3]	(<b>独身</b>) 彼はまだ独身です。<br> かれはまだどくしんです。 <br>He is still single.	
地価	[sound:k-2494_地価.mp3]<br>ちか <br> the price of land
the price of land	<b>地価<b> <br> ちか <br>[sound:k-2494_地価.mp3]
[sound:k-2494_地価.mp3]	the price of land<br> <b>地価</b> <br> (ちか)
(<b>付近</b>) この地域の付近には公園があります。	[sound:s-2494_この地域の付近には公園があります。.mp3] <br> このちいきのふきんにはこうえんがあります。 <br> There is a park near this area.
[sound:s-2484_消費者のニーズに応える製品を開発する。.mp3]	(<b>消費</b>) 消費者のニーズに応える製品を開発する。<br> しょうひしゃのニーズにこたえるせいひんをかいはつする。 <br>Develop products that meet consumer needs.	
物価	[sound:k-2495_物価.mp3]<br>ぶっか <br> prices of commodities, prices (in general), cost-of-living
prices of commodities, prices (in general), cost-of-living	<b>物価<b> <br> ぶっか <br>[sound:k-2495_物価.mp3]
[sound:k-2495_物価.mp3]	prices of commodities, prices<br> <b>in general), cost-of-living (物価</b> <br> (ぶっか)
(<b>寄付</b>) 地震の被害者への寄付を募る。	[sound:s-2495_地震の被害者への寄付を募る。.mp3] <br> じしんのひがいしゃへのきふをつのる。 <br> Collect donations for earthquake victims.
[sound:s-2485_消費者の声を聞いて商品を改良する。.mp3]	(<b>消費者</b>) 消費者の声を聞いて商品を改良する。<br> しょうひしゃのこえをきいてしょうひんをかいりょうする。 <br>Improve products based on consumer feedback.	
価値観	[sound:k-2496_価値観.mp3]<br>かちかん <br> values
values	<b>価値観<b> <br> かちかん <br>[sound:k-2496_価値観.mp3]
[sound:k-2496_価値観.mp3]	values<br> <b>価値観</b> <br> (かちかん)
(<b>付属</b>) 車には付属のマニュアルが付いています。	[sound:s-2496_車には付属のマニュアルが付いています。.mp3] <br> くるまにはふぞくのマニュアルがついています。 <br> The car comes with an accompanying manual.
[sound:s-2486_消費税率が上がった。.mp3]	(<b>消費税</b>) 消費税率が上がった。<br> しょうひぜいりつがあがった。 <br>The consumption tax rate has increased.	
有価証券	[sound:k-2497_有価証券.mp3]<br>ゆうかしょうけん <br> marketable securities, stocks and bonds
marketable securities, stocks and bonds	<b>有価証券<b> <br> ゆうかしょうけん <br>[sound:k-2497_有価証券.mp3]
[sound:k-2497_有価証券.mp3]	marketable securities, stocks and bonds<br> <b>有価証券</b> <br> (ゆうかしょうけん)
(<b>交付</b>) 免許証が交付されました。	[sound:s-2497_免許証が交付されました。.mp3] <br> めんきょしょうがこうふされました。 <br> The driver's license was issued.
[sound:s-2487_旅行の費用を計算する。.mp3]	(<b>費用</b>) 旅行の費用を計算する。<br> りょこうのひようをけいさんする。 <br>Calculate the expenses for the trip.	
米価	[sound:k-2498_米価.mp3]<br>べいか <br> rice price
rice price	<b>米価<b> <br> べいか <br>[sound:k-2498_米価.mp3]
[sound:k-2498_米価.mp3]	rice price<br> <b>米価</b> <br> (べいか)
(<b>付き合い</b>) 彼とは長い付き合いです。	[sound:s-2498_彼とは長い付き合いです。.mp3] <br> かれとはながいつきあいです。 <br> I've known him for a long time.
[sound:s-2488_このプロジェクトの経費を削減する必要がある。.mp3]	(<b>経費</b>) このプロジェクトの経費を削減する必要がある。<br> このぷろじぇくとのけいひをさくげんするひつようがある。 <br>It is necessary to reduce the expenses of this project.	
時価	[sound:k-2499_時価.mp3]<br>じか <br> current value, price, market value
current value, price, market value	<b>時価<b> <br> じか <br>[sound:k-2499_時価.mp3]
[sound:k-2499_時価.mp3]	current value, price, market value<br> <b>時価</b> <br> (じか)
(<b>貸付</b>) 銀行から融資を貸付してもらう。	[sound:s-2499_銀行から融資を貸付してもらう。.mp3] <br> ぎんこうからゆうしをかしつけしてもらう。 <br> Borrow a loan from the bank.
[sound:s-2489_会社の人件費が上昇している。.mp3]	(<b>人件費</b>) 会社の人件費が上昇している。<br> かいしゃのじんけんひがじょうしょうしている。 <br>The company's labor costs are rising.	
株式	[sound:k-2500_株式.mp3]<br>かぶしき <br> stock (company)
stock (company)	<b>株式<b> <br> かぶしき <br>[sound:k-2500_株式.mp3]
[sound:k-2500_株式.mp3]	stock<br> <b>company) (株式</b> <br> (かぶしき)
(<b>日付</b>) この書類には日付が記入されていません。	[sound:s-2500_この書類には日付が記入されていません。.mp3] <br> このしょるいにはひづけがきにゅうされていません。 <br> There is no date written on this document.
[sound:s-2490_このクラブの年会費は高い。.mp3]	(<b>会費</b>) このクラブの年会費は高い。<br> このくらぶのねんかいひはたかい。 <br>The annual membership fee for this club is high.	
公式	[sound:k-2501_公式.mp3]<br>こうしき <br> formality, formal, official; formula
formality, formal, official; formula	<b>公式<b> <br> こうしき <br>[sound:k-2501_公式.mp3]
[sound:k-2501_公式.mp3]	formality, formal, official; formula<br> <b>公式</b> <br> (こうしき)
(<b>付き</b>) この商品には保証付きです。	[sound:s-2501_この商品には保証付きです。.mp3] <br> このしょうひんにはほしょうつきです。 <br> This product comes with a warranty.
[sound:s-2491_公費でプロジェクトを支援する。.mp3]	(<b>公費</b>) 公費でプロジェクトを支援する。<br> こうひでプロジェクトをしえんする。 <br>Support the project with public funds.	
正式	[sound:k-2502_正式.mp3]<br>せいしき <br> due form, official, formality
due form, official, formality	<b>正式<b> <br> せいしき <br>[sound:k-2502_正式.mp3]
[sound:k-2502_正式.mp3]	due form, official, formality<br> <b>正式</b> <br> (せいしき)
(<b>給付</b>) 失業者に給付金が支給される。	[sound:s-2502_失業者に給付金が支給される。.mp3] <br> しつぎょうしゃにきゅうふきんがしきゅうされる。 <br> Unemployed individuals receive unemployment benefits.
[sound:s-2492_この旅行の交際費を計算する。.mp3]	(<b>交際費</b>) この旅行の交際費を計算する。<br> このりょこうのこうさいひをけいさんする。 <br>Calculate the entertainment expenses for this trip.	
方式	[sound:k-2503_方式.mp3]<br>ほうしき <br> form, method, system, formula
form, method, system, formula	<b>方式<b> <br> ほうしき <br>[sound:k-2503_方式.mp3]
[sound:k-2503_方式.mp3]	form, method, system, formula<br> <b>方式</b> <br> (ほうしき)
(<b>条件付き</b>) 条件付きの承認が与えられた。	[sound:s-2503_条件付きの承認が与えられた。.mp3] <br> じょうけんつきのしょうにんがあたえられた。 <br> Conditional approval was granted.
[sound:s-2493_工事の工費が予算を超えた。.mp3]	(<b>工費</b>) 工事の工費が予算を超えた。<br> こうじのこうひがよさんをこえた。 <br>The construction costs exceeded the budget.	
形式	[sound:k-2504_形式.mp3]<br>けいしき <br> form (as opposed to substance), formality; method, system, style; format, mode, appearance, form (something takes); math expression
form (as opposed to substance), formality; method, system, style; format, mode, appearance, form (something takes); math expression	<b>形式<b> <br> けいしき <br>[sound:k-2504_形式.mp3]
[sound:k-2504_形式.mp3]	form<br> <b>as opposed to substance), formality; method, system, style; format, mode, appearance, form (something takes); math expression (形式</b> <br> (けいしき)
(<b>施設126. 施政</b>)	政府の施政方針が発表された。 <br> [sound:s-2504_政府の施政方針が発表された。.mp3] <br> <br>せいふのせいせいほうしんがはっぴょうされた。 <br> The government's policy direction has been announced.
[sound:s-2494_この地域の付近には公園があります。.mp3]	(<b>付近</b>) この地域の付近には公園があります。<br> このちいきのふきんにはこうえんがあります。 <br>There is a park near this area.	
非公式	[sound:k-2505_非公式.mp3]<br>ひこうしき <br> informal
informal	<b>非公式<b> <br> ひこうしき <br>[sound:k-2505_非公式.mp3]
[sound:k-2505_非公式.mp3]	informal<br> <b>非公式</b> <br> (ひこうしき)
(<b>施工</b>) 工事の施工が完了した。	[sound:s-2505_工事の施工が完了した。.mp3] <br> こうじのしこうがかんりょうした。 <br> The construction work has been completed.
[sound:s-2495_地震の被害者への寄付を募る。.mp3]	(<b>寄付</b>) 地震の被害者への寄付を募る。<br> じしんのひがいしゃへのきふをつのる。 <br>Collect donations for earthquake victims.	
式典	[sound:k-2506_式典.mp3]<br>しきてん <br> ceremony, rites
ceremony, rites	<b>式典<b> <br> しきてん <br>[sound:k-2506_式典.mp3]
[sound:k-2506_式典.mp3]	ceremony, rites<br> <b>式典</b> <br> (しきてん)
(<b>施す</b>) 助けを必要とする人々に援助を施す。	[sound:s-2506_助けを必要とする人々に援助を施す。.mp3] <br> たすけをひつようとするひとびとにえんじょをほどこす。 <br> Provide assistance to those in need of help.
[sound:s-2496_車には付属のマニュアルが付いています。.mp3]	(<b>付属</b>) 車には付属のマニュアルが付いています。<br> くるまにはふぞくのマニュアルがついています。 <br>The car comes with an accompanying manual.	
結婚式	[sound:k-2507_結婚式.mp3]<br>けっこんしき <br> marriage ceremony, wedding
marriage ceremony, wedding	<b>結婚式<b> <br> けっこんしき <br>[sound:k-2507_結婚式.mp3]
[sound:k-2507_結婚式.mp3]	marriage ceremony, wedding<br> <b>結婚式</b> <br> (けっこんしき)
(<b>防衛施設庁</b>) 防衛施設庁が国内の基地を管理している。	[sound:s-2507_防衛施設庁が国内の基地を管理している。.mp3] <br> ぼうえいしせつちょうがこくないのきちをかんりしている。 <br> The Defense Facilities Administration Agency manages domestic bases.
[sound:s-2497_免許証が交付されました。.mp3]	(<b>交付</b>) 免許証が交付されました。<br> めんきょしょうがこうふされました。 <br>The driver's license was issued.	
株式会社	[sound:k-2508_株式会社.mp3]<br>かぶしきがいしゃ <br> public company, corporation, KK, formula for an incorporated public company
public company, corporation, KK, formula for an incorporated public company	<b>株式会社<b> <br> かぶしきがいしゃ <br>[sound:k-2508_株式会社.mp3]
[sound:k-2508_株式会社.mp3]	public company, corporation, KK, formula for an incorporated public company<br> <b>株式会社</b> <br> (かぶしきがいしゃ)
(<b>施錠</b>) ドアを施錠して、外出します。	[sound:s-2508_ドアを施錠して、外出します。.mp3] <br> ドアをせじょうして、がいしゅつします。 <br> Lock the door and go out.
[sound:s-2498_彼とは長い付き合いです。.mp3]	(<b>付き合い</b>) 彼とは長い付き合いです。<br> かれとはながいつきあいです。 <br>I've known him for a long time.	
儀式	[sound:k-2509_儀式.mp3]<br>ぎしき <br> ceremony, rite, ritual, service
ceremony, rite, ritual, service	<b>儀式<b> <br> ぎしき <br>[sound:k-2509_儀式.mp3]
[sound:k-2509_儀式.mp3]	ceremony, rite, ritual, service<br> <b>儀式</b> <br> (ぎしき)
(<b>大切</b>) 家族との時間はとても大切です。	[sound:s-2509_家族との時間はとても大切です。.mp3] <br> かぞくとのじかんはとてもたいせつです。 <br> Time with family is very important.
[sound:s-2499_銀行から融資を貸付してもらう。.mp3]	(<b>貸付</b>) 銀行から融資を貸付してもらう。<br> ぎんこうからゆうしをかしつけしてもらう。 <br>Borrow a loan from the bank.	
確か	[sound:k-2510_確か.mp3]<br>たしか <br> certain, sure, definite; if I'm not mistaken, if I remember correctly
certain, sure, definite; if I'm not mistaken, if I remember correctly	<b>確か<b> <br> たしか <br>[sound:k-2510_確か.mp3]
[sound:k-2510_確か.mp3]	certain, sure, definite; if I'm not mistaken, if I remember correctly<br> <b>確か</b> <br> (たしか)
(<b>切っ掛け</b>) その出来事が彼の転職の切っ掛けになった。	[sound:s-2510_その出来事が彼の転職の切っ掛けになった。.mp3] <br> そのできごとがかれのてんしょくのきっかけになった。 <br> That incident became the trigger for his job change.
[sound:s-2500_この書類には日付が記入されていません。.mp3]	(<b>日付</b>) この書類には日付が記入されていません。<br> このしょるいにはひづけがきにゅうされていません。 <br>There is no date written on this document.	
確実	[sound:k-2511_確実.mp3]<br>かくじつ <br> certainty, reliability, soundness
certainty, reliability, soundness	<b>確実<b> <br> かくじつ <br>[sound:k-2511_確実.mp3]
[sound:k-2511_確実.mp3]	certainty, reliability, soundness<br> <b>確実</b> <br> (かくじつ)
(<b>一切</b>) 彼は一切の手助けも受けたくない。	[sound:s-2511_彼は一切の手助けも受けたくない。.mp3] <br> かれはいっさいのてだすけもうけたくない。 <br> He doesn't want any help at all.
[sound:s-2501_この商品には保証付きです。.mp3]	(<b>付き</b>) この商品には保証付きです。<br> このしょうひんにはほしょうつきです。 <br>This product comes with a warranty.	
確保	[sound:k-2512_確保.mp3]<br>かくほ <br> guarantee, maintain, ensure, insure, secure, reservation
guarantee, maintain, ensure, insure, secure, reservation	<b>確保<b> <br> かくほ <br>[sound:k-2512_確保.mp3]
[sound:k-2512_確保.mp3]	guarantee, maintain, ensure, insure, secure, reservation<br> <b>確保</b> <br> (かくほ)
(<b>適切</b>) 適切な処置をとる必要があります。	[sound:s-2512_適切な処置をとる必要があります。.mp3] <br> てきせつなしょちをとるひつようがあります。 <br> It's necessary to take appropriate measures.
[sound:s-2502_失業者に給付金が支給される。.mp3]	(<b>給付</b>) 失業者に給付金が支給される。<br> しつぎょうしゃにきゅうふきんがしきゅうされる。 <br>Unemployed individuals receive unemployment benefits.	
明確	[sound:k-2513_明確.mp3]<br>めいかく <br> clear up, clarify, define
clear up, clarify, define	<b>明確<b> <br> めいかく <br>[sound:k-2513_明確.mp3]
[sound:k-2513_明確.mp3]	clear up, clarify, define<br> <b>明確</b> <br> (めいかく)
(<b>切り</b>) 彼は包丁で野菜を切りました。	[sound:s-2513_彼は包丁で野菜を切りました。.mp3] <br> かれはほうちょうでやさいをきりました。 <br> He cut the vegetables with a knife.
[sound:s-2503_条件付きの承認が与えられた。.mp3]	(<b>条件付き</b>) 条件付きの承認が与えられた。<br> じょうけんつきのしょうにんがあたえられた。 <br>Conditional approval was granted.	
確認	[sound:k-2514_確認.mp3]<br>かくにん <br> affirmation, confirmation, validation
affirmation, confirmation, validation	<b>確認<b> <br> かくにん <br>[sound:k-2514_確認.mp3]
[sound:k-2514_確認.mp3]	affirmation, confirmation, validation<br> <b>確認</b> <br> (かくにん)
(<b>思い切って</b>) 思い切って新しいことに挑戦してみよう。	[sound:s-2514_思い切って新しいことに挑戦してみよう。.mp3] <br> おもいきってあたらしいことにちょうせんしてみよう。 <br> Let's dare to try something new.
[sound:s-2504_政府の施政方針が発表された。.mp3]	(<b>施設126. 施政</b>)	政府の施政方針が発表された。<br> せいふのせいせいほうしんがはっぴょうされた。<br> The government's policy direction has been announced.
確立	[sound:k-2515_確立.mp3]<br>かくりつ <br> establishment
establishment	<b>確立<b> <br> かくりつ <br>[sound:k-2515_確立.mp3]
[sound:k-2515_確立.mp3]	establishment<br> <b>確立</b> <br> (かくりつ)
(<b>切らす</b>) お金がなくて電気を切らすしかなかった。	[sound:s-2515_お金がなくて電気を切らすしかなかった。.mp3] <br> おかねがなくてでんきをきらすしかなかった。 <br> We had no choice but to turn off the electricity because we had no money.
[sound:s-2505_工事の施工が完了した。.mp3]	(<b>施工</b>) 工事の施工が完了した。<br> こうじのしこうがかんりょうした。 <br>The construction work has been completed.	
確定	[sound:k-2516_確定.mp3]<br>かくてい <br> decision, settlement; definition
decision, settlement; definition	<b>確定<b> <br> かくてい <br>[sound:k-2516_確定.mp3]
[sound:k-2516_確定.mp3]	decision, settlement; definition<br> <b>確定</b> <br> (かくてい)
(<b>切る</b>) 野菜を切って、スープに入れる。	[sound:s-2516_野菜を切って、スープに入れる。.mp3] <br> やさいをきって、スープにいれる。 <br> Cut the vegetables and put them in the soup.
[sound:s-2506_助けを必要とする人々に援助を施す。.mp3]	(<b>施す</b>) 助けを必要とする人々に援助を施す。<br> たすけをひつようとするひとびとにえんじょをほどこす。 <br>Provide assistance to those in need of help.	
的確	[sound:k-2517_的確.mp3]<br>てきかく, てっかく <br> precise, accurate
precise, accurate	<b>的確<b> <br> てきかく, てっかく <br>[sound:k-2517_的確.mp3]
[sound:k-2517_的確.mp3]	precise, accurate<br> <b>的確</b> <br> (てきかく, てっかく)
(<b>締め切り</b>) レポートの締め切りは来週の金曜日です。	[sound:s-2517_レポートの締め切りは来週の金曜日です。.mp3] <br> れぽーとのしめきりはらいしゅうのきんようびです。 <br> The deadline for the report is next Friday.
[sound:s-2507_防衛施設庁が国内の基地を管理している。.mp3]	(<b>防衛施設庁</b>) 防衛施設庁が国内の基地を管理している。<br> ぼうえいしせつちょうがこくないのきちをかんりしている。 <br>The Defense Facilities Administration Agency manages domestic bases.	
確率	[sound:k-2518_確率.mp3]<br>かくりつ <br> probability, likelihood, chances
probability, likelihood, chances	<b>確率<b> <br> かくりつ <br>[sound:k-2518_確率.mp3]
[sound:k-2518_確率.mp3]	probability, likelihood, chances<br> <b>確率</b> <br> (かくりつ)
(<b>切手</b>) 手紙に切手を貼り付ける。	[sound:s-2518_手紙に切手を貼り付ける。.mp3] <br> てがみにきってをはりつける。 <br> Affix a stamp to the letter.
[sound:s-2508_ドアを施錠して、外出します。.mp3]	(<b>施錠</b>) ドアを施錠して、外出します。<br> ドアをせじょうして、がいしゅつします。 <br>Lock the door and go out.	
確執	[sound:k-2519_確執.mp3]<br>かくしつ <br> discord, antagonism
discord, antagonism	<b>確執<b> <br> かくしつ <br>[sound:k-2519_確執.mp3]
[sound:k-2519_確執.mp3]	discord, antagonism<br> <b>確執</b> <br> (かくしつ)
この施設は新しい設備を備えています。 	 このしせつはあたらしいせつびをそなえています。 <br> [sound:s-2519_このしせつはあたらしいせつびをそなえています。.mp3] <br> <br>This facility is equipped with new facilities.
[sound:s-2509_家族との時間はとても大切です。.mp3]	(<b>大切</b>) 家族との時間はとても大切です。<br> かぞくとのじかんはとてもたいせつです。 <br>Time with family is very important.	
村	[sound:k-2520_村.mp3]<br>むら <br> village
village	<b>村<b> <br> むら <br>[sound:k-2520_村.mp3]
[sound:k-2520_村.mp3]	village<br> <b>村</b> <br> (むら)
(<b>実施</b>) 計画の実施には時間がかかる。	[sound:s-2520_計画の実施には時間がかかる。.mp3] <br> けいかくのじっしにはじかんがかかる。 <br> Implementing the plan will take time.
[sound:s-2510_その出来事が彼の転職の切っ掛けになった。.mp3]	(<b>切っ掛け</b>) その出来事が彼の転職の切っ掛けになった。<br> そのできごとがかれのてんしょくのきっかけになった。 <br>That incident became the trigger for his job change.	
市町村	[sound:k-2521_市町村.mp3]<br>しちょうそん <br> cities, towns and villages, municipalities
cities, towns and villages, municipalities	<b>市町村<b> <br> しちょうそん <br>[sound:k-2521_市町村.mp3]
[sound:k-2521_市町村.mp3]	cities, towns and villages, municipalities<br> <b>市町村</b> <br> (しちょうそん)
(<b>布施</b>) 寺院に布施をする。	[sound:s-2521_寺院に布施をする。.mp3] <br> じいんにふせをする。 <br> Make an offering to the temple.
[sound:s-2511_彼は一切の手助けも受けたくない。.mp3]	(<b>一切</b>) 彼は一切の手助けも受けたくない。<br> かれはいっさいのてだすけもうけたくない。 <br>He doesn't want any help at all.	
農村	[sound:k-2522_農村.mp3]<br>のうそん <br> agricultural community, farm village, rural
agricultural community, farm village, rural	<b>農村<b> <br> のうそん <br>[sound:k-2522_農村.mp3]
[sound:k-2522_農村.mp3]	agricultural community, farm village, rural<br> <b>農村</b> <br> (のうそん)
(<b>施策</b>) 新しい施策を導入する。	[sound:s-2522_新しい施策を導入する。.mp3] <br> あたらしいしさくをどうにゅうする。
[sound:s-2512_適切な処置をとる必要があります。.mp3]	(<b>適切</b>) 適切な処置をとる必要があります。<br> てきせつなしょちをとるひつようがあります。 <br>It's necessary to take appropriate measures.	
山村	[sound:k-2523_山村.mp3]<br>さんそん <br> mountain village
mountain village	<b>山村<b> <br> さんそん <br>[sound:k-2523_山村.mp3]
[sound:k-2523_山村.mp3]	mountain village<br> <b>山村</b> <br> (さんそん)
(施政) 政府の施政方針が発表された。 <br> せいふのせいせいほうしんがはっぴょうされた。 <br> [sound:s-2523_せいふのせいせいほうしんがはっぴょうされた。.mp3] <br> <br>The government's policy direction has been announced.
[sound:s-2513_彼は包丁で野菜を切りました。.mp3]	(<b>切り</b>) 彼は包丁で野菜を切りました。<br> かれはほうちょうでやさいをきりました。 <br>He cut the vegetables with a knife.	
村長	[sound:k-2524_村長.mp3]<br>そんちょう <br> village headman
village headman	<b>村長<b> <br> そんちょう <br>[sound:k-2524_村長.mp3]
[sound:k-2524_村長.mp3]	village headman<br> <b>村長</b> <br> (そんちょう)
(<b>施工</b>) 工事の施工が完了した。	[sound:s-2524_工事の施工が完了した。.mp3] <br> こうじのしこうがかんりょうした。 <br> The construction work has been completed.
[sound:s-2514_思い切って新しいことに挑戦してみよう。.mp3]	(<b>思い切って</b>) 思い切って新しいことに挑戦してみよう。<br> おもいきってあたらしいことにちょうせんしてみよう。 <br>Let's dare to try something new.	
町村	[sound:k-2525_町村.mp3]<br>ちょうそん <br> towns and villages
towns and villages	<b>町村<b> <br> ちょうそん <br>[sound:k-2525_町村.mp3]
[sound:k-2525_町村.mp3]	towns and villages<br> <b>町村</b> <br> (ちょうそん)
(<b>施す</b>) 助けを必要とする人々に援助を施す。	[sound:s-2525_助けを必要とする人々に援助を施す。.mp3] <br> たすけをひつようとするひとびとにえんじょをほどこす。 <br> Provide assistance to those in need of help.
[sound:s-2515_お金がなくて電気を切らすしかなかった。.mp3]	(<b>切らす</b>) お金がなくて電気を切らすしかなかった。<br> おかねがなくてでんきをきらすしかなかった。 <br>We had no choice but to turn off the electricity because we had no money.	
村人	[sound:k-2526_村人.mp3]<br>むらびと <br> villager
villager	<b>村人<b> <br> むらびと <br>[sound:k-2526_村人.mp3]
[sound:k-2526_村人.mp3]	villager<br> <b>村人</b> <br> (むらびと)
(<b>防衛施設庁</b>) 防衛施設庁が国内の基地を管理している。	[sound:s-2526_防衛施設庁が国内の基地を管理している。.mp3] <br> ぼうえいしせつちょうがこくないのきちをかんりしている。 <br> The Defense Facilities Administration Agency manages domestic bases.
[sound:s-2516_野菜を切って、スープに入れる。.mp3]	(<b>切る</b>) 野菜を切って、スープに入れる。<br> やさいをきって、スープにいれる。 <br>Cut the vegetables and put them in the soup.	
選手村	[sound:k-2527_選手村.mp3]<br>せんしゅむら <br> athlete's village (during Olympics)
athlete's village (during Olympics)	<b>選手村<b> <br> せんしゅむら <br>[sound:k-2527_選手村.mp3]
[sound:k-2527_選手村.mp3]	athlete's village<br> <b>during Olympics) (選手村</b> <br> (せんしゅむら)
(<b>施錠</b>) ドアを施錠して、外出します。	[sound:s-2527_ドアを施錠して、外出します。.mp3] <br> ドアをせじょうして、がいしゅつします。 <br> Lock the door and go out.
[sound:s-2517_レポートの締め切りは来週の金曜日です。.mp3]	(<b>締め切り</b>) レポートの締め切りは来週の金曜日です。<br> れぽーとのしめきりはらいしゅうのきんようびです。 <br>The deadline for the report is next Friday.	
村民	[sound:k-2528_村民.mp3]<br>そんみん <br> villager
villager	<b>村民<b> <br> そんみん <br>[sound:k-2528_村民.mp3]
[sound:k-2528_村民.mp3]	villager<br> <b>村民</b> <br> (そんみん)
(<b>大切</b>) 家族との時間はとても大切です。	[sound:s-2528_家族との時間はとても大切です。.mp3] <br> かぞくとのじかんはとてもたいせつです。 <br> Time with family is very important.
[sound:s-2518_手紙に切手を貼り付ける。.mp3]	(<b>切手</b>) 手紙に切手を貼り付ける。<br> てがみにきってをはりつける。 <br>Affix a stamp to the letter.	
村議会	[sound:k-2529_村議会.mp3]<br>そんぎかい <br> village assembly
village assembly	<b>村議会<b> <br> そんぎかい <br>[sound:k-2529_村議会.mp3]
[sound:k-2529_村議会.mp3]	village assembly<br> <b>村議会</b> <br> (そんぎかい)
(<b>切っ掛け</b>) その出来事が彼の転職の切っ掛けになった。	[sound:s-2529_その出来事が彼の転職の切っ掛けになった。.mp3] <br> そのできごとがかれのてんしょくのきっかけになった。 <br> That incident became the trigger for his job change.
[sound:s-2519_このしせつはあたらしいせつびをそなえています。.mp3]	この施設は新しい設備を備えています。<br> このしせつはあたらしいせつびをそなえています。<br> This facility is equipped with new facilities.	
前提	[sound:k-2530_前提.mp3]<br>ぜんてい <br> preamble, premise, reason, prerequisite, condition, assumption, hypothesis
preamble, premise, reason, prerequisite, condition, assumption, hypothesis	<b>前提<b> <br> ぜんてい <br>[sound:k-2530_前提.mp3]
[sound:k-2530_前提.mp3]	preamble, premise, reason, prerequisite, condition, assumption, hypothesis<br> <b>前提</b> <br> (ぜんてい)
(<b>一切</b>) 彼は一切の手助けも受けたくない。	[sound:s-2530_彼は一切の手助けも受けたくない。.mp3] <br> かれはいっさいのてだすけもうけたくない。 <br> He doesn't want any help at all.
[sound:s-2520_計画の実施には時間がかかる。.mp3]	(<b>実施</b>) 計画の実施には時間がかかる。<br> けいかくのじっしにはじかんがかかる。 <br>Implementing the plan will take time.	
提案	[sound:k-2531_提案.mp3]<br>ていあん <br> proposal, proposition, suggestion
proposal, proposition, suggestion	<b>提案<b> <br> ていあん <br>[sound:k-2531_提案.mp3]
[sound:k-2531_提案.mp3]	proposal, proposition, suggestion<br> <b>提案</b> <br> (ていあん)
(<b>適切</b>) 適切な処置をとる必要があります。	[sound:s-2531_適切な処置をとる必要があります。.mp3] <br> てきせつなしょちをとるひつようがあります。 <br> It's necessary to take appropriate measures.
[sound:s-2521_寺院に布施をする。.mp3]	(<b>布施</b>) 寺院に布施をする。<br> じいんにふせをする。 <br>Make an offering to the temple.	
提供	[sound:k-2532_提供.mp3]<br>ていきょう <br> offer, tender, program sponsoring, programme sponsoring, furnishing
offer, tender, program sponsoring, programme sponsoring, furnishing	<b>提供<b> <br> ていきょう <br>[sound:k-2532_提供.mp3]
[sound:k-2532_提供.mp3]	offer, tender, program sponsoring, programme sponsoring, furnishing<br> <b>提供</b> <br> (ていきょう)
(<b>切り</b>) 彼は包丁で野菜を切りました。	[sound:s-2532_彼は包丁で野菜を切りました。.mp3] <br> かれはほうちょうでやさいをきりました。 <br> He cut the vegetables with a knife.
[sound:s-2522_新しい施策を導入する。.mp3]	(<b>施策</b>) 新しい施策を導入する。<br> あたらしいしさくをどうにゅうする。 <br>	
提出	[sound:k-2533_提出.mp3]<br>ていしゅつ <br> to present, to submit (e.g. a report or a thesis), to hand in, to file, to turn in; presentation, submission, filing
to present, to submit (e.g. a report or a thesis), to hand in, to file, to turn in; presentation, submission, filing	<b>提出<b> <br> ていしゅつ <br>[sound:k-2533_提出.mp3]
[sound:k-2533_提出.mp3]	to present, to submit<br> <b>e.g. a report or a thesis), to hand in, to file, to turn in; presentation, submission, filing (提出</b> <br> (ていしゅつ)
(<b>思い切って</b>) 思い切って新しいことに挑戦してみよう。	[sound:s-2533_思い切って新しいことに挑戦してみよう。.mp3] <br> おもいきってあたらしいことにちょうせんしてみよう。 <br> Let's dare to try something new.
[sound:s-2523_せいふのせいせいほうしんがはっぴょうされた。.mp3]	(施政) 政府の施政方針が発表された。<br> せいふのせいせいほうしんがはっぴょうされた。<br> The government's policy direction has been announced.	
提言	[sound:k-2534_提言.mp3]<br>ていげん <br> proposal, motion
proposal, motion	<b>提言<b> <br> ていげん <br>[sound:k-2534_提言.mp3]
[sound:k-2534_提言.mp3]	proposal, motion<br> <b>提言</b> <br> (ていげん)
(<b>切らす</b>) お金がなくて電気を切らすしかなかった。	[sound:s-2534_お金がなくて電気を切らすしかなかった。.mp3] <br> おかねがなくてでんきをきらすしかなかった。 <br> We had no choice but to turn off the electricity because we had no money.
[sound:s-2524_工事の施工が完了した。.mp3]	(<b>施工</b>) 工事の施工が完了した。<br> こうじのしこうがかんりょうした。 <br>The construction work has been completed.	
提携	[sound:k-2535_提携.mp3]<br>ていけい <br> cooperation, tie-up, joint business, link-up
cooperation, tie-up, joint business, link-up	<b>提携<b> <br> ていけい <br>[sound:k-2535_提携.mp3]
[sound:k-2535_提携.mp3]	cooperation, tie-up, joint business, link-up<br> <b>提携</b> <br> (ていけい)
(<b>切る</b>) 野菜を切って、スープに入れる。	[sound:s-2535_野菜を切って、スープに入れる。.mp3] <br> やさいをきって、スープにいれる。 <br> Cut the vegetables and put them in the soup.
[sound:s-2525_助けを必要とする人々に援助を施す。.mp3]	(<b>施す</b>) 助けを必要とする人々に援助を施す。<br> たすけをひつようとするひとびとにえんじょをほどこす。 <br>Provide assistance to those in need of help.	
提訴	[sound:k-2536_提訴.mp3]<br>ていそ <br> presenting a case, suing
