[sound:s-0281_彼は私の前に立っています。.mp3]	<b>前</b> <br> 彼は私の前に立っています。<br> かれはわたしのまえにたっています <br>He is standing in front of me.
生活	[sound:k-0282_生活.mp3]<br>せいかつ <br> living, life (one's daily existence), livelihood
living, life (one's daily existence), livelihood	<b>生活<b> <br> せいかつ <br>[sound:k-0282_生活.mp3]
[sound:k-0282_生活.mp3]	living, life<br> <b>one's daily existence), livelihood (生活</b> <br> (せいかつ)
<b>前後</b> <br> バスの到着時間は5分前後です。	[sound:s-0282_バスの到着時間は5分前後です。.mp3] <br> ばすのとうちゃくじかんはごふんぜんごです。 <br>The bus arrival time is around 5 minutes before or after.
[sound:s-0282_バスの到着時間は5分前後です。.mp3]	<b>前後</b> <br> バスの到着時間は5分前後です。<br> ばすのとうちゃくじかんはごふんぜんごです <br>The bus arrival time is around 5 minutes before or after.
生産	[sound:k-0283_生産.mp3]<br>せいさん <br> production, manufacture
production, manufacture	<b>生産<b> <br> せいさん <br>[sound:k-0283_生産.mp3]
[sound:k-0283_生産.mp3]	production, manufacture<br> <b>生産</b> <br> (せいさん)
<b>前述</b> <br> 前述の事柄をもう一度確認します。	[sound:s-0283_前述の事柄をもう一度確認します。.mp3] <br> ぜんじゅつのじがらをもういちどかくにんします。 <br>Let's review the aforementioned matters once again.
[sound:s-0283_前述の事柄をもう一度確認します。.mp3]	<b>前述</b> <br> 前述の事柄をもう一度確認します。<br> ぜんじゅつのじがらをもういちどかくにんします <br>Let's review the aforementioned matters once again.
厚生省	[sound:k-0284_厚生省.mp3]<br>こうせいしょう <br> Ministry of Health and Welfare (now Ministry of Health, Labour and Welfare)
Ministry of Health and Welfare (now Ministry of Health, Labour and Welfare)	<b>厚生省<b> <br> こうせいしょう <br>[sound:k-0284_厚生省.mp3]
[sound:k-0284_厚生省.mp3]	Ministry of Health and Welfare<br> <b>now Ministry of Health, Labour and Welfare) (厚生省</b> <br> (こうせいしょう)
<b>以前</b> <br> 彼女に会うのは以前からの夢でした。	[sound:s-0284_彼女に会うのは以前からの夢でした。.mp3] <br> かのじょにあうのはいぜんからのゆめでした。 <br>Meeting her has been a dream since before.
[sound:s-0284_彼女に会うのは以前からの夢でした。.mp3]	<b>以前</b> <br> 彼女に会うのは以前からの夢でした。<br> かのじょにあうのはいぜんからのゆめでした <br>Meeting her has been a dream since before.
新生	[sound:k-0285_新生.mp3]<br>しんせい <br> rebirth, new birth, nascent
rebirth, new birth, nascent	<b>新生<b> <br> しんせい <br>[sound:k-0285_新生.mp3]
[sound:k-0285_新生.mp3]	rebirth, new birth, nascent<br> <b>新生</b> <br> (しんせい)
<b>不足</b> <br> この町の駐車場は不足しています。	[sound:s-0285_この町の駐車場は不足しています。.mp3] <br> このまちのちゅうしゃじょうはふそくしています。 <br>There is a shortage of parking spaces in this town.
[sound:s-0285_この町の駐車場は不足しています。.mp3]	<b>不足</b> <br> この町の駐車場は不足しています。<br> このまちのちゅうしゃじょうはふそくしています <br>There is a shortage of parking spaces in this town.
人生	[sound:k-0286_人生.mp3]<br>じんせい <br> (human) life (i.e. conception to death)
(human) life (i.e. conception to death)	<b>人生<b> <br> じんせい <br>[sound:k-0286_人生.mp3]
[sound:k-0286_人生.mp3]	(human) life<br> <b>i.e. conception to death) (人生</b> <br> (じんせい)
<b>不安</b> <br> 彼女は新しい学校で不安を感じています。	[sound:s-0286_彼女は新しい学校で不安を感じています。.mp3] <br> かのじょはあたらしいがっこうでふあんをかんじています。 <br>She feels anxious about the new school.
[sound:s-0286_彼女は新しい学校で不安を感じています。.mp3]	<b>不安</b> <br> 彼女は新しい学校で不安を感じています。<br> かのじょはあたらしいがっこうでふあんをかんじています <br>She feels anxious about the new school.
生徒	[sound:k-0287_生徒.mp3]<br>せいと <br> pupil
pupil	<b>生徒<b> <br> せいと <br>[sound:k-0287_生徒.mp3]
[sound:k-0287_生徒.mp3]	pupil<br> <b>生徒</b> <br> (せいと)
<b>不満</b> <br> 彼は彼の給料に不満を抱いています。	[sound:s-0287_彼は彼の給料に不満を抱いています。.mp3] <br> かれはかれのきゅうりょうにふまんをだいています。 <br>He is dissatisfied with his salary.
[sound:s-0287_彼は彼の給料に不満を抱いています。.mp3]	<b>不満</b> <br> 彼は彼の給料に不満を抱いています。<br> かれはかれのきゅうりょうにふまんをだいています <br>He is dissatisfied with his salary.
先生	[sound:k-0288_先生.mp3]<br>せんせい <br> teacher, master, doctor; with names of teachers, etc. as an honorific
teacher, master, doctor; with names of teachers, etc. as an honorific	<b>先生<b> <br> せんせい <br>[sound:k-0288_先生.mp3]
[sound:k-0288_先生.mp3]	teacher, master, doctor; with names of teachers, etc. as an honorific<br> <b>先生</b> <br> (せんせい)
<b>不利</b> <br> 彼のチームは不利な状況にあります。	[sound:s-0288_彼のチームは不利な状況にあります。.mp3] <br> かれのちーむはふりなじょうきょうにあります。 <br>His team is in a disadvantageous situation.
[sound:s-0288_彼のチームは不利な状況にあります。.mp3]	<b>不利</b> <br> 彼のチームは不利な状況にあります。<br> かれのちーむはふりなじょうきょうにあります <br>His team is in a disadvantageous situation.
年生	[sound:k-0289_年生.mp3]<br>ねんせい <br> pupil in ... year, student in ... year
pupil in ... year, student in ... year	<b>年生<b> <br> ねんせい <br>[sound:k-0289_年生.mp3]
[sound:k-0289_年生.mp3]	pupil in ... year, student in ... year<br> <b>年生</b> <br> (ねんせい)
<b>不可</b> <br> その行動は不可とされました。	[sound:s-0289_その行動は不可とされました。.mp3] <br> そのこうどうはふかとされました。 <br>That action was deemed unacceptable.
[sound:s-0289_その行動は不可とされました。.mp3]	<b>不可</b> <br> その行動は不可とされました。<br> そのこうどうはふかとされました <br>That action was deemed unacceptable.
連	[sound:k-0290_連.mp3]<br>れん <br> (taxonomical) tribe; quinella (quiniela); party, company, group; two reams (i.e. 1000 sheets of paper)
(taxonomical) tribe; quinella (quiniela); party, company, group; two reams (i.e. 1000 sheets of paper)	<b>連<b> <br> れん <br>[sound:k-0290_連.mp3]
[sound:k-0290_連.mp3]	(taxonomical) tribe; quinella<br> <b>quiniela); party, company, group; two reams (i.e. 1000 sheets of paper) (連</b> <br> (れん)
<b>不可能</b> <br> 彼の計画は不可能だと思います。	[sound:s-0290_彼の計画は不可能だと思います。.mp3] <br> かれのけいかくはふかのうだとおもいます。 <br>I think his plan is impossible.
[sound:s-0290_彼の計画は不可能だと思います。.mp3]	<b>不可能</b> <br> 彼の計画は不可能だと思います。<br> かれのけいかくはふかのうだとおもいます <br>I think his plan is impossible.
関連	[sound:k-0291_関連.mp3]<br>かんれん <br> relation, connection, relevance
relation, connection, relevance	<b>関連<b> <br> かんれん <br>[sound:k-0291_関連.mp3]
[sound:k-0291_関連.mp3]	relation, connection, relevance<br> <b>関連</b> <br> (かんれん)
<b>不明</b> <br> その事件の原因はまだ不明です。	[sound:s-0291_その事件の原因はまだ不明です。.mp3] <br> そのじけんのげんいんはまだふめいです。 <br>The cause of the incident is still unknown.
[sound:s-0291_その事件の原因はまだ不明です。.mp3]	<b>不明</b> <br> その事件の原因はまだ不明です。<br> そのじけんのげんいんはまだふめいです <br>The cause of the incident is still unknown.
国連	[sound:k-0292_国連.mp3]<br>こくれん <br> UN, United Nations
UN, United Nations	<b>国連<b> <br> こくれん <br>[sound:k-0292_国連.mp3]
[sound:k-0292_国連.mp3]	UN, United Nations<br> <b>国連</b> <br> (こくれん)
<b>不動産</b> <br> 彼は不動産業で成功しています。	[sound:s-0292_彼は不動産業で成功しています。.mp3] <br> かれはふどうさんぎょうでせいこうしています。 <br>He is successful in real estate business.
[sound:s-0292_彼は不動産業で成功しています。.mp3]	<b>不動産</b> <br> 彼は不動産業で成功しています。<br> かれはふどうさんぎょうでせいこうしています <br>He is successful in real estate business.
連合	[sound:k-0293_連合.mp3]<br>れんごう <br> union, alliance, combination
union, alliance, combination	<b>連合<b> <br> れんごう <br>[sound:k-0293_連合.mp3]
[sound:k-0293_連合.mp3]	union, alliance, combination<br> <b>連合</b> <br> (れんごう)
<b>不安定</b> <br> この地域は地震が多く、不安定です。	[sound:s-0293_この地域は地震が多く、不安定です。.mp3] <br> このちいきはじしんがおおく、ふあんていです。 <br>This area is unstable due to frequent earthquakes.
[sound:s-0293_この地域は地震が多く、不安定です。.mp3]	<b>不安定</b> <br> この地域は地震が多く、不安定です。<br> このちいきはじしんがおおく、ふあんていです <br>This area is unstable due to frequent earthquakes.
連続	[sound:k-0294_連続.mp3]<br>れんぞく <br> serial, consecutive, continuity, occurring in succession, continuing
serial, consecutive, continuity, occurring in succession, continuing	<b>連続<b> <br> れんぞく <br>[sound:k-0294_連続.mp3]
[sound:k-0294_連続.mp3]	serial, consecutive, continuity, occurring in succession, continuing<br> <b>連続</b> <br> (れんぞく)
<b>不在</b> <br> 申し訳ありませんが、彼は不在です。	[sound:s-0294_申し訳ありませんが、彼は不在です。.mp3] <br> もうしわけありませんが、かれはふざいです。 <br>"I'm sorry, but he is not here."
[sound:s-0294_申し訳ありませんが、彼は不在です。.mp3]	<b>不在</b> <br> 申し訳ありませんが、彼は不在です。<br> もうしわけありませんが、かれはふざいです <br>I'm sorry, but he is not here.
連邦	[sound:k-0295_連邦.mp3]<br>れんぽう <br> commonwealth, federation of states
commonwealth, federation of states	<b>連邦<b> <br> れんぽう <br>[sound:k-0295_連邦.mp3]
[sound:k-0295_連邦.mp3]	commonwealth, federation of states<br> <b>連邦</b> <br> (れんぽう)
<b>不可能性</b> <br> その計画の実行は不可能性が高い。	[sound:s-0295_その計画の実行は不可能性が高い。.mp3] <br> そのけいかくのじっこうはふかのうせいがたかい。 <br>The execution of that plan is highly improbable.
[sound:s-0295_その計画の実行は不可能性が高い。.mp3]	<b>不可能性</b> <br> その計画の実行は不可能性が高い。<br> そのけいかくのじっこうはふかのうせいがたかい <br>The execution of that plan is highly improbable.
連立	[sound:k-0296_連立.mp3]<br>れんりつ <br> alliance, coalition
alliance, coalition	<b>連立<b> <br> れんりつ <br>[sound:k-0296_連立.mp3]
[sound:k-0296_連立.mp3]	alliance, coalition<br> <b>連立</b> <br> (れんりつ)
<b>不慮</b> <br> その事故は不慮の出来事です。	[sound:s-0296_その事故は不慮の出来事です。.mp3] <br> そのじこはふりょのできごとです。 <br>The accident was an unforeseen event.
[sound:s-0296_その事故は不慮の出来事です。.mp3]	<b>不慮</b> <br> その事故は不慮の出来事です。<br> そのじこはふりょのできごとです <br>The accident was an unforeseen event.
連盟	[sound:k-0297_連盟.mp3]<br>れんめい <br> league, union, alliance
league, union, alliance	<b>連盟<b> <br> れんめい <br>[sound:k-0297_連盟.mp3]
[sound:k-0297_連盟.mp3]	league, union, alliance<br> <b>連盟</b> <br> (れんめい)
<b>不潔</b> <br> 彼の行動は不潔だ。	[sound:s-0297_彼の行動は不潔だ。.mp3] <br> かれのこうどうはふけつだ。 <br>His behavior is unclean.
[sound:s-0297_彼の行動は不潔だ。.mp3]	<b>不潔</b> <br> 彼の行動は不潔だ。<br> かれのこうどうはふけつだ <br>His behavior is unclean.
連絡	[sound:k-0298_連絡.mp3]<br>れんらく <br> to contact, to get in touch; contacting, getting in touch, communication, call, message; connection, coordination, junction; intercalary, intercalaris, internuncial
to contact, to get in touch; contacting, getting in touch, communication, call, message; connection, coordination, junction; intercalary, intercalaris, internuncial	<b>連絡<b> <br> れんらく <br>[sound:k-0298_連絡.mp3]
[sound:k-0298_連絡.mp3]	to contact, to get in touch; contacting, getting in touch, communication, call, message; connection, coordination, junction; intercalary, intercalaris, internuncial<br> <b>連絡</b> <br> (れんらく)
<b>普通</b> <br> 彼は普通の人々とは異なっています。	[sound:s-0298_彼は普通の人々とは異なっています。.mp3] <br> かれはふつうのひとびととはことなっています。 <br>He is different from ordinary people.
[sound:s-0298_彼は普通の人々とは異なっています。.mp3]	<b>普通</b> <br> 彼は普通の人々とは異なっています。<br> かれはふつうのひとびととはことなっています <br>He is different from ordinary people.
一連	[sound:k-0299_一連.mp3]<br>いちれん <br> series, chain, sequence; two reams (i.e. 1000 sheets of paper); verse, stanza
series, chain, sequence; two reams (i.e. 1000 sheets of paper); verse, stanza	<b>一連<b> <br> いちれん <br>[sound:k-0299_一連.mp3]
[sound:k-0299_一連.mp3]	series, chain, sequence; two reams<br> <b>i.e. 1000 sheets of paper); verse, stanza (一連</b> <br> (いちれん)
<b>普段</b> <br> 彼女は普段からおしゃべりです。	[sound:s-0299_彼女は普段からおしゃべりです。.mp3] <br> かのじょはふだんからおしゃべりです。 <br>She is talkative as usual.
[sound:s-0299_彼女は普段からおしゃべりです。.mp3]	<b>普段</b> <br> 彼女は普段からおしゃべりです。<br> かのじょはふだんからおしゃべりです <br>She is talkative as usual.
五	[sound:k-0300_五.mp3]<br>ご, いつ, い <br> five
five	<b>五<b> <br> ご, いつ, い <br>[sound:k-0300_五.mp3]
[sound:k-0300_五.mp3]	five<br> <b>五</b> <br> (ご, いつ, い)
<b>普及</b> <br> この技術は急速に普及しています。	[sound:s-0300_この技術は急速に普及しています。.mp3] <br> このぎじゅつはきゅうそくにふきゅうしています。 <br>This technology is spreading rapidly.
[sound:s-0300_この技術は急速に普及しています。.mp3]	<b>普及</b> <br> この技術は急速に普及しています。<br> このぎじゅつはきゅうそくにふきゅうしています <br>This technology is spreading rapidly.
五月	[sound:k-0301_五月.mp3]<br>ごがつ <br> May
May	<b>五月<b> <br> ごがつ <br>[sound:k-0301_五月.mp3]
[sound:k-0301_五月.mp3]	May<br> <b>五月</b> <br> (ごがつ)
<b>普段</b> <br> 彼女は普段からおしゃべりです。	[sound:s-0301_彼女は普段からおしゃべりです。.mp3] <br> かのじょはふだんからおしゃべりです。 <br>She is talkative as usual.
[sound:s-0301_彼女は普段からおしゃべりです。.mp3]	<b>普段</b> <br> 彼女は普段からおしゃべりです。<br> かのじょはふだんからおしゃべりです <br>She is talkative as usual.
十五	[sound:k-0302_十五.mp3]<br>じゅうご <br> 15, fifteen
15, fifteen	<b>十五<b> <br> じゅうご <br>[sound:k-0302_十五.mp3]
[sound:k-0302_十五.mp3]	15, fifteen<br> <b>十五</b> <br> (じゅうご)
<b>普及</b> <br> この技術は急速に普及しています。	[sound:s-0302_この技術は急速に普及しています。.mp3] <br> このぎじゅつはきゅうそくにふきゅうしています。 <br>This technology is spreading rapidly.
[sound:s-0302_この技術は急速に普及しています。.mp3]	<b>普及</b> <br> この技術は急速に普及しています。<br> このぎじゅつはきゅうそくにふきゅうしています <br>This technology is spreading rapidly.
五輪	[sound:k-0303_五輪.mp3]<br>ごりん <br> the Olympics
the Olympics	<b>五輪<b> <br> ごりん <br>[sound:k-0303_五輪.mp3]
[sound:k-0303_五輪.mp3]	the Olympics<br> <b>五輪</b> <br> (ごりん)
<b>普遍</b> <br> その言葉は普遍的な真理を持っています。	[sound:s-0303_その言葉は普遍的な真理を持っています。.mp3] <br> そのことばはふへんてきなしんりをもっています。 <br>The words contain universal truths.
[sound:s-0303_その言葉は普遍的な真理を持っています。.mp3]	<b>普遍</b> <br> その言葉は普遍的な真理を持っています。<br> そのことばはふへんてきなしんりをもっています <br>The words contain universal truths.
五十	[sound:k-0304_五十.mp3]<br>ごじゅう, いそ, い <br> fifty
fifty	<b>五十<b> <br> ごじゅう, いそ, い <br>[sound:k-0304_五十.mp3]
[sound:k-0304_五十.mp3]	fifty<br> <b>五十</b> <br> (ごじゅう, いそ, い)
<b>普通</b> <br> このレストランの料理は普通です。	[sound:s-0304_このレストランの料理は普通です。.mp3] <br> このれすとらんのりょうりはふつうです。 <br>The food at this restaurant is ordinary.
[sound:s-0304_このレストランの料理は普通です。.mp3]	<b>普通</b> <br> このレストランの料理は普通です。<br> このれすとらんのりょうりはふつうです <br>The food at this restaurant is ordinary.
五つ	[sound:k-0305_五つ.mp3]<br>いつつ <br> five
five	<b>五つ<b> <br> いつつ <br>[sound:k-0305_五つ.mp3]
[sound:k-0305_五つ.mp3]	five<br> <b>五つ</b> <br> (いつつ)
<b>普段</b> <br> 彼は普段から運動をしています。	[sound:s-0305_彼は普段から運動をしています。.mp3] <br> かれはふだんからうんどうをしています。 <br>He exercises regularly.
[sound:s-0305_彼は普段から運動をしています。.mp3]	<b>普段</b> <br> 彼は普段から運動をしています。<br> かれはふだんからうんどうをしています <br>He exercises regularly.
五分	[sound:k-0306_五分.mp3]<br>ごぶ <br> half, 50%, tie, evenness; 5 parts, 5%
half, 50%, tie, evenness; 5 parts, 5%	<b>五分<b> <br> ごぶ <br>[sound:k-0306_五分.mp3]
[sound:k-0306_五分.mp3]	half, 50%, tie, evenness; 5 parts, 5%<br> <b>五分</b> <br> (ごぶ)
<b>普遍的</b> <br> 愛は普遍的な感情です。	[sound:s-0306_愛は普遍的な感情です。.mp3] <br> あいはふへんてきなかんじょうです。 <br>Love is a universal emotion.
[sound:s-0306_愛は普遍的な感情です。.mp3]	<b>普遍的</b> <br> 愛は普遍的な感情です。<br> あいはふへんてきなかんじょうです <br>Love is a universal emotion.
五十三次	[sound:k-0307_五十三次.mp3]<br>ごじゅうさんつぎ <br> the 53 Toukaidou stages
the 53 Toukaidou stages	<b>五十三次<b> <br> ごじゅうさんつぎ <br>[sound:k-0307_五十三次.mp3]
[sound:k-0307_五十三次.mp3]	the 53 Toukaidou stages<br> <b>五十三次</b> <br> (ごじゅうさんつぎ)
<b>普及</b> <br> この技術は急速に普及しています。	[sound:s-0307_この技術は急速に普及しています。.mp3] <br> このぎじゅつはきゅうそくにふきゅうしています。 <br>This technology is spreading rapidly.
[sound:s-0307_この技術は急速に普及しています。.mp3]	<b>普及</b> <br> この技術は急速に普及しています。<br> このぎじゅつはきゅうそくにふきゅうしています <br>This technology is spreading rapidly.
五感	[sound:k-0308_五感.mp3]<br>ごかん <br> the five senses
the five senses	<b>五感<b> <br> ごかん <br>[sound:k-0308_五感.mp3]
[sound:k-0308_五感.mp3]	the five senses<br> <b>五感</b> <br> (ごかん)
<b>普段</b> <br> 彼女は普段からおしゃべりです。	[sound:s-0308_彼女は普段からおしゃべりです。.mp3] <br> かのじょはふだんからおしゃべりです。 <br>She is talkative as usual.
[sound:s-0308_彼女は普段からおしゃべりです。.mp3]	<b>普段</b> <br> 彼女は普段からおしゃべりです。<br> かのじょはふだんからおしゃべりです <br>She is talkative as usual.
五十音	[sound:k-0309_五十音.mp3]<br>ごじゅうおん <br> the Japanese syllabary
the Japanese syllabary	<b>五十音<b> <br> ごじゅうおん <br>[sound:k-0309_五十音.mp3]
[sound:k-0309_五十音.mp3]	the Japanese syllabary<br> <b>五十音</b> <br> (ごじゅうおん)
<b>普遍</b> <br> その言葉は普遍的な真理を持っています。	[sound:s-0309_その言葉は普遍的な真理を持っています。.mp3] <br> そのことばはふへんてきなしんりをもっています。 <br>The words contain universal truths.
[sound:s-0309_その言葉は普遍的な真理を持っています。.mp3]	<b>普遍</b> <br> その言葉は普遍的な真理を持っています。<br> そのことばはふへんてきなしんりをもっています <br>The words contain universal truths.
発	[sound:k-0310_発.mp3]<br>はつ <br> departure, departing (from ...), departing (at time ...); beginning; issued by (e.g. document); counter for gunshots, counter for blows (punches)
departure, departing (from ...), departing (at time ...); beginning; issued by (e.g. document); counter for gunshots, counter for blows (punches)	<b>発<b> <br> はつ <br>[sound:k-0310_発.mp3]
[sound:k-0310_発.mp3]	departure, departing<br> <b>from ...), departing (at time ...); beginning; issued by (e.g. document); counter for gunshots, counter for blows (punches) (発</b> <br> (はつ)
<b>普通</b> <br> このレストランの料理は普通です。	[sound:s-0310_このレストランの料理は普通です。.mp3] <br> このれすとらんのりょうりはふつうです。 <br>The food at this restaurant is ordinary.
[sound:s-0310_このレストランの料理は普通です。.mp3]	<b>普通</b> <br> このレストランの料理は普通です。<br> このれすとらんのりょうりはふつうです <br>The food at this restaurant is ordinary.
開発	[sound:k-0311_開発.mp3]<br>かいはつ <br> development, exploitation
development, exploitation	<b>開発<b> <br> かいはつ <br>[sound:k-0311_開発.mp3]
[sound:k-0311_開発.mp3]	development, exploitation<br> <b>開発</b> <br> (かいはつ)
<b>普段</b> <br> 彼は普段から運動をしています。	[sound:s-0311_彼は普段から運動をしています。.mp3] <br> かれはふだんからうんどうをしています。 <br>He exercises regularly.
[sound:s-0311_彼は普段から運動をしています。.mp3]	<b>普段</b> <br> 彼は普段から運動をしています。<br> かれはふだんからうんどうをしています <br>He exercises regularly.
発言	[sound:k-0312_発言.mp3]<br>はつげん <br> utterance, speech, proposal
utterance, speech, proposal	<b>発言<b> <br> はつげん <br>[sound:k-0312_発言.mp3]
[sound:k-0312_発言.mp3]	utterance, speech, proposal<br> <b>発言</b> <br> (はつげん)
<b>普遍的</b> <br> 愛は普遍的な感情です。	[sound:s-0312_愛は普遍的な感情です。.mp3] <br> あいはふへんてきなかんじょうです。 <br>Love is a universal emotion.
[sound:s-0312_愛は普遍的な感情です。.mp3]	<b>普遍的</b> <br> 愛は普遍的な感情です。<br> あいはふへんてきなかんじょうです <br>Love is a universal emotion.
発行	[sound:k-0313_発行.mp3]<br>はっこう <br> issue (publications), publishing; raising an event (software)
issue (publications), publishing; raising an event (software)	<b>発行<b> <br> はっこう <br>[sound:k-0313_発行.mp3]
[sound:k-0313_発行.mp3]	issue<br> <b>publications), publishing; raising an event (software) (発行</b> <br> (はっこう)
<b>直る</b> <br> その時計は直りましたか？	[sound:s-0313_その時計は直りましたか？.mp3] <br> そのとけいはなおりましたか？ <br>Is the clock fixed now?
[sound:s-0313_その時計は直りましたか？.mp3]	(<b>直る</b>) その時計は直りましたか？	そのとけいはなおりましたか？ <br>Is the clock fixed now?
発展	[sound:k-0314_発展.mp3]<br>はってん <br> development, growth
development, growth	<b>発展<b> <br> はってん <br>[sound:k-0314_発展.mp3]
[sound:k-0314_発展.mp3]	development, growth<br> <b>発展</b> <br> (はってん)
<b>直ちに</b> <br> その問題は直ちに解決しなければなりません。	[sound:s-0314_その問題は直ちに解決しなければなりません。.mp3] <br> そのもんだいはただちにかいけつしなければなりません。 <br>The problem must be solved immediately.
[sound:s-0314_その問題は直ちに解決しなければなりません。.mp3]	<b>直ちに</b> <br> その問題は直ちに解決しなければなりません。<br> そのもんだいはただちにかいけつしなければなりません <br>The problem must be solved immediately.
発表	[sound:k-0315_発表.mp3]<br>はっぴょう <br> announcement, publication
announcement, publication	<b>発表<b> <br> はっぴょう <br>[sound:k-0315_発表.mp3]
[sound:k-0315_発表.mp3]	announcement, publication<br> <b>発表</b> <br> (はっぴょう)
<b>直感</b> <br> 彼女は直感に従いました。	[sound:s-0315_彼女は直感に従いました。.mp3] <br> かのじょはちょっかんにしたがいました。 <br>She followed her intuition.
[sound:s-0315_彼女は直感に従いました。.mp3]	<b>直感</b> <br> 彼女は直感に従いました。<br> かのじょはちょっかんにしたがいました <br>She followed her intuition.
反発	[sound:k-0316_反発.mp3]<br>はんぱつ <br> to repel, to oppose, to revolt, to react sharply (against); opposition, rebellion, resistance, backlash; rally, recovery (e.g. in stock prices), rebound; to rally, to recover, to rebound
to repel, to oppose, to revolt, to react sharply (against); opposition, rebellion, resistance, backlash; rally, recovery (e.g. in stock prices), rebound; to rally, to recover, to rebound	<b>反発<b> <br> はんぱつ <br>[sound:k-0316_反発.mp3]
[sound:k-0316_反発.mp3]	to repel, to oppose, to revolt, to react sharply<br> <b>against); opposition, rebellion, resistance, backlash; rally, recovery (e.g. in stock prices), rebound; to rally, to recover, to rebound (反発</b> <br> (はんぱつ)
<b>直面</b> <br> 彼は多くの困難に直面しています。	[sound:s-0316_彼は多くの困難に直面しています。.mp3] <br> かれはおおくのこんなんにちょくめんしています。 <br>He is facing many difficulties.
[sound:s-0316_彼は多くの困難に直面しています。.mp3]	<b>直面</b> <br> 彼は多くの困難に直面しています。<br> かれはおおくのこんなんにちょくめんしています <br>He is facing many difficulties.
活発	[sound:k-0317_活発.mp3]<br>かっぱつ <br> vigor, vigour, active, lively
vigor, vigour, active, lively	<b>活発<b> <br> かっぱつ <br>[sound:k-0317_活発.mp3]
[sound:k-0317_活発.mp3]	vigor, vigour, active, lively<br> <b>活発</b> <br> (かっぱつ)
<b>直接</b> <br> 彼と直接話した方がいいです。	[sound:s-0317_彼と直接話した方がいいです。.mp3] <br> かれとちょくせつはなしたほうがいいです。 <br>It's better to talk to him directly.
[sound:s-0317_彼と直接話した方がいいです。.mp3]	<b>直接</b> <br> 彼と直接話した方がいいです。<br> かれとちょくせつはなしたほうがいいです <br>It's better to talk to him directly.
原発	[sound:k-0318_原発.mp3]<br>げんぱつ <br> nuclear power plant, nuclear power supply
nuclear power plant, nuclear power supply	<b>原発<b> <br> げんぱつ <br>[sound:k-0318_原発.mp3]
[sound:k-0318_原発.mp3]	nuclear power plant, nuclear power supply<br> <b>原発</b> <br> (げんぱつ)
<b>直接的</b> <br> 彼は直接的なアプローチを好みます。	[sound:s-0318_彼は直接的なアプローチを好みます。.mp3] <br> かれはちょくせつてきなあぷろーちをこのみます。 <br>He prefers a direct approach.
[sound:s-0318_彼は直接的なアプローチを好みます。.mp3]	<b>直接的</b> <br> 彼は直接的なアプローチを好みます。<br> かれはちょくせつてきなあぷろーちをこのみます <br>He prefers a direct approach.
先発	[sound:k-0319_先発.mp3]<br>せんぱつ <br> forerunner, advance party, going on ahead; being in a (team sports) match or game from the start, starting
forerunner, advance party, going on ahead; being in a (team sports) match or game from the start, starting	<b>先発<b> <br> せんぱつ <br>[sound:k-0319_先発.mp3]
[sound:k-0319_先発.mp3]	forerunner, advance party, going on ahead; being in a<br> <b>team sports) match or game from the start, starting (先発</b> <br> (せんぱつ)
<b>直径</b> <br> その円の直径を計算してください。	[sound:s-0319_その円の直径を計算してください。.mp3] <br> そのえんのちょっけいをけいさんしてください。 <br>Please calculate the diameter of the circle.
[sound:s-0319_その円の直径を計算してください。.mp3]	<b>直径</b> <br> その円の直径を計算してください。<br> そのえんのちょっけいをけいさんしてください <br>Please calculate the diameter of the circle.
間	[sound:k-0320_間.mp3]<br>あいだ <br> space (between), gap, interval, distance; time (between), pause, break; span (temporal or spatial), stretch, period (while); relationship (between, among); members (within, among); due to, because of
space (between), gap, interval, distance; time (between), pause, break; span (temporal or spatial), stretch, period (while); relationship (between, among); members (within, among); due to, because of	<b>間<b> <br> あいだ <br>[sound:k-0320_間.mp3]
[sound:k-0320_間.mp3]	space<br> <b>between), gap, interval, distance; time (between), pause, break; span (temporal or spatial), stretch, period (while); relationship (between, among); members (within, among); due to, because of (間</b> <br> (あいだ)
<b>直角</b> <br> この角度は直角です。	[sound:s-0320_この角度は直角です。.mp3] <br> このかくどはちょっかくです。 <br>This angle is a right angle.
[sound:s-0320_この角度は直角です。.mp3]	<b>直角</b> <br> この角度は直角です。<br> このかくどはちょっかくです <br>This angle is a right angle.
間もなく	[sound:k-0321_間もなく.mp3]<br>まもなく <br> soon, before long, in a short time; (after verb) lacking time to ..., without time to ...
soon, before long, in a short time; (after verb) lacking time to ..., without time to ...	<b>間もなく<b> <br> まもなく <br>[sound:k-0321_間もなく.mp3]
[sound:k-0321_間もなく.mp3]	soon, before long, in a short time;<br> <b>after verb) lacking time to ..., without time to ... (間もなく</b> <br> (まもなく)
<b>直行</b> <br> 列車は直行便です。	[sound:s-0321_列車は直行便です。.mp3] <br> れっしゃはちょっこうびんです。 <br>The train is a direct service.
[sound:s-0321_列車は直行便です。.mp3]	<b>直行</b> <br> 列車は直行便です。<br> れっしゃはちょっこうびんです <br>The train is a direct service.
期間	[sound:k-0322_期間.mp3]<br>きかん <br> period, term, interval
period, term, interval	<b>期間<b> <br> きかん <br>[sound:k-0322_期間.mp3]
[sound:k-0322_期間.mp3]	period, term, interval<br> <b>期間</b> <br> (きかん)
<b>直感</b> <br> 彼女は直感に従いました。	[sound:s-0322_彼女は直感に従いました。.mp3] <br> かのじょはちょっかんにしたがいました。 <br>She followed her intuition.
[sound:s-0322_彼女は直感に従いました。.mp3]	<b>直感</b> <br> 彼女は直感に従いました。<br> かのじょはちょっかんにしたがいました <br>She followed her intuition.
時間	[sound:k-0323_時間.mp3]<br>じかん <br> time; hours
time; hours	<b>時間<b> <br> じかん <br>[sound:k-0323_時間.mp3]
[sound:k-0323_時間.mp3]	time; hours<br> <b>時間</b> <br> (じかん)
<b>直面</b> <br> 彼は多くの困難に直面しています。	[sound:s-0323_彼は多くの困難に直面しています。.mp3] <br> かれはおおくのこんなんにちょくめんしています。 <br>He is facing many difficulties.
[sound:s-0323_彼は多くの困難に直面しています。.mp3]	<b>直面</b> <br> 彼は多くの困難に直面しています。<br> かれはおおくのこんなんにちょくめんしています <br>He is facing many difficulties.
人間	[sound:k-0324_人間.mp3]<br>にんげん <br> human being, man, person; character (of a person)
human being, man, person; character (of a person)	<b>人間<b> <br> にんげん <br>[sound:k-0324_人間.mp3]
[sound:k-0324_人間.mp3]	human being, man, person; character<br> <b>of a person) (人間</b> <br> (にんげん)
<b>直接</b> <br> 彼と直接話した方がいいです。	[sound:s-0324_彼と直接話した方がいいです。.mp3] <br> かれとちょくせつはなしたほうがいいです。 <br>It's better to talk to him directly.
[sound:s-0324_彼と直接話した方がいいです。.mp3]	<b>直接</b> <br> 彼と直接話した方がいいです。<br> かれとちょくせつはなしたほうがいいです <br>It's better to talk to him directly.
年間	[sound:k-0325_年間.mp3]<br>ねんかん <br> year (period of)
year (period of)	<b>年間<b> <br> ねんかん <br>[sound:k-0325_年間.mp3]
[sound:k-0325_年間.mp3]	year<br> <b>period of) (年間</b> <br> (ねんかん)
<b>直接的</b> <br> 彼は直接的なアプローチを好みます。	[sound:s-0325_彼は直接的なアプローチを好みます。.mp3] <br> かれはちょくせつてきなあぷろーちをこのみます。 <br>He prefers a direct approach.
[sound:s-0325_彼は直接的なアプローチを好みます。.mp3]	<b>直接的</b> <br> 彼は直接的なアプローチを好みます。<br> かれはちょくせつてきなあぷろーちをこのみます <br>He prefers a direct approach.
民間	[sound:k-0326_民間.mp3]<br>みんかん <br> private, civilian, civil, popular, folk, unofficial
private, civilian, civil, popular, folk, unofficial	<b>民間<b> <br> みんかん <br>[sound:k-0326_民間.mp3]
[sound:k-0326_民間.mp3]	private, civilian, civil, popular, folk, unofficial<br> <b>民間</b> <br> (みんかん)
<b>直径</b> <br> その円の直径を計算してください。	[sound:s-0326_その円の直径を計算してください。.mp3] <br> そのえんのちょっけいをけいさんしてください。 <br>Please calculate the diameter of the circle.
[sound:s-0326_その円の直径を計算してください。.mp3]	<b>直径</b> <br> その円の直径を計算してください。<br> そのえんのちょっけいをけいさんしてください <br>Please calculate the diameter of the circle.
中間	[sound:k-0327_中間.mp3]<br>ちゅうかん <br> middle, midway, interim
middle, midway, interim	<b>中間<b> <br> ちゅうかん <br>[sound:k-0327_中間.mp3]
[sound:k-0327_中間.mp3]	middle, midway, interim<br> <b>中間</b> <br> (ちゅうかん)
<b>直角</b> <br> この角度は直角です。	[sound:s-0327_この角度は直角です。.mp3] <br> このかくどはちょっかくです。 <br>This angle is a right angle.
[sound:s-0327_この角度は直角です。.mp3]	<b>直角</b> <br> この角度は直角です。<br> このかくどはちょっかくです <br>This angle is a right angle.
仲間	[sound:k-0328_仲間.mp3]<br>なかま <br> company, fellow, colleague, associate, comrade, mate, group, circle of friends, partner
company, fellow, colleague, associate, comrade, mate, group, circle of friends, partner	<b>仲間<b> <br> なかま <br>[sound:k-0328_仲間.mp3]
[sound:k-0328_仲間.mp3]	company, fellow, colleague, associate, comrade, mate, group, circle of friends, partner<br> <b>仲間</b> <br> (なかま)
<b>直行</b> <br> 列車は直行便です。	[sound:s-0328_列車は直行便です。.mp3] <br> れっしゃはちょっこうびんです。 <br>The train is a direct service.
[sound:s-0328_列車は直行便です。.mp3]	<b>直行</b> <br> 列車は直行便です。<br> れっしゃはちょっこうびんです <br>The train is a direct service.
空間	[sound:k-0329_空間.mp3]<br>くうかん <br> space, room, airspace
space, room, airspace	<b>空間<b> <br> くうかん <br>[sound:k-0329_空間.mp3]
[sound:k-0329_空間.mp3]	space, room, airspace<br> <b>空間</b> <br> (くうかん)
<b>意見</b> <br> 彼女は自分の意見をはっきり述べました。	[sound:s-0329_彼女は自分の意見をはっきり述べました。.mp3] <br> かのじょはじぶんのいけんをはっきりのべました。 <br>She clearly stated her opinion.
[sound:s-0329_彼女は自分の意見をはっきり述べました。.mp3]	<b>意見</b> <br> 彼女は自分の意見をはっきり述べました。<br> かのじょはじぶんのいけんをはっきりのべました <br>She clearly stated her opinion.
対応	[sound:k-0330_対応.mp3]<br>たいおう <br> interaction, correspondence, coping with, dealing with, support
interaction, correspondence, coping with, dealing with, support	<b>対応<b> <br> たいおう <br>[sound:k-0330_対応.mp3]
[sound:k-0330_対応.mp3]	interaction, correspondence, coping with, dealing with, support<br> <b>対応</b> <br> (たいおう)
<b>意志</b> <br> 彼は成功するための強い意志を持っています。	[sound:s-0330_彼は成功するための強い意志を持っています。.mp3] <br> かれはせいこうするためのつよいいしをもっています。 <br>He has a strong will to succeed.
[sound:s-0330_彼は成功するための強い意志を持っています。.mp3]	<b>意志</b> <br> 彼は成功するための強い意志を持っています。<br> かれはせいこうするためのつよいいしをもっています <br>He has a strong will to succeed.
対策	[sound:k-0331_対策.mp3]<br>たいさく <br> counter-plan, counter-measure
counter-plan, counter-measure	<b>対策<b> <br> たいさく <br>[sound:k-0331_対策.mp3]
[sound:k-0331_対策.mp3]	counter-plan, counter-measure<br> <b>対策</b> <br> (たいさく)
<b>意味</b> <br> その言葉の意味を教えてください。	[sound:s-0331_その言葉の意味を教えてください。.mp3] <br> そのことばのいみをおしえてください。 <br>Please tell me the meaning of that word.
[sound:s-0331_その言葉の意味を教えてください。.mp3]	<b>意味</b> <br> その言葉の意味を教えてください。<br> そのことばのいみをおしえてください <br>Please tell me the meaning of that word.
対象	[sound:k-0332_対象.mp3]<br>たいしょう <br> target, object (of worship, study, etc.), subject (of taxation, etc.)
target, object (of worship, study, etc.), subject (of taxation, etc.)	<b>対象<b> <br> たいしょう <br>[sound:k-0332_対象.mp3]
[sound:k-0332_対象.mp3]	target, object<br> <b>of worship, study, etc.), subject (of taxation, etc.) (対象</b> <br> (たいしょう)
<b>意図</b> <br> 彼の発言の意図が理解できません。	[sound:s-0332_彼の発言の意図が理解できません。.mp3] <br> かれのはつげんのいとがりかいできません。 <br>I don't understand the intention behind his statement.
[sound:s-0332_彼の発言の意図が理解できません。.mp3]	<b>意図</b> <br> 彼の発言の意図が理解できません。<br> かれのはつげんのいとがりかいできません <br>I don't understand the intention behind his statement.
反対	[sound:k-0333_反対.mp3]<br>はんたい <br> opposition, resistance, antagonism, hostility, contrast, objection, dissension, reverse, opposite, vice versa
opposition, resistance, antagonism, hostility, contrast, objection, dissension, reverse, opposite, vice versa	<b>反対<b> <br> はんたい <br>[sound:k-0333_反対.mp3]
[sound:k-0333_反対.mp3]	opposition, resistance, antagonism, hostility, contrast, objection, dissension, reverse, opposite, vice versa<br> <b>反対</b> <br> (はんたい)
<b>意義</b> <br> 彼女の行動には深い意義があります。	[sound:s-0333_彼女の行動には深い意義があります。.mp3] <br> かのじょのこうどうにはふかいいぎがあります。 <br>Her actions have deep significance.
[sound:s-0333_彼女の行動には深い意義があります。.mp3]	<b>意義</b> <br> 彼女の行動には深い意義があります。<br> かのじょのこうどうにはふかいいぎがあります <br>Her actions have deep significance.
対立	[sound:k-0334_対立.mp3]<br>たいりつ <br> confrontation, opposition, antagonism
confrontation, opposition, antagonism	<b>対立<b> <br> たいりつ <br>[sound:k-0334_対立.mp3]
[sound:k-0334_対立.mp3]	confrontation, opposition, antagonism<br> <b>対立</b> <br> (たいりつ)
<b>意外</b> <br> 彼女の反応は意外でした。	[sound:s-0334_彼女の反応は意外でした。.mp3] <br> かのじょのはんのうはいがいでした。 <br>Her reaction was unexpected.
[sound:s-0334_彼女の反応は意外でした。.mp3]	<b>意外</b> <br> 彼女の反応は意外でした。<br> かのじょのはんのうはいがいでした <br>Her reaction was unexpected.
対話	[sound:k-0335_対話.mp3]<br>たいわ <br> interactive, interaction, conversation, dialogue
interactive, interaction, conversation, dialogue	<b>対話<b> <br> たいわ <br>[sound:k-0335_対話.mp3]
[sound:k-0335_対話.mp3]	interactive, interaction, conversation, dialogue<br> <b>対話</b> <br> (たいわ)
<b>意欲</b> <br> 彼は仕事に対する意欲があります。	[sound:s-0335_彼は仕事に対する意欲があります。.mp3] <br> かれはしごとにたいするいよくがあります。 <br>He has enthusiasm for his work.
[sound:s-0335_彼は仕事に対する意欲があります。.mp3]	<b>意欲</b> <br> 彼は仕事に対する意欲があります。<br> かれはしごとにたいするいよくがあります <br>He has enthusiasm for his work.
対日	[sound:k-0336_対日.mp3]<br>たいにち <br> with respect to Japan, with Japan
with respect to Japan, with Japan	<b>対日<b> <br> たいにち <br>[sound:k-0336_対日.mp3]
[sound:k-0336_対日.mp3]	with respect to Japan, with Japan<br> <b>対日</b> <br> (たいにち)
<b>意向</b> <br> 彼は昇進の意向を上司に伝えました。	[sound:s-0336_彼は昇進の意向を上司に伝えました。.mp3] <br> かれはしょうしんのいこうをじょうしにつたえました。 <br>He conveyed his intention to his boss for a promotion.
[sound:s-0336_彼は昇進の意向を上司に伝えました。.mp3]	<b>意向</b> <br> 彼は昇進の意向を上司に伝えました。<br> かれはしょうしんのいこうをじょうしにつたえました <br>He conveyed his intention to his boss for a promotion.
国対	[sound:k-0337_国対.mp3]<br>こくたい <br> Committee of the National Diet
Committee of the National Diet	<b>国対<b> <br> こくたい <br>[sound:k-0337_国対.mp3]
[sound:k-0337_国対.mp3]	Committee of the National Diet<br> <b>国対</b> <br> (こくたい)
<b>意志</b> <br> 彼は成功するための強い意志を持っています。	[sound:s-0337_彼は成功するための強い意志を持っています。.mp3] <br> かれはせいこうするためのつよいいしをもっています。 <br>He has a strong will to succeed.
[sound:s-0337_彼は成功するための強い意志を持っています。.mp3]	<b>意志</b> <br> 彼は成功するための強い意志を持っています。<br> かれはせいこうするためのつよいいしをもっています <br>He has a strong will to succeed.
絶対	[sound:k-0338_絶対.mp3]<br>ぜったい <br> absolutely, unconditionally; absolute, unconditional, unmistakable; absoluteness
absolutely, unconditionally; absolute, unconditional, unmistakable; absoluteness	<b>絶対<b> <br> ぜったい <br>[sound:k-0338_絶対.mp3]
[sound:k-0338_絶対.mp3]	absolutely, unconditionally; absolute, unconditional, unmistakable; absoluteness<br> <b>絶対</b> <br> (ぜったい)
<b>意見</b> <br> 彼女は自分の意見をはっきり述べました。	[sound:s-0338_彼女は自分の意見をはっきり述べました。.mp3] <br> かのじょはじぶんのいけんをはっきりのべました。 <br>She clearly stated her opinion.
[sound:s-0338_彼女は自分の意見をはっきり述べました。.mp3]	<b>意見</b> <br> 彼女は自分の意見をはっきり述べました。<br> かのじょはじぶんのいけんをはっきりのべました <br>She clearly stated her opinion.
対外	[sound:k-0339_対外.mp3]<br>たいがい <br> external, foreign
external, foreign	<b>対外<b> <br> たいがい <br>[sound:k-0339_対外.mp3]
[sound:k-0339_対外.mp3]	external, foreign<br> <b>対外</b> <br> (たいがい)
<b>意志</b> <br> 彼は成功するための強い意志を持っています。	[sound:s-0339_彼は成功するための強い意志を持っています。.mp3] <br> かれはせいこうするためのつよいいしをもっています。 <br>He has a strong will to succeed.
[sound:s-0339_彼は成功するための強い意志を持っています。.mp3]	<b>意志</b> <br> 彼は成功するための強い意志を持っています。<br> かれはせいこうするためのつよいいしをもっています <br>He has a strong will to succeed.
上がったり	[sound:k-0340_上がったり.mp3]<br>あがったり <br> doomed, in a bad state, poor (e.g. business)
doomed, in a bad state, poor (e.g. business)	<b>上がったり<b> <br> あがったり <br>[sound:k-0340_上がったり.mp3]
[sound:k-0340_上がったり.mp3]	doomed, in a bad state, poor<br> <b>e.g. business) (上がったり</b> <br> (あがったり)
<b>意味</b> <br> その言葉の意味を教えてください。	[sound:s-0340_その言葉の意味を教えてください。.mp3] <br> そのことばのいみをおしえてください。 <br>Please tell me the meaning of that word.
[sound:s-0340_その言葉の意味を教えてください。.mp3]	<b>意味</b> <br> その言葉の意味を教えてください。<br> そのことばのいみをおしえてください <br>Please tell me the meaning of that word.
史上	[sound:k-0341_史上.mp3]<br>しじょう <br> historical
historical	<b>史上<b> <br> しじょう <br>[sound:k-0341_史上.mp3]
[sound:k-0341_史上.mp3]	historical<br> <b>史上</b> <br> (しじょう)
<b>意図</b> <br> 彼の発言の意図が理解できません。	[sound:s-0341_彼の発言の意図が理解できません。.mp3] <br> かれのはつげんのいとがりかいできません。 <br>I don't understand the intention behind his statement.
[sound:s-0341_彼の発言の意図が理解できません。.mp3]	<b>意図</b> <br> 彼の発言の意図が理解できません。<br> かれのはつげんのいとがりかいできません <br>I don't understand the intention behind his statement.
事実上	[sound:k-0342_事実上.mp3]<br>じじつじょう <br> (as a) matter of fact, actually, in reality
(as a) matter of fact, actually, in reality	<b>事実上<b> <br> じじつじょう <br>[sound:k-0342_事実上.mp3]
[sound:k-0342_事実上.mp3]	(as a) matter of fact, actually, in reality<br> <b>事実上</b> <br> (じじつじょう)
<b>意義</b> <br> 彼女の行動には深い意義があります。	[sound:s-0342_彼女の行動には深い意義があります。.mp3] <br> かのじょのこうどうにはふかいいぎがあります。 <br>Her actions have deep significance.
[sound:s-0342_彼女の行動には深い意義があります。.mp3]	<b>意義</b> <br> 彼女の行動には深い意義があります。<br> かのじょのこうどうにはふかいいぎがあります <br>Her actions have deep significance.
上げ	[sound:k-0343_上げ.mp3]<br>あげ <br> rise in price, making a tuck
rise in price, making a tuck	<b>上げ<b> <br> あげ <br>[sound:k-0343_上げ.mp3]
[sound:k-0343_上げ.mp3]	rise in price, making a tuck<br> <b>上げ</b> <br> (あげ)
<b>意外</b> <br> 彼女の反応は意外でした。	[sound:s-0343_彼女の反応は意外でした。.mp3] <br> かのじょのはんのうはいがいでした。 <br>Her reaction was unexpected.
[sound:s-0343_彼女の反応は意外でした。.mp3]	<b>意外</b> <br> 彼女の反応は意外でした。<br> かのじょのはんのうはいがいでした <br>Her reaction was unexpected.
上昇	[sound:k-0344_上昇.mp3]<br>じょうしょう <br> rising, ascending, climbing
rising, ascending, climbing	<b>上昇<b> <br> じょうしょう <br>[sound:k-0344_上昇.mp3]
[sound:k-0344_上昇.mp3]	rising, ascending, climbing<br> <b>上昇</b> <br> (じょうしょう)
<b>意欲</b> <br> 彼は仕事に対する意欲があります。	[sound:s-0344_彼は仕事に対する意欲があります。.mp3] <br> かれはしごとにたいするいよくがあります。 <br>He has enthusiasm for his work.
[sound:s-0344_彼は仕事に対する意欲があります。.mp3]	<b>意欲</b> <br> 彼は仕事に対する意欲があります。<br> かれはしごとにたいするいよくがあります <br>He has enthusiasm for his work.
向上	[sound:k-0345_向上.mp3]<br>こうじょう <br> elevation, rise, improvement, advancement, progress
elevation, rise, improvement, advancement, progress	<b>向上<b> <br> こうじょう <br>[sound:k-0345_向上.mp3]
[sound:k-0345_向上.mp3]	elevation, rise, improvement, advancement, progress<br> <b>向上</b> <br> (こうじょう)
<b>意向</b> <br> 彼は昇進の意向を上司に伝えました。	[sound:s-0345_彼は昇進の意向を上司に伝えました。.mp3] <br> かれはしょうしんのいこうをじょうしにつたえました。 <br>He conveyed his intention to his boss for a promotion.
[sound:s-0345_彼は昇進の意向を上司に伝えました。.mp3]	<b>意向</b> <br> 彼は昇進の意向を上司に伝えました。<br> かれはしょうしんのいこうをじょうしにつたえました <br>He conveyed his intention to his boss for a promotion.
上がり	[sound:k-0346_上がり.mp3]<br>あがり <br> ascent, rise, slope; freshly-drawn green tea (esp. in sushi shops); advance income, crop yield; death, spinning, completion, stop, finish; after (rain), ex (official, etc.); (end) results (e.g. of crafts like painting, pottery, etc.), how something comes out
ascent, rise, slope; freshly-drawn green tea (esp. in sushi shops); advance income, crop yield; death, spinning, completion, stop, finish; after (rain), ex (official, etc.); (end) results (e.g. of crafts like painting, pottery, etc.), how something comes out	<b>上がり<b> <br> あがり <br>[sound:k-0346_上がり.mp3]
[sound:k-0346_上がり.mp3]	ascent, rise, slope; freshly-drawn green tea<br> <b>esp. in sushi shops); advance income, crop yield; death, spinning, completion, stop, finish; after (rain), ex (official, etc.); (end) results (e.g. of crafts like painting, pottery, etc.), how something comes out (上がり</b> <br> (あがり)
<b>測る</b> <br> 彼はテープで部屋の大きさを測りました。	[sound:s-0346_彼はテープで部屋の大きさを測りました。.mp3] <br> かれはてーぷでへやのおおきさをはかりました。 <br>He measured the size of the room with a tape measure.
[sound:s-0346_彼はテープで部屋の大きさを測りました。.mp3]	<b>測る</b> <br> 彼はテープで部屋の大きさを測りました。<br> かれはてーぷでへやのおおきさをはかりました <br>He measured the size of the room with a tape measure.
上位	[sound:k-0347_上位.mp3]<br>じょうい <br> superior (rank not class); higher order (e.g. byte); host computer (of connected device)
superior (rank not class); higher order (e.g. byte); host computer (of connected device)	<b>上位<b> <br> じょうい <br>[sound:k-0347_上位.mp3]
[sound:k-0347_上位.mp3]	superior<br> <b>rank not class); higher order (e.g. byte); host computer (of connected device) (上位</b> <br> (じょうい)
<b>測量</b> <br> 地図を作るために測量が行われました。	[sound:s-0347_地図を作るために測量が行われました。.mp3] <br> ちずをつくるためにそくりょうがおこなわれました。 <br>Surveying was conducted to make the map.
[sound:s-0347_地図を作るために測量が行われました。.mp3]	<b>測量</b> <br> 地図を作るために測量が行われました。<br> ちずをつくるためにそくりょうがおこなわれました <br>Surveying was conducted to make the map.
地上	[sound:k-0348_地上.mp3]<br>ちじょう <br> above ground
above ground	<b>地上<b> <br> ちじょう <br>[sound:k-0348_地上.mp3]
[sound:k-0348_地上.mp3]	above ground<br> <b>地上</b> <br> (ちじょう)
<b>測定</b> <br> 彼は血圧を測定しました。	[sound:s-0348_彼は血圧を測定しました。.mp3] <br> かれはけつあつをそくていしました。 <br>He measured his blood pressure.
[sound:s-0348_彼は血圧を測定しました。.mp3]	<b>測定</b> <br> 彼は血圧を測定しました。<br> かれはけつあつをそくていしました <br>He measured his blood pressure.
途上国	[sound:k-0349_途上国.mp3]<br>とじょうこく <br> developing country
developing country	<b>途上国<b> <br> とじょうこく <br>[sound:k-0349_途上国.mp3]
[sound:k-0349_途上国.mp3]	developing country<br> <b>途上国</b> <br> (とじょうこく)
<b>測る</b> <br> 彼はテープで部屋の大きさを測りました。	[sound:s-0349_彼はテープで部屋の大きさを測りました。.mp3] <br> かれはてーぷでへやのおおきさをはかりました。 <br>He measured the size of the room with a tape measure.
[sound:s-0349_彼はテープで部屋の大きさを測りました。.mp3]	<b>測る</b> <br> 彼はテープで部屋の大きさを測りました。<br> かれはてーぷでへやのおおきさをはかりました <br>He measured the size of the room with a tape measure.
一部	[sound:k-0350_一部.mp3]<br>いちぶ <br> one part, one portion, one section, some; one copy (e.g. of a document)
one part, one portion, one section, some; one copy (e.g. of a document)	<b>一部<b> <br> いちぶ <br>[sound:k-0350_一部.mp3]
[sound:k-0350_一部.mp3]	one part, one portion, one section, some; one copy<br> <b>e.g. of a document) (一部</b> <br> (いちぶ)
<b>付加</b> <br> この料金には追加料金が付加されます。	[sound:s-0350_この料金には追加料金が付加されます。.mp3] <br> このりょうきんにはついかりょうきんがふかされます。 <br>Additional charges are added to this fee.
[sound:s-0350_この料金には追加料金が付加されます。.mp3]	<b>付加</b> <br> この料金には追加料金が付加されます。<br> このりょうきんにはついかりょうきんがふかされます <br>Additional charges are added to this fee.
幹部	[sound:k-0351_幹部.mp3]<br>かんぶ <br> management, (executive) staff, leaders, leadership, top brass, upper echelons
management, (executive) staff, leaders, leadership, top brass, upper echelons	<b>幹部<b> <br> かんぶ <br>[sound:k-0351_幹部.mp3]
[sound:k-0351_幹部.mp3]	management,<br> <b>executive) staff, leaders, leadership, top brass, upper echelons (幹部</b> <br> (かんぶ)
<b>山</b> <br> 山の頂上に登るのが好きです。	[sound:s-0351_山の頂上に登るのが好きです。.mp3] <br> やまのちょうじょうにのぼるのがすきです。 <br>I like climbing to the top of mountains.
[sound:s-0351_山の頂上に登るのが好きです。.mp3]	<b>山</b> <br> 山の頂上に登るのが好きです。<br> やまのちょうじょうにのぼるのがすきです <br>I like climbing to the top of mountains.
部長	[sound:k-0352_部長.mp3]<br>ぶちょう <br> head (chief, director) of a section or department; head of a (school) club, head of a (school) team
head (chief, director) of a section or department; head of a (school) club, head of a (school) team	<b>部長<b> <br> ぶちょう <br>[sound:k-0352_部長.mp3]
[sound:k-0352_部長.mp3]	head<br> <b>chief, director) of a section or department; head of a (school) club, head of a (school) team (部長</b> <br> (ぶちょう)
<b>火山</b> <br> その国には活火山が多いです。	[sound:s-0352_その国には活火山が多いです。.mp3] <br> そのくににはかっかざんがおおいです。 <br>There are many active volcanoes in that country.
[sound:s-0352_その国には活火山が多いです。.mp3]	<b>火山</b> <br> その国には活火山が多いです。<br> そのくににはかっかざんがおおいです <br>There are many active volcanoes in that country.
部分	[sound:k-0353_部分.mp3]<br>ぶぶん <br> portion, section, part
portion, section, part	<b>部分<b> <br> ぶぶん <br>[sound:k-0353_部分.mp3]
[sound:k-0353_部分.mp3]	portion, section, part<br> <b>部分</b> <br> (ぶぶん)
<b>青山</b> <br> 青山公園は美しい景色が広がっています。	[sound:s-0353_青山公園は美しい景色が広がっています。.mp3] <br> あおやまこうえんはうつくしいけしきがひろがっています。 <br>Aoyama Park offers beautiful scenery.
[sound:s-0353_青山公園は美しい景色が広がっています。.mp3]	<b>青山</b> <br> 青山公園は美しい景色が広がっています。<br> あおやまこうえんはうつくしいけしきがひろがっています <br>Aoyama Park offers beautiful scenery.
部門	[sound:k-0354_部門.mp3]<br>ぶもん <br> class, group, category, department, field, branch
class, group, category, department, field, branch	<b>部門<b> <br> ぶもん <br>[sound:k-0354_部門.mp3]
[sound:k-0354_部門.mp3]	class, group, category, department, field, branch<br> <b>部門</b> <br> (ぶもん)
<b>山形</b> <br> 山形県は四季折々の美しい風景が広がっています。	[sound:s-0354_山形県は四季折々の美しい風景が広がっています。.mp3] <br> やまがたけんはしきおりおりのうつくしいふうけいがひろがっています。 <br>Yamagata Prefecture offers beautiful landscapes throughout the four seasons.
[sound:s-0354_山形県は四季折々の美しい風景が広がっています。.mp3]	<b>山形</b> <br> 山形県は四季折々の美しい風景が広がっています。<br> やまがたけんはしきおりおりのうつくしいふうけいがひろがっています <br>Yamagata Prefecture offers beautiful landscapes throughout the four seasons.
本部	[sound:k-0355_本部.mp3]<br>ほんぶ <br> headquarters
headquarters	<b>本部<b> <br> ほんぶ <br>[sound:k-0355_本部.mp3]
[sound:k-0355_本部.mp3]	headquarters<br> <b>本部</b> <br> (ほんぶ)
<b>登山</b> <br> 彼は毎年、富士山に登山します。	[sound:s-0355_彼は毎年、富士山に登山します。.mp3] <br> かれはまいねん、ふじさんにとざんします。 <br>He climbs Mount Fuji every year.
[sound:s-0355_彼は毎年、富士山に登山します。.mp3]	<b>登山</b> <br> 彼は毎年、富士山に登山します。<br> かれはまいねん、ふじさんにとざんします <br>He climbs Mount Fuji every year.
学部	[sound:k-0356_学部.mp3]<br>がくぶ <br> department of a university; undergraduate (course, program, etc.)
department of a university; undergraduate (course, program, etc.)	<b>学部<b> <br> がくぶ <br>[sound:k-0356_学部.mp3]
[sound:k-0356_学部.mp3]	department of a university; undergraduate<br> <b>course, program, etc.) (学部</b> <br> (がくぶ)
<b>山岳</b> <br> 山岳地帯での登山には十分な準備が必要です。	[sound:s-0356_山岳地帯での登山には十分な準備が必要です。.mp3] <br> さんがくちたいでのとざんにはじゅうぶんなじゅんびがひつようです。 <br>Adequate preparation is necessary for mountain climbing in mountainous regions.
[sound:s-0356_山岳地帯での登山には十分な準備が必要です。.mp3]	<b>山岳</b> <br> 山岳地帯での登山には十分な準備が必要です。<br> さんがくちたいでのとざんにはじゅうぶんなじゅんびがひつようです <br>Adequate preparation is necessary for mountain climbing in mountainous regions.
内部	[sound:k-0357_内部.mp3]<br>ないぶ <br> interior, inside, internal
interior, inside, internal	<b>内部<b> <br> ないぶ <br>[sound:k-0357_内部.mp3]
[sound:k-0357_内部.mp3]	interior, inside, internal<br> <b>内部</b> <br> (ないぶ)
<b>小山</b> <br> その小さな村の近くに小山があります。	[sound:s-0357_その小さな村の近くに小山があります。.mp3] <br> そのちいさなむらのちかくにこやまがあります。 <br>There is a small hill near the village.
[sound:s-0357_その小さな村の近くに小山があります。.mp3]	<b>小山</b> <br> その小さな村の近くに小山があります。<br> そのちいさなむらのちかくにこやまがあります <br>There is a small hill near the village.
部屋	[sound:k-0358_部屋.mp3]<br>へや <br> room; sumo stable
room; sumo stable	<b>部屋<b> <br> へや <br>[sound:k-0358_部屋.mp3]
[sound:k-0358_部屋.mp3]	room; sumo stable<br> <b>部屋</b> <br> (へや)
<b>富士山</b> <br> 富士山は日本の象徴的な山です。	[sound:s-0358_富士山は日本の象徴的な山です。.mp3] <br> ふじさんはにほんのしょうちょうてきなやまです。 <br>Mount Fuji is a symbolic mountain of Japan.
[sound:s-0358_富士山は日本の象徴的な山です。.mp3]	<b>富士山</b> <br> 富士山は日本の象徴的な山です。<br> ふじさんはにほんのしょうちょうてきなやまです <br>Mount Fuji is a symbolic mountain of Japan.
部隊	[sound:k-0359_部隊.mp3]<br>ぶたい <br> force, unit, corps, echelon, element
force, unit, corps, echelon, element	<b>部隊<b> <br> ぶたい <br>[sound:k-0359_部隊.mp3]
[sound:k-0359_部隊.mp3]	force, unit, corps, echelon, element<br> <b>部隊</b> <br> (ぶたい)
<b>大山</b> <br> 大山は美しい景色が広がっています。	[sound:s-0359_大山は美しい景色が広がっています。.mp3] <br> おおやまはうつくしいけしきがひろがっています。 <br>Ooyama offers beautiful scenery.
[sound:s-0359_大山は美しい景色が広がっています。.mp3]	<b>大山</b> <br> 大山は美しい景色が広がっています。<br> おおやまはうつくしいけしきがひろがっています <br>Ooyama offers beautiful scenery.
東	[sound:k-0360_東.mp3]<br>ひがし, ひむかし, ひんがし <br> east
east	<b>東<b> <br> ひがし, ひむかし, ひんがし <br>[sound:k-0360_東.mp3]
[sound:k-0360_東.mp3]	east<br> <b>東</b> <br> (ひがし, ひむかし, ひんがし)
<b>山村</b> <br> 山村での生活は自然との調和が大切です。	[sound:s-0360_山村での生活は自然との調和が大切です。.mp3] <br> やまむらでのせいかつはしぜんとのちょうわがたいせつです。 <br>Living in a mountain village requires harmony with nature.
[sound:s-0360_山村での生活は自然との調和が大切です。.mp3]	<b>山村</b> <br> 山村での生活は自然との調和が大切です。<br> やまむらでのせいかつはしぜんとのちょうわがたいせつです <br>Living in a mountain village requires harmony with nature.
東京	[sound:k-0361_東京.mp3]<br>とうきょう <br> Tokyo (current capital of Japan)
Tokyo (current capital of Japan)	<b>東京<b> <br> とうきょう <br>[sound:k-0361_東京.mp3]
[sound:k-0361_東京.mp3]	Tokyo<br> <b>current capital of Japan) (東京</b> <br> (とうきょう)
<b>思わず</b> <br> その景色に感動して思わず涙が出ました。	[sound:s-0361_その景色に感動して思わず涙が出ました。.mp3] <br> そのけしきにかんどうしておもわずなみだがでました。 <br>"Moved by the scenery, tears came involuntarily."
[sound:s-0361_その景色に感動して思わず涙が出ました。.mp3]	<b>思わず</b> <br> その景色に感動して思わず涙が出ました。<br> そのけしきにかんどうしておもわずなみだがでました <br>Moved by the scenery, tears came involuntarily.
中東	[sound:k-0362_中東.mp3]<br>ちゅうとう <br> Middle East
Middle East	<b>中東<b> <br> ちゅうとう <br>[sound:k-0362_中東.mp3]
[sound:k-0362_中東.mp3]	Middle East<br> <b>中東</b> <br> (ちゅうとう)
<b>思い</b> <br> 彼女の優しさに心に温かい思いが湧きました。	[sound:s-0362_彼女の優しさに心に温かい思いが湧きました。.mp3] <br> かのじょのやさしさにこころにあたたかいおもいがわきました。 <br>Her kindness warmed my heart.
[sound:s-0362_彼女の優しさに心に温かい思いが湧きました。.mp3]	<b>思い</b> <br> 彼女の優しさに心に温かい思いが湧きました。<br> かのじょのやさしさにこころにあたたかいおもいがわきました <br>Her kindness warmed my heart.
東海	[sound:k-0363_東海.mp3]<br>とうかい <br> region south of Tokyo on Pacific Ocean side of Japan, eastern sea
region south of Tokyo on Pacific Ocean side of Japan, eastern sea	<b>東海<b> <br> とうかい <br>[sound:k-0363_東海.mp3]
[sound:k-0363_東海.mp3]	region south of Tokyo on Pacific Ocean side of Japan, eastern sea<br> <b>東海</b> <br> (とうかい)
<b>思う</b> <br> 彼は自分の未来について真剣に考えています。	[sound:s-0363_彼は自分の未来について真剣に考えています。.mp3] <br> かれはじぶんのみらいについてしんけんにかんがえています。 <br>He is seriously thinking about his future.
[sound:s-0363_彼は自分の未来について真剣に考えています。.mp3]	<b>思う</b> <br> 彼は自分の未来について真剣に考えています。<br> かれはじぶんのみらいについてしんけんにかんがえています <br>He is seriously thinking about his future.
東北	[sound:k-0364_東北.mp3]<br>とうほく, ひがしきた <br> north-east; Northern most six prefectures of Honshu
north-east; Northern most six prefectures of Honshu	<b>東北<b> <br> とうほく, ひがしきた <br>[sound:k-0364_東北.mp3]
[sound:k-0364_東北.mp3]	north-east; Northern most six prefectures of Honshu<br> <b>東北</b> <br> (とうほく, ひがしきた)
<b>意思</b> <br> 彼女は自分の意思を貫き通します。	[sound:s-0364_彼女は自分の意思を貫き通します。.mp3] <br> かのじょはじぶんのいしをぬきとおします。 <br>She sticks to her own will.
[sound:s-0364_彼女は自分の意思を貫き通します。.mp3]	<b>意思</b> <br> 彼女は自分の意思を貫き通します。<br> かのじょはじぶんのいしをぬきとおします <br>She sticks to her own will.
東欧	[sound:k-0365_東欧.mp3]<br>とうおう <br> Eastern Europe
Eastern Europe	<b>東欧<b> <br> とうおう <br>[sound:k-0365_東欧.mp3]
[sound:k-0365_東欧.mp3]	Eastern Europe<br> <b>東欧</b> <br> (とうおう)
<b>思想</b> <br> その本は哲学的な思想に基づいています。	[sound:s-0365_その本は哲学的な思想に基づいています。.mp3] <br> そのほんはてつがくてきなしそうにもとづいています。 <br>The book is based on philosophical thoughts.
[sound:s-0365_その本は哲学的な思想に基づいています。.mp3]	<b>思想</b> <br> その本は哲学的な思想に基づいています。<br> そのほんはてつがくてきなしそうにもとづいています <br>The book is based on philosophical thoughts.
東西	[sound:k-0366_東西.mp3]<br>とうざい <br> East and West; whole country; Orient and Occident, Western and Eastern; Your attention, please!
East and West; whole country; Orient and Occident, Western and Eastern; Your attention, please!	<b>東西<b> <br> とうざい <br>[sound:k-0366_東西.mp3]
[sound:k-0366_東西.mp3]	East and West; whole country; Orient and Occident, Western and Eastern; Your attention, please!<br> <b>東西</b> <br> (とうざい)
<b>思惑</b> <br> 彼の行動の裏には何か思惑があるようです。	[sound:s-0366_彼の行動の裏には何か思惑があるようです。.mp3] <br> かれのこうどうのうらにはなにかおもわくがあるようです。 <br>There seems to be some intention behind his actions.
[sound:s-0366_彼の行動の裏には何か思惑があるようです。.mp3]	<b>思惑</b> <br> 彼の行動の裏には何か思惑があるようです。<br> かれのこうどうのうらにはなにかおもわくがあるようです <br>There seems to be some intention behind his actions.
東南	[sound:k-0367_東南.mp3]<br>とうなん, ひがしみなみ <br> south-east
south-east	<b>東南<b> <br> とうなん, ひがしみなみ <br>[sound:k-0367_東南.mp3]
[sound:k-0367_東南.mp3]	south-east<br> <b>東南</b> <br> (とうなん, ひがしみなみ)
<b>思い切って</b> <br> 彼は思い切って辞表を提出した。	[sound:s-0367_彼は思い切って辞表を提出した。.mp3] <br> かれはおもいきってじひょうをていしゅつした。 <br>He plucked up the courage and submitted his resignation.
[sound:s-0367_彼は思い切って辞表を提出した。.mp3]	<b>思い切って</b> <br> 彼は思い切って辞表を提出した。<br> かれはおもいきってじひょうをていしゅつした <br>He plucked up the courage and submitted his resignation.
東芝	[sound:k-0368_東芝.mp3]<br>とうしば <br> Toshiba (company)
Toshiba (company)	<b>東芝<b> <br> とうしば <br>[sound:k-0368_東芝.mp3]
[sound:k-0368_東芝.mp3]	Toshiba<br> <b>company) (東芝</b> <br> (とうしば)
<b>思い出</b> <br> 子供時代の思い出を楽しむことが大切です。	[sound:s-0368_子供時代の思い出を楽しむことが大切です。.mp3] <br> こどもじだいのおもいでをたのしむことがたいせつです。 <br>It's important to cherish childhood memories.
[sound:s-0368_子供時代の思い出を楽しむことが大切です。.mp3]	<b>思い出</b> <br> 子供時代の思い出を楽しむことが大切です。<br> こどもじだいのおもいでをたのしむことがたいせつです <br>It's important to cherish childhood memories.
東洋	[sound:k-0369_東洋.mp3]<br>とうよう <br> Orient
Orient	<b>東洋<b> <br> とうよう <br>[sound:k-0369_東洋.mp3]
[sound:k-0369_東洋.mp3]	Orient<br> <b>東洋</b> <br> (とうよう)
<b>思いやり</b> <br> 彼の思いやりのある言葉に励まされました。	[sound:s-0369_彼の思いやりのある言葉に励まされました。.mp3] <br> かれのおもいやりのあることばにはげまされました。 <br>I was encouraged by his considerate words.
[sound:s-0369_彼の思いやりのある言葉に励まされました。.mp3]	<b>思いやり</b> <br> 彼の思いやりのある言葉に励まされました。<br> かれのおもいやりのあることばにはげまされました <br>I was encouraged by his considerate words.
患者	[sound:k-0370_患者.mp3]<br>かんじゃ <br> (a) patient
(a) patient	<b>患者<b> <br> かんじゃ <br>[sound:k-0370_患者.mp3]
[sound:k-0370_患者.mp3]	(a) patient<br> <b>患者</b> <br> (かんじゃ)
<b>思考</b> <br> 私たちは将来の計画について熟考しなければなりません。	[sound:s-0370_私たちは将来の計画について熟考しなければなりません。.mp3] <br> わたしたちはしょうらいのけいかくについてじゅっこうしなければなりません。 <br>We need to think carefully about our future plans.
[sound:s-0370_私たちは将来の計画について熟考しなければなりません。.mp3]	<b>思考</b> <br> 私たちは将来の計画について熟考しなければなりません。<br> わたしたちはしょうらいのけいかくについてじゅっこうしなければなりません <br>We need to think carefully about our future plans.
関係者	[sound:k-0371_関係者.mp3]<br>かんけいしゃ <br> authorized people, authorised people, person(s) concerned
authorized people, authorised people, person(s) concerned	<b>関係者<b> <br> かんけいしゃ <br>[sound:k-0371_関係者.mp3]
[sound:k-0371_関係者.mp3]	authorized people, authorised people, person(s) concerned<br> <b>関係者</b> <br> (かんけいしゃ)
<b>家族</b> <br> 彼は大家族で育ちました。	[sound:s-0371_彼は大家族で育ちました。.mp3] <br> かれはだいかぞくでそだちました。 <br>He grew up in a large family.
[sound:s-0371_彼は大家族で育ちました。.mp3]	<b>家族</b> <br> 彼は大家族で育ちました。<br> かれはだいかぞくでそだちました <br>He grew up in a large family.
記者	[sound:k-0372_記者.mp3]<br>きしゃ <br> reporter
reporter	<b>記者<b> <br> きしゃ <br>[sound:k-0372_記者.mp3]
[sound:k-0372_記者.mp3]	reporter<br> <b>記者</b> <br> (きしゃ)
<b>家庭</b> <br> 彼女は家庭的な雰囲気を大切にしています。	[sound:s-0372_彼女は家庭的な雰囲気を大切にしています。.mp3] <br> かのじょはかていてきなふんいきをたいせつにしています。 <br>She values a homely atmosphere.
[sound:s-0372_彼女は家庭的な雰囲気を大切にしています。.mp3]	<b>家庭</b> <br> 彼女は家庭的な雰囲気を大切にしています。<br> かのじょはかていてきなふんいきをたいせつにしています <br>She values a homely atmosphere.
業者	[sound:k-0373_業者.mp3]<br>ぎょうしゃ <br> trader, merchant
trader, merchant	<b>業者<b> <br> ぎょうしゃ <br>[sound:k-0373_業者.mp3]
[sound:k-0373_業者.mp3]	trader, merchant<br> <b>業者</b> <br> (ぎょうしゃ)
<b>国家</b> <br> 彼は国家の安全を守るために尽力しています。	[sound:s-0373_彼は国家の安全を守るために尽力しています。.mp3] <br> かれはこっかのあんぜんをまもるためにじんりょくしています。 <br>He is working hard to protect the security of the nation.
[sound:s-0373_彼は国家の安全を守るために尽力しています。.mp3]	<b>国家</b> <br> 彼は国家の安全を守るために尽力しています。<br> かれはこっかのあんぜんをまもるためにじんりょくしています <br>He is working hard to protect the security of the nation.
容疑者	[sound:k-0374_容疑者.mp3]<br>ようぎしゃ <br> suspect (person)
suspect (person)	<b>容疑者<b> <br> ようぎしゃ <br>[sound:k-0374_容疑者.mp3]
[sound:k-0374_容疑者.mp3]	suspect<br> <b>person) (容疑者</b> <br> (ようぎしゃ)
<b>政治家</b> <br> 彼は有名な政治家です。	[sound:s-0374_彼は有名な政治家です。.mp3] <br> かれはゆうめいなせいじかです。 <br>He is a famous politician.
[sound:s-0374_彼は有名な政治家です。.mp3]	<b>政治家</b> <br> 彼は有名な政治家です。<br> かれはゆうめいなせいじかです <br>He is a famous politician.
若者	[sound:k-0375_若者.mp3]<br>わかもの <br> young man, youth, lad
young man, youth, lad	<b>若者<b> <br> わかもの <br>[sound:k-0375_若者.mp3]
[sound:k-0375_若者.mp3]	young man, youth, lad<br> <b>若者</b> <br> (わかもの)
<b>作家</b> <br> 彼は有名な作家で、多くの小説を書いています。	[sound:s-0375_彼は有名な作家で、多くの小説を書いています。.mp3] <br> かれはゆうめいなさっかで、おおくのしょうせつをかいています。 <br>He is a famous writer who has written many novels.
[sound:s-0375_彼は有名な作家で、多くの小説を書いています。.mp3]	<b>作家</b> <br> 彼は有名な作家で、多くの小説を書いています。<br> かれはゆうめいなさっかで、おおくのしょうせつをかいています <br>He is a famous writer who has written many novels.
消費者	[sound:k-0376_消費者.mp3]<br>しょうひしゃ <br> consumer
consumer	<b>消費者<b> <br> しょうひしゃ <br>[sound:k-0376_消費者.mp3]
[sound:k-0376_消費者.mp3]	consumer<br> <b>消費者</b> <br> (しょうひしゃ)
<b>専門家</b> <br> この問題に対処するために専門家の助言が必要です。	[sound:s-0376_この問題に対処するために専門家の助言が必要です。.mp3] <br> このもんだいにたいしょするためにせんもんかのじょげんがひつようです。 <br>Expert advice is needed to address this issue.
[sound:s-0376_この問題に対処するために専門家の助言が必要です。.mp3]	<b>専門家</b> <br> この問題に対処するために専門家の助言が必要です。<br> このもんだいにたいしょするためにせんもんかのじょげんがひつようです <br>Expert advice is needed to address this issue.
労働者	[sound:k-0377_労働者.mp3]<br>ろうどうしゃ <br> laborer (labourer), blue-collar worker
laborer (labourer), blue-collar worker	<b>労働者<b> <br> ろうどうしゃ <br>[sound:k-0377_労働者.mp3]
[sound:k-0377_労働者.mp3]	laborer<br> <b>labourer), blue-collar worker (労働者</b> <br> (ろうどうしゃ)
<b>農家</b> <br> その町は農家が多いです。	[sound:s-0377_その町は農家が多いです。.mp3] <br> そのまちはのうかがおおいです。 <br>There are many farmers in that town.
[sound:s-0377_その町は農家が多いです。.mp3]	<b>農家</b> <br> その町は農家が多いです。<br> そのまちはのうかがおおいです <br>There are many farmers in that town.
学者	[sound:k-0378_学者.mp3]<br>がくしゃ <br> scholar
scholar	<b>学者<b> <br> がくしゃ <br>[sound:k-0378_学者.mp3]
[sound:k-0378_学者.mp3]	scholar<br> <b>学者</b> <br> (がくしゃ)
<b>評論家</b> <br> 彼は映画評論家として有名です。	[sound:s-0378_彼は映画評論家として有名です。.mp3] <br> かれはえいがひょうろんかとしてゆうめいです。 <br>He is famous as a movie critic.
[sound:s-0378_彼は映画評論家として有名です。.mp3]	<b>評論家</b> <br> 彼は映画評論家として有名です。<br> かれはえいがひょうろんかとしてゆうめいです <br>He is famous as a movie critic.
経営者	[sound:k-0379_経営者.mp3]<br>けいえいしゃ <br> manager, proprietor
manager, proprietor	<b>経営者<b> <br> けいえいしゃ <br>[sound:k-0379_経営者.mp3]
[sound:k-0379_経営者.mp3]	manager, proprietor<br> <b>経営者</b> <br> (けいえいしゃ)
<b>一家</b> <br> 彼は一家の大黒柱です。	[sound:s-0379_彼は一家の大黒柱です。.mp3] <br> かれはいっかのだいこくちゅうです。 <br>He is the mainstay of the family.
[sound:s-0379_彼は一家の大黒柱です。.mp3]	<b>一家</b> <br> 彼は一家の大黒柱です。<br> かれはいっかのだいこくちゅうです <br>He is the mainstay of the family.
党	[sound:k-0380_党.mp3]<br>とう <br> party (political); faction, -ite
party (political); faction, -ite	<b>党<b> <br> とう <br>[sound:k-0380_党.mp3]
[sound:k-0380_党.mp3]	party<br> <b>political); faction, -ite (党</b> <br> (とう)
<b>家電</b> <br> 新しい家電製品を買いました。	[sound:s-0380_新しい家電製品を買いました。.mp3] <br> あたらしいかでんせいひんをかいました。 <br>I bought a new home appliance.
[sound:s-0380_新しい家電製品を買いました。.mp3]	<b>家電</b> <br> 新しい家電製品を買いました。<br> あたらしいかでんせいひんをかいました <br>I bought a new home appliance.
共産党	[sound:k-0381_共産党.mp3]<br>きょうさんとう <br> Communist Party
Communist Party	<b>共産党<b> <br> きょうさんとう <br>[sound:k-0381_共産党.mp3]
[sound:k-0381_共産党.mp3]	Communist Party<br> <b>共産党</b> <br> (きょうさんとう)
<b>話</b> <br> 今日は面白い話がたくさん聞けました。	[sound:s-0381_今日は面白い話がたくさん聞けました。.mp3] <br> きょうはおもしろいはなしがたくさんきけました。 <br>I heard many interesting stories today.
[sound:s-0381_今日は面白い話がたくさん聞けました。.mp3]	<b>話</b> <br> 今日は面白い話がたくさん聞けました。<br> きょうはおもしろいはなしがたくさんきけました <br>I heard many interesting stories today.
社会党	[sound:k-0382_社会党.mp3]<br>しゃかいとう <br> Socialist Party
Socialist Party	<b>社会党<b> <br> しゃかいとう <br>[sound:k-0382_社会党.mp3]
[sound:k-0382_社会党.mp3]	Socialist Party<br> <b>社会党</b> <br> (しゃかいとう)
<b>電話</b> <br> 彼から電話がかかってきました。	[sound:s-0382_彼から電話がかかってきました。.mp3] <br> かれからでんわがかってきました。 <br>I received a phone call from him.
[sound:s-0382_彼から電話がかかってきました。.mp3]	<b>電話</b> <br> 彼から電話がかかってきました。<br> かれからでんわがかってきました <br>I received a phone call from him.
新党	[sound:k-0383_新党.mp3]<br>しんとう <br> new (political) party
new (political) party	<b>新党<b> <br> しんとう <br>[sound:k-0383_新党.mp3]
[sound:k-0383_新党.mp3]	new<br> <b>political) party (新党</b> <br> (しんとう)
<b>対話</b> <br> 対話を通じて問題を解決しましょう。	[sound:s-0383_対話を通じて問題を解決しましょう。.mp3] <br> たいわをつうじてもんだいをかいけつしましょう。 <br>Let's solve the problem through dialogue.
[sound:s-0383_対話を通じて問題を解決しましょう。.mp3]	<b>対話</b> <br> 対話を通じて問題を解決しましょう。<br> たいわをつうじてもんだいをかいけつしましょう <br>Let's solve the problem through dialogue.
政党	[sound:k-0384_政党.mp3]<br>せいとう <br> (member of) political party
(member of) political party	<b>政党<b> <br> せいとう <br>[sound:k-0384_政党.mp3]
[sound:k-0384_政党.mp3]	(member of) political party<br> <b>政党</b> <br> (せいとう)
<b>話題</b> <br> 最近のニュースが話題になっています。	[sound:s-0384_最近のニュースが話題になっています。.mp3] <br> さいきんのにゅーすがわだいになっています。 <br>Recent news has become a topic of conversation.
[sound:s-0384_最近のニュースが話題になっています。.mp3]	<b>話題</b> <br> 最近のニュースが話題になっています。<br> さいきんのにゅーすがわだいになっています <br>Recent news has become a topic of conversation.
野党	[sound:k-0385_野党.mp3]<br>やとう <br> opposition party, political opposition, opposition
opposition party, political opposition, opposition	<b>野党<b> <br> やとう <br>[sound:k-0385_野党.mp3]
[sound:k-0385_野党.mp3]	opposition party, political opposition, opposition<br> <b>野党</b> <br> (やとう)
<b>話し合い</b> <br> 二人で話し合って解決しました。	[sound:s-0385_二人で話し合って解決しました。.mp3] <br> ふたりではなしあってかいけつしました。 <br>We resolved it by talking it over together.
[sound:s-0385_二人で話し合って解決しました。.mp3]	<b>話し合い</b> <br> 二人で話し合って解決しました。<br> ふたりではなしあってかいけつしました <br>We resolved it by talking it over together.
与党	[sound:k-0386_与党.mp3]<br>よとう <br> government party, (ruling) party in power, government
government party, (ruling) party in power, government	<b>与党<b> <br> よとう <br>[sound:k-0386_与党.mp3]
[sound:k-0386_与党.mp3]	government party,<br> <b>ruling) party in power, government (与党</b> <br> (よとう)
<b>会話</b> <br> 日本語を使って会話を楽しみましょう。	[sound:s-0386_日本語を使って会話を楽しみましょう。.mp3] <br> にほんごをつかってかいわをたのしみましょう。 <br>Let's enjoy conversation using Japanese.
[sound:s-0386_日本語を使って会話を楽しみましょう。.mp3]	<b>会話</b> <br> 日本語を使って会話を楽しみましょう。<br> にほんごをつかってかいわをたのしみましょう <br>Let's enjoy conversation using Japanese.
自民党	[sound:k-0387_自民党.mp3]<br>じみんとう <br> Liberal Democratic Party, LDP
Liberal Democratic Party, LDP	<b>自民党<b> <br> じみんとう <br>[sound:k-0387_自民党.mp3]
[sound:k-0387_自民党.mp3]	Liberal Democratic Party, LDP<br> <b>自民党</b> <br> (じみんとう)
<b>世話</b> <br> 彼は母親にたくさん世話になっています。	[sound:s-0387_彼は母親にたくさん世話になっています。.mp3] <br> かれはははおやにたくさんせわになっています。 <br>He relies heavily on his mother's care.
[sound:s-0387_彼は母親にたくさん世話になっています。.mp3]	<b>世話</b> <br> 彼は母親にたくさん世話になっています。<br> かれはははおやにたくさんせわになっています <br>He relies heavily on his mother's care.
党首	[sound:k-0388_党首.mp3]<br>とうしゅ <br> party leader
party leader	<b>党首<b> <br> とうしゅ <br>[sound:k-0388_党首.mp3]
[sound:k-0388_党首.mp3]	party leader<br> <b>党首</b> <br> (とうしゅ)
<b>談話</b> <br> 会議の前に簡単な談話がありました。	[sound:s-0388_会議の前に簡単な談話がありました。.mp3] <br> かいぎのまえにかんたんなだんわがありました。 <br>There was a brief conversation before the meeting.
[sound:s-0388_会議の前に簡単な談話がありました。.mp3]	<b>談話</b> <br> 会議の前に簡単な談話がありました。<br> かいぎのまえにかんたんなだんわがありました <br>There was a brief conversation before the meeting.
党内	[sound:k-0389_党内.mp3]<br>とうない <br> party-internal
party-internal	<b>党内<b> <br> とうない <br>[sound:k-0389_党内.mp3]
[sound:k-0389_党内.mp3]	party-internal<br> <b>党内</b> <br> (とうない)
<b>通話</b> <br> スマートフォンで通話ができます。	[sound:s-0389_スマートフォンで通話ができます。.mp3] <br> すまーとふぉんでつうわができます。 <br>You can make phone calls on a smartphone.
[sound:s-0389_スマートフォンで通話ができます。.mp3]	<b>通話</b> <br> スマートフォンで通話ができます。<br> すまーとふぉんでつうわができます <br>You can make phone calls on a smartphone.
地	[sound:k-0390_地.mp3]<br>ち <br> earth, ground, land, soil; place; territory; bottom (of a package, book, etc.)
earth, ground, land, soil; place; territory; bottom (of a package, book, etc.)	<b>地<b> <br> ち <br>[sound:k-0390_地.mp3]
[sound:k-0390_地.mp3]	earth, ground, land, soil; place; territory; bottom<br> <b>of a package, book, etc.) (地</b> <br> (ち)
<b>神話</b> <br> 古代の神話は興味深いです。	[sound:s-0390_古代の神話は興味深いです。.mp3] <br> こだいのしんわはきょうみぶかいです。 <br>Ancient myths are fascinating.
[sound:s-0390_古代の神話は興味深いです。.mp3]	<b>神話</b> <br> 古代の神話は興味深いです。<br> こだいのしんわはきょうみぶかいです <br>Ancient myths are fascinating.
現地	[sound:k-0391_現地.mp3]<br>げんち <br> actual place, local
actual place, local	<b>現地<b> <br> げんち <br>[sound:k-0391_現地.mp3]
[sound:k-0391_現地.mp3]	actual place, local<br> <b>現地</b> <br> (げんち)
<b>世</b> <br> 世の中にはいろいろな人がいます。	[sound:s-0391_世の中にはいろいろな人がいます。.mp3] <br> よのなかにはいろいろなひとがいます。 <br>There are various kinds of people in the world.
[sound:s-0391_世の中にはいろいろな人がいます。.mp3]	<b>世</b> <br> 世の中にはいろいろな人がいます。<br> よのなかにはいろいろなひとがいます <br>There are various kinds of people in the world.
地域	[sound:k-0392_地域.mp3]<br>ちいき <br> area, region
area, region	<b>地域<b> <br> ちいき <br>[sound:k-0392_地域.mp3]
[sound:k-0392_地域.mp3]	area, region<br> <b>地域</b> <br> (ちいき)
<b>世界</b> <br> 世界中を旅するのが夢です。	[sound:s-0392_世界中を旅するのが夢です。.mp3] <br> せかいじゅうをたびするのがゆめです。 <br>It is my dream to travel around the world.
[sound:s-0392_世界中を旅するのが夢です。.mp3]	<b>世界</b> <br> 世界中を旅するのが夢です。<br> せかいじゅうをたびするのがゆめです <br>It is my dream to travel around the world.
地球	[sound:k-0393_地球.mp3]<br>ちきゅう <br> the earth
the earth	<b>地球<b> <br> ちきゅう <br>[sound:k-0393_地球.mp3]
[sound:k-0393_地球.mp3]	the earth<br> <b>地球</b> <br> (ちきゅう)
<b>世代</b> <br> 私たちの世代はテクノロジーに囲まれて育ちました。	[sound:s-0393_私たちの世代はテクノロジーに囲まれて育ちました。.mp3] <br> わたしたちのせだいはてくのろじーにかこまれてそだちました。 <br>Our generation grew up surrounded by technology.
[sound:s-0393_私たちの世代はテクノロジーに囲まれて育ちました。.mp3]	<b>世代</b> <br> 私たちの世代はテクノロジーに囲まれて育ちました。<br> わたしたちのせだいはてくのろじーにかこまれてそだちました <br>Our generation grew up surrounded by technology.
地区	[sound:k-0394_地区.mp3]<br>ちく <br> district, section, sector
district, section, sector	<b>地区<b> <br> ちく <br>[sound:k-0394_地区.mp3]
[sound:k-0394_地区.mp3]	district, section, sector<br> <b>地区</b> <br> (ちく)
<b>世論</b> <br> 世論はその政策に反対しています。	[sound:s-0394_世論はその政策に反対しています。.mp3] <br> よろんはそのせいさくにはんたいしています。 <br>Public opinion is against that policy.
[sound:s-0394_世論はその政策に反対しています。.mp3]	<b>世論</b> <br> 世論はその政策に反対しています。<br> よろんはそのせいさくにはんたいしています <br>Public opinion is against that policy.
地元	[sound:k-0395_地元.mp3]<br>じもと <br> home area, home town; local
home area, home town; local	<b>地元<b> <br> じもと <br>[sound:k-0395_地元.mp3]
[sound:k-0395_地元.mp3]	home area, home town; local<br> <b>地元</b> <br> (じもと)
<b>世界的</b> <br> 彼は世界的な有名人です。	[sound:s-0395_彼は世界的な有名人です。.mp3] <br> かれはせかいてきなゆうめいじんです。 <br>He is a world-famous celebrity.
[sound:s-0395_彼は世界的な有名人です。.mp3]	<b>世界的</b> <br> 彼は世界的な有名人です。<br> かれはせかいてきなゆうめいじんです <br>He is a world-famous celebrity.
地方	[sound:k-0396_地方.mp3]<br>ちほう, じかた <br> area, locality, district, region, province; countryside, rural area; coast (esp. as seen from the water); person singing ballads in Noh, person in charge of music in a Japanese dance performance
area, locality, district, region, province; countryside, rural area; coast (esp. as seen from the water); person singing ballads in Noh, person in charge of music in a Japanese dance performance	<b>地方<b> <br> ちほう, じかた <br>[sound:k-0396_地方.mp3]
[sound:k-0396_地方.mp3]	area, locality, district, region, province; countryside, rural area; coast<br> <b>esp. as seen from the water); person singing ballads in Noh, person in charge of music in a Japanese dance performance (地方</b> <br> (ちほう, じかた)
<b>世紀</b> <br> この発明は新しい世紀を開くかもしれません。	[sound:s-0396_この発明は新しい世紀を開くかもしれません。.mp3] <br> このはつめいはあたらしいせいきをひらくかもしれません。 <br>This invention may open a new century.
[sound:s-0396_この発明は新しい世紀を開くかもしれません。.mp3]	<b>世紀</b> <br> この発明は新しい世紀を開くかもしれません。<br> このはつめいはあたらしいせいきをひらくかもしれません <br>This invention may open a new century.
土地	[sound:k-0397_土地.mp3]<br>とち <br> plot of land, lot, soil
plot of land, lot, soil	<b>土地<b> <br> とち <br>[sound:k-0397_土地.mp3]
[sound:k-0397_土地.mp3]	plot of land, lot, soil<br> <b>土地</b> <br> (とち)
<b>世帯</b> <br> 一人暮らしの世帯も増えています。	[sound:s-0397_一人暮らしの世帯も増えています。.mp3] <br> ひとりぐらしのせたいもふえています。 <br>The number of single-person households is increasing.
[sound:s-0397_一人暮らしの世帯も増えています。.mp3]	<b>世帯</b> <br> 一人暮らしの世帯も増えています。<br> ひとりぐらしのせたいもふえています <br>The number of single-person households is increasing.
基地	[sound:k-0398_基地.mp3]<br>きち <br> base
base	<b>基地<b> <br> きち <br>[sound:k-0398_基地.mp3]
[sound:k-0398_基地.mp3]	base<br> <b>基地</b> <br> (きち)
<b>世話</b> <br> 彼は毎日祖母の世話をしています。	[sound:s-0398_彼は毎日祖母の世話をしています。.mp3] <br> かれはまいにちそぼのせわをしています。 <br>He takes care of his grandmother every day.
[sound:s-0398_彼は毎日祖母の世話をしています。.mp3]	<b>世話</b> <br> 彼は毎日祖母の世話をしています。<br> かれはまいにちそぼのせわをしています <br>He takes care of his grandmother every day.
地検	[sound:k-0399_地検.mp3]<br>ちけん <br> District Public Prosecutor's Office
District Public Prosecutor's Office	<b>地検<b> <br> ちけん <br>[sound:k-0399_地検.mp3]
[sound:k-0399_地検.mp3]	District Public Prosecutor's Office<br> <b>地検</b> <br> (ちけん)
<b>世の中</b> <br> 世の中には不思議なことがたくさんあります。	[sound:s-0399_世の中には不思議なことがたくさんあります。.mp3] <br> よのなかにはふしぎなことがたくさんあります。 <br>There are many wonders in the world.
[sound:s-0399_世の中には不思議なことがたくさんあります。.mp3]	<b>世の中</b> <br> 世の中には不思議なことがたくさんあります。<br> よのなかにはふしぎなことがたくさんあります <br>There are many wonders in the world.
合	[sound:k-0400_合.mp3]<br>ごう <br> 0.18039 litres (liters); 0.3306 metres square (meters); one-tenth of the way from the base to the summit of a mountain; (astronomical) conjunction; counter for covered containers; counter for matches, battles, etc.
0.18039 litres (liters); 0.3306 metres square (meters); one-tenth of the way from the base to the summit of a mountain; (astronomical) conjunction; counter for covered containers; counter for matches, battles, etc.	<b>合<b> <br> ごう <br>[sound:k-0400_合.mp3]
[sound:k-0400_合.mp3]	0.18039 litres<br> <b>liters); 0.3306 metres square (meters); one-tenth of the way from the base to the summit of a mountain; (astronomical) conjunction; counter for covered containers; counter for matches, battles, etc. (合</b> <br> (ごう)
<b>世間</b> <br> 彼は世間で評判の良い人です。	[sound:s-0400_彼は世間で評判の良い人です。.mp3] <br> かれはせけんでひょうばんのよいひとです。 <br>He is well-regarded in society.
[sound:s-0400_彼は世間で評判の良い人です。.mp3]	<b>世間</b> <br> 彼は世間で評判の良い人です。<br> かれはせけんでひょうばんのよいひとです <br>He is well-regarded in society.
合意	[sound:k-0401_合意.mp3]<br>ごうい <br> agreement, consent, mutual understanding
agreement, consent, mutual understanding	<b>合意<b> <br> ごうい <br>[sound:k-0401_合意.mp3]
[sound:k-0401_合意.mp3]	agreement, consent, mutual understanding<br> <b>合意</b> <br> (ごうい)
<b>受け</b> <br> 彼女の提案は好意的に受け入れられました。	[sound:s-0401_彼女の提案は好意的に受け入れられました。.mp3] <br> かのじょのていあんはこういてきにうけいれられました。 <br>Her proposal was positively received.
[sound:s-0401_彼女の提案は好意的に受け入れられました。.mp3]	<b>受け</b> <br> 彼女の提案は好意的に受け入れられました。<br> かのじょのていあんはこういてきにうけいれられました <br>Her proposal was positively received.
試合	[sound:k-0402_試合.mp3]<br>しあい <br> match, game, bout, contest
match, game, bout, contest	<b>試合<b> <br> しあい <br>[sound:k-0402_試合.mp3]
[sound:k-0402_試合.mp3]	match, game, bout, contest<br> <b>試合</b> <br> (しあい)
<b>受験</b> <br> 彼は来週、大学受験を控えています。	[sound:s-0402_彼は来週、大学受験を控えています。.mp3] <br> かれはらいしゅう、だいがくじゅけんをひかえています。 <br>He is preparing for university entrance exams next week.
[sound:s-0402_彼は来週、大学受験を控えています。.mp3]	<b>受験</b> <br> 彼は来週、大学受験を控えています。<br> かれはらいしゅう、だいがくじゅけんをひかえています <br>He is preparing for university entrance exams next week.
連合	[sound:k-0403_連合.mp3]<br>れんごう <br> union, alliance, combination
union, alliance, combination	<b>連合<b> <br> れんごう <br>[sound:k-0403_連合.mp3]
[sound:k-0403_連合.mp3]	union, alliance, combination<br> <b>連合</b> <br> (れんごう)
<b>受け入れ</b> <br> 新しいアイデアが社内で受け入れられました。	[sound:s-0403_新しいアイデアが社内で受け入れられました。.mp3] <br> あたらしいあいであがしゃないでうけいれられました。 <br>The new idea was accepted within the company.
[sound:s-0403_新しいアイデアが社内で受け入れられました。.mp3]	<b>受け入れ</b> <br> 新しいアイデアが社内で受け入れられました。<br> あたらしいあいであがしゃないでうけいれられました <br>The new idea was accepted within the company.
総合	[sound:k-0404_総合.mp3]<br>そうごう <br> synthesis, coordination, putting together, integration, composite; comprehensive
synthesis, coordination, putting together, integration, composite; comprehensive	<b>総合<b> <br> そうごう <br>[sound:k-0404_総合.mp3]
[sound:k-0404_総合.mp3]	synthesis, coordination, putting together, integration, composite; comprehensive<br> <b>総合</b> <br> (そうごう)
<b>受賞</b> <br> 彼は昨夜、最優秀賞を受賞しました。	[sound:s-0404_彼は昨夜、最優秀賞を受賞しました。.mp3] <br> かれはさくや、さいゆうしゅうしょうをじゅしょうしました。 <br>He won the Best Actor Award last night.
[sound:s-0404_彼は昨夜、最優秀賞を受賞しました。.mp3]	<b>受賞</b> <br> 彼は昨夜、最優秀賞を受賞しました。<br> かれはさくや、さいゆうしゅうしょうをじゅしょうしました <br>He won the Best Actor Award last night.
問い合わせ	[sound:k-0405_問い合わせ.mp3]<br>といあわせ <br> enquiry, inquiry, ENQ, query, interrogation
enquiry, inquiry, ENQ, query, interrogation	<b>問い合わせ<b> <br> といあわせ <br>[sound:k-0405_問い合わせ.mp3]
[sound:k-0405_問い合わせ.mp3]	enquiry, inquiry, ENQ, query, interrogation<br> <b>問い合わせ</b> <br> (といあわせ)
<b>受注</b> <br> この製品の受注が増えています。	[sound:s-0405_この製品の受注が増えています。.mp3] <br> このせいひんのじゅちゅうがふえています。 <br>Orders for this product are increasing.
[sound:s-0405_この製品の受注が増えています。.mp3]	<b>受注</b> <br> この製品の受注が増えています。<br> このせいひんのじゅちゅうがふえています <br>Orders for this product are increasing.
会合	[sound:k-0406_会合.mp3]<br>かいごう <br> meeting, assembly; association; (astronomical) conjunction
meeting, assembly; association; (astronomical) conjunction	<b>会合<b> <br> かいごう <br>[sound:k-0406_会合.mp3]
[sound:k-0406_会合.mp3]	meeting, assembly; association;<br> <b>astronomical) conjunction (会合</b> <br> (かいごう)
<b>受け止める</b> <br> 彼は批判を真剣に受け止めました。	[sound:s-0406_彼は批判を真剣に受け止めました。.mp3] <br> かれはひはんをしんけんにうけとめました。 <br>He took the criticism seriously.
[sound:s-0406_彼は批判を真剣に受け止めました。.mp3]	<b>受け止める</b> <br> 彼は批判を真剣に受け止めました。<br> かれはひはんをしんけんにうけとめました <br>He took the criticism seriously.
組合	[sound:k-0407_組合.mp3]<br>くみあい <br> association, union
association, union	<b>組合<b> <br> くみあい <br>[sound:k-0407_組合.mp3]
[sound:k-0407_組合.mp3]	association, union<br> <b>組合</b> <br> (くみあい)
<b>受け入れる</b> <br> 彼は新しい仕事を喜んで受け入れました。	[sound:s-0407_彼は新しい仕事を喜んで受け入れました。.mp3] <br> かれはあたらしいしごとをよろこんでうけいれました。 <br>He gladly accepted the new job.
[sound:s-0407_彼は新しい仕事を喜んで受け入れました。.mp3]	<b>受け入れる</b> <br> 彼は新しい仕事を喜んで受け入れました。<br> かれはあたらしいしごとをよろこんでうけいれました <br>He gladly accepted the new job.
統合	[sound:k-0408_統合.mp3]<br>とうごう <br> integration, unification, synthesis; integrated, built-in
integration, unification, synthesis; integrated, built-in	<b>統合<b> <br> とうごう <br>[sound:k-0408_統合.mp3]
[sound:k-0408_統合.mp3]	integration, unification, synthesis; integrated, built-in<br> <b>統合</b> <br> (とうごう)
<b>受講</b> <br> この講座は多くの学生に受講されています。	[sound:s-0408_この講座は多くの学生に受講されています。.mp3] <br> このこうざはおおくのがくせいにじゅこうされています。 <br>Many students are taking this course.
[sound:s-0408_この講座は多くの学生に受講されています。.mp3]	<b>受講</b> <br> この講座は多くの学生に受講されています。<br> このこうざはおおくのがくせいにじゅこうされています <br>Many students are taking this course.
合う	[sound:k-0409_合う.mp3]<br>あう, おう <br> to come together, to merge, to unite, to meet; to fit, to match, to suit, to agree with, to be correct; to be profitable, to be equitable; (after the -masu stem of a verb) to do ... to each other, to do ... together
to come together, to merge, to unite, to meet; to fit, to match, to suit, to agree with, to be correct; to be profitable, to be equitable; (after the -masu stem of a verb) to do ... to each other, to do ... together	<b>合う<b> <br> あう, おう <br>[sound:k-0409_合う.mp3]
[sound:k-0409_合う.mp3]	to come together, to merge, to unite, to meet; to fit, to match, to suit, to agree with, to be correct; to be profitable, to be equitable;<br> <b>after the -masu stem of a verb) to do ... to each other, to do ... together (合う</b> <br> (あう, おう)
<b>受信</b> <br> 私はそのメールを受信しました。	[sound:s-0409_私はそのメールを受信しました。.mp3] <br> わたしはそのめーるをじゅしんしました。 <br>I received the email.
[sound:s-0409_私はそのメールを受信しました。.mp3]	<b>受信</b> <br> 私はそのメールを受信しました。<br> わたしはそのめーるをじゅしんしました <br>I received the email.
市場	[sound:k-0410_市場.mp3]<br>いちば <br> (town) market; (the) marketplace
(town) market; (the) marketplace	<b>市場<b> <br> いちば <br>[sound:k-0410_市場.mp3]
[sound:k-0410_市場.mp3]	(town) market;<br> <b>the) marketplace (市場</b> <br> (いちば)
<b>授受</b> <br> 彼らの授受は互いに信頼があります。	[sound:s-0410_彼らの授受は互いに信頼があります。.mp3] <br> かれらのじゅじゅはたがいにしんらいがあります。 <br>They have mutual trust in their giving and receiving.
[sound:s-0410_彼らの授受は互いに信頼があります。.mp3]	<b>授受</b> <br> 彼らの授受は互いに信頼があります。<br> かれらのじゅじゅはたがいにしんらいがあります <br>They have mutual trust in their giving and receiving.
市内	[sound:k-0411_市内.mp3]<br>しない <br> (within a) city, local
(within a) city, local	<b>市内<b> <br> しない <br>[sound:k-0411_市内.mp3]
[sound:k-0411_市内.mp3]	(within a) city, local<br> <b>市内</b> <br> (しない)
<b>区</b> <br> この市は六つの区に分かれています。	[sound:s-0411_この市は六つの区に分かれています。.mp3] <br> このしはむつのくにわかれています。 <br>This city is divided into six districts.
[sound:s-0411_この市は六つの区に分かれています。.mp3]	<b>区</b> <br> この市は六つの区に分かれています。<br> このしはむつのくにわかれています <br>This city is divided into six districts.
市民	[sound:k-0412_市民.mp3]<br>しみん <br> citizen, townspeople
citizen, townspeople	<b>市民<b> <br> しみん <br>[sound:k-0412_市民.mp3]
[sound:k-0412_市民.mp3]	citizen, townspeople<br> <b>市民</b> <br> (しみん)
<b>地区</b> <br> その地区は治安が良いと評判です。	[sound:s-0412_その地区は治安が良いと評判です。.mp3] <br> そのちくはちあんがよいとひょうばんです。 <br>That district is reputed to have good public safety.
[sound:s-0412_その地区は治安が良いと評判です。.mp3]	<b>地区</b> <br> その地区は治安が良いと評判です。<br> そのちくはちあんがよいとひょうばんです <br>That district is reputed to have good public safety.
都市	[sound:k-0413_都市.mp3]<br>とし <br> town, city, municipal, urban
town, city, municipal, urban	<b>都市<b> <br> とし <br>[sound:k-0413_都市.mp3]
[sound:k-0413_都市.mp3]	town, city, municipal, urban<br> <b>都市</b> <br> (とし)
<b>小選挙区</b> <br> 小選挙区での選挙は激戦が予想されています。	[sound:s-0413_小選挙区での選挙は激戦が予想されています。.mp3] <br> しょうせんきょくでのせんきょはげきせんがよそうされています。 <br>A fierce battle is expected in the constituency election.
[sound:s-0413_小選挙区での選挙は激戦が予想されています。.mp3]	<b>小選挙区</b> <br> 小選挙区での選挙は激戦が予想されています。<br> しょうせんきょくでのせんきょはげきせんがよそうされています <br>A fierce battle is expected in the constituency election.
同市	[sound:k-0414_同市.mp3]<br>どうし <br> same city
same city	<b>同市<b> <br> どうし <br>[sound:k-0414_同市.mp3]
[sound:k-0414_同市.mp3]	same city<br> <b>同市</b> <br> (どうし)
<b>区内</b> <br> この区内には多くの公園があります。	[sound:s-0414_この区内には多くの公園があります。.mp3] <br> このくないにはおおくのこうえんがあります。 <br>There are many parks within this district.
[sound:s-0414_この区内には多くの公園があります。.mp3]	<b>区内</b> <br> この区内には多くの公園があります。<br> このくないにはおおくのこうえんがあります <br>There are many parks within this district.
市長	[sound:k-0415_市長.mp3]<br>しちょう <br> mayor
mayor	<b>市長<b> <br> しちょう <br>[sound:k-0415_市長.mp3]
[sound:k-0415_市長.mp3]	mayor<br> <b>市長</b> <br> (しちょう)
<b>区域</b> <br> この地域は新しい開発地域として注目されています。	[sound:s-0415_この地域は新しい開発地域として注目されています。.mp3] <br> このちいきはあたらしいかいはつちいきとしてちゅうもくされています。 <br>This area is attracting attention as a new development zone.
[sound:s-0415_この地域は新しい開発地域として注目されています。.mp3]	<b>区域</b> <br> この地域は新しい開発地域として注目されています。<br> このちいきはあたらしいかいはつちいきとしてちゅうもくされています <br>This area is attracting attention as a new development zone.
市町村	[sound:k-0416_市町村.mp3]<br>しちょうそん <br> cities, towns and villages, municipalities
cities, towns and villages, municipalities	<b>市町村<b> <br> しちょうそん <br>[sound:k-0416_市町村.mp3]
[sound:k-0416_市町村.mp3]	cities, towns and villages, municipalities<br> <b>市町村</b> <br> (しちょうそん)
<b>区間</b> <br> この区間の列車は特に混雑しています。	[sound:s-0416_この区間の列車は特に混雑しています。.mp3] <br> このくかんのれっしゃはとくにこんざつしています。 <br>Trains on this section are particularly crowded.
[sound:s-0416_この区間の列車は特に混雑しています。.mp3]	<b>区間</b> <br> この区間の列車は特に混雑しています。<br> このくかんのれっしゃはとくにこんざつしています <br>Trains on this section are particularly crowded.
市立	[sound:k-0417_市立.mp3]<br>しりつ, いちりつ <br> municipal, city
municipal, city	<b>市立<b> <br> しりつ, いちりつ <br>[sound:k-0417_市立.mp3]
[sound:k-0417_市立.mp3]	municipal, city<br> <b>市立</b> <br> (しりつ, いちりつ)
<b>区長</b> <br> 彼は地元の区長候補として立候補しました。	[sound:s-0417_彼は地元の区長候補として立候補しました。.mp3] <br> かれはじもとのくちょうこうほとしてりっこうほしました。 <br>He ran as a candidate for local ward mayor.
[sound:s-0417_彼は地元の区長候補として立候補しました。.mp3]	<b>区長</b> <br> 彼は地元の区長候補として立候補しました。<br> かれはじもとのくちょうこうほとしてりっこうほしました <br>He ran as a candidate for local ward mayor.
市議	[sound:k-0418_市議.mp3]<br>しぎ <br> city councillor, city councilor, city assemblyman
city councillor, city councilor, city assemblyman	<b>市議<b> <br> しぎ <br>[sound:k-0418_市議.mp3]
[sound:k-0418_市議.mp3]	city councillor, city councilor, city assemblyman<br> <b>市議</b> <br> (しぎ)
<b>区立</b> <br> この学校は区立です。	[sound:s-0418_この学校は区立です。.mp3] <br> このがっこうはくりつです。 <br>This school is run by the ward office.
[sound:s-0418_この学校は区立です。.mp3]	<b>区立</b> <br> この学校は区立です。<br> このがっこうはくりつです <br>This school is run by the ward office.
市中	[sound:k-0419_市中.mp3]<br>しちゅう <br> in the city
in the city	<b>市中<b> <br> しちゅう <br>[sound:k-0419_市中.mp3]
[sound:k-0419_市中.mp3]	in the city<br> <b>市中</b> <br> (しちゅう)
<b>区別</b> <br> 彼らは日本人と韓国人を区別することが難しいと言っています。	[sound:s-0419_彼らは日本人と韓国人を区別することが難しいと言っています。.mp3] <br> かれらはにほんじんとかんこくじんをくべつすることがむずかしいといっています。 <br>They say it's difficult to distinguish between Japanese and Koreans.
[sound:s-0419_彼らは日本人と韓国人を区別することが難しいと言っています。.mp3]	<b>区別</b> <br> 彼らは日本人と韓国人を区別することが難しいと言っています。<br> かれらはにほんじんとかんこくじんをくべつすることがむずかしいといっています <br>They say it's difficult to distinguish between Japanese and Koreans.
業	[sound:k-0420_業.mp3]<br>ごう <br> karma (i.e. actions committed in a former life)
karma (i.e. actions committed in a former life)	<b>業<b> <br> ごう <br>[sound:k-0420_業.mp3]
[sound:k-0420_業.mp3]	karma<br> <b>i.e. actions committed in a former life) (業</b> <br> (ごう)
<b>区民</b> <br> この地域の区民は親睦を深めるためにイベントを開催しました。	[sound:s-0420_この地域の区民は親睦を深めるためにイベントを開催しました。.mp3] <br> このちいきのくみんはしんぼくをふかめるためにいべんとをかいさいしました。 <br>Residents of this area held an event to deepen friendship.
[sound:s-0420_この地域の区民は親睦を深めるためにイベントを開催しました。.mp3]	<b>区民</b> <br> この地域の区民は親睦を深めるためにイベントを開催しました。<br> このちいきのくみんはしんぼくをふかめるためにいべんとをかいさいしました <br>Residents of this area held an event to deepen friendship.
企業	[sound:k-0421_企業.mp3]<br>きぎょう <br> enterprise, undertaking, corporation, business
enterprise, undertaking, corporation, business	<b>企業<b> <br> きぎょう <br>[sound:k-0421_企業.mp3]
[sound:k-0421_企業.mp3]	enterprise, undertaking, corporation, business<br> <b>企業</b> <br> (きぎょう)
<b>大統領</b> <br> 彼は次期大統領の有力候補です。	[sound:s-0421_彼は次期大統領の有力候補です。.mp3] <br> かれはじきだいとうりょうのゆうりょくこうほです。 <br>He is a leading candidate for the next president.
[sound:s-0421_彼は次期大統領の有力候補です。.mp3]	<b>大統領</b> <br> 彼は次期大統領の有力候補です。<br> かれはじきだいとうりょうのゆうりょくこうほです <br>He is a leading candidate for the next president.
業界	[sound:k-0422_業界.mp3]<br>ぎょうかい <br> industry, business
industry, business	<b>業界<b> <br> ぎょうかい <br>[sound:k-0422_業界.mp3]
[sound:k-0422_業界.mp3]	industry, business<br> <b>業界</b> <br> (ぎょうかい)
<b>領土</b> <br> その国との間で領土問題が発生しました。	[sound:s-0422_その国との間で領土問題が発生しました。.mp3] <br> そのくにとのあいだでりょうどもんだいがはっせいしました。 <br>A territorial dispute arose between the two countries.
[sound:s-0422_その国との間で領土問題が発生しました。.mp3]	<b>領土</b> <br> その国との間で領土問題が発生しました。<br> そのくにとのあいだでりょうどもんだいがはっせいしました <br>A territorial dispute arose between the two countries.
業者	[sound:k-0423_業者.mp3]<br>ぎょうしゃ <br> trader, merchant
trader, merchant	<b>業者<b> <br> ぎょうしゃ <br>[sound:k-0423_業者.mp3]
[sound:k-0423_業者.mp3]	trader, merchant<br> <b>業者</b> <br> (ぎょうしゃ)
<b>占領</b> <br> 戦後、その国は占領されました。	[sound:s-0423_戦後、その国は占領されました。.mp3] <br> せんご、そのくにはせんりょうされました。 <br>The country was occupied after the war.
[sound:s-0423_戦後、その国は占領されました。.mp3]	<b>占領</b> <br> 戦後、その国は占領されました。<br> せんご、そのくにはせんりょうされました <br>The country was occupied after the war.
作業	[sound:k-0424_作業.mp3]<br>さぎょう <br> work, operation, manufacturing, fatigue duty
work, operation, manufacturing, fatigue duty	<b>作業<b> <br> さぎょう <br>[sound:k-0424_作業.mp3]
[sound:k-0424_作業.mp3]	work, operation, manufacturing, fatigue duty<br> <b>作業</b> <br> (さぎょう)
<b>領域</b> <br> この地域は自然保護の重要な領域です。	[sound:s-0424_この地域は自然保護の重要な領域です。.mp3] <br> このちいきはしぜんほごのじゅうようなりょういきです。 <br>This area is an important territory for nature conservation.
[sound:s-0424_この地域は自然保護の重要な領域です。.mp3]	<b>領域</b> <br> この地域は自然保護の重要な領域です。<br> このちいきはしぜんほごのじゅうようなりょういきです <br>This area is an important territory for nature conservation.
産業	[sound:k-0425_産業.mp3]<br>さんぎょう <br> industry
industry	<b>産業<b> <br> さんぎょう <br>[sound:k-0425_産業.mp3]
[sound:k-0425_産業.mp3]	industry<br> <b>産業</b> <br> (さんぎょう)
<b>綱領</b> <br> その政党は新しい綱領を採択しました。	[sound:s-0425_その政党は新しい綱領を採択しました。.mp3] <br> そのせいとうはあたらしいこうりょうをさいたくしました。 <br>The party adopted a new platform.
[sound:s-0425_その政党は新しい綱領を採択しました。.mp3]	<b>綱領</b> <br> その政党は新しい綱領を採択しました。<br> そのせいとうはあたらしいこうりょうをさいたくしました <br>The party adopted a new platform.
事業	[sound:k-0426_事業.mp3]<br>じぎょう <br> project, enterprise, business, industry, operations
project, enterprise, business, industry, operations	<b>事業<b> <br> じぎょう <br>[sound:k-0426_事業.mp3]
[sound:k-0426_事業.mp3]	project, enterprise, business, industry, operations<br> <b>事業</b> <br> (じぎょう)
<b>領内</b> <br> 領内での交通状況が改善されました。	[sound:s-0426_領内での交通状況が改善されました。.mp3] <br> りょうないでのこうつうじょうきょうがかいぜんされました。 <br>Transportation within the territory has improved.
[sound:s-0426_領内での交通状況が改善されました。.mp3]	<b>領内</b> <br> 領内での交通状況が改善されました。<br> りょうないでのこうつうじょうきょうがかいぜんされました <br>Transportation within the territory has improved.
農業	[sound:k-0427_農業.mp3]<br>のうぎょう <br> agriculture
agriculture	<b>農業<b> <br> のうぎょう <br>[sound:k-0427_農業.mp3]
[sound:k-0427_農業.mp3]	agriculture<br> <b>農業</b> <br> (のうぎょう)
<b>領有</b> <br> その地域の領有権を巡る論争が続いています。	[sound:s-0427_その地域の領有権を巡る論争が続いています。.mp3] <br> そのちいきのりょうゆうけんをめぐるろんそうがつづいています。 <br>Disputes over territorial rights in that area continue.
[sound:s-0427_その地域の領有権を巡る論争が続いています。.mp3]	<b>領有</b> <br> その地域の領有権を巡る論争が続いています。<br> そのちいきのりょうゆうけんをめぐるろんそうがつづいています <br>Disputes over territorial rights in that area continue.
営業	[sound:k-0428_営業.mp3]<br>えいぎょう <br> business, trade, sales, operations
business, trade, sales, operations	<b>営業<b> <br> えいぎょう <br>[sound:k-0428_営業.mp3]
[sound:k-0428_営業.mp3]	business, trade, sales, operations<br> <b>営業</b> <br> (えいぎょう)
<b>横領</b> <br> 彼の不正行為は公金の横領でした。	[sound:s-0428_彼の不正行為は公金の横領でした。.mp3] <br> かれのふせいこういはこうきんのおうりょうでした。 <br>His misconduct involved embezzlement of public funds.
[sound:s-0428_彼の不正行為は公金の横領でした。.mp3]	<b>横領</b> <br> 彼の不正行為は公金の横領でした。<br> かれのふせいこういはこうきんのおうりょうでした <br>His misconduct involved embezzlement of public funds.
業務	[sound:k-0429_業務.mp3]<br>ぎょうむ <br> business, affairs, duties, work, procedure, task, action, function
business, affairs, duties, work, procedure, task, action, function	<b>業務<b> <br> ぎょうむ <br>[sound:k-0429_業務.mp3]
[sound:k-0429_業務.mp3]	business, affairs, duties, work, procedure, task, action, function<br> <b>業務</b> <br> (ぎょうむ)
<b>受領</b> <br> 書類が正しく受領されました。	[sound:s-0429_書類が正しく受領されました。.mp3] <br> しょるいがただしくじゅりょうされました。 <br>The documents were received correctly.
[sound:s-0429_書類が正しく受領されました。.mp3]	<b>受領</b> <br> 書類が正しく受領されました。<br> しょるいがただしくじゅりょうされました <br>The documents were received correctly.
内	[sound:k-0430_内.mp3]<br>うち <br> inside, within; while; among, amongst, between; we (referring to one's in-group, i.e. company, etc.); my spouse; imperial palace grounds; emperor; I (primarily used by women and children), me
inside, within; while; among, amongst, between; we (referring to one's in-group, i.e. company, etc.); my spouse; imperial palace grounds; emperor; I (primarily used by women and children), me	<b>内<b> <br> うち <br>[sound:k-0430_内.mp3]
[sound:k-0430_内.mp3]	inside, within; while; among, amongst, between; we<br> <b>referring to one's in-group, i.e. company, etc.); my spouse; imperial palace grounds; emperor; I (primarily used by women and children), me (内</b> <br> (うち)
<b>総領事</b> <br> 彼は総領事としてその国に赴任しました。	[sound:s-0430_彼は総領事としてその国に赴任しました。.mp3] <br> かれはそうりょうじとしてそのくににふにんしました。 <br>He was appointed as the consul general to that country.
[sound:s-0430_彼は総領事としてその国に赴任しました。.mp3]	<b>総領事</b> <br> 彼は総領事としてその国に赴任しました。<br> かれはそうりょうじとしてそのくににふにんしました <br>He was appointed as the consul general to that country.
国内	[sound:k-0431_国内.mp3]<br>こくない <br> internal, domestic
internal, domestic	<b>国内<b> <br> こくない <br>[sound:k-0431_国内.mp3]
[sound:k-0431_国内.mp3]	internal, domestic<br> <b>国内</b> <br> (こくない)
<b>多数</b> <br> 多数の人々がその提案に賛成しました。	[sound:s-0431_多数の人々がその提案に賛成しました。.mp3] <br> たすうのひとびとがそのていあんにさんせいしました。 <br>A majority of people supported the proposal.
[sound:s-0431_多数の人々がその提案に賛成しました。.mp3]	<b>多数</b> <br> 多数の人々がその提案に賛成しました。<br> たすうのひとびとがそのていあんにさんせいしました <br>A majority of people supported the proposal.
市内	[sound:k-0432_市内.mp3]<br>しない <br> (within a) city, local
(within a) city, local	<b>市内<b> <br> しない <br>[sound:k-0432_市内.mp3]
[sound:k-0432_市内.mp3]	(within a) city, local<br> <b>市内</b> <br> (しない)
<b>多様</b> <br> その地域は文化的にも自然的にも多様です。	[sound:s-0432_その地域は文化的にも自然的にも多様です。.mp3] <br> そのちいきはぶんかてきにもしぜんてきにもたようです。 <br>The region is diverse culturally and environmentally.
[sound:s-0432_その地域は文化的にも自然的にも多様です。.mp3]	<b>多様</b> <br> その地域は文化的にも自然的にも多様です。<br> そのちいきはぶんかてきにもしぜんてきにもたようです <br>The region is diverse culturally and environmentally.
都内	[sound:k-0433_都内.mp3]<br>とない <br> metropolitan area
metropolitan area	<b>都内<b> <br> とない <br>[sound:k-0433_都内.mp3]
[sound:k-0433_都内.mp3]	metropolitan area<br> <b>都内</b> <br> (とない)
<b>多角</b> <br> 彼は多角的な視点から問題を分析します。	[sound:s-0433_彼は多角的な視点から問題を分析します。.mp3] <br> かれはたかくてきなしてんからもんだいをぶんせきします。 <br>He analyzes problems from various perspectives.
[sound:s-0433_彼は多角的な視点から問題を分析します。.mp3]	<b>多角</b> <br> 彼は多角的な視点から問題を分析します。<br> かれはたかくてきなしてんからもんだいをぶんせきします <br>He analyzes problems from various perspectives.
内閣	[sound:k-0434_内閣.mp3]<br>ないかく <br> cabinet, (government) ministry
cabinet, (government) ministry	<b>内閣<b> <br> ないかく <br>[sound:k-0434_内閣.mp3]
[sound:k-0434_内閣.mp3]	cabinet,<br> <b>government) ministry (内閣</b> <br> (ないかく)
<b>最多</b> <br> 彼は過去最多の得票数を記録しました。	[sound:s-0434_彼は過去最多の得票数を記録しました。.mp3] <br> かれはかこさいたのとくひょうすうをきろくしました。 <br>He recorded the highest number of votes ever.
[sound:s-0434_彼は過去最多の得票数を記録しました。.mp3]	<b>最多</b> <br> 彼は過去最多の得票数を記録しました。<br> かれはかこさいたのとくひょうすうをきろくしました <br>He recorded the highest number of votes ever.
内容	[sound:k-0435_内容.mp3]<br>ないよう <br> subject, contents, matter, substance, detail, import
subject, contents, matter, substance, detail, import	<b>内容<b> <br> ないよう <br>[sound:k-0435_内容.mp3]
[sound:k-0435_内容.mp3]	subject, contents, matter, substance, detail, import<br> <b>内容</b> <br> (ないよう)
<b>多額</b> <br> 彼は多額の賞金を受賞しました。	[sound:s-0435_彼は多額の賞金を受賞しました。.mp3] <br> かれはたがくのしょうきんをじゅしょうしました。 <br>He won a large cash prize.
[sound:s-0435_彼は多額の賞金を受賞しました。.mp3]	<b>多額</b> <br> 彼は多額の賞金を受賞しました。<br> かれはたがくのしょうきんをじゅしょうしました <br>He won a large cash prize.
以内	[sound:k-0436_以内.mp3]<br>いない <br> within, inside of, less than
within, inside of, less than	<b>以内<b> <br> いない <br>[sound:k-0436_以内.mp3]
[sound:k-0436_以内.mp3]	within, inside of, less than<br> <b>以内</b> <br> (いない)
<b>多彩</b> <br> その国の料理は多彩で美味しいです。	[sound:s-0436_その国の料理は多彩で美味しいです。.mp3] <br> そのくにのりょうりはたさいでおいしいです。 <br>The cuisine of that country is diverse and delicious.
[sound:s-0436_その国の料理は多彩で美味しいです。.mp3]	<b>多彩</b> <br> その国の料理は多彩で美味しいです。<br> そのくにのりょうりはたさいでおいしいです <br>The cuisine of that country is diverse and delicious.
党内	[sound:k-0437_党内.mp3]<br>とうない <br> party-internal
party-internal	<b>党内<b> <br> とうない <br>[sound:k-0437_党内.mp3]
[sound:k-0437_党内.mp3]	party-internal<br> <b>党内</b> <br> (とうない)
<b>多少</b> <br> 彼の話には多少の誇張があるかもしれません。	[sound:s-0437_彼の話には多少の誇張があるかもしれません。.mp3] <br> かれのはなしにはたしょうのこちょうがあるかもしれません。 <br>There may be some exaggeration in his story.
[sound:s-0437_彼の話には多少の誇張があるかもしれません。.mp3]	<b>多少</b> <br> 彼の話には多少の誇張があるかもしれません。<br> かれのはなしにはたしょうのこちょうがあるかもしれません <br>There may be some exaggeration in his story.
内部	[sound:k-0438_内部.mp3]<br>ないぶ <br> interior, inside, internal
interior, inside, internal	<b>内部<b> <br> ないぶ <br>[sound:k-0438_内部.mp3]
[sound:k-0438_内部.mp3]	interior, inside, internal<br> <b>内部</b> <br> (ないぶ)
<b>数多く</b> <br> この街には数多くの歴史的建造物があります。	[sound:s-0438_この街には数多くの歴史的建造物があります。.mp3] <br> このまちにはかずおおくのれきしてきけんぞうぶつがあります。 <br>This city has numerous historical buildings.
[sound:s-0438_この街には数多くの歴史的建造物があります。.mp3]	<b>数多く</b> <br> この街には数多くの歴史的建造物があります。<br> このまちにはかずおおくのれきしてきけんぞうぶつがあります <br>This city has numerous historical buildings.
県内	[sound:k-0439_県内.mp3]<br>けんない <br> within the prefecture
within the prefecture	<b>県内<b> <br> けんない <br>[sound:k-0439_県内.mp3]
[sound:k-0439_県内.mp3]	within the prefecture<br> <b>県内</b> <br> (けんない)
<b>多様化</b> <br> 産業が多様化しています。	[sound:s-0439_産業が多様化しています。.mp3] <br> さんぎょうがたようかしています。 <br>Industries are diversifying.
[sound:s-0439_産業が多様化しています。.mp3]	<b>多様化</b> <br> 産業が多様化しています。<br> さんぎょうがたようかしています <br>Industries are diversifying.
外相	[sound:k-0440_外相.mp3]<br>がいしょう <br> Foreign Minister
Foreign Minister	<b>外相<b> <br> がいしょう <br>[sound:k-0440_外相.mp3]
[sound:k-0440_外相.mp3]	Foreign Minister<br> <b>外相</b> <br> (がいしょう)
<b>多大</b> <br> 彼は多大な努力を払ってプロジェクトを完成させました。	[sound:s-0440_彼は多大な努力を払ってプロジェクトを完成させました。.mp3] <br> かれはただいなどりょくをはってぷろじぇくとをかんせいさせました。 <br>He put in a great deal of effort to complete the project.
[sound:s-0440_彼は多大な努力を払ってプロジェクトを完成させました。.mp3]	<b>多大</b> <br> 彼は多大な努力を払ってプロジェクトを完成させました。<br> かれはただいなどりょくをはってぷろじぇくとをかんせいさせました <br>He put in a great deal of effort to complete the project.
首相	[sound:k-0441_首相.mp3]<br>しゅしょう <br> Prime Minister, Chancellor (Germany, Austria, etc.), Premier
Prime Minister, Chancellor (Germany, Austria, etc.), Premier	<b>首相<b> <br> しゅしょう <br>[sound:k-0441_首相.mp3]
[sound:k-0441_首相.mp3]	Prime Minister, Chancellor<br> <b>Germany, Austria, etc.), Premier (首相</b> <br> (しゅしょう)
<b>県警</b> <br> 県警は事件を調査しています。	[sound:s-0441_県警は事件を調査しています。.mp3] <br> けんけいはじけんをちょうさしています。 <br>The prefectural police are investigating the case.
[sound:s-0441_県警は事件を調査しています。.mp3]	<b>県警</b> <br> 県警は事件を調査しています。<br> けんけいはじけんをちょうさしています <br>The prefectural police are investigating the case.
相手	[sound:k-0442_相手.mp3]<br>あいて <br> companion, partner, company; other party, addressee; opponent (sports, etc.)
companion, partner, company; other party, addressee; opponent (sports, etc.)	<b>相手<b> <br> あいて <br>[sound:k-0442_相手.mp3]
[sound:k-0442_相手.mp3]	companion, partner, company; other party, addressee; opponent<br> <b>sports, etc.) (相手</b> <br> (あいて)
<b>同県</b> <br> 彼と私は同県出身です。	[sound:s-0442_彼と私は同県出身です。.mp3] <br> かれとわたしはどうけんしゅっしんです。 <br>He and I are from the same prefecture.
[sound:s-0442_彼と私は同県出身です。.mp3]	<b>同県</b> <br> 彼と私は同県出身です。<br> かれとわたしはどうけんしゅっしんです <br>He and I are from the same prefecture.
相談	[sound:k-0443_相談.mp3]<br>そうだん <br> consultation, discussion
consultation, discussion	<b>相談<b> <br> そうだん <br>[sound:k-0443_相談.mp3]
[sound:k-0443_相談.mp3]	consultation, discussion<br> <b>相談</b> <br> (そうだん)
<b>県知事</b> <br> 彼は次期の県知事選挙に立候補する予定です。	[sound:s-0443_彼は次期の県知事選挙に立候補する予定です。.mp3] <br> かれはじきのけんちじせんきょにりっこうほするよていです。 <br>He plans to run for governor in the next prefectural election.
[sound:s-0443_彼は次期の県知事選挙に立候補する予定です。.mp3]	<b>県知事</b> <br> 彼は次期の県知事選挙に立候補する予定です。<br> かれはじきのけんちじせんきょにりっこうほするよていです <br>He plans to run for governor in the next prefectural election.
蔵相	[sound:k-0444_蔵相.mp3]<br>ぞうしょう <br> Minister of Finance
Minister of Finance	<b>蔵相<b> <br> ぞうしょう <br>[sound:k-0444_蔵相.mp3]
[sound:k-0444_蔵相.mp3]	Minister of Finance<br> <b>蔵相</b> <br> (ぞうしょう)
<b>県内</b> <br> 県内には多くの観光地があります。	[sound:s-0444_県内には多くの観光地があります。.mp3] <br> けんないにはおおくのかんこうちがあります。 <br>There are many tourist attractions within the prefecture.
[sound:s-0444_県内には多くの観光地があります。.mp3]	<b>県内</b> <br> 県内には多くの観光地があります。<br> けんないにはおおくのかんこうちがあります <br>There are many tourist attractions within the prefecture.
相互	[sound:k-0445_相互.mp3]<br>そうご <br> mutual, reciprocal
mutual, reciprocal	<b>相互<b> <br> そうご <br>[sound:k-0445_相互.mp3]
[sound:k-0445_相互.mp3]	mutual, reciprocal<br> <b>相互</b> <br> (そうご)
<b>都道府県</b> <br> 日本は都道府県に分かれています。	[sound:s-0445_日本は都道府県に分かれています。.mp3] <br> にほんはとどうふけんにわかれています。 <br>Japan is divided into prefectures.
[sound:s-0445_日本は都道府県に分かれています。.mp3]	<b>都道府県</b> <br> 日本は都道府県に分かれています。<br> にほんはとどうふけんにわかれています <br>Japan is divided into prefectures.
相場	[sound:k-0446_相場.mp3]<br>そうば <br> market price, speculation, estimation
market price, speculation, estimation	<b>相場<b> <br> そうば <br>[sound:k-0446_相場.mp3]
[sound:k-0446_相場.mp3]	market price, speculation, estimation<br> <b>相場</b> <br> (そうば)
<b>県議</b> <br> 彼は市の議員から県議に転身しました。	[sound:s-0446_彼は市の議員から県議に転身しました。.mp3] <br> かれはしのぎいんからけんぎにてんしんしました。 <br>He transitioned from a city councilor to a prefectural assembly member.
[sound:s-0446_彼は市の議員から県議に転身しました。.mp3]	<b>県議</b> <br> 彼は市の議員から県議に転身しました。<br> かれはしのぎいんからけんぎにてんしんしました <br>He transitioned from a city councilor to a prefectural assembly member.
相当	[sound:k-0447_相当.mp3]<br>そうとう <br> befitting, becoming, worthy of, proportionate, in keeping with, suitable; considerable, substantial; to be worthy of, to be proportionate to; to correspond to (in meaning, function, etc.), to be equivalent; extremely, considerably
befitting, becoming, worthy of, proportionate, in keeping with, suitable; considerable, substantial; to be worthy of, to be proportionate to; to correspond to (in meaning, function, etc.), to be equivalent; extremely, considerably	<b>相当<b> <br> そうとう <br>[sound:k-0447_相当.mp3]
[sound:k-0447_相当.mp3]	befitting, becoming, worthy of, proportionate, in keeping with, suitable; considerable, substantial; to be worthy of, to be proportionate to; to correspond to<br> <b>in meaning, function, etc.), to be equivalent; extremely, considerably (相当</b> <br> (そうとう)
<b>県立</b> <br> この病院は県立の施設です。	[sound:s-0447_この病院は県立の施設です。.mp3] <br> このびょういんはけんりつのしせつです。 <br>This hospital is a prefectural facility.
[sound:s-0447_この病院は県立の施設です。.mp3]	<b>県立</b> <br> この病院は県立の施設です。<br> このびょういんはけんりつのしせつです <br>This hospital is a prefectural facility.
相撲	[sound:k-0448_相撲.mp3]<br>すもう, すまい <br> sumo wrestling; sumo wrestler, rikishi
sumo wrestling; sumo wrestler, rikishi	<b>相撲<b> <br> すもう, すまい <br>[sound:k-0448_相撲.mp3]
[sound:k-0448_相撲.mp3]	sumo wrestling; sumo wrestler, rikishi<br> <b>相撲</b> <br> (すもう, すまい)
<b>県民</b> <br> その計画は県民からの支持を得ています。	[sound:s-0448_その計画は県民からの支持を得ています。.mp3] <br> そのけいかくはけんみんからのしじをえています。 <br>The plan has the support of the prefectural residents.
[sound:s-0448_その計画は県民からの支持を得ています。.mp3]	<b>県民</b> <br> その計画は県民からの支持を得ています。<br> そのけいかくはけんみんからのしじをえています <br>The plan has the support of the prefectural residents.
真相	[sound:k-0449_真相.mp3]<br>しんそう <br> truth, real situation
truth, real situation	<b>真相<b> <br> しんそう <br>[sound:k-0449_真相.mp3]
[sound:k-0449_真相.mp3]	truth, real situation<br> <b>真相</b> <br> (しんそう)
<b>県庁</b> <br> 県庁はこの地域の中心地にあります。	[sound:s-0449_県庁はこの地域の中心地にあります。.mp3] <br> けんちょうはこのちいきのちゅうしんちにあります。 <br>The prefectural office is located in the center of this area.
[sound:s-0449_県庁はこの地域の中心地にあります。.mp3]	<b>県庁</b> <br> 県庁はこの地域の中心地にあります。<br> けんちょうはこのちいきのちゅうしんちにあります <br>The prefectural office is located in the center of this area.
一方	[sound:k-0450_一方.mp3]<br>いっぽう <br> one (esp. of two), the other, one way, the other way, one direction, the other direction, one side, the other side, one party, the other party; on the one hand, on the other hand; whereas, although, but at the same time, meanwhile, in turn; (after noun, adjective-stem or plain verb) just keeps, being inclined to ..., tending to be ..., tending to do ..., ntinuously ..., just keeps on ...ing, only
one (esp. of two), the other, one way, the other way, one direction, the other direction, one side, the other side, one party, the other party; on the one hand, on the other hand; whereas, although, but at the same time, meanwhile, in turn; (after noun, adjective-stem or plain verb) just keeps, being inclined to ..., tending to be ..., tending to do ..., ntinuously ..., just keeps on ...ing, only	<b>一方<b> <br> いっぽう <br>[sound:k-0450_一方.mp3]
[sound:k-0450_一方.mp3]	one<br> <b>esp. of two), the other, one way, the other way, one direction, the other direction, one side, the other side, one party, the other party; on the one hand, on the other hand; whereas, although, but at the same time, meanwhile, in turn; (after noun, adjective-stem or plain verb) just keeps, being inclined to ..., tending to be ..., tending to do ..., ntinuously ..., just keeps on ...ing, only (一方</b> <br> (いっぽう)
<b>府県</b> <br> 彼は大阪府出身です。	[sound:s-0450_彼は大阪府出身です。.mp3] <br> かれはおおさかふしゅっしんです。 <br>He is from Osaka Prefecture.
[sound:s-0450_彼は大阪府出身です。.mp3]	<b>府県</b> <br> 彼は大阪府出身です。<br> かれはおおさかふしゅっしんです <br>He is from Osaka Prefecture.
見方	[sound:k-0451_見方.mp3]<br>みかた <br> viewpoint
viewpoint	<b>見方<b> <br> みかた <br>[sound:k-0451_見方.mp3]
[sound:k-0451_見方.mp3]	viewpoint<br> <b>見方</b> <br> (みかた)
<b>連続</b> <br> 彼の作品は連続してベストセラーとなりました。	[sound:s-0451_彼の作品は連続してベストセラーとなりました。.mp3] <br> かれのさくひんはれんぞくしてベストセラーとなりました。 <br>His works became bestsellers one after another.
[sound:s-0451_彼の作品は連続してベストセラーとなりました。.mp3]	<b>連続</b> <br> 彼の作品は連続してベストセラーとなりました。<br> かれのさくひんはれんぞくしてベストセラーとなりました <br>His works became bestsellers one after another.
地方	[sound:k-0452_地方.mp3]<br>ちほう, じかた <br> area, locality, district, region, province; countryside, rural area; coast (esp. as seen from the water); person singing ballads in Noh, person in charge of music in a Japanese dance performance
area, locality, district, region, province; countryside, rural area; coast (esp. as seen from the water); person singing ballads in Noh, person in charge of music in a Japanese dance performance	<b>地方<b> <br> ちほう, じかた <br>[sound:k-0452_地方.mp3]
[sound:k-0452_地方.mp3]	area, locality, district, region, province; countryside, rural area; coast<br> <b>esp. as seen from the water); person singing ballads in Noh, person in charge of music in a Japanese dance performance (地方</b> <br> (ちほう, じかた)
<b>手続き</b> <br> この手続きは簡単です。	[sound:s-0452_この手続きは簡単です。.mp3] <br> このてつづきはかんたんです。 <br>This procedure is simple.
[sound:s-0452_この手続きは簡単です。.mp3]	<b>手続き</b> <br> この手続きは簡単です。<br> このてつづきはかんたんです <br>This procedure is simple.
方向	[sound:k-0453_方向.mp3]<br>ほうこう <br> direction, orientation, bearing, way; course (e.g. of action)
direction, orientation, bearing, way; course (e.g. of action)	<b>方向<b> <br> ほうこう <br>[sound:k-0453_方向.mp3]
[sound:k-0453_方向.mp3]	direction, orientation, bearing, way; course<br> <b>e.g. of action) (方向</b> <br> (ほうこう)
<b>継続</b> <br> 彼の努力の結果、好成績を継続しました。	[sound:s-0453_彼の努力の結果、好成績を継続しました。.mp3] <br> かれのどりょくのけっか、こうせいせきをけいぞくしました。 <br>"As a result of his efforts, he maintained good grades."
[sound:s-0453_彼の努力の結果、好成績を継続しました。.mp3]	<b>継続</b> <br> 彼の努力の結果、好成績を継続しました。<br> かれのどりょくのけっか、こうせいせきをけいぞくしました <br>As a result of his efforts, he maintained good grades.
方針	[sound:k-0454_方針.mp3]<br>ほうしん <br> objective, plan, policy
objective, plan, policy	<b>方針<b> <br> ほうしん <br>[sound:k-0454_方針.mp3]
[sound:k-0454_方針.mp3]	objective, plan, policy<br> <b>方針</b> <br> (ほうしん)
<b>続き</b> <br> 前回の話の続きを教えてください。	[sound:s-0454_前回の話の続きを教えてください。.mp3] <br> ぜんかいのはなしのつづきをおしえてください。 <br>Please tell me what happened next in the previous story.
[sound:s-0454_前回の話の続きを教えてください。.mp3]	<b>続き</b> <br> 前回の話の続きを教えてください。<br> ぜんかいのはなしのつづきをおしえてください <br>Please tell me what happened next in the previous story.
方法	[sound:k-0455_方法.mp3]<br>ほうほう <br> method, process, manner, way, means, technique
method, process, manner, way, means, technique	<b>方法<b> <br> ほうほう <br>[sound:k-0455_方法.mp3]
[sound:k-0455_方法.mp3]	method, process, manner, way, means, technique<br> <b>方法</b> <br> (ほうほう)
<b>持続</b> <br> 彼女は平和を持続するために努力しています。	[sound:s-0455_彼女は平和を持続するために努力しています。.mp3] <br> かのじょはへいわをじぞくするためにどりょくしています。 <br>She is working to maintain peace.
[sound:s-0455_彼女は平和を持続するために努力しています。.mp3]	<b>持続</b> <br> 彼女は平和を持続するために努力しています。<br> かのじょはへいわをじぞくするためにどりょくしています <br>She is working to maintain peace.
考え方	[sound:k-0456_考え方.mp3]<br>かんがえかた <br> way of thinking
way of thinking	<b>考え方<b> <br> かんがえかた <br>[sound:k-0456_考え方.mp3]
[sound:k-0456_考え方.mp3]	way of thinking<br> <b>考え方</b> <br> (かんがえかた)
<b>存続</b> <br> そのビジネスは存続が危ぶまれています。	[sound:s-0456_そのビジネスは存続が危ぶまれています。.mp3] <br> そのびじねすはそんぞくがあやぶまれています。 <br>The survival of the business is in doubt.
[sound:s-0456_そのビジネスは存続が危ぶまれています。.mp3]	<b>存続</b> <br> そのビジネスは存続が危ぶまれています。<br> そのびじねすはそんぞくがあやぶまれています <br>The survival of the business is in doubt.
行方	[sound:k-0457_行方.mp3]<br>ゆくえ <br> (one's) whereabouts; course, direction
(one's) whereabouts; course, direction	<b>行方<b> <br> ゆくえ <br>[sound:k-0457_行方.mp3]
[sound:k-0457_行方.mp3]	(one's) whereabouts; course, direction<br> <b>行方</b> <br> (ゆくえ)
<b>続々</b> <br> 新しい店が続々とオープンしています。	[sound:s-0457_新しい店が続々とオープンしています。.mp3] <br> あたらしいみせがぞくぞくとおーぷんしています。 <br>New stores are opening one after another.
[sound:s-0457_新しい店が続々とオープンしています。.mp3]	<b>続々</b> <br> 新しい店が続々とオープンしています。<br> あたらしいみせがぞくぞくとおーぷんしています <br>New stores are opening one after another.
双方	[sound:k-0458_双方.mp3]<br>そうほう <br> two way, both parties, mutual, both
two way, both parties, mutual, both	<b>双方<b> <br> そうほう <br>[sound:k-0458_双方.mp3]
[sound:k-0458_双方.mp3]	two way, both parties, mutual, both<br> <b>双方</b> <br> (そうほう)
<b>引き続き</b> <br> 今後も引き続きご協力をお願いします。	[sound:s-0458_今後も引き続きご協力をお願いします。.mp3] <br> こんごもひきぞきごきょうりょくをおねがいします。 <br>We ask for your continued cooperation in the future.
[sound:s-0458_今後も引き続きご協力をお願いします。.mp3]	<b>引き続き</b> <br> 今後も引き続きご協力をお願いします。<br> こんごもひきぞきごきょうりょくをおねがいします <br>We ask for your continued cooperation in the future.
方	[sound:k-0459_方.mp3]<br>ほう <br> side, direction, way
side, direction, way	<b>方<b> <br> ほう <br>[sound:k-0459_方.mp3]
[sound:k-0459_方.mp3]	side, direction, way<br> <b>方</b> <br> (ほう)
<b>相続</b> <br> 彼は父親の遺産を相続しました。	[sound:s-0459_彼は父親の遺産を相続しました。.mp3] <br> かれはちちおやのいさんをそうぞくしました。 <br>He inherited his father's estate.
[sound:s-0459_彼は父親の遺産を相続しました。.mp3]	<b>相続</b> <br> 彼は父親の遺産を相続しました。<br> かれはちちおやのいさんをそうぞくしました <br>He inherited his father's estate.
四	[sound:k-0460_四.mp3]<br>よん, し, よ <br> four
four	<b>四<b> <br> よん, し, よ <br>[sound:k-0460_四.mp3]
[sound:k-0460_四.mp3]	four<br> <b>四</b> <br> (よん, し, よ)
<b>相続税</b> <br> 相続税の申告書を提出しました。	[sound:s-0460_相続税の申告書を提出しました。.mp3] <br> そうぞくぜいのしんこくしょをていしゅつしました。 <br>I submitted the inheritance tax return.
[sound:s-0460_相続税の申告書を提出しました。.mp3]	<b>相続税</b> <br> 相続税の申告書を提出しました。<br> そうぞくぜいのしんこくしょをていしゅつしました <br>I submitted the inheritance tax return.
四つ	[sound:k-0461_四つ.mp3]<br>よっつ <br> four
four	<b>四つ<b> <br> よっつ <br>[sound:k-0461_四つ.mp3]
[sound:k-0461_四つ.mp3]	four<br> <b>四つ</b> <br> (よっつ)
<b>推進</b> <br> そのプロジェクトの推進には多くの資金が必要です。	[sound:s-0461_そのプロジェクトの推進には多くの資金が必要です。.mp3] <br> そのぷろじぇくとのすいしんにはおおくのしきんがひつようです。 <br>The project requires a lot of funding for its promotion.
[sound:s-0461_そのプロジェクトの推進には多くの資金が必要です。.mp3]	<b>推進</b> <br> そのプロジェクトの推進には多くの資金が必要です。<br> そのぷろじぇくとのすいしんにはおおくのしきんがひつようです <br>The project requires a lot of funding for its promotion.
四月	[sound:k-0462_四月.mp3]<br>しがつ <br> April
April	<b>四月<b> <br> しがつ <br>[sound:k-0462_四月.mp3]
[sound:k-0462_四月.mp3]	April<br> <b>四月</b> <br> (しがつ)
<b>進出</b> <br> 会社は海外市場への進出を計画しています。	[sound:s-0462_会社は海外市場への進出を計画しています。.mp3] <br> かいしゃはかいがいしじょうへのしんしゅつをけいかくしています。 <br>The company is planning to enter the overseas market.
[sound:s-0462_会社は海外市場への進出を計画しています。.mp3]	<b>進出</b> <br> 会社は海外市場への進出を計画しています。<br> かいしゃはかいがいしじょうへのしんしゅつをけいかくしています <br>The company is planning to enter the overseas market.
十四	[sound:k-0463_十四.mp3]<br>じゅうし, じゅうよん <br> 14, fourteen
14, fourteen	<b>十四<b> <br> じゅうし, じゅうよん <br>[sound:k-0463_十四.mp3]
[sound:k-0463_十四.mp3]	14, fourteen<br> <b>十四</b> <br> (じゅうし, じゅうよん)
<b>先進国</b> <br> その国は先進国の一つです。	[sound:s-0463_その国は先進国の一つです。.mp3] <br> そのくにはせんしんこくのひとつです。 <br>That country is one of the advanced nations.
[sound:s-0463_その国は先進国の一つです。.mp3]	<b>先進国</b> <br> その国は先進国の一つです。<br> そのくにはせんしんこくのひとつです <br>That country is one of the advanced nations.
四十	[sound:k-0464_四十.mp3]<br>よんじゅう, しじゅう, よそ <br> forty
forty	<b>四十<b> <br> よんじゅう, しじゅう, よそ <br>[sound:k-0464_四十.mp3]
[sound:k-0464_四十.mp3]	forty<br> <b>四十</b> <br> (よんじゅう, しじゅう, よそ)
<b>進展</b> <br> プロジェクトは順調に進展しています。	[sound:s-0464_プロジェクトは順調に進展しています。.mp3] <br> ぷろじぇくとはじゅんちょうにしんてんしています。 <br>The project is progressing smoothly.
[sound:s-0464_プロジェクトは順調に進展しています。.mp3]	<b>進展</b> <br> プロジェクトは順調に進展しています。<br> ぷろじぇくとはじゅんちょうにしんてんしています <br>The project is progressing smoothly.
四百	[sound:k-0465_四百.mp3]<br>よんひゃく <br> four hundred
four hundred	<b>四百<b> <br> よんひゃく <br>[sound:k-0465_四百.mp3]
[sound:k-0465_四百.mp3]	four hundred<br> <b>四百</b> <br> (よんひゃく)
<b>促進</b> <br> 政府は経済成長を促進するために政策を実施しています。	[sound:s-0465_政府は経済成長を促進するために政策を実施しています。.mp3] <br> せいふはけいざいせいちょうをそくしんするためにせいさくをじっししています。 <br>The government is implementing policies to promote economic growth.
[sound:s-0465_政府は経済成長を促進するために政策を実施しています。.mp3]	<b>促進</b> <br> 政府は経済成長を促進するために政策を実施しています。<br> せいふはけいざいせいちょうをそくしんするためにせいさくをじっししています <br>The government is implementing policies to promote economic growth.
四球	[sound:k-0466_四球.mp3]<br>しきゅう <br> four balls, base on balls (baseball), a walk
four balls, base on balls (baseball), a walk	<b>四球<b> <br> しきゅう <br>[sound:k-0466_四球.mp3]
[sound:k-0466_四球.mp3]	four balls, base on balls<br> <b>baseball), a walk (四球</b> <br> (しきゅう)
<b>先進</b> <br> 彼らは先進技術を使って新しい製品を開発しています。	[sound:s-0466_彼らは先進技術を使って新しい製品を開発しています。.mp3] <br> かれらはせんしんぎじゅつをつかってあたらしいせいひんをかいはつしています。 <br>They are developing new products using advanced technology.
[sound:s-0466_彼らは先進技術を使って新しい製品を開発しています。.mp3]	<b>先進</b> <br> 彼らは先進技術を使って新しい製品を開発しています。<br> かれらはせんしんぎじゅつをつかってあたらしいせいひんをかいはつしています <br>They are developing new products using advanced technology.
四千	[sound:k-0467_四千.mp3]<br>よんせん <br> four thousand
four thousand	<b>四千<b> <br> よんせん <br>[sound:k-0467_四千.mp3]
[sound:k-0467_四千.mp3]	four thousand<br> <b>四千</b> <br> (よんせん)
<b>進学</b> <br> 彼は医学部に進学する予定です。	[sound:s-0467_彼は医学部に進学する予定です。.mp3] <br> かれはいがくぶにしんがくするよていです。 <br>He plans to go to medical school.
[sound:s-0467_彼は医学部に進学する予定です。.mp3]	<b>進学</b> <br> 彼は医学部に進学する予定です。<br> かれはいがくぶにしんがくするよていです <br>He plans to go to medical school.
四十七士	[sound:k-0468_四十七士.mp3]<br>しじゅうしちし <br> The 47 Ronin
The 47 Ronin	<b>四十七士<b> <br> しじゅうしちし <br>[sound:k-0468_四十七士.mp3]
[sound:k-0468_四十七士.mp3]	The 47 Ronin<br> <b>四十七士</b> <br> (しじゅうしちし)
<b>進路</b> <br> 彼女は進路について悩んでいます。	[sound:s-0468_彼女は進路について悩んでいます。.mp3] <br> かのじょはしんろについてなやんでいます。 <br>She is worried about her future path.
[sound:s-0468_彼女は進路について悩んでいます。.mp3]	<b>進路</b> <br> 彼女は進路について悩んでいます。<br> かのじょはしんろについてなやんでいます <br>She is worried about her future path.
四半期	[sound:k-0469_四半期.mp3]<br>しはんき <br> quarter (of a year)
quarter (of a year)	<b>四半期<b> <br> しはんき <br>[sound:k-0469_四半期.mp3]
[sound:k-0469_四半期.mp3]	quarter<br> <b>of a year) (四半期</b> <br> (しはんき)
<b>前進</b> <br> チームは試合での勝利に向けて前進しています。	[sound:s-0469_チームは試合での勝利に向けて前進しています。.mp3] <br> ちーむはしあいでのしょうりにむけてぜんしんしています。 <br>The team is advancing toward victory in the match.
[sound:s-0469_チームは試合での勝利に向けて前進しています。.mp3]	<b>前進</b> <br> チームは試合での勝利に向けて前進しています。<br> ちーむはしあいでのしょうりにむけてぜんしんしています <br>The team is advancing toward victory in the match.
協定	[sound:k-0470_協定.mp3]<br>きょうてい <br> arrangement, pact, agreement
arrangement, pact, agreement	<b>協定<b> <br> きょうてい <br>[sound:k-0470_協定.mp3]
[sound:k-0470_協定.mp3]	arrangement, pact, agreement<br> <b>協定</b> <br> (きょうてい)
<b>昇進</b> <br> 彼女は昨日、昇進の通知を受け取りました。	[sound:s-0470_彼女は昨日、昇進の通知を受け取りました。.mp3] <br> かのじょはきのう、しょうしんのつうちをうけとりました。 <br>She received a promotion notice yesterday.
[sound:s-0470_彼女は昨日、昇進の通知を受け取りました。.mp3]	<b>昇進</b> <br> 彼女は昨日、昇進の通知を受け取りました。<br> かのじょはきのう、しょうしんのつうちをうけとりました <br>She received a promotion notice yesterday.
決定	[sound:k-0471_決定.mp3]<br>けってい <br> decision, determination
decision, determination	<b>決定<b> <br> けってい <br>[sound:k-0471_決定.mp3]
[sound:k-0471_決定.mp3]	decision, determination<br> <b>決定</b> <br> (けってい)
<b>正</b> <br> 彼の行動は正しいとは限りません。	[sound:s-0471_彼の行動は正しいとは限りません。.mp3] <br> かれのこうどうはただしいとはかぎりません。 <br>His actions are not necessarily right.
[sound:s-0471_彼の行動は正しいとは限りません。.mp3]	<b>正</b> <br> 彼の行動は正しいとは限りません。<br> かれのこうどうはただしいとはかぎりません <br>His actions are not necessarily right.
予定	[sound:k-0472_予定.mp3]<br>よてい <br> plans, arrangement, schedule, program, programme, expectation, estimate
plans, arrangement, schedule, program, programme, expectation, estimate	<b>予定<b> <br> よてい <br>[sound:k-0472_予定.mp3]
[sound:k-0472_予定.mp3]	plans, arrangement, schedule, program, programme, expectation, estimate<br> <b>予定</b> <br> (よてい)
<b>改正</b> <br> 法律が改正されました。	[sound:s-0472_法律が改正されました。.mp3] <br> ほうりつがかいせいされました。 <br>The law has been amended.
[sound:s-0472_法律が改正されました。.mp3]	<b>改正</b> <br> 法律が改正されました。<br> ほうりつがかいせいされました <br>The law has been amended.
安定	[sound:k-0473_安定.mp3]<br>あんてい <br> stability, equilibrium
stability, equilibrium	<b>安定<b> <br> あんてい <br>[sound:k-0473_安定.mp3]
[sound:k-0473_安定.mp3]	stability, equilibrium<br> <b>安定</b> <br> (あんてい)
<b>修正</b> <br> その誤りを修正する必要があります。	[sound:s-0473_その誤りを修正する必要があります。.mp3] <br> そのあやまりをしゅうせいするひつようがあります。 <br>The mistake needs to be corrected.
[sound:s-0473_その誤りを修正する必要があります。.mp3]	<b>修正</b> <br> その誤りを修正する必要があります。<br> そのあやまりをしゅうせいするひつようがあります <br>The mistake needs to be corrected.
暫定	[sound:k-0474_暫定.mp3]<br>ざんてい <br> tentative, temporary
tentative, temporary	<b>暫定<b> <br> ざんてい <br>[sound:k-0474_暫定.mp3]
[sound:k-0474_暫定.mp3]	tentative, temporary<br> <b>暫定</b> <br> (ざんてい)
<b>正式</b> <br> 彼は正式な謝罪を行いました。	[sound:s-0474_彼は正式な謝罪を行いました。.mp3] <br> かれはせいしきなしゃざいをおこないました。 <br>He made a formal apology.
[sound:s-0474_彼は正式な謝罪を行いました。.mp3]	<b>正式</b> <br> 彼は正式な謝罪を行いました。<br> かれはせいしきなしゃざいをおこないました <br>He made a formal apology.
定数	[sound:k-0475_定数.mp3]<br>ていすう <br> constant; literal
constant; literal	<b>定数<b> <br> ていすう <br>[sound:k-0475_定数.mp3]
[sound:k-0475_定数.mp3]	constant; literal<br> <b>定数</b> <br> (ていすう)
<b>正常</b> <br> 機械が正常に作動しています。	[sound:s-0475_機械が正常に作動しています。.mp3] <br> きかいがせいじょうにさどうしています。 <br>The machine is operating normally.
[sound:s-0475_機械が正常に作動しています。.mp3]	<b>正常</b> <br> 機械が正常に作動しています。<br> きかいがせいじょうにさどうしています <br>The machine is operating normally.
一定	[sound:k-0476_一定.mp3]<br>いってい, いちじょう <br> fixed, settled, constant, definite, uniform, regularized, regularised, defined, standardized, standardised, certain, prescribed
fixed, settled, constant, definite, uniform, regularized, regularised, defined, standardized, standardised, certain, prescribed	<b>一定<b> <br> いってい, いちじょう <br>[sound:k-0476_一定.mp3]
[sound:k-0476_一定.mp3]	fixed, settled, constant, definite, uniform, regularized, regularised, defined, standardized, standardised, certain, prescribed<br> <b>一定</b> <br> (いってい, いちじょう)
<b>是正</b> <br> その問題を是正する必要があります。	[sound:s-0476_その問題を是正する必要があります。.mp3] <br> そのもんだいをぜせいするひつようがあります。 <br>The problem needs to be corrected.
[sound:s-0476_その問題を是正する必要があります。.mp3]	<b>是正</b> <br> その問題を是正する必要があります。<br> そのもんだいをぜせいするひつようがあります <br>The problem needs to be corrected.
規定	[sound:k-0477_規定.mp3]<br>きてい <br> regulation, provisions
regulation, provisions	<b>規定<b> <br> きてい <br>[sound:k-0477_規定.mp3]
[sound:k-0477_規定.mp3]	regulation, provisions<br> <b>規定</b> <br> (きてい)
<b>正義</b> <br> 公正な判決が下されました。	[sound:s-0477_公正な判決が下されました。.mp3] <br> こうせいなはんけつがくだされました。 <br>A just verdict was reached.
[sound:s-0477_公正な判決が下されました。.mp3]	<b>正義</b> <br> 公正な判決が下されました。<br> こうせいなはんけつがくだされました <br>A just verdict was reached.
指定	[sound:k-0478_指定.mp3]<br>してい <br> designation, specification, assignment, appointment, pointing at
designation, specification, assignment, appointment, pointing at	<b>指定<b> <br> してい <br>[sound:k-0478_指定.mp3]
[sound:k-0478_指定.mp3]	designation, specification, assignment, appointment, pointing at<br> <b>指定</b> <br> (してい)
<b>正午</b> <br> 今日の正午に会議があります。	[sound:s-0478_今日の正午に会議があります。.mp3] <br> きょうのしょうごにかいぎがあります。 <br>There is a meeting at noon today.
[sound:s-0478_今日の正午に会議があります。.mp3]	<b>正午</b> <br> 今日の正午に会議があります。<br> きょうのしょうごにかいぎがあります <br>There is a meeting at noon today.
定期	[sound:k-0479_定期.mp3]<br>ていき <br> fixed term; fixed-term commutation pass; fixed-term deposit
fixed term; fixed-term commutation pass; fixed-term deposit	<b>定期<b> <br> ていき <br>[sound:k-0479_定期.mp3]
[sound:k-0479_定期.mp3]	fixed term; fixed-term commutation pass; fixed-term deposit<br> <b>定期</b> <br> (ていき)
<b>正面</b> <br> 彼女は正面から問題に取り組みました。	[sound:s-0479_彼女は正面から問題に取り組みました。.mp3] <br> かのじょはしょうめんからもんだいにとりくみました。 <br>She addressed the issue head-on.
[sound:s-0479_彼女は正面から問題に取り組みました。.mp3]	<b>正面</b> <br> 彼女は正面から問題に取り組みました。<br> かのじょはしょうめんからもんだいにとりくみました <br>She addressed the issue head-on.
今	[sound:k-0480_今.mp3]<br>いま <br> now, the present time, just now, soon, immediately, (one) more
now, the present time, just now, soon, immediately, (one) more	<b>今<b> <br> いま <br>[sound:k-0480_今.mp3]
[sound:k-0480_今.mp3]	now, the present time, just now, soon, immediately,<br> <b>one) more (今</b> <br> (いま)
<b>不正</b> <br> その行為は不正だとされました。	[sound:s-0480_その行為は不正だとされました。.mp3] <br> そのこういはふせいだとされました。 <br>The act was deemed unethical.
[sound:s-0480_その行為は不正だとされました。.mp3]	<b>不正</b> <br> その行為は不正だとされました。<br> そのこういはふせいだとされました <br>The act was deemed unethical.
今や	[sound:k-0481_今や.mp3]<br>いまや <br> now
now	<b>今や<b> <br> いまや <br>[sound:k-0481_今や.mp3]
[sound:k-0481_今や.mp3]	now<br> <b>今や</b> <br> (いまや)
<b>安全</b> <br> 安全が最優先です。	[sound:s-0481_安全が最優先です。.mp3] <br> あんぜんがさいゆうせんです。 <br>Safety is the top priority.
[sound:s-0481_安全が最優先です。.mp3]	<b>安全</b> <br> 安全が最優先です。<br> あんぜんがさいゆうせんです <br>Safety is the top priority.
今回	[sound:k-0482_今回.mp3]<br>こんかい <br> now, this time, lately
now, this time, lately	<b>今回<b> <br> こんかい <br>[sound:k-0482_今回.mp3]
[sound:k-0482_今回.mp3]	now, this time, lately<br> <b>今回</b> <br> (こんかい)
<b>安保</b> <br> その国は安保政策を強化しています。	[sound:s-0482_その国は安保政策を強化しています。.mp3] <br> そのくにはあんぽせいさくをきょうかしています。 <br>The country is strengthening its security policy.
[sound:s-0482_その国は安保政策を強化しています。.mp3]	<b>安保</b> <br> その国は安保政策を強化しています。<br> そのくにはあんぽせいさくをきょうかしています <br>The country is strengthening its security policy.
今月	[sound:k-0483_今月.mp3]<br>こんげつ <br> this month
this month	<b>今月<b> <br> こんげつ <br>[sound:k-0483_今月.mp3]
[sound:k-0483_今月.mp3]	this month<br> <b>今月</b> <br> (こんげつ)
<b>安全保障</b> <br> その条約は地域の安全保障を確保します。	[sound:s-0483_その条約は地域の安全保障を確保します。.mp3] <br> そのじょうやくはちいきのあんぜんほしょうをかくほします。 <br>The treaty ensures regional security.
[sound:s-0483_その条約は地域の安全保障を確保します。.mp3]	<b>安全保障</b> <br> その条約は地域の安全保障を確保します。<br> そのじょうやくはちいきのあんぜんほしょうをかくほします <br>The treaty ensures regional security.
今後	[sound:k-0484_今後.mp3]<br>こんご <br> from now on, hereafter
from now on, hereafter	<b>今後<b> <br> こんご <br>[sound:k-0484_今後.mp3]
[sound:k-0484_今後.mp3]	from now on, hereafter<br> <b>今後</b> <br> (こんご)
<b>安定</b> <br> その市場は安定しています。	[sound:s-0484_その市場は安定しています。.mp3] <br> そのしじょうはあんていしています。 <br>The market is stable.
[sound:s-0484_その市場は安定しています。.mp3]	<b>安定</b> <br> その市場は安定しています。<br> そのしじょうはあんていしています <br>The market is stable.
今年	[sound:k-0485_今年.mp3]<br>ことし, こんねん <br> this year
this year	<b>今年<b> <br> ことし, こんねん <br>[sound:k-0485_今年.mp3]
[sound:k-0485_今年.mp3]	this year<br> <b>今年</b> <br> (ことし, こんねん)
<b>不安</b> <br> 彼は将来について不安に感じています。	[sound:s-0485_彼は将来について不安に感じています。.mp3] <br> かれはしょうらいについてふあんにかんじています。 <br>He feels anxious about the future.
[sound:s-0485_彼は将来について不安に感じています。.mp3]	<b>不安</b> <br> 彼は将来について不安に感じています。<br> かれはしょうらいについてふあんにかんじています <br>He feels anxious about the future.
今度	[sound:k-0486_今度.mp3]<br>こんど <br> now, this time, next time, another time
now, this time, next time, another time	<b>今度<b> <br> こんど <br>[sound:k-0486_今度.mp3]
[sound:k-0486_今度.mp3]	now, this time, next time, another time<br> <b>今度</b> <br> (こんど)
<b>慰安</b> <br> 戦地での慰安施設が設置されました。	[sound:s-0486_戦地での慰安施設が設置されました。.mp3] <br> せんちでのいあんしせつがせっちされました。 <br>Comfort facilities were established in the war zone.
[sound:s-0486_戦地での慰安施設が設置されました。.mp3]	<b>慰安</b> <br> 戦地での慰安施設が設置されました。<br> せんちでのいあんしせつがせっちされました <br>Comfort facilities were established in the war zone.
今日	[sound:k-0487_今日.mp3]<br>こんにち, きょう, こんち, こんじつ <br> today, this day
today, this day	<b>今日<b> <br> こんにち, きょう, こんち, こんじつ <br>[sound:k-0487_今日.mp3]
[sound:k-0487_今日.mp3]	today, this day<br> <b>今日</b> <br> (こんにち, きょう, こんち, こんじつ)
<b>安打</b> <br> 彼は安打を放ちました。	[sound:s-0487_彼は安打を放ちました。.mp3] <br> かれはあんだをはなちました。 <br>He hit a safe hit.
[sound:s-0487_彼は安打を放ちました。.mp3]	<b>安打</b> <br> 彼は安打を放ちました。<br> かれはあんだをはなちました <br>He hit a safe hit.
今季	[sound:k-0488_今季.mp3]<br>こんき <br> this season
this season	<b>今季<b> <br> こんき <br>[sound:k-0488_今季.mp3]
[sound:k-0488_今季.mp3]	this season<br> <b>今季</b> <br> (こんき)
<b>治安</b> <br> この地域の治安は良好です。	[sound:s-0488_この地域の治安は良好です。.mp3] <br> このちいきのちあんはりょうこうです。 <br>The public order in this area is good.
[sound:s-0488_この地域の治安は良好です。.mp3]	<b>治安</b> <br> この地域の治安は良好です。<br> このちいきのちあんはりょうこうです <br>The public order in this area is good.
今春	[sound:k-0489_今春.mp3]<br>こんしゅん <br> this spring, spring this year
this spring, spring this year	<b>今春<b> <br> こんしゅん <br>[sound:k-0489_今春.mp3]
[sound:k-0489_今春.mp3]	this spring, spring this year<br> <b>今春</b> <br> (こんしゅん)
<b>安心</b> <br> 彼女は彼の安心を感じました。	[sound:s-0489_彼女は彼の安心を感じました。.mp3] <br> かのじょはかれのあんしんをかんじました。 <br>She felt relieved by his assurance.
[sound:s-0489_彼女は彼の安心を感じました。.mp3]	<b>安心</b> <br> 彼女は彼の安心を感じました。<br> かのじょはかれのあんしんをかんじました <br>She felt relieved by his assurance.
回	[sound:k-0490_回.mp3]<br>かい <br> counter for occurrences; counter for innings (baseball)
counter for occurrences; counter for innings (baseball)	<b>回<b> <br> かい <br>[sound:k-0490_回.mp3]
[sound:k-0490_回.mp3]	counter for occurrences; counter for innings<br> <b>baseball) (回</b> <br> (かい)
<b>不安定</b> <br> その地域は経済的に不安定です。	[sound:s-0490_その地域は経済的に不安定です。.mp3] <br> そのちいきはけいざいてきにふあんていです。 <br>The region is economically unstable.
[sound:s-0490_その地域は経済的に不安定です。.mp3]	<b>不安定</b> <br> その地域は経済的に不安定です。<br> そのちいきはけいざいてきにふあんていです <br>The region is economically unstable.
回復	[sound:k-0491_回復.mp3]<br>かいふく <br> recovery (from illness), improvement, rehabilitation, restoration, convalescence
recovery (from illness), improvement, rehabilitation, restoration, convalescence	<b>回復<b> <br> かいふく <br>[sound:k-0491_回復.mp3]
[sound:k-0491_回復.mp3]	recovery<br> <b>from illness), improvement, rehabilitation, restoration, convalescence (回復</b> <br> (かいふく)
<b>建設</b> <br> そのプロジェクトは新しい学校の建設を含んでいます。	[sound:s-0491_そのプロジェクトは新しい学校の建設を含んでいます。.mp3] <br> そのぷろじぇくとはあたらしいがっこうのけんせつをふくんでいます。 <br>The project includes the construction of a new school.
[sound:s-0491_そのプロジェクトは新しい学校の建設を含んでいます。.mp3]	<b>建設</b> <br> そのプロジェクトは新しい学校の建設を含んでいます。<br> そのぷろじぇくとはあたらしいがっこうのけんせつをふくんでいます <br>The project includes the construction of a new school.
今回	[sound:k-0492_今回.mp3]<br>こんかい <br> now, this time, lately
now, this time, lately	<b>今回<b> <br> こんかい <br>[sound:k-0492_今回.mp3]
[sound:k-0492_今回.mp3]	now, this time, lately<br> <b>今回</b> <br> (こんかい)
<b>施設</b> <br> この施設は公共のものです。	[sound:s-0492_この施設は公共のものです。.mp3] <br> このしせつはこうきょうのものです。 <br>This facility is public.
[sound:s-0492_この施設は公共のものです。.mp3]	<b>施設</b> <br> この施設は公共のものです。<br> このしせつはこうきょうのものです <br>This facility is public.
回答	[sound:k-0493_回答.mp3]<br>かいとう <br> reply, answer
reply, answer	<b>回答<b> <br> かいとう <br>[sound:k-0493_回答.mp3]
[sound:k-0493_回答.mp3]	reply, answer<br> <b>回答</b> <br> (かいとう)
<b>設置</b> <br> その街に新しい遊び場が設置されました。	[sound:s-0493_その街に新しい遊び場が設置されました。.mp3] <br> そのまちにあたらしいあそびばがせっちされました。 <br>A new playground was installed in the town.
[sound:s-0493_その街に新しい遊び場が設置されました。.mp3]	<b>設置</b> <br> その街に新しい遊び場が設置されました。<br> そのまちにあたらしいあそびばがせっちされました <br>A new playground was installed in the town.
前回	[sound:k-0494_前回.mp3]<br>ぜんかい <br> last time, last installment, last instalment, last session
last time, last installment, last instalment, last session	<b>前回<b> <br> ぜんかい <br>[sound:k-0494_前回.mp3]
[sound:k-0494_前回.mp3]	last time, last installment, last instalment, last session<br> <b>前回</b> <br> (ぜんかい)
<b>設備</b> <br> この施設は最新の設備を備えています。	[sound:s-0494_この施設は最新の設備を備えています。.mp3] <br> このしせつはさいしんのせつびをそなえています。 <br>This facility is equipped with state-of-the-art facilities.
[sound:s-0494_この施設は最新の設備を備えています。.mp3]	<b>設備</b> <br> この施設は最新の設備を備えています。<br> このしせつはさいしんのせつびをそなえています <br>This facility is equipped with state-of-the-art facilities.
回戦	[sound:k-0495_回戦.mp3]<br>かいせん <br> match, game
match, game	<b>回戦<b> <br> かいせん <br>[sound:k-0495_回戦.mp3]
[sound:k-0495_回戦.mp3]	match, game<br> <b>回戦</b> <br> (かいせん)
<b>設計</b> <br> この建物の設計は非常にモダンです。	[sound:s-0495_この建物の設計は非常にモダンです。.mp3] <br> このたてもののせっけいはひじょうにモダンです。 <br>The design of this building is very modern.
[sound:s-0495_この建物の設計は非常にモダンです。.mp3]	<b>設計</b> <br> この建物の設計は非常にモダンです。<br> このたてもののせっけいはひじょうにモダンです <br>The design of this building is very modern.
一回	[sound:k-0496_一回.mp3]<br>いっかい <br> once, one time, one round, one game, one bout, one heat, one inning
once, one time, one round, one game, one bout, one heat, one inning	<b>一回<b> <br> いっかい <br>[sound:k-0496_一回.mp3]
[sound:k-0496_一回.mp3]	once, one time, one round, one game, one bout, one heat, one inning<br> <b>一回</b> <br> (いっかい)
<b>設立</b> <br> 彼は新しい会社を設立しました。	[sound:s-0496_彼は新しい会社を設立しました。.mp3] <br> かれはあたらしいかいしゃをせつりつしました。 <br>He established a new company.
[sound:s-0496_彼は新しい会社を設立しました。.mp3]	<b>設立</b> <br> 彼は新しい会社を設立しました。<br> かれはあたらしいかいしゃをせつりつしました <br>He established a new company.
回収	[sound:k-0497_回収.mp3]<br>かいしゅう <br> collection, recovery
collection, recovery	<b>回収<b> <br> かいしゅう <br>[sound:k-0497_回収.mp3]
[sound:k-0497_回収.mp3]	collection, recovery<br> <b>回収</b> <br> (かいしゅう)
<b>設定</b> <br> 彼は目標を達成するために計画を設定しました。	[sound:s-0497_彼は目標を達成するために計画を設定しました。.mp3] <br> かれはもくひょうをたっせいするためにけいかくをせっていしました。 <br>He set up a plan to achieve the goal.
[sound:s-0497_彼は目標を達成するために計画を設定しました。.mp3]	<b>設定</b> <br> 彼は目標を達成するために計画を設定しました。<br> かれはもくひょうをたっせいするためにけいかくをせっていしました <br>He set up a plan to achieve the goal.
回数	[sound:k-0498_回数.mp3]<br>かいすう <br> number of times, frequency, count
number of times, frequency, count	<b>回数<b> <br> かいすう <br>[sound:k-0498_回数.mp3]
[sound:k-0498_回数.mp3]	number of times, frequency, count<br> <b>回数</b> <br> (かいすう)
<b>創設</b> <br> その慈善団体は数十年前に創設されました。	[sound:s-0498_その慈善団体は数十年前に創設されました。.mp3] <br> そのじぜんだんたいはすうじゅうねんまえにそうせつされました。 <br>The charity organization was founded several decades ago.
[sound:s-0498_その慈善団体は数十年前に創設されました。.mp3]	<b>創設</b> <br> その慈善団体は数十年前に創設されました。<br> そのじぜんだんたいはすうじゅうねんまえにそうせつされました <br>The charity organization was founded several decades ago.
次回	[sound:k-0499_次回.mp3]<br>じかい <br> next time (occasion)
next time (occasion)	<b>次回<b> <br> じかい <br>[sound:k-0499_次回.mp3]
[sound:k-0499_次回.mp3]	next time<br> <b>occasion) (次回</b> <br> (じかい)
<b>建設省</b> <br> 建設省は新しい橋の建設を計画しています。	[sound:s-0499_建設省は新しい橋の建設を計画しています。.mp3] <br> けんせつしょうはあたらしいはしのけんせつをけいかくしています。 <br>The Ministry of Construction is planning to build a new bridge.
[sound:s-0499_建設省は新しい橋の建設を計画しています。.mp3]	<b>建設省</b> <br> 建設省は新しい橋の建設を計画しています。<br> けんせつしょうはあたらしいはしのけんせつをけいかくしています <br>The Ministry of Construction is planning to build a new bridge.
新た	[sound:k-0500_新た.mp3]<br>あらた <br> new, fresh, novel; newly, freshly, re-
new, fresh, novel; newly, freshly, re-	<b>新た<b> <br> あらた <br>[sound:k-0500_新た.mp3]
[sound:k-0500_新た.mp3]	new, fresh, novel; newly, freshly, re-<br> <b>新た</b> <br> (あらた)
<b>開設</b> <br> 彼は新しい店舗を開設しました。	[sound:s-0500_彼は新しい店舗を開設しました。.mp3] <br> かれはあたらしいてんぽをかいせつしました。 <br>He opened a new store.
[sound:s-0500_彼は新しい店舗を開設しました。.mp3]	<b>開設</b> <br> 彼は新しい店舗を開設しました。<br> かれはあたらしいてんぽをかいせつしました <br>He opened a new store.
新党	[sound:k-0501_新党.mp3]<br>しんとう <br> new (political) party
new (political) party	<b>新党<b> <br> しんとう <br>[sound:k-0501_新党.mp3]
[sound:k-0501_新党.mp3]	new<br> <b>political) party (新党</b> <br> (しんとう)
<b>保する</b> <br> 安全を保するために必要な対策を講じています。	[sound:s-0501_安全を保するために必要な対策を講じています。.mp3] <br> あんぜんをほするためにひつようなたいさくをこうじています。 <br>Necessary measures are being taken to ensure safety.
[sound:s-0501_安全を保するために必要な対策を講じています。.mp3]	<b>保する</b> <br> 安全を保するために必要な対策を講じています。<br> あんぜんをほするためにひつようなたいさくをこうじています <br>Necessary measures are being taken to ensure safety.
新聞	[sound:k-0502_新聞.mp3]<br>しんぶん <br> newspaper
newspaper	<b>新聞<b> <br> しんぶん <br>[sound:k-0502_新聞.mp3]
[sound:k-0502_新聞.mp3]	newspaper<br> <b>新聞</b> <br> (しんぶん)
<b>安保</b> <br> その国は安保政策を強化しています。	[sound:s-0502_その国は安保政策を強化しています。.mp3] <br> そのくにはあんぽせいさくをきょうかしています。 <br>The country is strengthening its security policy.
[sound:s-0502_その国は安保政策を強化しています。.mp3]	<b>安保</b> <br> その国は安保政策を強化しています。<br> そのくにはあんぽせいさくをきょうかしています <br>The country is strengthening its security policy.
新人	[sound:k-0503_新人.mp3]<br>しんじん <br> new face, newcomer; modern humans (from Cro-Magnon man onwards)
new face, newcomer; modern humans (from Cro-Magnon man onwards)	<b>新人<b> <br> しんじん <br>[sound:k-0503_新人.mp3]
[sound:k-0503_新人.mp3]	new face, newcomer; modern humans<br> <b>from Cro-Magnon man onwards) (新人</b> <br> (しんじん)
<b>保護</b> <br> 子供たちの保護が最優先です。	[sound:s-0503_子供たちの保護が最優先です。.mp3] <br> こどもたちのほごがさいゆうせんです。 <br>Protecting children is the top priority.
[sound:s-0503_子供たちの保護が最優先です。.mp3]	<b>保護</b> <br> 子供たちの保護が最優先です。<br> こどもたちのほごがさいゆうせんです <br>Protecting children is the top priority.
新生	[sound:k-0504_新生.mp3]<br>しんせい <br> rebirth, new birth, nascent
rebirth, new birth, nascent	<b>新生<b> <br> しんせい <br>[sound:k-0504_新生.mp3]
[sound:k-0504_新生.mp3]	rebirth, new birth, nascent<br> <b>新生</b> <br> (しんせい)
<b>安全保障</b> <br> その条約は地域の安全保障を確保します。	[sound:s-0504_その条約は地域の安全保障を確保します。.mp3] <br> そのじょうやくはちいきのあんぜんほしょうをかくほします。 <br>The treaty ensures regional security.
[sound:s-0504_その条約は地域の安全保障を確保します。.mp3]	<b>安全保障</b> <br> その条約は地域の安全保障を確保します。<br> そのじょうやくはちいきのあんぜんほしょうをかくほします <br>The treaty ensures regional security.
新しい	[sound:k-0505_新しい.mp3]<br>あたらしい <br> new
new	<b>新しい<b> <br> あたらしい <br>[sound:k-0505_新しい.mp3]
[sound:k-0505_新しい.mp3]	new<br> <b>新しい</b> <br> (あたらしい)
<b>確保</b> <br> 資料の安全を確保するためにセキュリティを強化しました。	[sound:s-0505_資料の安全を確保するためにセキュリティを強化しました。.mp3] <br> しりょうのあんぜんをかくほするためにせきゅりてぃをきょうかしました。 <br>Security has been strengthened to ensure the safety of the documents.
[sound:s-0505_資料の安全を確保するためにセキュリティを強化しました。.mp3]	<b>確保</b> <br> 資料の安全を確保するためにセキュリティを強化しました。<br> しりょうのあんぜんをかくほするためにせきゅりてぃをきょうかしました <br>Security has been strengthened to ensure the safety of the documents.
新幹線	[sound:k-0506_新幹線.mp3]<br>しんかんせん <br> bullet train (very high speed), Shinkansen
bullet train (very high speed), Shinkansen	<b>新幹線<b> <br> しんかんせん <br>[sound:k-0506_新幹線.mp3]
[sound:k-0506_新幹線.mp3]	bullet train<br> <b>very high speed), Shinkansen (新幹線</b> <br> (しんかんせん)
<b>保険</b> <br> 保険に加入することは重要です。	[sound:s-0506_保険に加入することは重要です。.mp3] <br> ほけんにかにゅうすることはじゅうようです。 <br>It is important to enroll in insurance.
[sound:s-0506_保険に加入することは重要です。.mp3]	<b>保険</b> <br> 保険に加入することは重要です。<br> ほけんにかにゅうすることはじゅうようです <br>It is important to enroll in insurance.
革新	[sound:k-0507_革新.mp3]<br>かくしん <br> reform, innovation
reform, innovation	<b>革新<b> <br> かくしん <br>[sound:k-0507_革新.mp3]
[sound:k-0507_革新.mp3]	reform, innovation<br> <b>革新</b> <br> (かくしん)
<b>保守</b> <br> 彼は保守的な考え方を持っています。	[sound:s-0507_彼は保守的な考え方を持っています。.mp3] <br> かれはほしゅてきなかんがえかたをもっています。 <br>He has conservative views.
[sound:s-0507_彼は保守的な考え方を持っています。.mp3]	<b>保守</b> <br> 彼は保守的な考え方を持っています。<br> かれはほしゅてきなかんがえかたをもっています <br>He has conservative views.
最新	[sound:k-0508_最新.mp3]<br>さいしん <br> latest, newest, late-breaking (news)
latest, newest, late-breaking (news)	<b>最新<b> <br> さいしん <br>[sound:k-0508_最新.mp3]
[sound:k-0508_最新.mp3]	latest, newest, late-breaking<br> <b>news) (最新</b> <br> (さいしん)
<b>保全</b> <br> その動物園は絶滅危惧種の保全活動を行っています。	[sound:s-0508_その動物園は絶滅危惧種の保全活動を行っています。.mp3] <br> そのどうぶつえんはぜつめつきぐしゅのほぜんかつどうをおこなっています。 <br>The zoo is engaged in conservation efforts for endangered species.
[sound:s-0508_その動物園は絶滅危惧種の保全活動を行っています。.mp3]	<b>保全</b> <br> その動物園は絶滅危惧種の保全活動を行っています。<br> そのどうぶつえんはぜつめつきぐしゅのほぜんかつどうをおこなっています <br>The zoo is engaged in conservation efforts for endangered species.
新規	[sound:k-0509_新規.mp3]<br>しんき <br> new, fresh; new customer; new rules or regulations
new, fresh; new customer; new rules or regulations	<b>新規<b> <br> しんき <br>[sound:k-0509_新規.mp3]
[sound:k-0509_新規.mp3]	new, fresh; new customer; new rules or regulations<br> <b>新規</b> <br> (しんき)
<b>保証</b> <br> 購入者に製品の品質を保証します。	[sound:s-0509_購入者に製品の品質を保証します。.mp3] <br> こうにゅうしゃにせいひんのひんしつをほしょうします。 <br>The quality of the product is guaranteed to the buyer.
[sound:s-0509_購入者に製品の品質を保証します。.mp3]	<b>保証</b> <br> 購入者に製品の品質を保証します。<br> こうにゅうしゃにせいひんのひんしつをほしょうします <br>The quality of the product is guaranteed to the buyer.
現場	[sound:k-0510_現場.mp3]<br>げんば, げんじょう <br> actual spot, scene, scene of the crime
actual spot, scene, scene of the crime	<b>現場<b> <br> げんば, げんじょう <br>[sound:k-0510_現場.mp3]
[sound:k-0510_現場.mp3]	actual spot, scene, scene of the crime<br> <b>現場</b> <br> (げんば, げんじょう)
<b>担保</b> <br> 彼はローンのために家を担保にしました。	[sound:s-0510_彼はローンのために家を担保にしました。.mp3] <br> かれはろーんのためにいえをたんぽにしました。 <br>He used his house as collateral for the loan.
[sound:s-0510_彼はローンのために家を担保にしました。.mp3]	<b>担保</b> <br> 彼はローンのために家を担保にしました。<br> かれはろーんのためにいえをたんぽにしました <br>He used his house as collateral for the loan.
市場	[sound:k-0511_市場.mp3]<br>いちば <br> (town) market; (the) marketplace
(town) market; (the) marketplace	<b>市場<b> <br> いちば <br>[sound:k-0511_市場.mp3]
[sound:k-0511_市場.mp3]	(town) market;<br> <b>the) marketplace (市場</b> <br> (いちば)
<b>改革</b> <br> その政府は教育制度の改革を進めています。	[sound:s-0511_その政府は教育制度の改革を進めています。.mp3] <br> そのせいふはきょういくせいどのかいかくをすすめています。 <br>The government is pushing forward with education system reforms.
[sound:s-0511_その政府は教育制度の改革を進めています。.mp3]	<b>改革</b> <br> その政府は教育制度の改革を進めています。<br> そのせいふはきょういくせいどのかいかくをすすめています <br>The government is pushing forward with education system reforms.
場所	[sound:k-0512_場所.mp3]<br>ばしょ <br> place, location
place, location	<b>場所<b> <br> ばしょ <br>[sound:k-0512_場所.mp3]
[sound:k-0512_場所.mp3]	place, location<br> <b>場所</b> <br> (ばしょ)
<b>改正</b> <br> 法律が改正されました。	[sound:s-0512_法律が改正されました。.mp3] <br> ほうりつがかいせいされました。 <br>The law has been amended.
[sound:s-0512_法律が改正されました。.mp3]	<b>改正</b> <br> 法律が改正されました。<br> ほうりつがかいせいされました <br>The law has been amended.
立場	[sound:k-0513_立場.mp3]<br>たちば <br> standpoint, position, situation
standpoint, position, situation	<b>立場<b> <br> たちば <br>[sound:k-0513_立場.mp3]
[sound:k-0513_立場.mp3]	standpoint, position, situation<br> <b>立場</b> <br> (たちば)
<b>改善</b> <br> 彼はサービスの改善に取り組んでいます。	[sound:s-0513_彼はサービスの改善に取り組んでいます。.mp3] <br> かれはさーびすのかいぜんにとりくんでいます。 <br>He is working on improving the service.
[sound:s-0513_彼はサービスの改善に取り組んでいます。.mp3]	<b>改善</b> <br> 彼はサービスの改善に取り組んでいます。<br> かれはさーびすのかいぜんにとりくんでいます <br>He is working on improving the service.
工場	[sound:k-0514_工場.mp3]<br>こうじょう, こうば <br> factory, plant, mill, workshop
factory, plant, mill, workshop	<b>工場<b> <br> こうじょう, こうば <br>[sound:k-0514_工場.mp3]
[sound:k-0514_工場.mp3]	factory, plant, mill, workshop<br> <b>工場</b> <br> (こうじょう, こうば)
<b>改造</b> <br> 彼は古い家を改造してホテルにした。	[sound:s-0514_彼は古い家を改造してホテルにした。.mp3] <br> かれはふるいいえをかいぞうしてほてるにした。 <br>He converted an old house into a hotel.
[sound:s-0514_彼は古い家を改造してホテルにした。.mp3]	<b>改造</b> <br> 彼は古い家を改造してホテルにした。<br> かれはふるいいえをかいぞうしてほてるにした <br>He converted an old house into a hotel.
会場	[sound:k-0515_会場.mp3]<br>かいじょう <br> assembly hall, meeting place, the grounds
assembly hall, meeting place, the grounds	<b>会場<b> <br> かいじょう <br>[sound:k-0515_会場.mp3]
[sound:k-0515_会場.mp3]	assembly hall, meeting place, the grounds<br> <b>会場</b> <br> (かいじょう)
<b>改める</b> <br> 彼は態度を改めました。	[sound:s-0515_彼は態度を改めました。.mp3] <br> かれはたいどをあらためました。 <br>He changed his attitude.
[sound:s-0515_彼は態度を改めました。.mp3]	<b>改める</b> <br> 彼は態度を改めました。<br> かれはたいどをあらためました <br>He changed his attitude.
劇場	[sound:k-0516_劇場.mp3]<br>げきじょう <br> theatre, theater, playhouse
theatre, theater, playhouse	<b>劇場<b> <br> げきじょう <br>[sound:k-0516_劇場.mp3]
[sound:k-0516_劇場.mp3]	theatre, theater, playhouse<br> <b>劇場</b> <br> (げきじょう)
<b>改定</b> <br> その計画は改定されました。	[sound:s-0516_その計画は改定されました。.mp3] <br> そのけいかくはかいていされました。 <br>The plan has been revised.
[sound:s-0516_その計画は改定されました。.mp3]	<b>改定</b> <br> その計画は改定されました。<br> そのけいかくはかいていされました <br>The plan has been revised.
出場	[sound:k-0517_出場.mp3]<br>しゅつじょう <br> (stage) appearance, participation, performance
(stage) appearance, participation, performance	<b>出場<b> <br> しゅつじょう <br>[sound:k-0517_出場.mp3]
[sound:k-0517_出場.mp3]	(stage) appearance, participation, performance<br> <b>出場</b> <br> (しゅつじょう)
<b>改憲</b> <br> 政府は憲法の改憲を検討しています。	[sound:s-0517_政府は憲法の改憲を検討しています。.mp3] <br> せいふはけんぽうのかいけんをけんとうしています。 <br>The government is considering an amendment to the constitution.
[sound:s-0517_政府は憲法の改憲を検討しています。.mp3]	<b>改憲</b> <br> 政府は憲法の改憲を検討しています。<br> せいふはけんぽうのかいけんをけんとうしています <br>The government is considering an amendment to the constitution.
場面	[sound:k-0518_場面.mp3]<br>ばめん <br> scene, setting (e.g. of novel)
scene, setting (e.g. of novel)	<b>場面<b> <br> ばめん <br>[sound:k-0518_場面.mp3]
[sound:k-0518_場面.mp3]	scene, setting<br> <b>e.g. of novel) (場面</b> <br> (ばめん)
<b>改良</b> <br> 彼は製品を改良して市場に出しました。	[sound:s-0518_彼は製品を改良して市場に出しました。.mp3] <br> かれはせいひんをかいりょうしてしじょうにだしました。 <br>He improved the product and released it to the market.
[sound:s-0518_彼は製品を改良して市場に出しました。.mp3]	<b>改良</b> <br> 彼は製品を改良して市場に出しました。<br> かれはせいひんをかいりょうしてしじょうにだしました <br>He improved the product and released it to the market.
職場	[sound:k-0519_職場.mp3]<br>しょくば <br> one's post, place of work, workplace
one's post, place of work, workplace	<b>職場<b> <br> しょくば <br>[sound:k-0519_職場.mp3]
[sound:k-0519_職場.mp3]	one's post, place of work, workplace<br> <b>職場</b> <br> (しょくば)
<b>改選</b> <br> その地域では新しい議員の改選が行われました。	[sound:s-0519_その地域では新しい議員の改選が行われました。.mp3] <br> そのちいきではあたらしいぎいんのかいせんがおこなわれました。 <br>The area conducted a new election for the members of parliament.
[sound:s-0519_その地域では新しい議員の改選が行われました。.mp3]	<b>改選</b> <br> その地域では新しい議員の改選が行われました。<br> そのちいきではあたらしいぎいんのかいせんがおこなわれました <br>The area conducted a new election for the members of parliament.
お金	[sound:k-0520_お金.mp3]<br>おかね <br> money
money	<b>お金<b> <br> おかね <br>[sound:k-0520_お金.mp3]
[sound:k-0520_お金.mp3]	money<br> <b>お金</b> <br> (おかね)
<b>改修</b> <br> この建物は改修工事中です。	[sound:s-0520_この建物は改修工事中です。.mp3] <br> このたてものはかいしゅうこうじちゅうです。 <br>This building is undergoing renovation.
[sound:s-0520_この建物は改修工事中です。.mp3]	<b>改修</b> <br> この建物は改修工事中です。<br> このたてものはかいしゅうこうじちゅうです <br>This building is undergoing renovation.
金融	[sound:k-0521_金融.mp3]<br>きんゆう <br> financing, credit transacting, loaning of money, circulation of money
financing, credit transacting, loaning of money, circulation of money	<b>金融<b> <br> きんゆう <br>[sound:k-0521_金融.mp3]
[sound:k-0521_金融.mp3]	financing, credit transacting, loaning of money, circulation of money<br> <b>金融</b> <br> (きんゆう)
<b>数</b> <br> 数が足りません。	[sound:s-0521_数が足りません。.mp3] <br> かずがたりません。 <br>There are not enough numbers.
[sound:s-0521_数が足りません。.mp3]	<b>数</b> <br> 数が足りません。<br> かずがたりません <br>There are not enough numbers.
金利	[sound:k-0522_金利.mp3]<br>きんり <br> interest rates
interest rates	<b>金利<b> <br> きんり <br>[sound:k-0522_金利.mp3]
[sound:k-0522_金利.mp3]	interest rates<br> <b>金利</b> <br> (きんり)
<b>数字</b> <br> 彼は数字の計算が得意です。	[sound:s-0522_彼は数字の計算が得意です。.mp3] <br> かれはすうじのけいさんがとくいです。 <br>He is good at calculating numbers.
[sound:s-0522_彼は数字の計算が得意です。.mp3]	<b>数字</b> <br> 彼は数字の計算が得意です。<br> かれはすうじのけいさんがとくいです <br>He is good at calculating numbers.
献金	[sound:k-0523_献金.mp3]<br>けんきん <br> donation, contribution, offering
donation, contribution, offering	<b>献金<b> <br> けんきん <br>[sound:k-0523_献金.mp3]
[sound:k-0523_献金.mp3]	donation, contribution, offering<br> <b>献金</b> <br> (けんきん)
<b>多数</b> <br> 多数の人々がその提案に賛成しました。	[sound:s-0523_多数の人々がその提案に賛成しました。.mp3] <br> たすうのひとびとがそのていあんにさんせいしました。 <br>A majority of people supported the proposal.
[sound:s-0523_多数の人々がその提案に賛成しました。.mp3]	<b>多数</b> <br> 多数の人々がその提案に賛成しました。<br> たすうのひとびとがそのていあんにさんせいしました <br>A majority of people supported the proposal.
資金	[sound:k-0524_資金.mp3]<br>しきん <br> funds, capital
funds, capital	<b>資金<b> <br> しきん <br>[sound:k-0524_資金.mp3]
[sound:k-0524_資金.mp3]	funds, capital<br> <b>資金</b> <br> (しきん)
<b>定数</b> <br> その部屋の定数は10人です。	[sound:s-0524_その部屋の定数は10人です。.mp3] <br> そのへやのていすうは10にんです。 <br>The capacity of the room is 10 people.
[sound:s-0524_その部屋の定数は10人です。.mp3]	<b>定数</b> <br> その部屋の定数は10人です。<br> そのへやのていすうは10にんです <br>The capacity of the room is 10 people.
基金	[sound:k-0525_基金.mp3]<br>ききん <br> fund, foundation
fund, foundation	<b>基金<b> <br> ききん <br>[sound:k-0525_基金.mp3]
[sound:k-0525_基金.mp3]	fund, foundation<br> <b>基金</b> <br> (ききん)
<b>少数</b> <br> 少数の人々がその意見に反対しました。	[sound:s-0525_少数の人々がその意見に反対しました。.mp3] <br> しょうすうのひとびとがそのいけんにはんたいしました。 <br>A minority of people opposed the opinion.
[sound:s-0525_少数の人々がその意見に反対しました。.mp3]	<b>少数</b> <br> 少数の人々がその意見に反対しました。<br> しょうすうのひとびとがそのいけんにはんたいしました <br>A minority of people opposed the opinion.
年金	[sound:k-0526_年金.mp3]<br>ねんきん <br> annuity, pension
annuity, pension	<b>年金<b> <br> ねんきん <br>[sound:k-0526_年金.mp3]
[sound:k-0526_年金.mp3]	annuity, pension<br> <b>年金</b> <br> (ねんきん)
<b>複数</b> <br> 複数の選択肢があります。	[sound:s-0526_複数の選択肢があります。.mp3] <br> ふくすうのせんたくしゃがあります。 <br>There are multiple choices.
[sound:s-0526_複数の選択肢があります。.mp3]	<b>複数</b> <br> 複数の選択肢があります。<br> ふくすうのせんたくしゃがあります <br>There are multiple choices.
料金	[sound:k-0527_料金.mp3]<br>りょうきん <br> fee, charge, fare
fee, charge, fare	<b>料金<b> <br> りょうきん <br>[sound:k-0527_料金.mp3]
[sound:k-0527_料金.mp3]	fee, charge, fare<br> <b>料金</b> <br> (りょうきん)
<b>過半数</b> <br> この案を通すためには過半数の賛成が必要です。	[sound:s-0527_この案を通すためには過半数の賛成が必要です。.mp3] <br> このあんをとおすためにはかはんすうのさんせいがひつようです。 <br>A majority vote is needed to pass this proposal.
[sound:s-0527_この案を通すためには過半数の賛成が必要です。.mp3]	<b>過半数</b> <br> この案を通すためには過半数の賛成が必要です。<br> このあんをとおすためにはかはんすうのさんせいがひつようです <br>A majority vote is needed to pass this proposal.
金額	[sound:k-0528_金額.mp3]<br>きんがく <br> amount of money
amount of money	<b>金額<b> <br> きんがく <br>[sound:k-0528_金額.mp3]
[sound:k-0528_金額.mp3]	amount of money<br> <b>金額</b> <br> (きんがく)
<b>半数</b> <br> 半数以上の票を獲得する必要があります。	[sound:s-0528_半数以上の票を獲得する必要があります。.mp3] <br> はんすういじょうのひょうをかくとくするひつようがあります。 <br>You need to win more than half the votes.
[sound:s-0528_半数以上の票を獲得する必要があります。.mp3]	<b>半数</b> <br> 半数以上の票を獲得する必要があります。<br> はんすういじょうのひょうをかくとくするひつようがあります <br>You need to win more than half the votes.
金融機関	[sound:k-0529_金融機関.mp3]<br>きんゆうきかん <br> financial institutions, banking facilities
financial institutions, banking facilities	<b>金融機関<b> <br> きんゆうきかん <br>[sound:k-0529_金融機関.mp3]
[sound:k-0529_金融機関.mp3]	financial institutions, banking facilities<br> <b>金融機関</b> <br> (きんゆうきかん)
(回数) 会議は毎週一回行われます。	かいぎはまいしゅういっかいおこなわれます。	s-0529_かいぎはまいしゅういっかいおこなわれます。.mp3
[sound:s-0529_かいぎはまいしゅういっかいおこなわれます。.mp3]	(回数) 会議は毎週一回行われます。かいぎはまいしゅういっかいおこなわれます。The meeting is held once a week.	
委員	[sound:k-0530_委員.mp3]<br>いいん <br> committee member
committee member	<b>委員<b> <br> いいん <br>[sound:k-0530_委員.mp3]
[sound:k-0530_委員.mp3]	committee member<br> <b>委員</b> <br> (いいん)
<b>指数</b> <br> その指数は急速に上昇しています。	[sound:s-0530_その指数は急速に上昇しています。.mp3] <br> そのしすうはきゅうそくにじょうしょうしています。 <br>The index is rising rapidly.
[sound:s-0530_その指数は急速に上昇しています。.mp3]	<b>指数</b> <br> その指数は急速に上昇しています。<br> そのしすうはきゅうそくにじょうしょうしています <br>The index is rising rapidly.
委員会	[sound:k-0531_委員会.mp3]<br>いいんかい <br> committee, commission, board, panel, committee meeting
committee, commission, board, panel, committee meeting	<b>委員会<b> <br> いいんかい <br>[sound:k-0531_委員会.mp3]
[sound:k-0531_委員会.mp3]	committee, commission, board, panel, committee meeting<br> <b>委員会</b> <br> (いいんかい)
<b>記事</b> <br> 彼の新しい記事が雑誌に掲載されました。	[sound:s-0531_彼の新しい記事が雑誌に掲載されました。.mp3] <br> かれのあたらしいきじがざっしにけいさいされました。 <br>His new article was published in the magazine.
[sound:s-0531_彼の新しい記事が雑誌に掲載されました。.mp3]	<b>記事</b> <br> 彼の新しい記事が雑誌に掲載されました。<br> かれのあたらしいきじがざっしにけいさいされました <br>His new article was published in the magazine.
委員長	[sound:k-0532_委員長.mp3]<br>いいんちょう <br> committee chairman
committee chairman	<b>委員長<b> <br> いいんちょう <br>[sound:k-0532_委員長.mp3]
[sound:k-0532_委員長.mp3]	committee chairman<br> <b>委員長</b> <br> (いいんちょう)
<b>記者</b> <br> 彼女は地元の新聞社の記者です。	[sound:s-0532_彼女は地元の新聞社の記者です。.mp3] <br> かのじょはじもとのしんぶんしゃのきしゃです。 <br>She is a reporter for the local newspaper.
[sound:s-0532_彼女は地元の新聞社の記者です。.mp3]	<b>記者</b> <br> 彼女は地元の新聞社の記者です。<br> かのじょはじもとのしんぶんしゃのきしゃです <br>She is a reporter for the local newspaper.
会員	[sound:k-0533_会員.mp3]<br>かいいん <br> member, the membership
member, the membership	<b>会員<b> <br> かいいん <br>[sound:k-0533_会員.mp3]
[sound:k-0533_会員.mp3]	member, the membership<br> <b>会員</b> <br> (かいいん)
<b>記録</b> <br> 彼は新記録を樹立しました。	[sound:s-0533_彼は新記録を樹立しました。.mp3] <br> かれはしんきろくをじゅりつしました。 <br>He set a new record.
[sound:s-0533_彼は新記録を樹立しました。.mp3]	<b>記録</b> <br> 彼は新記録を樹立しました。<br> かれはしんきろくをじゅりつしました <br>He set a new record.
議員	[sound:k-0534_議員.mp3]<br>ぎいん <br> member of the Diet, congress or parliament
member of the Diet, congress or parliament	<b>議員<b> <br> ぎいん <br>[sound:k-0534_議員.mp3]
[sound:k-0534_議員.mp3]	member of the Diet, congress or parliament<br> <b>議員</b> <br> (ぎいん)
<b>書記</b> <br> 彼は会議の書記を務めています。	[sound:s-0534_彼は会議の書記を務めています。.mp3] <br> かれはかいぎのしょきをつとめています。 <br>He is serving as the secretary of the meeting.
[sound:s-0534_彼は会議の書記を務めています。.mp3]	<b>書記</b> <br> 彼は会議の書記を務めています。<br> かれはかいぎのしょきをつとめています <br>He is serving as the secretary of the meeting.
職員	[sound:k-0535_職員.mp3]<br>しょくいん <br> staff member, personnel
staff member, personnel	<b>職員<b> <br> しょくいん <br>[sound:k-0535_職員.mp3]
[sound:k-0535_職員.mp3]	staff member, personnel<br> <b>職員</b> <br> (しょくいん)
<b>記念</b> <br> その記念碑は市民によって建てられました。	[sound:s-0535_その記念碑は市民によって建てられました。.mp3] <br> そのきねんひはしみんによってたてられました。 <br>The monument was erected by the citizens.
[sound:s-0535_その記念碑は市民によって建てられました。.mp3]	<b>記念</b> <br> その記念碑は市民によって建てられました。<br> そのきねんひはしみんによってたてられました <br>The monument was erected by the citizens.
国会議員	[sound:k-0536_国会議員.mp3]<br>こっかいぎいん <br> member of National Diet, Diet member
member of National Diet, Diet member	<b>国会議員<b> <br> こっかいぎいん <br>[sound:k-0536_国会議員.mp3]
[sound:k-0536_国会議員.mp3]	member of National Diet, Diet member<br> <b>国会議員</b> <br> (こっかいぎいん)
<b>記憶</b> <br> 彼はその日の出来事をよく記憶しています。	[sound:s-0536_彼はその日の出来事をよく記憶しています。.mp3] <br> かれはそのひのできごとをよくきおくしています。 <br>He remembers the events of that day well.
[sound:s-0536_彼はその日の出来事をよく記憶しています。.mp3]	<b>記憶</b> <br> 彼はその日の出来事をよく記憶しています。<br> かれはそのひのできごとをよくきおくしています <br>He remembers the events of that day well.
社員	[sound:k-0537_社員.mp3]<br>しゃいん <br> company employee; company stockholders (esp. in legal contexts), members of a corporation
company employee; company stockholders (esp. in legal contexts), members of a corporation	<b>社員<b> <br> しゃいん <br>[sound:k-0537_社員.mp3]
[sound:k-0537_社員.mp3]	company employee; company stockholders<br> <b>esp. in legal contexts), members of a corporation (社員</b> <br> (しゃいん)
<b>記す</b> <br> その出来事を日記に記しました。	[sound:s-0537_その出来事を日記に記しました。.mp3] <br> そのできごとをにっきにしるしました。 <br>I recorded the event in my diary.
[sound:s-0537_その出来事を日記に記しました。.mp3]	<b>記す</b> <br> その出来事を日記に記しました。<br> そのできごとをにっきにしるしました <br>I recorded the event in my diary.
全員	[sound:k-0538_全員.mp3]<br>ぜんいん <br> all members (unanimity), all hands, the whole crew, everyone, everybody
all members (unanimity), all hands, the whole crew, everyone, everybody	<b>全員<b> <br> ぜんいん <br>[sound:k-0538_全員.mp3]
[sound:k-0538_全員.mp3]	all members<br> <b>unanimity), all hands, the whole crew, everyone, everybody (全員</b> <br> (ぜんいん)
<b>記述</b> <br> 彼の論文は詳細に記述されています。	[sound:s-0538_彼の論文は詳細に記述されています。.mp3] <br> かれのろんぶんはしょうさいにきじゅつされています。 <br>His paper is described in detail.
[sound:s-0538_彼の論文は詳細に記述されています。.mp3]	<b>記述</b> <br> 彼の論文は詳細に記述されています。<br> かれのろんぶんはしょうさいにきじゅつされています <br>His paper is described in detail.
役員	[sound:k-0539_役員.mp3]<br>やくいん <br> officer, official, executive, staff
officer, official, executive, staff	<b>役員<b> <br> やくいん <br>[sound:k-0539_役員.mp3]
[sound:k-0539_役員.mp3]	officer, official, executive, staff<br> <b>役員</b> <br> (やくいん)
<b>記念日</b> <br> 彼らは結婚記念日を祝っています。	[sound:s-0539_彼らは結婚記念日を祝っています。.mp3] <br> かれらはけっこんきねんびをいわっています。 <br>They are celebrating their wedding anniversary.
[sound:s-0539_彼らは結婚記念日を祝っています。.mp3]	<b>記念日</b> <br> 彼らは結婚記念日を祝っています。<br> かれらはけっこんきねんびをいわっています <br>They are celebrating their wedding anniversary.
九	[sound:k-0540_九.mp3]<br>きゅう, く, ここの, この, ここ <br> nine
nine	<b>九<b> <br> きゅう, く, ここの, この, ここ <br>[sound:k-0540_九.mp3]
[sound:k-0540_九.mp3]	nine<br> <b>九</b> <br> (きゅう, く, ここの, この, ここ)
<b>日記</b> <br> 彼女は毎日日記をつけています。	[sound:s-0540_彼女は毎日日記をつけています。.mp3] <br> かのじょはまいにちにっきをつけています。 <br>She keeps a diary every day.
[sound:s-0540_彼女は毎日日記をつけています。.mp3]	<b>日記</b> <br> 彼女は毎日日記をつけています。<br> かのじょはまいにちにっきをつけています <br>She keeps a diary every day.
九月	[sound:k-0541_九月.mp3]<br>くがつ <br> September
September	<b>九月<b> <br> くがつ <br>[sound:k-0541_九月.mp3]
[sound:k-0541_九月.mp3]	September<br> <b>九月</b> <br> (くがつ)
<b>参院</b> <br> 参院選挙は来月行われます。	[sound:s-0541_参院選挙は来月行われます。.mp3] <br> さんいんせんきょはらいげつおこなわれます。 <br>The Upper House election will be held next month.
[sound:s-0541_参院選挙は来月行われます。.mp3]	<b>参院</b> <br> 参院選挙は来月行われます。<br> さんいんせんきょはらいげつおこなわれます <br>The Upper House election will be held next month.
十九	[sound:k-0542_十九.mp3]<br>じゅうきゅう <br> 19, nineteen
19, nineteen	<b>十九<b> <br> じゅうきゅう <br>[sound:k-0542_十九.mp3]
[sound:k-0542_十九.mp3]	19, nineteen<br> <b>十九</b> <br> (じゅうきゅう)
<b>衆院</b> <br> 衆院選挙の投票日が決まりました。	[sound:s-0542_衆院選挙の投票日が決まりました。.mp3] <br> しゅういんせんきょのとうひょうびがきまりました。 <br>The voting day for the Lower House election has been decided.
[sound:s-0542_衆院選挙の投票日が決まりました。.mp3]	<b>衆院</b> <br> 衆院選挙の投票日が決まりました。<br> しゅういんせんきょのとうひょうびがきまりました <br>The voting day for the Lower House election has been decided.
九州	[sound:k-0543_九州.mp3]<br>きゅうしゅう <br> Kyushu (southernmost of the four main islands of Japan)
Kyushu (southernmost of the four main islands of Japan)	<b>九州<b> <br> きゅうしゅう <br>[sound:k-0543_九州.mp3]
[sound:k-0543_九州.mp3]	Kyushu<br> <b>southernmost of the four main islands of Japan) (九州</b> <br> (きゅうしゅう)
<b>病院</b> <br> 彼は病院で働いています。	[sound:s-0543_彼は病院で働いています。.mp3] <br> かれはびょういんではたらいています。 <br>He works at the hospital.
[sound:s-0543_彼は病院で働いています。.mp3]	<b>病院</b> <br> 彼は病院で働いています。<br> かれはびょういんではたらいています <br>He works at the hospital.
九十	[sound:k-0544_九十.mp3]<br>きゅうじゅう, くじゅう <br> ninety
ninety	<b>九十<b> <br> きゅうじゅう, くじゅう <br>[sound:k-0544_九十.mp3]
[sound:k-0544_九十.mp3]	ninety<br> <b>九十</b> <br> (きゅうじゅう, くじゅう)
<b>下院</b> <br> 下院は新しい法案を審議しています。	[sound:s-0544_下院は新しい法案を審議しています。.mp3] <br> かいんはあたらしいほうあんをしんぎしています。 <br>The Lower House is deliberating on a new bill.
[sound:s-0544_下院は新しい法案を審議しています。.mp3]	<b>下院</b> <br> 下院は新しい法案を審議しています。<br> かいんはあたらしいほうあんをしんぎしています <br>The Lower House is deliberating on a new bill.
九九	[sound:k-0545_九九.mp3]<br>くく <br> multiplication table, times table
multiplication table, times table	<b>九九<b> <br> くく <br>[sound:k-0545_九九.mp3]
[sound:k-0545_九九.mp3]	multiplication table, times table<br> <b>九九</b> <br> (くく)
<b>上院</b> <br> 上院での議論は熱を帯びています。	[sound:s-0545_上院での議論は熱を帯びています。.mp3] <br> じょういんでのぎろんはあつをおびています。 <br>The debate in the Upper House is heating up.
[sound:s-0545_上院での議論は熱を帯びています。.mp3]	<b>上院</b> <br> 上院での議論は熱を帯びています。<br> じょういんでのぎろんはあつをおびています <br>The debate in the Upper House is heating up.
九つ	[sound:k-0546_九つ.mp3]<br>ここのつ <br> nine
nine	<b>九つ<b> <br> ここのつ <br>[sound:k-0546_九つ.mp3]
[sound:k-0546_九つ.mp3]	nine<br> <b>九つ</b> <br> (ここのつ)
<b>学院</b> <br> 彼は医学院に通っています。	[sound:s-0546_彼は医学院に通っています。.mp3] <br> かれはいがくいんにかよっています。 <br>He attends medical school.
[sound:s-0546_彼は医学院に通っています。.mp3]	<b>学院</b> <br> 彼は医学院に通っています。<br> かれはいがくいんにかよっています <br>He attends medical school.
一一九番	[sound:k-0547_一一九番.mp3]<br>ひゃくじゅうきゅうばん <br> ambulance and fire brigade emergency tel. no. (in Japan)
ambulance and fire brigade emergency tel. no. (in Japan)	<b>一一九番<b> <br> ひゃくじゅうきゅうばん <br>[sound:k-0547_一一九番.mp3]
[sound:k-0547_一一九番.mp3]	ambulance and fire brigade emergency tel. no.<br> <b>in Japan) (一一九番</b> <br> (ひゃくじゅうきゅうばん)
<b>大学院</b> <br> 彼女は大学院で修士号を取得しました。	[sound:s-0547_彼女は大学院で修士号を取得しました。.mp3] <br> かのじょはだいがくいんでしゅうしごうをしゅとくしました。 <br>She obtained a master's degree at graduate school.
[sound:s-0547_彼女は大学院で修士号を取得しました。.mp3]	<b>大学院</b> <br> 彼女は大学院で修士号を取得しました。<br> かのじょはだいがくいんでしゅうしごうをしゅとくしました <br>She obtained a master's degree at graduate school.
千九百年代	[sound:k-0548_千九百年代.mp3]<br>せんきゅうひゃくねんだい <br> the 1900s
the 1900s	<b>千九百年代<b> <br> せんきゅうひゃくねんだい <br>[sound:k-0548_千九百年代.mp3]
[sound:k-0548_千九百年代.mp3]	the 1900s<br> <b>千九百年代</b> <br> (せんきゅうひゃくねんだい)
<b>入院</b> <br> 父は入院しています。	[sound:s-0548_父は入院しています。.mp3] <br> ちちはにゅういんしています。 <br>My father is in the hospital.
[sound:s-0548_父は入院しています。.mp3]	<b>入院</b> <br> 父は入院しています。<br> ちちはにゅういんしています <br>My father is in the hospital.
九重	[sound:k-0549_九重.mp3]<br>ここのえ <br> ninefold, imperial palace, the Court
ninefold, imperial palace, the Court	<b>九重<b> <br> ここのえ <br>[sound:k-0549_九重.mp3]
[sound:k-0549_九重.mp3]	ninefold, imperial palace, the Court<br> <b>九重</b> <br> (ここのえ)
<b>両院</b> <br> この法案は両院で可決されました。	[sound:s-0549_この法案は両院で可決されました。.mp3] <br> このほうあんはりょういんでかけつされました。 <br>This bill was passed by both houses.    
[sound:s-0549_この法案は両院で可決されました。.mp3]	<b>両院</b> <br> この法案は両院で可決されました。<br> このほうあんはりょういんでかけつされました <br>This bill was passed by both houses.    
入り	[sound:k-0550_入り.mp3]<br>いり <br> entering; setting (of the sun); containing, content, audience; income; beginning
entering; setting (of the sun); containing, content, audience; income; beginning	<b>入り<b> <br> いり <br>[sound:k-0550_入り.mp3]
[sound:k-0550_入り.mp3]	entering; setting<br> <b>of the sun); containing, content, audience; income; beginning (入り</b> <br> (いり)
その病院の院長は有名です。	そのびょういんのいんちょうはゆうめいです。	s-0550_そのびょういんのいんちょうはゆうめいです。.mp3
[sound:s-0550_そのびょういんのいんちょうはゆうめいです。.mp3]	その病院の院長は有名です。そのびょういんのいんちょうはゆうめいです。The director of that hospital is famous.	
輸入	[sound:k-0551_輸入.mp3]<br>ゆにゅう, しゅにゅう <br> importation, import, introduction
importation, import, introduction	<b>輸入<b> <br> ゆにゅう, しゅにゅう <br>[sound:k-0551_輸入.mp3]
[sound:k-0551_輸入.mp3]	importation, import, introduction<br> <b>輸入</b> <br> (ゆにゅう, しゅにゅう)
その店の店員はみんな女性です。	そのみせのてんいんはみんなおんなせいです。	s-0551_そのみせのてんいんはみんなおんなせいです。.mp3
[sound:s-0551_そのみせのてんいんはみんなおんなせいです。.mp3]	その店の店員はみんな女性です。そのみせのてんいんはみんなおんなせいです。All the staff in that store are women.	
購入	[sound:k-0552_購入.mp3]<br>こうにゅう <br> purchase, buy
purchase, buy	<b>購入<b> <br> こうにゅう <br>[sound:k-0552_購入.mp3]
[sound:k-0552_購入.mp3]	purchase, buy<br> <b>購入</b> <br> (こうにゅう)
学校の女子は明日試合があります。	がっこうのじょしはあしたしあいがあります。	s-0552_がっこうのじょしはあしたしあいがあります。.mp3
[sound:s-0552_がっこうのじょしはあしたしあいがあります。.mp3]	学校の女子は明日試合があります。がっこうのじょしはあしたしあいがあります。The schoolgirls have a match tomorrow.	
収入	[sound:k-0553_収入.mp3]<br>しゅうにゅう <br> income, receipts, revenue
income, receipts, revenue	<b>収入<b> <br> しゅうにゅう <br>[sound:k-0553_収入.mp3]
[sound:k-0553_収入.mp3]	income, receipts, revenue<br> <b>収入</b> <br> (しゅうにゅう)
その会社のCEOは女性です。	そのかいしゃのCEOはじょせいです。	s-0553_そのかいしゃのCEOはじょせいです。.mp3
[sound:s-0553_そのかいしゃのCEOはじょせいです。.mp3]	その会社のCEOは女性です。そのかいしゃのCEOはじょせいです。The CEO of that company is a woman.	
導入	[sound:k-0554_導入.mp3]<br>どうにゅう <br> introduction, bringing in, leading in, installation
introduction, bringing in, leading in, installation	<b>導入<b> <br> どうにゅう <br>[sound:k-0554_導入.mp3]
[sound:k-0554_導入.mp3]	introduction, bringing in, leading in, installation<br> <b>導入</b> <br> (どうにゅう)
そのイベントは男女共にオープンです。	そのイベントはだんじょともにオープンです。	s-0554_そのイベントはだんじょともにオープンです。.mp3
[sound:s-0554_そのイベントはだんじょともにオープンです。.mp3]	そのイベントは男女共にオープンです。そのイベントはだんじょともにオープンです。The event is open to both men and women.	
介入	[sound:k-0555_介入.mp3]<br>かいにゅう <br> intervention
intervention	<b>介入<b> <br> かいにゅう <br>[sound:k-0555_介入.mp3]
[sound:k-0555_介入.mp3]	intervention<br> <b>介入</b> <br> (かいにゅう)
彼女は毎日公園で犬と散歩します。	かのじょはまいにちこうえんでいぬとさんぽします。	s-0555_かのじょはまいにちこうえんでいぬとさんぽします。.mp3
[sound:s-0555_かのじょはまいにちこうえんでいぬとさんぽします。.mp3]	彼女は毎日公園で犬と散歩します。かのじょはまいにちこうえんでいぬとさんぽします。She walks her dog in the park every day.	
受け入れ	[sound:k-0556_受け入れ.mp3]<br>うけいれ <br> receiving, acceptance
receiving, acceptance	<b>受け入れ<b> <br> うけいれ <br>[sound:k-0556_受け入れ.mp3]
[sound:k-0556_受け入れ.mp3]	receiving, acceptance<br> <b>受け入れ</b> <br> (うけいれ)
その女優は映画で素晴らしい演技を見せました。	そのじょゆうはえいがですばらしいえんぎをみせました。	s-0556_そのじょゆうはえいがですばらしいえんぎをみせました。.mp3
[sound:s-0556_そのじょゆうはえいがですばらしいえんぎをみせました。.mp3]	その女優は映画で素晴らしい演技を見せました。そのじょゆうはえいがですばらしいえんぎをみせました。That actress delivered a wonderful performance in the movie.	
入札	[sound:k-0557_入札.mp3]<br>にゅうさつ <br> bid, bidding
bid, bidding	<b>入札<b> <br> にゅうさつ <br>[sound:k-0557_入札.mp3]
[sound:k-0557_入札.mp3]	bid, bidding<br> <b>入札</b> <br> (にゅうさつ)
彼の家族には長女と次女がいます。	かれのかぞくにはちょうじょとじじょがいます。	s-0557_かれのかぞくにはちょうじょとじじょがいます。.mp3
[sound:s-0557_かれのかぞくにはちょうじょとじじょがいます。.mp3]	彼の家族には長女と次女がいます。かれのかぞくにはちょうじょとじじょがいます。He has an eldest daughter and a second daughter in his family.	
加入	[sound:k-0558_加入.mp3]<br>かにゅう <br> becoming a member, joining, entry, admission, subscription, affiliation, adherence, signing
becoming a member, joining, entry, admission, subscription, affiliation, adherence, signing	<b>加入<b> <br> かにゅう <br>[sound:k-0558_加入.mp3]
[sound:k-0558_加入.mp3]	becoming a member, joining, entry, admission, subscription, affiliation, adherence, signing<br> <b>加入</b> <br> (かにゅう)
その少女は夢中で本を読んでいました。	そのしょうじょはむちゅうでほんをよんでいました。	s-0558_そのしょうじょはむちゅうでほんをよんでいました。.mp3
[sound:s-0558_そのしょうじょはむちゅうでほんをよんでいました。.mp3]	その少女は夢中で本を読んでいました。そのしょうじょはむちゅうでほんをよんでいました。The young girl was absorbed in reading a book.	
参入	[sound:k-0559_参入.mp3]<br>さんにゅう <br> coming, visiting, going
coming, visiting, going	<b>参入<b> <br> さんにゅう <br>[sound:k-0559_参入.mp3]
[sound:k-0559_参入.mp3]	coming, visiting, going<br> <b>参入</b> <br> (さんにゅう)
彼女は有名な女子大学で学んでいます。	かのじょはゆうめいなじょしだいがくでまなんでいます。	s-0559_かのじょはゆうめいなじょしだいがくでまなんでいます。.mp3
[sound:s-0559_かのじょはゆうめいなじょしだいがくでまなんでいます。.mp3]	彼女は有名な女子大学で学んでいます。かのじょはゆうめいなじょしだいがくでまなんでいます。She is studying at a famous women's university.	
選	[sound:k-0560_選.mp3]<br>せん <br> selection, choice, election; compilation, editing
selection, choice, election; compilation, editing	<b>選<b> <br> せん <br>[sound:k-0560_選.mp3]
[sound:k-0560_選.mp3]	selection, choice, election; compilation, editing<br> <b>選</b> <br> (せん)
公園でたくさんの女の子が遊んでいます。	こうえんでたくさんのおんなのこがあそんでいます。	s-0560_こうえんでたくさんのおんなのこがあそんでいます。.mp3
[sound:s-0560_こうえんでたくさんのおんなのこがあそんでいます。.mp3]	公園でたくさんの女の子が遊んでいます。こうえんでたくさんのおんなのこがあそんでいます。Many girls are playing in the park.	
選ぶ	[sound:k-0561_選ぶ.mp3]<br>えらぶ <br> to choose, to select
to choose, to select	<b>選ぶ<b> <br> えらぶ <br>[sound:k-0561_選ぶ.mp3]
[sound:k-0561_選ぶ.mp3]	to choose, to select<br> <b>選ぶ</b> <br> (えらぶ)
彼の初恋は中学生の時でした。	かれのはつこいはちゅうがくせいのときでした。	s-0561_かれのはつこいはちゅうがくせいのときでした。.mp3
[sound:s-0561_かれのはつこいはちゅうがくせいのときでした。.mp3]	彼の初恋は中学生の時でした。かれのはつこいはちゅうがくせいのときでした。His first love was in middle school.	
選挙	[sound:k-0562_選挙.mp3]<br>せんきょ <br> election
election	<b>選挙<b> <br> せんきょ <br>[sound:k-0562_選挙.mp3]
[sound:k-0562_選挙.mp3]	election<br> <b>選挙</b> <br> (せんきょ)
その映画の最初のシーンが印象的でした。	そのえいがのさいしょのしーんがいんしょうてきでした。	s-0562_そのえいがのさいしょのしーんがいんしょうてきでした。.mp3
[sound:s-0562_そのえいがのさいしょのしーんがいんしょうてきでした。.mp3]	その映画の最初のシーンが印象的でした。そのえいがのさいしょのしーんがいんしょうてきでした。The first scene of the movie was impressive.	
選手	[sound:k-0563_選手.mp3]<br>せんしゅ <br> player (in game), team member
player (in game), team member	<b>選手<b> <br> せんしゅ <br>[sound:k-0563_選手.mp3]
[sound:k-0563_選手.mp3]	player<br> <b>in game), team member (選手</b> <br> (せんしゅ)
