[sound:s-3089_家族でピクニックに行きます。.mp3]	(<b>家族</b>) 家族でピクニックに行きます。<br> かぞくでピクニックにいきます。 <br>We're going on a picnic with the family.	
送る	[sound:k-3100_送る.mp3]<br>おくる <br> to send (a thing), to dispatch, to despatch; to take or escort (a person somewhere), to see off (a person); to bid farewell (to the departed), to bury; to spend (time), to live one's life; to pass (down the line); to affix okurigana
to send (a thing), to dispatch, to despatch; to take or escort (a person somewhere), to see off (a person); to bid farewell (to the departed), to bury; to spend (time), to live one's life; to pass (down the line); to affix okurigana	<b>送る<b> <br> おくる <br>[sound:k-3100_送る.mp3]
[sound:k-3100_送る.mp3]	to send<br> <b>a thing), to dispatch, to despatch; to take or escort (a person somewhere), to see off (a person); to bid farewell (to the departed), to bury; to spend (time), to live one's life; to pass (down the line); to affix okurigana (送る</b> <br> (おくる)
(<b>印象</b>) 彼の笑顔は私に良い印象を与えました。	[sound:s-3100_彼の笑顔は私に良い印象を与えました。.mp3] <br> かれのえがおはわたしにいいいんしょうをあたえました。 <br> His smile left a good impression on me.
[sound:s-3090_彼は先住民族の一員です。.mp3]	(<b>族</b>) 彼は先住民族の一員です。<br> かれはせんじゅうみんぞくのいちいんです。 <br>He is a member of an indigenous tribe.	
放送	[sound:k-3101_放送.mp3]<br>ほうそう <br> broadcast, broadcasting
broadcast, broadcasting	<b>放送<b> <br> ほうそう <br>[sound:k-3101_放送.mp3]
[sound:k-3101_放送.mp3]	broadcast, broadcasting<br> <b>放送</b> <br> (ほうそう)
(<b>現象</b>) その現象は自然の摂理に基づいています。	[sound:s-3101_その現象は自然の摂理に基づいています。.mp3] <br> そのげんしょうはしぜんのせつりにもとづいています。 <br> The phenomenon is based on the laws of nature.
[sound:s-3091_その国には多様な民族が暮らしています。.mp3]	(<b>民族</b>) その国には多様な民族が暮らしています。<br> そのくににはたようなみんぞくがくらしています。 <br>Various ethnic groups live in that country.	
輸送	[sound:k-3102_輸送.mp3]<br>ゆそう <br> transport, transportation
transport, transportation	<b>輸送<b> <br> ゆそう <br>[sound:k-3102_輸送.mp3]
[sound:k-3102_輸送.mp3]	transport, transportation<br> <b>輸送</b> <br> (ゆそう)
(<b>象</b>) アフリカで象の群れを見たことがありますか？	[sound:s-3102_アフリカで象の群れを見たことがありますか？.mp3] <br> アフリカでぞうのむれをみたことがありますか？	Have you ever seen a herd of elephants in Africa?
[sound:s-3092_戦争で亡くなった兵士の遺族に支援を提供します。.mp3]	(<b>遺族</b>) 戦争で亡くなった兵士の遺族に支援を提供します。<br> せんそうでなくなったへいしのいぞくにしえんをていきゅうします。 <br>We provide support to the families of soldiers who died in war.	
送り	[sound:k-3103_送り.mp3]<br>おくり <br> seeing off, sending off; funeral; escapement
seeing off, sending off; funeral; escapement	<b>送り<b> <br> おくり <br>[sound:k-3103_送り.mp3]
[sound:k-3103_送り.mp3]	seeing off, sending off; funeral; escapement<br> <b>送り</b> <br> (おくり)
(<b>気象庁</b>) 台風の情報は気象庁から提供されます。	[sound:s-3103_台風の情報は気象庁から提供されます。.mp3] <br> たいふうのじょうほうはきしょうちょうからていきゅうされます。 <br> Typhoon information is provided by the Meteorological Agency.
[sound:s-3093_彼は強い民族主義者です。.mp3]	(<b>民族主義</b>) 彼は強い民族主義者です。<br> かれはつよいみんぞくしゅぎしゃです。 <br>He is a strong nationalist.	
先送り	[sound:k-3104_先送り.mp3]<br>さきおくり <br> postpone
postpone	<b>先送り<b> <br> さきおくり <br>[sound:k-3104_先送り.mp3]
[sound:k-3104_先送り.mp3]	postpone<br> <b>先送り</b> <br> (さきおくり)
(<b>気象</b>) 彼は気象学者として働いています。	[sound:s-3104_彼は気象学者として働いています。.mp3] <br> かれはきしょうがくしゃとしてはたらいています。 <br> He works as a meteorologist.
[sound:s-3094_葬儀には親族だけを招待します。.mp3]	(<b>親族</b>) 葬儀には親族だけを招待します。<br> そうぎにはしんぞくだけをしょうたいします。 <br>Only close relatives are invited to the funeral.	
見送り	[sound:k-3105_見送り.mp3]<br>みおくり <br> seeing one off, farewell, escort
seeing one off, farewell, escort	<b>見送り<b> <br> みおくり <br>[sound:k-3105_見送り.mp3]
[sound:k-3105_見送り.mp3]	seeing one off, farewell, escort<br> <b>見送り</b> <br> (みおくり)
(<b>象徴</b>) その建物は国の繁栄を象徴しています。	[sound:s-3105_その建物は国の繁栄を象徴しています。.mp3] <br> そのたてものはくにのはんえいをしょうちょうしています。 <br> The building symbolizes the prosperity of the country.
[sound:s-3095_彼女は昔からの名門の一族です。.mp3]	(<b>一族</b>) 彼女は昔からの名門の一族です。<br> かのじょはむかしからのめいもんのいちぞくです。 <br>She is from an ancient noble family.	
見送る	[sound:k-3106_見送る.mp3]<br>みおくる <br> to see off (e.g. to the station, an airport, etc.), to escort (e.g. home), to farewell; to see out, to send off; to let pass, to wait and see, to continue (e.g. in legal contexts); to let a pitch go by (baseball), to watch a batted ball go into the stands
to see off (e.g. to the station, an airport, etc.), to escort (e.g. home), to farewell; to see out, to send off; to let pass, to wait and see, to continue (e.g. in legal contexts); to let a pitch go by (baseball), to watch a batted ball go into the stands	<b>見送る<b> <br> みおくる <br>[sound:k-3106_見送る.mp3]
[sound:k-3106_見送る.mp3]	to see off<br> <b>e.g. to the station, an airport, etc.), to escort (e.g. home), to farewell; to see out, to send off; to let pass, to wait and see, to continue (e.g. in legal contexts); to let a pitch go by (baseball), to watch a batted ball go into the stands (見送る</b> <br> (みおくる)
(<b>印象的</b>) 彼女の演技は私たちに印象的なものを残しました。	[sound:s-3106_彼女の演技は私たちに印象的なものを残しました。.mp3] <br> かのじょのえんぎはわたしたちにいんしょうてきなものをのこしました。 <br> Her performance left an impressive impression on us.
[sound:s-3096_その地域には複数の部族が住んでいる。.mp3]	(<b>部族</b>) その地域には複数の部族が住んでいる。<br> そのちいきにはふくすうのぶぞくがすんでいる。 <br>Several tribes live in that region.	
運送	[sound:k-3107_運送.mp3]<br>うんそう <br> transport, freight, shipping
transport, freight, shipping	<b>運送<b> <br> うんそう <br>[sound:k-3107_運送.mp3]
[sound:k-3107_運送.mp3]	transport, freight, shipping<br> <b>運送</b> <br> (うんそう)
(<b>象徴的</b>) その象徴的な場所は多くの人々に親しまれています。	[sound:s-3107_その象徴的な場所は多くの人々に親しまれています。.mp3] <br> そのしょうちょうてきなばしょはおおくのひとびとにしたしまれています。 <br> That symbolic place is cherished by many people.
[sound:s-3097_彼らは家族計画について話し合っています。.mp3]	(<b>家族計画</b>) 彼らは家族計画について話し合っています。<br> かれらはかぞくけいかくについてはなしあっています。 <br>They are discussing family planning.	
送金	[sound:k-3108_送金.mp3]<br>そうきん <br> remittance, sending money
remittance, sending money	<b>送金<b> <br> そうきん <br>[sound:k-3108_送金.mp3]
[sound:k-3108_送金.mp3]	remittance, sending money<br> <b>送金</b> <br> (そうきん)
(<b>抽象</b>) 彼女の作品は抽象的な美しさを表しています。	[sound:s-3108_彼女の作品は抽象的な美しさを表しています。.mp3] <br> かのじょのさくひんはちゅうしょうてきなうつくしさをあらわしています。 <br> Her work expresses abstract beauty.
[sound:s-3098_彼は貴族の家系に生まれました。.mp3]	(<b>貴族</b>) 彼は貴族の家系に生まれました。<br> かれはきぞくのかけいにうまれました。 <br>He was born into a noble family.	
郵送	[sound:k-3109_郵送.mp3]<br>ゆうそう <br> mailing
mailing	<b>郵送<b> <br> ゆうそう <br>[sound:k-3109_郵送.mp3]
[sound:k-3109_郵送.mp3]	mailing<br> <b>郵送</b> <br> (ゆうそう)
(<b>銀</b>) 彼は古銀貨をコレクションしています。	[sound:s-3109_彼は古銀貨をコレクションしています。.mp3] <br> かれはこぎんかをコレクションしています。 <br> He collects old silver coins.
[sound:s-3099_このプログラムは子供たちを対象としています。.mp3]	(<b>対象</b>) このプログラムは子供たちを対象としています。<br> このプログラムはこどもたちをたいしょうとしています。 <br>This program targets children.	
援助	[sound:k-3110_援助.mp3]<br>えんじょ <br> assistance, aid, support
assistance, aid, support	<b>援助<b> <br> えんじょ <br>[sound:k-3110_援助.mp3]
[sound:k-3110_援助.mp3]	assistance, aid, support<br> <b>援助</b> <br> (えんじょ)
(<b>銀行</b>) 私たちは銀行で口座を開設しました。	[sound:s-3110_私たちは銀行で口座を開設しました。.mp3] <br> わたしたちはぎんこうでこうざをかいせつしました。 <br> We opened an account at the bank.
[sound:s-3100_彼の笑顔は私に良い印象を与えました。.mp3]	(<b>印象</b>) 彼の笑顔は私に良い印象を与えました。<br> かれのえがおはわたしにいいいんしょうをあたえました。 <br>His smile left a good impression on me.	
支援	[sound:k-3111_支援.mp3]<br>しえん <br> support, backing, aid, assistance
support, backing, aid, assistance	<b>支援<b> <br> しえん <br>[sound:k-3111_支援.mp3]
[sound:k-3111_支援.mp3]	support, backing, aid, assistance<br> <b>支援</b> <br> (しえん)
(<b>銀座</b>) 銀座は東京の有名なショッピングエリアです。	[sound:s-3111_銀座は東京の有名なショッピングエリアです。.mp3] <br> ぎんざはとうきょうのゆうめいなショッピングエリアです。 <br> Ginza is a famous shopping area in Tokyo.
[sound:s-3101_その現象は自然の摂理に基づいています。.mp3]	(<b>現象</b>) その現象は自然の摂理に基づいています。<br> そのげんしょうはしぜんのせつりにもとづいています。 <br>The phenomenon is based on the laws of nature.	
応援	[sound:k-3112_応援.mp3]<br>おうえん <br> aid, assistance, help, reinforcement, rooting, barracking, support, cheering
aid, assistance, help, reinforcement, rooting, barracking, support, cheering	<b>応援<b> <br> おうえん <br>[sound:k-3112_応援.mp3]
[sound:k-3112_応援.mp3]	aid, assistance, help, reinforcement, rooting, barracking, support, cheering<br> <b>応援</b> <br> (おうえん)
(<b>住友銀行</b>) 住友銀行は日本の有力な銀行の一つです。	[sound:s-3112_住友銀行は日本の有力な銀行の一つです。.mp3] <br> すみともぎんこうはにほんのゆうりょくなぎんこうのひとつです。 <br> Sumitomo Bank is one of Japan's leading banks.
[sound:s-3102_アフリカで象の群れを見たことがありますか？.mp3]	(<b>象</b>) アフリカで象の群れを見たことがありますか？	アフリカでぞうのむれをみたことがありますか？ <br>Have you ever seen a herd of elephants in Africa?
救援	[sound:k-3113_救援.mp3]<br>きゅうえん <br> relief, rescue, reinforcement
relief, rescue, reinforcement	<b>救援<b> <br> きゅうえん <br>[sound:k-3113_救援.mp3]
[sound:k-3113_救援.mp3]	relief, rescue, reinforcement<br> <b>救援</b> <br> (きゅうえん)
(<b>日本銀行</b>) 日本銀行は日本の中央銀行です。	[sound:s-3113_日本銀行は日本の中央銀行です。.mp3] <br> にほんぎんこうはにほんのちゅうおうぎんこうです。 <br> The Bank of Japan is the central bank of Japan.
[sound:s-3103_台風の情報は気象庁から提供されます。.mp3]	(<b>気象庁</b>) 台風の情報は気象庁から提供されます。<br> たいふうのじょうほうはきしょうちょうからていきゅうされます。 <br>Typhoon information is provided by the Meteorological Agency.	
後援	[sound:k-3114_後援.mp3]<br>こうえん <br> support, backing
support, backing	<b>後援<b> <br> こうえん <br>[sound:k-3114_後援.mp3]
[sound:k-3114_後援.mp3]	support, backing<br> <b>後援</b> <br> (こうえん)
(<b>世界銀行</b>) 世界銀行は途上国の開発を支援しています。	[sound:s-3114_世界銀行は途上国の開発を支援しています。.mp3] <br> せかいぎんこうはとじょうこくのかいはつをしえんしています。 <br> The World Bank supports the development of developing countries.
[sound:s-3104_彼は気象学者として働いています。.mp3]	(<b>気象</b>) 彼は気象学者として働いています。<br> かれはきしょうがくしゃとしてはたらいています。 <br>He works as a meteorologist.	
援護	[sound:k-3115_援護.mp3]<br>えんご <br> covering, protection, backing, relief
covering, protection, backing, relief	<b>援護<b> <br> えんご <br>[sound:k-3115_援護.mp3]
[sound:k-3115_援護.mp3]	covering, protection, backing, relief<br> <b>援護</b> <br> (えんご)
(<b>水銀</b>) 水銀は有毒な物質です。	[sound:s-3115_水銀は有毒な物質です。.mp3] <br> すいぎんはゆうどくなぶっしつです。 <br> Mercury is a toxic substance.
[sound:s-3105_その建物は国の繁栄を象徴しています。.mp3]	(<b>象徴</b>) その建物は国の繁栄を象徴しています。<br> そのたてものはくにのはんえいをしょうちょうしています。 <br>The building symbolizes the prosperity of the country.	
声援	[sound:k-3116_声援.mp3]<br>せいえん <br> encouragement, cheering, support
encouragement, cheering, support	<b>声援<b> <br> せいえん <br>[sound:k-3116_声援.mp3]
[sound:k-3116_声援.mp3]	encouragement, cheering, support<br> <b>声援</b> <br> (せいえん)
(<b>世銀</b>) 世銀は国際開発銀行の略称です。	[sound:s-3116_世銀は国際開発銀行の略称です。.mp3] <br> せぎんはこくさいかいはつぎんこうのりゃくしょうです。 <br> The IDB is an abbreviation for the International Development Bank.
[sound:s-3106_彼女の演技は私たちに印象的なものを残しました。.mp3]	(<b>印象的</b>) 彼女の演技は私たちに印象的なものを残しました。<br> かのじょのえんぎはわたしたちにいんしょうてきなものをのこしました。 <br>Her performance left an impressive impression on us.	
義援金	[sound:k-3117_義援金.mp3]<br>ぎえんきん <br> donation money, contribution
donation money, contribution	<b>義援金<b> <br> ぎえんきん <br>[sound:k-3117_義援金.mp3]
[sound:k-3117_義援金.mp3]	donation money, contribution<br> <b>義援金</b> <br> (ぎえんきん)
(<b>銀河</b>) 銀河系には多くの星があります。	[sound:s-3117_銀河系には多くの星があります。.mp3] <br> ぎんがけいにはおおくのほしがあります。 <br> There are many stars in the Milky Way.
[sound:s-3107_その象徴的な場所は多くの人々に親しまれています。.mp3]	(<b>象徴的</b>) その象徴的な場所は多くの人々に親しまれています。<br> そのしょうちょうてきなばしょはおおくのひとびとにしたしまれています。 <br>That symbolic place is cherished by many people.	
援軍	[sound:k-3118_援軍.mp3]<br>えんぐん <br> reinforcement
reinforcement	<b>援軍<b> <br> えんぐん <br>[sound:k-3118_援軍.mp3]
[sound:k-3118_援軍.mp3]	reinforcement<br> <b>援軍</b> <br> (えんぐん)
(<b>輸銀</b>) 輸銀は国際的な銀行業務を担当しています。	[sound:s-3118_輸銀は国際的な銀行業務を担当しています。.mp3] <br> ゆぎんはこくさいてきなぎんこうぎょうむをたんとうしています。 <br> Yugin is responsible for international banking operations.
[sound:s-3108_彼女の作品は抽象的な美しさを表しています。.mp3]	(<b>抽象</b>) 彼女の作品は抽象的な美しさを表しています。<br> かのじょのさくひんはちゅうしょうてきなうつくしさをあらわしています。 <br>Her work expresses abstract beauty.	
無援	[sound:k-3119_無援.mp3]<br>むえん <br> helpless, unsupporting
helpless, unsupporting	<b>無援<b> <br> むえん <br>[sound:k-3119_無援.mp3]
[sound:k-3119_無援.mp3]	helpless, unsupporting<br> <b>無援</b> <br> (むえん)
(<b>地域</b>) この地域は豊かな自然景観で知られています。	[sound:s-3119_この地域は豊かな自然景観で知られています。.mp3] <br> このちいきはゆたかなしぜんけいかんでしられています。 <br> This area is known for its rich natural landscapes.
[sound:s-3109_彼は古銀貨をコレクションしています。.mp3]	(<b>銀</b>) 彼は古銀貨をコレクションしています。<br> かれはこぎんかをコレクションしています。 <br>He collects old silver coins.	
子供	[sound:k-3120_子供.mp3]<br>こども <br> child, children
child, children	<b>子供<b> <br> こども <br>[sound:k-3120_子供.mp3]
[sound:k-3120_子供.mp3]	child, children<br> <b>子供</b> <br> (こども)
(<b>区域</b>) 犬の散歩は指定された区域内で行われます。	[sound:s-3120_犬の散歩は指定された区域内で行われます。.mp3] <br> いぬのさんぽはしていされたくいきないでおこなわれます。 <br> Dog walking is conducted within designated areas.
[sound:s-3110_私たちは銀行で口座を開設しました。.mp3]	(<b>銀行</b>) 私たちは銀行で口座を開設しました。<br> わたしたちはぎんこうでこうざをかいせつしました。 <br>We opened an account at the bank.	
供給	[sound:k-3121_供給.mp3]<br>きょうきゅう <br> supply, provision
supply, provision	<b>供給<b> <br> きょうきゅう <br>[sound:k-3121_供給.mp3]
[sound:k-3121_供給.mp3]	supply, provision<br> <b>供給</b> <br> (きょうきゅう)
(<b>域内</b>) 公園は市域内に位置しています。	[sound:s-3121_公園は市域内に位置しています。.mp3] <br> こうえんはしきいないにいちしています。 <br> The park is located within the city limits.
[sound:s-3111_銀座は東京の有名なショッピングエリアです。.mp3]	(<b>銀座</b>) 銀座は東京の有名なショッピングエリアです。<br> ぎんざはとうきょうのゆうめいなショッピングエリアです。 <br>Ginza is a famous shopping area in Tokyo.	
提供	[sound:k-3122_提供.mp3]<br>ていきょう <br> offer, tender, program sponsoring, programme sponsoring, furnishing
offer, tender, program sponsoring, programme sponsoring, furnishing	<b>提供<b> <br> ていきょう <br>[sound:k-3122_提供.mp3]
[sound:k-3122_提供.mp3]	offer, tender, program sponsoring, programme sponsoring, furnishing<br> <b>提供</b> <br> (ていきょう)
(<b>海域</b>) この海域は多くの漁業に利用されています。	[sound:s-3122_この海域は多くの漁業に利用されています。.mp3] <br> このかいいきはおおくのぎょぎょうにりようされています。 <br> This maritime area is utilized by many fisheries.
[sound:s-3112_住友銀行は日本の有力な銀行の一つです。.mp3]	(<b>住友銀行</b>) 住友銀行は日本の有力な銀行の一つです。<br> すみともぎんこうはにほんのゆうりょくなぎんこうのひとつです。 <br>Sumitomo Bank is one of Japan's leading banks.	
供与	[sound:k-3123_供与.mp3]<br>きょうよ <br> giving, provision, furnishing
giving, provision, furnishing	<b>供与<b> <br> きょうよ <br>[sound:k-3123_供与.mp3]
[sound:k-3123_供与.mp3]	giving, provision, furnishing<br> <b>供与</b> <br> (きょうよ)
(<b>全域</b>) この地図は市の全域をカバーしています。	[sound:s-3123_この地図は市の全域をカバーしています。.mp3] <br> このちずはしのぜんいきをカバーしています。 <br> This map covers the entire city area.
[sound:s-3113_日本銀行は日本の中央銀行です。.mp3]	(<b>日本銀行</b>) 日本銀行は日本の中央銀行です。<br> にほんぎんこうはにほんのちゅうおうぎんこうです。 <br>The Bank of Japan is the central bank of Japan.	
供述	[sound:k-3124_供述.mp3]<br>きょうじゅつ <br> affidavit, deposition, testimony
affidavit, deposition, testimony	<b>供述<b> <br> きょうじゅつ <br>[sound:k-3124_供述.mp3]
[sound:k-3124_供述.mp3]	affidavit, deposition, testimony<br> <b>供述</b> <br> (きょうじゅつ)
(<b>領域</b>) その研究は新しい科学の領域に進んでいます。	[sound:s-3124_その研究は新しい科学の領域に進んでいます。.mp3] <br> そのけんきゅうはあたらしいかがくのりょういきにすすんでいます。 <br> The research is advancing into the realm of new science.
[sound:s-3114_世界銀行は途上国の開発を支援しています。.mp3]	(<b>世界銀行</b>) 世界銀行は途上国の開発を支援しています。<br> せかいぎんこうはとじょうこくのかいはつをしえんしています。 <br>The World Bank supports the development of developing countries.	
供	[sound:k-3125_供.mp3]<br>とも <br> companion, follower, attendant, retinue
companion, follower, attendant, retinue	<b>供<b> <br> とも <br>[sound:k-3125_供.mp3]
[sound:k-3125_供.mp3]	companion, follower, attendant, retinue<br> <b>供</b> <br> (とも)
(<b>域外</b>) このプランは地域外の顧客にも適用されます。	[sound:s-3125_このプランは地域外の顧客にも適用されます。.mp3] <br> このプランはちいきがいのこきゃくにもてきようされます。 <br> This plan also applies to customers outside the region.
[sound:s-3115_水銀は有毒な物質です。.mp3]	(<b>水銀</b>) 水銀は有毒な物質です。<br> すいぎんはゆうどくなぶっしつです。 <br>Mercury is a toxic substance.	
提供者	[sound:k-3126_提供者.mp3]<br>ていきょうしゃ <br> donor, contributer, provider
donor, contributer, provider	<b>提供者<b> <br> ていきょうしゃ <br>[sound:k-3126_提供者.mp3]
[sound:k-3126_提供者.mp3]	donor, contributer, provider<br> <b>提供者</b> <br> (ていきょうしゃ)
(<b>流域</b>) この川の流域には多くの農村があります。	[sound:s-3126_この川の流域には多くの農村があります。.mp3] <br> このかわのりゅういきにはおおくののうそんがあります。 <br> There are many villages in the basin of this river.
[sound:s-3116_世銀は国際開発銀行の略称です。.mp3]	(<b>世銀</b>) 世銀は国際開発銀行の略称です。<br> せぎんはこくさいかいはつぎんこうのりゃくしょうです。 <br>The IDB is an abbreviation for the International Development Bank.	
供養	[sound:k-3127_供養.mp3]<br>くよう <br> memorial service for the dead, holding a service
memorial service for the dead, holding a service	<b>供養<b> <br> くよう <br>[sound:k-3127_供養.mp3]
[sound:k-3127_供養.mp3]	memorial service for the dead, holding a service<br> <b>供養</b> <br> (くよう)
(<b>広域</b>) このプロジェクトは広域にわたって実施されます。	[sound:s-3127_このプロジェクトは広域にわたって実施されます。.mp3] <br> このプロジェクトはこういきにわたってじっしされます。 <br> This project will be implemented over a wide area.
[sound:s-3117_銀河系には多くの星があります。.mp3]	(<b>銀河</b>) 銀河系には多くの星があります。<br> ぎんがけいにはおおくのほしがあります。 <br>There are many stars in the Milky Way.	
供給源	[sound:k-3128_供給源.mp3]<br>きょうきゅうげん <br> source of supply
source of supply	<b>供給源<b> <br> きょうきゅうげん <br>[sound:k-3128_供給源.mp3]
[sound:k-3128_供給源.mp3]	source of supply<br> <b>供給源</b> <br> (きょうきゅうげん)
(<b>地域社会</b>) 地域社会でのボランティア活動に参加します。	[sound:s-3128_地域社会でのボランティア活動に参加します。.mp3] <br> ちいきしゃかいでのボランティアかつどうにさんかします。 <br> I participate in volunteer activities in the local community.
[sound:s-3118_輸銀は国際的な銀行業務を担当しています。.mp3]	(<b>輸銀</b>) 輸銀は国際的な銀行業務を担当しています。<br> ゆぎんはこくさいてきなぎんこうぎょうむをたんとうしています。 <br>Yugin is responsible for international banking operations.	
自供	[sound:k-3129_自供.mp3]<br>じきょう <br> confession
confession	<b>自供<b> <br> じきょう <br>[sound:k-3129_自供.mp3]
[sound:k-3129_自供.mp3]	confession<br> <b>自供</b> <br> (じきょう)
(<b>援助</b>) 困っている人々に援助を提供することが大切です。	[sound:s-3129_困っている人々に援助を提供することが大切です。.mp3] <br> こまっているひとびとにえんじょをていきゅうすることがたいせつです。 <br> It is important to provide assistance to those in need.
[sound:s-3119_この地域は豊かな自然景観で知られています。.mp3]	(<b>地域</b>) この地域は豊かな自然景観で知られています。<br> このちいきはゆたかなしぜんけいかんでしられています。 <br>This area is known for its rich natural landscapes.	
可	[sound:k-3130_可.mp3]<br>か <br> passable, acceptable, tolerable, fair
passable, acceptable, tolerable, fair	<b>可<b> <br> か <br>[sound:k-3130_可.mp3]
[sound:k-3130_可.mp3]	passable, acceptable, tolerable, fair<br> <b>可</b> <br> (か)
(<b>補助</b>) 政府は地方のプロジェクトに補助金を提供します。	[sound:s-3130_政府は地方のプロジェクトに補助金を提供します。.mp3] <br> せいふはちほうのプロジェクトにほじょきんをていきゅうします。 <br> The government provides subsidies to local projects.
[sound:s-3120_犬の散歩は指定された区域内で行われます。.mp3]	(<b>区域</b>) 犬の散歩は指定された区域内で行われます。<br> いぬのさんぽはしていされたくいきないでおこなわれます。 <br>Dog walking is conducted within designated areas.	
可能	[sound:k-3131_可能.mp3]<br>かのう <br> possible, practicable, feasible
possible, practicable, feasible	<b>可能<b> <br> かのう <br>[sound:k-3131_可能.mp3]
[sound:k-3131_可能.mp3]	possible, practicable, feasible<br> <b>可能</b> <br> (かのう)
(<b>助教授</b>) 彼女は大学で助教授として働いています。	[sound:s-3131_彼女は大学で助教授として働いています。.mp3] <br> かのじょはだいがくでじょきょうじゅとしてはたらいています。 <br> She works as an associate professor at the university.
[sound:s-3121_公園は市域内に位置しています。.mp3]	(<b>域内</b>) 公園は市域内に位置しています。<br> こうえんはしきいないにいちしています。 <br>The park is located within the city limits.	
可能性	[sound:k-3132_可能性.mp3]<br>かのうせい <br> potentiality, likelihood, possibility, availability
potentiality, likelihood, possibility, availability	<b>可能性<b> <br> かのうせい <br>[sound:k-3132_可能性.mp3]
[sound:k-3132_可能性.mp3]	potentiality, likelihood, possibility, availability<br> <b>可能性</b> <br> (かのうせい)
(<b>助成</b>) 文化プロジェクトへの助成金が与えられました。	[sound:s-3132_文化プロジェクトへの助成金が与えられました。.mp3] <br> ぶんかプロジェクトへのじょせいきんがあたえられました。 <br> Grants were provided for the cultural project.
[sound:s-3122_この海域は多くの漁業に利用されています。.mp3]	(<b>海域</b>) この海域は多くの漁業に利用されています。<br> このかいいきはおおくのぎょぎょうにりようされています。 <br>This maritime area is utilized by many fisheries.	
許可	[sound:k-3133_許可.mp3]<br>きょか <br> permission, approval, authorization
permission, approval, authorization	<b>許可<b> <br> きょか <br>[sound:k-3133_許可.mp3]
[sound:k-3133_許可.mp3]	permission, approval, authorization<br> <b>許可</b> <br> (きょか)
(<b>助手</b>) 私の助手が手伝ってくれました。	[sound:s-3133_私の助手が手伝ってくれました。.mp3] <br> わたしのじょしゅがてつだってくれました。 <br> My assistant helped me.
[sound:s-3123_この地図は市の全域をカバーしています。.mp3]	(<b>全域</b>) この地図は市の全域をカバーしています。<br> このちずはしのぜんいきをカバーしています。 <br>This map covers the entire city area.	
可笑しい	[sound:k-3134_可笑しい.mp3]<br>おかしい <br> strange, funny, amusing, ridiculous
strange, funny, amusing, ridiculous	<b>可笑しい<b> <br> おかしい <br>[sound:k-3134_可笑しい.mp3]
[sound:k-3134_可笑しい.mp3]	strange, funny, amusing, ridiculous<br> <b>可笑しい</b> <br> (おかしい)
(<b>助け</b>) 彼女は彼を助けました。	[sound:s-3134_彼女は彼を助けました。.mp3] <br> かのじょはかれをたすけました。 <br> She helped him.
[sound:s-3124_その研究は新しい科学の領域に進んでいます。.mp3]	(<b>領域</b>) その研究は新しい科学の領域に進んでいます。<br> そのけんきゅうはあたらしいかがくのりょういきにすすんでいます。 <br>The research is advancing into the realm of new science.	
認可	[sound:k-3135_認可.mp3]<br>にんか <br> approval, license, licence, permission
approval, license, licence, permission	<b>認可<b> <br> にんか <br>[sound:k-3135_認可.mp3]
[sound:k-3135_認可.mp3]	approval, license, licence, permission<br> <b>認可</b> <br> (にんか)
(<b>救助</b>) 沈んでいる船の救助に向かいます。	[sound:s-3135_沈んでいる船の救助に向かいます。.mp3] <br> しずんでいるふねのきゅうじょにむかいます。 <br> We're heading for the rescue of the sinking ship.
[sound:s-3125_このプランは地域外の顧客にも適用されます。.mp3]	(<b>域外</b>) このプランは地域外の顧客にも適用されます。<br> このプランはちいきがいのこきゃくにもてきようされます。 <br>This plan also applies to customers outside the region.	
不可欠	[sound:k-3136_不可欠.mp3]<br>ふかけつ <br> indispensable, essential
indispensable, essential	<b>不可欠<b> <br> ふかけつ <br>[sound:k-3136_不可欠.mp3]
[sound:k-3136_不可欠.mp3]	indispensable, essential<br> <b>不可欠</b> <br> (ふかけつ)
(<b>助役</b>) 彼は村の助役を務めています。	[sound:s-3136_彼は村の助役を務めています。.mp3] <br> かれはむらのじょやくをつとめています。 <br> He serves as the deputy mayor of the village.
[sound:s-3126_この川の流域には多くの農村があります。.mp3]	(<b>流域</b>) この川の流域には多くの農村があります。<br> このかわのりゅういきにはおおくののうそんがあります。 <br>There are many villages in the basin of this river.	
不可能	[sound:k-3137_不可能.mp3]<br>ふかのう <br> impossible
impossible	<b>不可能<b> <br> ふかのう <br>[sound:k-3137_不可能.mp3]
[sound:k-3137_不可能.mp3]	impossible<br> <b>不可能</b> <br> (ふかのう)
(<b>助言</b>) 彼からの助言はいつも役に立ちます。	[sound:s-3137_彼からの助言はいつも役に立ちます。.mp3] <br> かれからのじょげんはいつもやくにたちます。 <br> His advice is always helpful.
[sound:s-3127_このプロジェクトは広域にわたって実施されます。.mp3]	(<b>広域</b>) このプロジェクトは広域にわたって実施されます。<br> このプロジェクトはこういきにわたってじっしされます。 <br>This project will be implemented over a wide area.	
可決	[sound:k-3138_可決.mp3]<br>かけつ <br> approval, adoption (e.g. motion, bill), passage
approval, adoption (e.g. motion, bill), passage	<b>可決<b> <br> かけつ <br>[sound:k-3138_可決.mp3]
[sound:k-3138_可決.mp3]	approval, adoption<br> <b>e.g. motion, bill), passage (可決</b> <br> (かけつ)
(<b>自助</b>) 困難に直面したら自助が大切です。	[sound:s-3138_困難に直面したら自助が大切です。.mp3] <br> こんなんにちょくめんしたらじじょがたいせつです。 <br> Self-help is important when facing difficulties.
[sound:s-3128_地域社会でのボランティア活動に参加します。.mp3]	(<b>地域社会</b>) 地域社会でのボランティア活動に参加します。<br> ちいきしゃかいでのボランティアかつどうにさんかします。 <br>I participate in volunteer activities in the local community.	
不可分	[sound:k-3139_不可分.mp3]<br>ふかぶん <br> atomic, indivisibility
atomic, indivisibility	<b>不可分<b> <br> ふかぶん <br>[sound:k-3139_不可分.mp3]
[sound:k-3139_不可分.mp3]	atomic, indivisibility<br> <b>不可分</b> <br> (ふかぶん)
(<b>労働</b>) 労働は社会の基盤です。	[sound:s-3139_労働は社会の基盤です。.mp3] <br> ろうどうはしゃかいのきばんです。 <br> Labor is the foundation of society.
[sound:s-3129_困っている人々に援助を提供することが大切です。.mp3]	(<b>援助</b>) 困っている人々に援助を提供することが大切です。<br> こまっているひとびとにえんじょをていきゅうすることがたいせつです。 <br>It is important to provide assistance to those in need.	
役	[sound:k-3140_役.mp3]<br>やく <br> use, service, role, position
use, service, role, position	<b>役<b> <br> やく <br>[sound:k-3140_役.mp3]
[sound:k-3140_役.mp3]	use, service, role, position<br> <b>役</b> <br> (やく)
(<b>労働者</b>) 労働者は労働条件の改善を要求しています。	[sound:s-3140_労働者は労働条件の改善を要求しています。.mp3] <br> ろうどうしゃはろうどうじょうけんのかいぜんをようきゅうしています。 <br> Workers are demanding improvements in labor conditions.
[sound:s-3130_政府は地方のプロジェクトに補助金を提供します。.mp3]	(<b>補助</b>) 政府は地方のプロジェクトに補助金を提供します。<br> せいふはちほうのプロジェクトにほじょきんをていきゅうします。 <br>The government provides subsidies to local projects.	
役割	[sound:k-3141_役割.mp3]<br>やくわり <br> part, assigning (allotment of) parts, role, duties
part, assigning (allotment of) parts, role, duties	<b>役割<b> <br> やくわり <br>[sound:k-3141_役割.mp3]
[sound:k-3141_役割.mp3]	part, assigning<br> <b>allotment of) parts, role, duties (役割</b> <br> (やくわり)
(<b>労組</b>) 労組は労働者の権利を守る役割を果たしています。	[sound:s-3141_労組は労働者の権利を守る役割を果たしています。.mp3] <br> ろうそはろうどうしゃのけんりをまもるやくわりをはたしています。 <br> Labor unions play a role in protecting the rights of workers.
[sound:s-3131_彼女は大学で助教授として働いています。.mp3]	(<b>助教授</b>) 彼女は大学で助教授として働いています。<br> かのじょはだいがくでじょきょうじゅとしてはたらいています。 <br>She works as an associate professor at the university.	
役員	[sound:k-3142_役員.mp3]<br>やくいん <br> officer, official, executive, staff
officer, official, executive, staff	<b>役員<b> <br> やくいん <br>[sound:k-3142_役員.mp3]
[sound:k-3142_役員.mp3]	officer, official, executive, staff<br> <b>役員</b> <br> (やくいん)
(<b>労働省</b>) 労働省は労働に関する政策を策定しています。	[sound:s-3142_労働省は労働に関する政策を策定しています。.mp3] <br> ろうどうしょうはろうどうにかんするせいさくをさくていしています。 <br> The Ministry of Labor formulates policies related to labor.
[sound:s-3132_文化プロジェクトへの助成金が与えられました。.mp3]	(<b>助成</b>) 文化プロジェクトへの助成金が与えられました。<br> ぶんかプロジェクトへのじょせいきんがあたえられました。 <br>Grants were provided for the cultural project.	
取締役	[sound:k-3143_取締役.mp3]<br>とりしまりやく <br> company director, board member
company director, board member	<b>取締役<b> <br> とりしまりやく <br>[sound:k-3143_取締役.mp3]
[sound:k-3143_取締役.mp3]	company director, board member<br> <b>取締役</b> <br> (とりしまりやく)
(<b>労働党</b>) 労働党は労働者の利益を代表しています。	[sound:s-3143_労働党は労働者の利益を代表しています。.mp3] <br> ろうどうとうはろうどうしゃのりえきをだいひょうしています。 <br> The Labor Party represents the interests of workers.
[sound:s-3133_私の助手が手伝ってくれました。.mp3]	(<b>助手</b>) 私の助手が手伝ってくれました。<br> わたしのじょしゅがてつだってくれました。 <br>My assistant helped me.	
懲役	[sound:k-3144_懲役.mp3]<br>ちょうえき <br> penal servitude, imprisonment with hard labor (hard labour)
penal servitude, imprisonment with hard labor (hard labour)	<b>懲役<b> <br> ちょうえき <br>[sound:k-3144_懲役.mp3]
[sound:k-3144_懲役.mp3]	penal servitude, imprisonment with hard labor<br> <b>hard labour) (懲役</b> <br> (ちょうえき)
(<b>苦労</b>) 彼は苦労して成功を手に入れました。	[sound:s-3144_彼は苦労して成功を手に入れました。.mp3] <br> かれはくろうしてせいこうをてにいれました。 <br> He struggled and achieved success.
[sound:s-3134_彼女は彼を助けました。.mp3]	(<b>助け</b>) 彼女は彼を助けました。<br> かのじょはかれをたすけました。 <br>She helped him.	
現役	[sound:k-3145_現役.mp3]<br>げんえき <br> active duty, active service
active duty, active service	<b>現役<b> <br> げんえき <br>[sound:k-3145_現役.mp3]
[sound:k-3145_現役.mp3]	active duty, active service<br> <b>現役</b> <br> (げんえき)
(<b>労使</b>) 労使間の対立が解消されました。	[sound:s-3145_労使間の対立が解消されました。.mp3] <br> ろうしまんのたいりつがかいしょうされました。 <br> The conflict between labor and management has been resolved.
[sound:s-3135_沈んでいる船の救助に向かいます。.mp3]	(<b>救助</b>) 沈んでいる船の救助に向かいます。<br> しずんでいるふねのきゅうじょにむかいます。 <br>We're heading for the rescue of the sinking ship.	
三役	[sound:k-3146_三役.mp3]<br>さんやく <br> three highest ranks (wrestling, unions, etc.)
three highest ranks (wrestling, unions, etc.)	<b>三役<b> <br> さんやく <br>[sound:k-3146_三役.mp3]
[sound:k-3146_三役.mp3]	three highest ranks<br> <b>wrestling, unions, etc.) (三役</b> <br> (さんやく)
(<b>労働組合</b>) 労働組合は労働者の権利を守るために存在します。	[sound:s-3146_労働組合は労働者の権利を守るために存在します。.mp3] <br> ろうどうくみあいはろうどうしゃのけんりをまもるためにそんざいします。 <br> Labor unions exist to protect the rights of workers.
[sound:s-3136_彼は村の助役を務めています。.mp3]	(<b>助役</b>) 彼は村の助役を務めています。<br> かれはむらのじょやくをつとめています。 <br>He serves as the deputy mayor of the village.	
主役	[sound:k-3147_主役.mp3]<br>しゅやく <br> leading part, leading actor (actress)
leading part, leading actor (actress)	<b>主役<b> <br> しゅやく <br>[sound:k-3147_主役.mp3]
[sound:k-3147_主役.mp3]	leading part, leading actor<br> <b>actress) (主役</b> <br> (しゅやく)
(<b>疲労</b>) 長時間の仕事で彼は疲労困憊している。	[sound:s-3147_長時間の仕事で彼は疲労困憊している。.mp3] <br> ちょうじかんのしごとでかれはひろうこんぱいしています。 <br> He is exhausted from long hours of work.
[sound:s-3137_彼からの助言はいつも役に立ちます。.mp3]	(<b>助言</b>) 彼からの助言はいつも役に立ちます。<br> かれからのじょげんはいつもやくにたちます。 <br>His advice is always helpful.	
取締役会	[sound:k-3148_取締役会.mp3]<br>とりしまりやくかい <br> board of directors; board of directors' meeting
board of directors; board of directors' meeting	<b>取締役会<b> <br> とりしまりやくかい <br>[sound:k-3148_取締役会.mp3]
[sound:k-3148_取締役会.mp3]	board of directors; board of directors' meeting<br> <b>取締役会</b> <br> (とりしまりやくかい)
(<b>労連</b>) 労働組合連合会は労働者の利益を代表しています。	[sound:s-3148_労働組合連合会は労働者の利益を代表しています。.mp3] <br> ろうどうくみあいれんごうかいはろうどうしゃのりえきをだいひょうしています。 <br> The Federation of Labor Unions represents the interests of workers.
[sound:s-3138_困難に直面したら自助が大切です。.mp3]	(<b>自助</b>) 困難に直面したら自助が大切です。<br> こんなんにちょくめんしたらじじょがたいせつです。 <br>Self-help is important when facing difficulties.	
役所	[sound:k-3149_役所.mp3]<br>やくしょ <br> government office, public office
government office, public office	<b>役所<b> <br> やくしょ <br>[sound:k-3149_役所.mp3]
[sound:k-3149_役所.mp3]	government office, public office<br> <b>役所</b> <br> (やくしょ)
(<b>例</b>) 彼は良い例を示しました。	[sound:s-3149_彼は良い例を示しました。.mp3] <br> かれはよいれいをしめしました。 <br> He set a good example.
[sound:s-3139_労働は社会の基盤です。.mp3]	(<b>労働</b>) 労働は社会の基盤です。<br> ろうどうはしゃかいのきばんです。 <br>Labor is the foundation of society.	
機構	[sound:k-3150_機構.mp3]<br>きこう <br> mechanism, organization, organisation
mechanism, organization, organisation	<b>機構<b> <br> きこう <br>[sound:k-3150_機構.mp3]
[sound:k-3150_機構.mp3]	mechanism, organization, organisation<br> <b>機構</b> <br> (きこう)
(<b>例えば</b>) 例えば、彼はとても親切です。	[sound:s-3150_例えば、彼はとても親切です。.mp3] <br> たとえば、かれはとてもしんせつです。 <br> For example, he is very kind.
[sound:s-3140_労働者は労働条件の改善を要求しています。.mp3]	(<b>労働者</b>) 労働者は労働条件の改善を要求しています。<br> ろうどうしゃはろうどうじょうけんのかいぜんをようきゅうしています。 <br>Workers are demanding improvements in labor conditions.	
構造	[sound:k-3151_構造.mp3]<br>こうぞう <br> structure, construction
structure, construction	<b>構造<b> <br> こうぞう <br>[sound:k-3151_構造.mp3]
[sound:k-3151_構造.mp3]	structure, construction<br> <b>構造</b> <br> (こうぞう)
(<b>比例</b>) 努力と成功は比例します。	[sound:s-3151_努力と成功は比例します。.mp3] <br> どりょくとせいこうはひれいします。 <br> Effort and success are proportional.
[sound:s-3141_労組は労働者の権利を守る役割を果たしています。.mp3]	(<b>労組</b>) 労組は労働者の権利を守る役割を果たしています。<br> ろうそはろうどうしゃのけんりをまもるやくわりをはたしています。 <br>Labor unions play a role in protecting the rights of workers.	
構想	[sound:k-3152_構想.mp3]<br>こうそう <br> plan, plot, idea, conception
plan, plot, idea, conception	<b>構想<b> <br> こうそう <br>[sound:k-3152_構想.mp3]
[sound:k-3152_構想.mp3]	plan, plot, idea, conception<br> <b>構想</b> <br> (こうそう)
(<b>異例</b>) 今年の天候は異例の暑さです。	[sound:s-3152_今年の天候は異例の暑さです。.mp3] <br> ことしのてんこうはいれいのあつさです。 <br> This year's weather is unusually hot.
[sound:s-3142_労働省は労働に関する政策を策定しています。.mp3]	(<b>労働省</b>) 労働省は労働に関する政策を策定しています。<br> ろうどうしょうはろうどうにかんするせいさくをさくていしています。 <br>The Ministry of Labor formulates policies related to labor.	
構成	[sound:k-3153_構成.mp3]<br>こうせい <br> organization, organisation, configuration, composition
organization, organisation, configuration, composition	<b>構成<b> <br> こうせい <br>[sound:k-3153_構成.mp3]
[sound:k-3153_構成.mp3]	organization, organisation, configuration, composition<br> <b>構成</b> <br> (こうせい)
(<b>特例</b>) 特例が適用されました。	[sound:s-3153_特例が適用されました。.mp3] <br> とくれいがてきようされました。 <br> An exception was applied.
[sound:s-3143_労働党は労働者の利益を代表しています。.mp3]	(<b>労働党</b>) 労働党は労働者の利益を代表しています。<br> ろうどうとうはろうどうしゃのりえきをだいひょうしています。 <br>The Labor Party represents the interests of workers.	
構築	[sound:k-3154_構築.mp3]<br>こうちく <br> construction
construction	<b>構築<b> <br> こうちく <br>[sound:k-3154_構築.mp3]
[sound:k-3154_構築.mp3]	construction<br> <b>構築</b> <br> (こうちく)
(<b>例外</b>) この規則にはいくつかの例外があります。	[sound:s-3154_この規則にはいくつかの例外があります。.mp3] <br> このきそくにはいくつかのれいがあります。 <br> There are some exceptions to this rule.
[sound:s-3144_彼は苦労して成功を手に入れました。.mp3]	(<b>苦労</b>) 彼は苦労して成功を手に入れました。<br> かれはくろうしてせいこうをてにいれました。 <br>He struggled and achieved success.	
構図	[sound:k-3155_構図.mp3]<br>こうず <br> composition
composition	<b>構図<b> <br> こうず <br>[sound:k-3155_構図.mp3]
[sound:k-3155_構図.mp3]	composition<br> <b>構図</b> <br> (こうず)
(<b>例年</b>) 例年、その地域では雨季が始まります。	[sound:s-3155_例年、その地域では雨季が始まります。.mp3] <br> れいねん、そのちいきではうきがはじまります。 <br> Usually, the rainy season begins in that region.
[sound:s-3145_労使間の対立が解消されました。.mp3]	(<b>労使</b>) 労使間の対立が解消されました。<br> ろうしまんのたいりつがかいしょうされました。 <br>The conflict between labor and management has been resolved.	
結構	[sound:k-3156_結構.mp3]<br>けっこう <br> splendid, nice, wonderful, delicious, sweet; sufficient, fine (in the sense of "I'm fine"), (by implication) no thank you; well enough, OK, tolerable; reasonably, fairly, tolerably; construction, architecture
splendid, nice, wonderful, delicious, sweet; sufficient, fine (in the sense of "I'm fine"), (by implication) no thank you; well enough, OK, tolerable; reasonably, fairly, tolerably; construction, architecture	<b>結構<b> <br> けっこう <br>[sound:k-3156_結構.mp3]
[sound:k-3156_結構.mp3]	splendid, nice, wonderful, delicious, sweet; sufficient, fine<br> <b>in the sense of "I'm fine"), (by implication) no thank you; well enough, OK, tolerable; reasonably, fairly, tolerably; construction, architecture (結構</b> <br> (けっこう)
(<b>条例</b>) この条例は市民の安全を保障します。	[sound:s-3156_この条例は市民の安全を保障します。.mp3] <br> このじょうれいはしみんのあんぜんをほしょうします。 <br> This ordinance ensures the safety of citizens.
[sound:s-3146_労働組合は労働者の権利を守るために存在します。.mp3]	(<b>労働組合</b>) 労働組合は労働者の権利を守るために存在します。<br> ろうどうくみあいはろうどうしゃのけんりをまもるためにそんざいします。 <br>Labor unions exist to protect the rights of workers.	
構う	[sound:k-3157_構う.mp3]<br>かまう <br> to mind, to care about, to be concerned about; to care for, to look after; to prepare for; to intefere with, to meddle in; to tease
to mind, to care about, to be concerned about; to care for, to look after; to prepare for; to intefere with, to meddle in; to tease	<b>構う<b> <br> かまう <br>[sound:k-3157_構う.mp3]
[sound:k-3157_構う.mp3]	to mind, to care about, to be concerned about; to care for, to look after; to prepare for; to intefere with, to meddle in; to tease<br> <b>構う</b> <br> (かまう)
(<b>定例</b>) 定例会議は毎月第一金曜日に開催されます。	[sound:s-3157_定例会議は毎月第一金曜日に開催されます。.mp3] <br> ていれいかいぎはまいつきだいいちきんようびにかいさいされます。 <br> Regular meetings are held on the first Friday of every month.
[sound:s-3147_長時間の仕事で彼は疲労困憊している。.mp3]	(<b>疲労</b>) 長時間の仕事で彼は疲労困憊している。<br> ちょうじかんのしごとでかれはひろうこんぱいしています。 <br>He is exhausted from long hours of work.	
構内	[sound:k-3158_構内.mp3]<br>こうない <br> premises, grounds, campus, in-house
premises, grounds, campus, in-house	<b>構内<b> <br> こうない <br>[sound:k-3158_構内.mp3]
[sound:k-3158_構内.mp3]	premises, grounds, campus, in-house<br> <b>構内</b> <br> (こうない)
(<b>事例</b>) その事例は問題解決のヒントを与えてくれるかもしれません。	[sound:s-3158_その事例は問題解決のヒントを与えてくれるかもしれません。.mp3] <br> そのじれいはもんだいかいけつのヒントをあたえてくれるかもしれません。 <br> That case might provide clues for problem-solving.
[sound:s-3148_労働組合連合会は労働者の利益を代表しています。.mp3]	(<b>労連</b>) 労働組合連合会は労働者の利益を代表しています。<br> ろうどうくみあいれんごうかいはろうどうしゃのりえきをだいひょうしています。 <br>The Federation of Labor Unions represents the interests of workers.	
心構え	[sound:k-3159_心構え.mp3]<br>こころがまえ <br> preparedness, readiness
preparedness, readiness	<b>心構え<b> <br> こころがまえ <br>[sound:k-3159_心構え.mp3]
[sound:k-3159_心構え.mp3]	preparedness, readiness<br> <b>心構え</b> <br> (こころがまえ)
(<b>自衛隊</b>) 自衛隊は国の安全を守る役割を果たしています。	[sound:s-3159_自衛隊は国の安全を守る役割を果たしています。.mp3] <br> じえいたいはくにのあんぜんをまもるやくわりをはたしています。 <br> The Self-Defense Forces play a role in protecting the country's security.
[sound:s-3149_彼は良い例を示しました。.mp3]	(<b>例</b>) 彼は良い例を示しました。<br> かれはよいれいをしめしました。 <br>He set a good example.	
木	[sound:k-3160_木.mp3]<br>き <br> tree, wood, timber
tree, wood, timber	<b>木<b> <br> き <br>[sound:k-3160_木.mp3]
[sound:k-3160_木.mp3]	tree, wood, timber<br> <b>木</b> <br> (き)
(<b>防衛</b>) 防衛のために新しい施設が建設されました。	[sound:s-3160_防衛のために新しい施設が建設されました。.mp3] <br> ぼうえいのためにあたらしいしせつがけんせつされました。 <br> New facilities have been built for defense purposes.
[sound:s-3150_例えば、彼はとても親切です。.mp3]	(<b>例えば</b>) 例えば、彼はとても親切です。<br> たとえば、かれはとてもしんせつです。 <br>For example, he is very kind.	
青木	[sound:k-3161_青木.mp3]<br>あおき, アオキ <br> Japanese laurel, spotted laurel, Aucuba japonica; live tree
Japanese laurel, spotted laurel, Aucuba japonica; live tree	<b>青木<b> <br> あおき, アオキ <br>[sound:k-3161_青木.mp3]
[sound:k-3161_青木.mp3]	Japanese laurel, spotted laurel, Aucuba japonica; live tree<br> <b>青木</b> <br> (あおき, アオキ)
(<b>衛星</b>) 衛星は地球の周りを回っています。	[sound:s-3161_衛星は地球の周りを回っています。.mp3] <br> えいせいはちきゅうのまわりをまわっています。 <br> Satellites orbit the Earth.
[sound:s-3151_努力と成功は比例します。.mp3]	(<b>比例</b>) 努力と成功は比例します。<br> どりょくとせいこうはひれいします。 <br>Effort and success are proportional.	
木造	[sound:k-3162_木造.mp3]<br>もくぞう <br> wooden, made of wood
wooden, made of wood	<b>木造<b> <br> もくぞう <br>[sound:k-3162_木造.mp3]
[sound:k-3162_木造.mp3]	wooden, made of wood<br> <b>木造</b> <br> (もくぞう)
(<b>防衛庁</b>) 防衛庁は国の安全保障に関する政策を策定しています。	[sound:s-3162_防衛庁は国の安全保障に関する政策を策定しています。.mp3] <br> ぼうえいちょうはくにのあんぜんほしょうにかんするせいさくをさくていしています。 <br> The Defense Agency formulates policies related to national security.
[sound:s-3152_今年の天候は異例の暑さです。.mp3]	(<b>異例</b>) 今年の天候は異例の暑さです。<br> ことしのてんこうはいれいのあつさです。 <br>This year's weather is unusually hot.	
土木	[sound:k-3163_土木.mp3]<br>どぼく <br> public works
public works	<b>土木<b> <br> どぼく <br>[sound:k-3163_土木.mp3]
[sound:k-3163_土木.mp3]	public works<br> <b>土木</b> <br> (どぼく)
(<b>衛生</b>) 衛生には十分な注意が必要です。	[sound:s-3163_衛生には十分な注意が必要です。.mp3] <br> えいせいにはじゅうぶんなちゅういがひつようです。 <br> Proper hygiene requires careful attention.
[sound:s-3153_特例が適用されました。.mp3]	(<b>特例</b>) 特例が適用されました。<br> とくれいがてきようされました。 <br>An exception was applied.	
木材	[sound:k-3164_木材.mp3]<br>もくざい <br> lumber, timber, wood
lumber, timber, wood	<b>木材<b> <br> もくざい <br>[sound:k-3164_木材.mp3]
[sound:k-3164_木材.mp3]	lumber, timber, wood<br> <b>木材</b> <br> (もくざい)
(<b>自衛</b>) 彼らは自衛のために武器を持っています。	[sound:s-3164_彼らは自衛のために武器を持っています。.mp3] <br> かれらはじえいのためにぶきをもっています。 <br> They have weapons for self-defense.
[sound:s-3154_この規則にはいくつかの例外があります。.mp3]	(<b>例外</b>) この規則にはいくつかの例外があります。<br> このきそくにはいくつかのれいがあります。 <br>There are some exceptions to this rule.	
荒木	[sound:k-3165_荒木.mp3]<br>あらき <br> logs in bark, rough wood
logs in bark, rough wood	<b>荒木<b> <br> あらき <br>[sound:k-3165_荒木.mp3]
[sound:k-3165_荒木.mp3]	logs in bark, rough wood<br> <b>荒木</b> <br> (あらき)
(<b>自衛官</b>) 自衛官は日々国の安全を守っています。	[sound:s-3165_自衛官は日々国の安全を守っています。.mp3] <br> じえいかんはひびくにのあんぜんをまもっています。 <br> Self-Defense Forces personnel protect the country's security every day.
[sound:s-3155_例年、その地域では雨季が始まります。.mp3]	(<b>例年</b>) 例年、その地域では雨季が始まります。<br> れいねん、そのちいきではうきがはじまります。 <br>Usually, the rainy season begins in that region.	
樹木	[sound:k-3166_樹木.mp3]<br>じゅもく <br> trees and shrubs, arbour, arbor
trees and shrubs, arbour, arbor	<b>樹木<b> <br> じゅもく <br>[sound:k-3166_樹木.mp3]
[sound:k-3166_樹木.mp3]	trees and shrubs, arbour, arbor<br> <b>樹木</b> <br> (じゅもく)
(<b>陸上自衛隊</b>) 陸上自衛隊は陸上での国防を担当しています。	[sound:s-3166_陸上自衛隊は陸上での国防を担当しています。.mp3] <br> りくじょうじえいたいはりくじょうでのこくぼうをたんとうしています。 <br> The Ground Self-Defense Forces are responsible for defense on land.
[sound:s-3156_この条例は市民の安全を保障します。.mp3]	(<b>条例</b>) この条例は市民の安全を保障します。<br> このじょうれいはしみんのあんぜんをほしょうします。 <br>This ordinance ensures the safety of citizens.	
木曜	[sound:k-3167_木曜.mp3]<br>もくよう <br> Thursday
Thursday	<b>木曜<b> <br> もくよう <br>[sound:k-3167_木曜.mp3]
[sound:k-3167_木曜.mp3]	Thursday<br> <b>木曜</b> <br> (もくよう)
(<b>通信衛星</b>) 通信衛星は地球上の通信網を支えています。	[sound:s-3167_通信衛星は地球上の通信網を支えています。.mp3] <br> つうしんえいせいはちきゅうじょうのつうしんもうをささえています。 <br> Communication satellites support the communication network on Earth.
[sound:s-3157_定例会議は毎月第一金曜日に開催されます。.mp3]	(<b>定例</b>) 定例会議は毎月第一金曜日に開催されます。<br> ていれいかいぎはまいつきだいいちきんようびにかいさいされます。 <br>Regular meetings are held on the first Friday of every month.	
木星	[sound:k-3168_木星.mp3]<br>もくせい <br> Jupiter (planet)
Jupiter (planet)	<b>木星<b> <br> もくせい <br>[sound:k-3168_木星.mp3]
[sound:k-3168_木星.mp3]	Jupiter<br> <b>planet) (木星</b> <br> (もくせい)
(<b>海上自衛隊</b>) 海上自衛隊は海洋での安全を守る任務を担っています。	[sound:s-3168_海上自衛隊は海洋での安全を守る任務を担っています。.mp3] <br> かいじょうじえいたいはかいようでのあんぜんをまもるにんむをたんっています。 <br> The Maritime Self-Defense Force is tasked with ensuring safety at sea.
[sound:s-3158_その事例は問題解決のヒントを与えてくれるかもしれません。.mp3]	(<b>事例</b>) その事例は問題解決のヒントを与えてくれるかもしれません。<br> そのじれいはもんだいかいけつのヒントをあたえてくれるかもしれません。 <br>That case might provide clues for problem-solving.	
木製	[sound:k-3169_木製.mp3]<br>もくせい <br> wooden, made of wood
wooden, made of wood	<b>木製<b> <br> もくせい <br>[sound:k-3169_木製.mp3]
[sound:k-3169_木製.mp3]	wooden, made of wood<br> <b>木製</b> <br> (もくせい)
(<b>地検</b>) 地検は犯罪捜査を行います。	[sound:s-3169_地検は犯罪捜査を行います。.mp3] <br> ちけんははんざいそうさをおこないます。 <br> The district prosecutor's office conducts criminal investigations.
[sound:s-3159_自衛隊は国の安全を守る役割を果たしています。.mp3]	(<b>自衛隊</b>) 自衛隊は国の安全を守る役割を果たしています。<br> じえいたいはくにのあんぜんをまもるやくわりをはたしています。 <br>The Self-Defense Forces play a role in protecting the country's security.	
割り	[sound:k-3170_割り.mp3]<br>わり <br> rate, ratio, proportion, percentage; profit; assignment; 10%, unit of ten percent; sumo match, schedule of sumo matches; diluted with (of drinks), mixed with
rate, ratio, proportion, percentage; profit; assignment; 10%, unit of ten percent; sumo match, schedule of sumo matches; diluted with (of drinks), mixed with	<b>割り<b> <br> わり <br>[sound:k-3170_割り.mp3]
[sound:k-3170_割り.mp3]	rate, ratio, proportion, percentage; profit; assignment; 10%, unit of ten percent; sumo match, schedule of sumo matches; diluted with<br> <b>of drinks), mixed with (割り</b> <br> (わり)
(<b>合</b>) 彼らは手を合わせて祈りました。	[sound:s-3170_彼らは手を合わせて祈りました。.mp3] <br> かれらはてをあわせていのりました。 <br> They clasped their hands together and prayed.
[sound:s-3160_防衛のために新しい施設が建設されました。.mp3]	(<b>防衛</b>) 防衛のために新しい施設が建設されました。<br> ぼうえいのためにあたらしいしせつがけんせつされました。 <br>New facilities have been built for defense purposes.	
役割	[sound:k-3171_役割.mp3]<br>やくわり <br> part, assigning (allotment of) parts, role, duties
part, assigning (allotment of) parts, role, duties	<b>役割<b> <br> やくわり <br>[sound:k-3171_役割.mp3]
[sound:k-3171_役割.mp3]	part, assigning<br> <b>allotment of) parts, role, duties (役割</b> <br> (やくわり)
(<b>合意</b>) 交渉の結果、両者は合意に達した。	[sound:s-3171_交渉の結果、両者は合意に達した。.mp3] <br> こうしょうのけっか、りょうしゃはごういにたっした。 <br> As a result of negotiations, both parties reached an agreement.
[sound:s-3161_衛星は地球の周りを回っています。.mp3]	(<b>衛星</b>) 衛星は地球の周りを回っています。<br> えいせいはちきゅうのまわりをまわっています。 <br>Satellites orbit the Earth.	
割合	[sound:k-3172_割合.mp3]<br>わりあい <br> rate, ratio, percentage, proportion; comparatively; contrary to expectations
rate, ratio, percentage, proportion; comparatively; contrary to expectations	<b>割合<b> <br> わりあい <br>[sound:k-3172_割合.mp3]
[sound:k-3172_割合.mp3]	rate, ratio, percentage, proportion; comparatively; contrary to expectations<br> <b>割合</b> <br> (わりあい)
(<b>試合</b>) 明日、サッカーの試合があります。	[sound:s-3172_明日、サッカーの試合があります。.mp3] <br> あした、さっかーのしあいがあります。 <br> There's a soccer match tomorrow.
[sound:s-3162_防衛庁は国の安全保障に関する政策を策定しています。.mp3]	(<b>防衛庁</b>) 防衛庁は国の安全保障に関する政策を策定しています。<br> ぼうえいちょうはくにのあんぜんほしょうにかんするせいさくをさくていしています。 <br>The Defense Agency formulates policies related to national security.	
分割	[sound:k-3173_分割.mp3]<br>ぶんかつ <br> partition, division, separation, segmenting, splitting
partition, division, separation, segmenting, splitting	<b>分割<b> <br> ぶんかつ <br>[sound:k-3173_分割.mp3]
[sound:k-3173_分割.mp3]	partition, division, separation, segmenting, splitting<br> <b>分割</b> <br> (ぶんかつ)
(<b>連合</b>) 労働組合は連合して行動します。	[sound:s-3173_労働組合は連合して行動します。.mp3] <br> ろうどうくみあいはれんごうしてこうどうします。 <br> Labor unions collaborate and take action together.
[sound:s-3163_衛生には十分な注意が必要です。.mp3]	(<b>衛生</b>) 衛生には十分な注意が必要です。<br> えいせいにはじゅうぶんなちゅういがひつようです。 <br>Proper hygiene requires careful attention.	
割引	[sound:k-3174_割引.mp3]<br>わりびき <br> discount, reduction, rebate, tenths discounted
discount, reduction, rebate, tenths discounted	<b>割引<b> <br> わりびき <br>[sound:k-3174_割引.mp3]
[sound:k-3174_割引.mp3]	discount, reduction, rebate, tenths discounted<br> <b>割引</b> <br> (わりびき)
(<b>総合</b>) この報告書は総合的な分析を提供しています。	[sound:s-3174_この報告書は総合的な分析を提供しています。.mp3] <br> このほうこくしょはそうごうてきなぶんせきをていきょうしています。 <br> This report provides a comprehensive analysis.
[sound:s-3164_彼らは自衛のために武器を持っています。.mp3]	(<b>自衛</b>) 彼らは自衛のために武器を持っています。<br> かれらはじえいのためにぶきをもっています。 <br>They have weapons for self-defense.	
割高	[sound:k-3175_割高.mp3]<br>わりだか <br> comparatively high, fairly expensive
comparatively high, fairly expensive	<b>割高<b> <br> わりだか <br>[sound:k-3175_割高.mp3]
[sound:k-3175_割高.mp3]	comparatively high, fairly expensive<br> <b>割高</b> <br> (わりだか)
(<b>問い合わせ</b>) 質問や疑問があれば、お問い合わせください。	[sound:s-3175_質問や疑問があれば、お問い合わせください。.mp3] <br> しつもんやぎもんがあれば、おといあわせください。 <br> If you have any questions or concerns, please inquire.
[sound:s-3165_自衛官は日々国の安全を守っています。.mp3]	(<b>自衛官</b>) 自衛官は日々国の安全を守っています。<br> じえいかんはひびくにのあんぜんをまもっています。 <br>Self-Defense Forces personnel protect the country's security every day.	
割安	[sound:k-3176_割安.mp3]<br>わりやす <br> economical, comparatively cheap
economical, comparatively cheap	<b>割安<b> <br> わりやす <br>[sound:k-3176_割安.mp3]
[sound:k-3176_割安.mp3]	economical, comparatively cheap<br> <b>割安</b> <br> (わりやす)
(<b>会合</b>) 今夜は友人との会合があります。	[sound:s-3176_今夜は友人との会合があります。.mp3] <br> こんやはゆうじんとのかいごうがあります。 <br> There's a gathering with friends tonight.
[sound:s-3166_陸上自衛隊は陸上での国防を担当しています。.mp3]	(<b>陸上自衛隊</b>) 陸上自衛隊は陸上での国防を担当しています。<br> りくじょうじえいたいはりくじょうでのこくぼうをたんとうしています。 <br>The Ground Self-Defense Forces are responsible for defense on land.	
割引債	[sound:k-3177_割引債.mp3]<br>わりびきさい <br> discount bond
discount bond	<b>割引債<b> <br> わりびきさい <br>[sound:k-3177_割引債.mp3]
[sound:k-3177_割引債.mp3]	discount bond<br> <b>割引債</b> <br> (わりびきさい)
(<b>組合</b>) 労働組合は労働者の権利を守ります。	[sound:s-3177_労働組合は労働者の権利を守ります。.mp3] <br> ろうどうくみあいはろうどうしゃのけんりをまもります。 <br> Labor unions protect the rights of workers.
[sound:s-3167_通信衛星は地球上の通信網を支えています。.mp3]	(<b>通信衛星</b>) 通信衛星は地球上の通信網を支えています。<br> つうしんえいせいはちきゅうじょうのつうしんもうをささえています。 <br>Communication satellites support the communication network on Earth.	
割り当て	[sound:k-3178_割り当て.mp3]<br>わりあて, かっとう <br> allotment, assignment, allocation, quota, rationing; binding
allotment, assignment, allocation, quota, rationing; binding	<b>割り当て<b> <br> わりあて, かっとう <br>[sound:k-3178_割り当て.mp3]
[sound:k-3178_割り当て.mp3]	allotment, assignment, allocation, quota, rationing; binding<br> <b>割り当て</b> <br> (わりあて, かっとう)
(<b>統合</b>) 両社は統合して一つの会社となった。	[sound:s-3178_両社は統合して一つの会社となった。.mp3] <br> りょうしゃはとうごうしてひとつのかいしゃとなった。 <br> The two companies merged and became one corporation.
[sound:s-3168_海上自衛隊は海洋での安全を守る任務を担っています。.mp3]	(<b>海上自衛隊</b>) 海上自衛隊は海洋での安全を守る任務を担っています。<br> かいじょうじえいたいはかいようでのあんぜんをまもるにんむをたんっています。 <br>The Maritime Self-Defense Force is tasked with ensuring safety at sea.	
割り出す	[sound:k-3179_割り出す.mp3]<br>わりだす <br> to calculate, to compute, to infer
to calculate, to compute, to infer	<b>割り出す<b> <br> わりだす <br>[sound:k-3179_割り出す.mp3]
[sound:k-3179_割り出す.mp3]	to calculate, to compute, to infer<br> <b>割り出す</b> <br> (わりだす)
(<b>合う</b>) この服は彼に合っています。	[sound:s-3179_この服は彼に合っています。.mp3] <br> このふくはかれにあっています。 <br> This clothes suits him.
[sound:s-3169_地検は犯罪捜査を行います。.mp3]	(<b>地検</b>) 地検は犯罪捜査を行います。<br> ちけんははんざいそうさをおこないます。 <br>The district prosecutor's office conducts criminal investigations.	
聞かす	[sound:k-3180_聞かす.mp3]<br>きかす <br> to inform about, to read to, to sing for
to inform about, to read to, to sing for	<b>聞かす<b> <br> きかす <br>[sound:k-3180_聞かす.mp3]
[sound:k-3180_聞かす.mp3]	to inform about, to read to, to sing for<br> <b>聞かす</b> <br> (きかす)
(<b>市場</b>) 町の中心には市場があります。	[sound:s-3180_町の中心には市場があります。.mp3] <br> まちのちゅうしんにはいちばがあります。 <br> There is a market at the center of the town.
[sound:s-3170_彼らは手を合わせて祈りました。.mp3]	(<b>合</b>) 彼らは手を合わせて祈りました。<br> かれらはてをあわせていのりました。 <br>They clasped their hands together and prayed.	
新聞	[sound:k-3181_新聞.mp3]<br>しんぶん <br> newspaper
newspaper	<b>新聞<b> <br> しんぶん <br>[sound:k-3181_新聞.mp3]
[sound:k-3181_新聞.mp3]	newspaper<br> <b>新聞</b> <br> (しんぶん)
(<b>市内</b>) 地元の人々は市内で買い物をします。	[sound:s-3181_地元の人々は市内で買い物をします。.mp3] <br> じもとのひとびとはしないでかいものをします。 <br> Local people shop in the city.
[sound:s-3171_交渉の結果、両者は合意に達した。.mp3]	(<b>合意</b>) 交渉の結果、両者は合意に達した。<br> こうしょうのけっか、りょうしゃはごういにたっした。 <br>As a result of negotiations, both parties reached an agreement.	
新聞社	[sound:k-3182_新聞社.mp3]<br>しんぶんしゃ <br> newspaper company
newspaper company	<b>新聞社<b> <br> しんぶんしゃ <br>[sound:k-3182_新聞社.mp3]
[sound:k-3182_新聞社.mp3]	newspaper company<br> <b>新聞社</b> <br> (しんぶんしゃ)
(<b>市民</b>) 市民は地方の発展に貢献します。	[sound:s-3182_市民は地方の発展に貢献します。.mp3] <br> しみんはちほうのはってんにこうけんします。 <br> Citizens contribute to the development of the region.
[sound:s-3172_明日、サッカーの試合があります。.mp3]	(<b>試合</b>) 明日、サッカーの試合があります。<br> あした、さっかーのしあいがあります。 <br>There's a soccer match tomorrow.	
聞き手	[sound:k-3183_聞き手.mp3]<br>ききて <br> hearer, listener, audience; interviewer, questioner
hearer, listener, audience; interviewer, questioner	<b>聞き手<b> <br> ききて <br>[sound:k-3183_聞き手.mp3]
[sound:k-3183_聞き手.mp3]	hearer, listener, audience; interviewer, questioner<br> <b>聞き手</b> <br> (ききて)
(<b>都市</b>) 東京は世界有数の大都市です。	[sound:s-3183_東京は世界有数の大都市です。.mp3] <br> とうきょうはせかいゆうすうのだいとしです。 <br> Tokyo is one of the world's largest cities.
[sound:s-3173_労働組合は連合して行動します。.mp3]	(<b>連合</b>) 労働組合は連合して行動します。<br> ろうどうくみあいはれんごうしてこうどうします。 <br>Labor unions collaborate and take action together.	
新聞紙	[sound:k-3184_新聞紙.mp3]<br>しんぶんし <br> newsprint, newspaper
newsprint, newspaper	<b>新聞紙<b> <br> しんぶんし <br>[sound:k-3184_新聞紙.mp3]
[sound:k-3184_新聞紙.mp3]	newsprint, newspaper<br> <b>新聞紙</b> <br> (しんぶんし)
(<b>同市</b>) 彼らは同市で会った。	[sound:s-3184_彼らは同市で会った。.mp3] <br> かれらはどうしであった。 <br> They met in the same city.
[sound:s-3174_この報告書は総合的な分析を提供しています。.mp3]	(<b>総合</b>) この報告書は総合的な分析を提供しています。<br> このほうこくしょはそうごうてきなぶんせきをていきょうしています。 <br>This report provides a comprehensive analysis.	
前代未聞	[sound:k-3185_前代未聞.mp3]<br>ぜんだいみもん <br> unheard-of, unprecedented, unparalleled in history (unparallelled), record-breaking
unheard-of, unprecedented, unparalleled in history (unparallelled), record-breaking	<b>前代未聞<b> <br> ぜんだいみもん <br>[sound:k-3185_前代未聞.mp3]
[sound:k-3185_前代未聞.mp3]	unheard-of, unprecedented, unparalleled in history<br> <b>unparallelled), record-breaking (前代未聞</b> <br> (ぜんだいみもん)
(<b>市長</b>) 彼は新しい市長に選ばれました。	[sound:s-3185_彼は新しい市長に選ばれました。.mp3] <br> かれはあたらしいしちょうにえらばれました。 <br> He was elected as the new mayor.
[sound:s-3175_質問や疑問があれば、お問い合わせください。.mp3]	(<b>問い合わせ</b>) 質問や疑問があれば、お問い合わせください。<br> しつもんやぎもんがあれば、おといあわせください。 <br>If you have any questions or concerns, please inquire.	
新聞記事	[sound:k-3186_新聞記事.mp3]<br>しんぶんきじ <br> newspaper story (article, account)
newspaper story (article, account)	<b>新聞記事<b> <br> しんぶんきじ <br>[sound:k-3186_新聞記事.mp3]
[sound:k-3186_新聞記事.mp3]	newspaper story<br> <b>article, account) (新聞記事</b> <br> (しんぶんきじ)
(<b>市町村</b>) この地域には多くの市町村があります。	[sound:s-3186_この地域には多くの市町村があります。.mp3] <br> このちいきにはおおくのしちょうそんがあります。 <br> There are many towns and villages in this area.
[sound:s-3176_今夜は友人との会合があります。.mp3]	(<b>会合</b>) 今夜は友人との会合があります。<br> こんやはゆうじんとのかいごうがあります。 <br>There's a gathering with friends tonight.	
聞き書き	[sound:k-3187_聞き書き.mp3]<br>ききがき <br> account of what one hears
account of what one hears	<b>聞き書き<b> <br> ききがき <br>[sound:k-3187_聞き書き.mp3]
[sound:k-3187_聞き書き.mp3]	account of what one hears<br> <b>聞き書き</b> <br> (ききがき)
(<b>市立</b>) その公園は市立のものです。	[sound:s-3187_その公園は市立のものです。.mp3] <br> そのこうえんはしりつのものです。 <br> The park is owned by the city.
[sound:s-3177_労働組合は労働者の権利を守ります。.mp3]	(<b>組合</b>) 労働組合は労働者の権利を守ります。<br> ろうどうくみあいはろうどうしゃのけんりをまもります。 <br>Labor unions protect the rights of workers.	
聞こえる	[sound:k-3188_聞こえる.mp3]<br>きこえる <br> to be heard, to be audible; to be said to be, to be reputed
to be heard, to be audible; to be said to be, to be reputed	<b>聞こえる<b> <br> きこえる <br>[sound:k-3188_聞こえる.mp3]
[sound:k-3188_聞こえる.mp3]	to be heard, to be audible; to be said to be, to be reputed<br> <b>聞こえる</b> <br> (きこえる)
(<b>市議</b>) 彼は市議会のメンバーです。	[sound:s-3188_彼は市議会のメンバーです。.mp3] <br> かれはしぎかいのメンバーです。 <br> He is a member of the city council.
[sound:s-3178_両社は統合して一つの会社となった。.mp3]	(<b>統合</b>) 両社は統合して一つの会社となった。<br> りょうしゃはとうごうしてひとつのかいしゃとなった。 <br>The two companies merged and became one corporation.	
聞き取り	[sound:k-3189_聞き取り.mp3]<br>ききとり <br> listening comprehension
listening comprehension	<b>聞き取り<b> <br> ききとり <br>[sound:k-3189_聞き取り.mp3]
[sound:k-3189_聞き取り.mp3]	listening comprehension<br> <b>聞き取り</b> <br> (ききとり)
(<b>市中</b>) 夜には市中が静かになります。	[sound:s-3189_夜には市中が静かになります。.mp3] <br> よるにはしちゅうがしずかになります。 <br> The city becomes quiet at night.
[sound:s-3179_この服は彼に合っています。.mp3]	(<b>合う</b>) この服は彼に合っています。<br> このふくはかれにあっています。 <br>This clothes suits him.	
身	[sound:k-3190_身.mp3]<br>み <br> body; oneself; one's place, one's position; main part, meat (as opposed to bone, skin, etc.), wood (as opposed to bark), blade (as opposed to its handle), container(as opposed to its lid)
body; oneself; one's place, one's position; main part, meat (as opposed to bone, skin, etc.), wood (as opposed to bark), blade (as opposed to its handle), container(as opposed to its lid)	<b>身<b> <br> み <br>[sound:k-3190_身.mp3]
[sound:k-3190_身.mp3]	body; oneself; one's place, one's position; main part, meat<br> <b>as opposed to bone, skin, etc.), wood (as opposed to bark), blade (as opposed to its handle), container(as opposed to its lid) (身</b> <br> (み)
(<b>業</b>) 彼は芸術の業に身を捧げている。	[sound:s-3190_彼は芸術の業に身を捧げている。.mp3] <br> かれはげいじゅつのわざにみをささげている。 <br> He has devoted himself to the art profession.
[sound:s-3180_町の中心には市場があります。.mp3]	(<b>市場</b>) 町の中心には市場があります。<br> まちのちゅうしんにはいちばがあります。 <br>There is a market at the center of the town.	
自身	[sound:k-3191_自身.mp3]<br>じしん <br> by oneself, personally
by oneself, personally	<b>自身<b> <br> じしん <br>[sound:k-3191_自身.mp3]
[sound:k-3191_自身.mp3]	by oneself, personally<br> <b>自身</b> <br> (じしん)
(<b>企業</b>) この地域には多くの大企業があります。	[sound:s-3191_この地域には多くの大企業があります。.mp3] <br> このちいきにはおおくのだいきぎょうがあります。 <br> There are many large corporations in this area.
[sound:s-3181_地元の人々は市内で買い物をします。.mp3]	(<b>市内</b>) 地元の人々は市内で買い物をします。<br> じもとのひとびとはしないでかいものをします。 <br>Local people shop in the city.	
出身	[sound:k-3192_出身.mp3]<br>しゅっしん <br> person's origin (town, city, country, etc.); institution from which one graduated; director in charge of employee relations
person's origin (town, city, country, etc.); institution from which one graduated; director in charge of employee relations	<b>出身<b> <br> しゅっしん <br>[sound:k-3192_出身.mp3]
[sound:k-3192_出身.mp3]	person's origin<br> <b>town, city, country, etc.); institution from which one graduated; director in charge of employee relations (出身</b> <br> (しゅっしん)
(<b>業界</b>) 彼はIT業界で成功しました。	[sound:s-3192_彼はIT業界で成功しました。.mp3] <br> かれはITぎょうかいでせいこうしました。 <br> He succeeded in the IT industry.
[sound:s-3182_市民は地方の発展に貢献します。.mp3]	(<b>市民</b>) 市民は地方の発展に貢献します。<br> しみんはちほうのはってんにこうけんします。 <br>Citizens contribute to the development of the region.	
中身	[sound:k-3193_中身.mp3]<br>なかみ <br> contents, interior, substance, filling, (sword) blade
contents, interior, substance, filling, (sword) blade	<b>中身<b> <br> なかみ <br>[sound:k-3193_中身.mp3]
[sound:k-3193_中身.mp3]	contents, interior, substance, filling,<br> <b>sword) blade (中身</b> <br> (なかみ)
(<b>業者</b>) その店は信頼できる業者です。	[sound:s-3193_その店は信頼できる業者です。.mp3] <br> そのみせはしんらいできるぎょうしゃです。 <br> That shop is a reliable business.
[sound:s-3183_東京は世界有数の大都市です。.mp3]	(<b>都市</b>) 東京は世界有数の大都市です。<br> とうきょうはせかいゆうすうのだいとしです。 <br>Tokyo is one of the world's largest cities.	
身長	[sound:k-3194_身長.mp3]<br>しんちょう <br> height (of body), stature
height (of body), stature	<b>身長<b> <br> しんちょう <br>[sound:k-3194_身長.mp3]
[sound:k-3194_身長.mp3]	height<br> <b>of body), stature (身長</b> <br> (しんちょう)
(<b>作業</b>) 彼らは一緒に作業を行いました。	[sound:s-3194_彼らは一緒に作業を行いました。.mp3] <br> かれらはいっしょにさぎょうをおこないました。 <br> They worked together.
[sound:s-3184_彼らは同市で会った。.mp3]	(<b>同市</b>) 彼らは同市で会った。<br> かれらはどうしであった。 <br>They met in the same city.	
全身	[sound:k-3195_全身.mp3]<br>ぜんしん <br> whole (body), full-length (e.g. portrait); systemic
whole (body), full-length (e.g. portrait); systemic	<b>全身<b> <br> ぜんしん <br>[sound:k-3195_全身.mp3]
[sound:k-3195_全身.mp3]	whole<br> <b>body), full-length (e.g. portrait); systemic (全身</b> <br> (ぜんしん)
(<b>産業</b>) 自動車産業はこの地域の主要産業です。	[sound:s-3195_自動車産業はこの地域の主要産業です。.mp3] <br> じどうしゃさんぎょうはこのちいきのしゅようさんぎょうです。 <br> The automobile industry is the main industry in this region.
[sound:s-3185_彼は新しい市長に選ばれました。.mp3]	(<b>市長</b>) 彼は新しい市長に選ばれました。<br> かれはあたらしいしちょうにえらばれました。 <br>He was elected as the new mayor.	
出身者	[sound:k-3196_出身者.mp3]<br>しゅっしんしゃ <br> alumnus (alumnae), graduate, old boy (girl); former member of an organization; former inhabitant (country, region, etc.)
alumnus (alumnae), graduate, old boy (girl); former member of an organization; former inhabitant (country, region, etc.)	<b>出身者<b> <br> しゅっしんしゃ <br>[sound:k-3196_出身者.mp3]
[sound:k-3196_出身者.mp3]	alumnus<br> <b>alumnae), graduate, old boy (girl); former member of an organization; former inhabitant (country, region, etc.) (出身者</b> <br> (しゅっしんしゃ)
(<b>事業</b>) 彼は新しい事業を立ち上げました。	[sound:s-3196_彼は新しい事業を立ち上げました。.mp3] <br> かれはあたらしいじぎょうをたちあげました。 <br> He started a new business.
[sound:s-3186_この地域には多くの市町村があります。.mp3]	(<b>市町村</b>) この地域には多くの市町村があります。<br> このちいきにはおおくのしちょうそんがあります。 <br>There are many towns and villages in this area.	
単身	[sound:k-3197_単身.mp3]<br>たんしん <br> alone, unaided, away from home
alone, unaided, away from home	<b>単身<b> <br> たんしん <br>[sound:k-3197_単身.mp3]
[sound:k-3197_単身.mp3]	alone, unaided, away from home<br> <b>単身</b> <br> (たんしん)
(<b>農業</b>) この地域は農業が盛んです。	[sound:s-3197_この地域は農業が盛んです。.mp3] <br> このちいきはのうぎょうがさかんです。 <br> Agriculture is thriving in this area.
[sound:s-3187_その公園は市立のものです。.mp3]	(<b>市立</b>) その公園は市立のものです。<br> そのこうえんはしりつのものです。 <br>The park is owned by the city.	
身元	[sound:k-3198_身元.mp3]<br>みもと <br> person's identity, ID, past, background
person's identity, ID, past, background	<b>身元<b> <br> みもと <br>[sound:k-3198_身元.mp3]
[sound:k-3198_身元.mp3]	person's identity, ID, past, background<br> <b>身元</b> <br> (みもと)
(<b>営業</b>) 彼女は営業部長です。	[sound:s-3198_彼女は営業部長です。.mp3] <br> かのじょはえいぎょうぶちょうです。 <br> She is the sales manager.
[sound:s-3188_彼は市議会のメンバーです。.mp3]	(<b>市議</b>) 彼は市議会のメンバーです。<br> かれはしぎかいのメンバーです。 <br>He is a member of the city council.	
独身	[sound:k-3199_独身.mp3]<br>どくしん <br> bachelorhood, single, unmarried, celibate
bachelorhood, single, unmarried, celibate	<b>独身<b> <br> どくしん <br>[sound:k-3199_独身.mp3]
[sound:k-3199_独身.mp3]	bachelorhood, single, unmarried, celibate<br> <b>独身</b> <br> (どくしん)
(<b>業務</b>) その会社は日々の業務を効率的に行っています。	[sound:s-3199_その会社は日々の業務を効率的に行っています。.mp3] <br> そのかいしゃはひびのぎょうむをこうりつてきにおこなっています。 <br> The company efficiently performs its daily operations.
[sound:s-3189_夜には市中が静かになります。.mp3]	(<b>市中</b>) 夜には市中が静かになります。<br> よるにはしちゅうがしずかになります。 <br>The city becomes quiet at night.	
消費	[sound:k-3200_消費.mp3]<br>しょうひ <br> consumption, expenditure
consumption, expenditure	<b>消費<b> <br> しょうひ <br>[sound:k-3200_消費.mp3]
[sound:k-3200_消費.mp3]	consumption, expenditure<br> <b>消費</b> <br> (しょうひ)
(<b>内</b>) 箱の中には何が入っていますか？	[sound:s-3200_箱の中には何が入っていますか？.mp3] <br> はこのなかにはなにがはいっていますか？	What's inside the box?
[sound:s-3190_彼は芸術の業に身を捧げている。.mp3]	(<b>業</b>) 彼は芸術の業に身を捧げている。<br> かれはげいじゅつのわざにみをささげている。 <br>He has devoted himself to the art profession.	
消費者	[sound:k-3201_消費者.mp3]<br>しょうひしゃ <br> consumer
consumer	<b>消費者<b> <br> しょうひしゃ <br>[sound:k-3201_消費者.mp3]
[sound:k-3201_消費者.mp3]	consumer<br> <b>消費者</b> <br> (しょうひしゃ)
(<b>国内</b>) この製品は国内で生産されています。	[sound:s-3201_この製品は国内で生産されています。.mp3] <br> このせいひんはこくないでせいさんされています。 <br> This product is manufactured domestically.
[sound:s-3191_この地域には多くの大企業があります。.mp3]	(<b>企業</b>) この地域には多くの大企業があります。<br> このちいきにはおおくのだいきぎょうがあります。 <br>There are many large corporations in this area.	
消費税	[sound:k-3202_消費税.mp3]<br>しょうひぜい <br> consumption tax (incl. sales tax, VAT, excise duty, etc.)
consumption tax (incl. sales tax, VAT, excise duty, etc.)	<b>消費税<b> <br> しょうひぜい <br>[sound:k-3202_消費税.mp3]
[sound:k-3202_消費税.mp3]	consumption tax<br> <b>incl. sales tax, VAT, excise duty, etc.) (消費税</b> <br> (しょうひぜい)
(<b>市内 (repeated)</b>) 町の中心には市内で買い物をします。	[sound:s-3202_町の中心には市内で買い物をします。.mp3] <br> まちのちゅうしんにはいちないでかいものをします。 <br> People shop within the city center.
[sound:s-3192_彼はIT業界で成功しました。.mp3]	(<b>業界</b>) 彼はIT業界で成功しました。<br> かれはITぎょうかいでせいこうしました。 <br>He succeeded in the IT industry.	
費用	[sound:k-3203_費用.mp3]<br>ひよう <br> cost, expense
cost, expense	<b>費用<b> <br> ひよう <br>[sound:k-3203_費用.mp3]
[sound:k-3203_費用.mp3]	cost, expense<br> <b>費用</b> <br> (ひよう)
(<b>都内</b>) 雨の日は都内の交通が混雑します。	[sound:s-3203_雨の日は都内の交通が混雑します。.mp3] <br> あめのひはとないのこうつうがこんざつします。 <br> Traffic in the city gets congested on rainy days.
[sound:s-3193_その店は信頼できる業者です。.mp3]	(<b>業者</b>) その店は信頼できる業者です。<br> そのみせはしんらいできるぎょうしゃです。 <br>That shop is a reliable business.	
経費	[sound:k-3204_経費.mp3]<br>けいひ <br> expenses, cost, outlay
expenses, cost, outlay	<b>経費<b> <br> けいひ <br>[sound:k-3204_経費.mp3]
[sound:k-3204_経費.mp3]	expenses, cost, outlay<br> <b>経費</b> <br> (けいひ)
(<b>内閣</b>) 内閣は政府の重要な部分です。	[sound:s-3204_内閣は政府の重要な部分です。.mp3] <br> ないかくはせいふのじゅうようなぶぶんです。 <br> The cabinet is an important part of the government.
[sound:s-3194_彼らは一緒に作業を行いました。.mp3]	(<b>作業</b>) 彼らは一緒に作業を行いました。<br> かれらはいっしょにさぎょうをおこないました。 <br>They worked together.	
人件費	[sound:k-3205_人件費.mp3]<br>じんけんひ <br> personnel expenses, labor cost, labour cost; indirect labour costs, indirect labor costs
personnel expenses, labor cost, labour cost; indirect labour costs, indirect labor costs	<b>人件費<b> <br> じんけんひ <br>[sound:k-3205_人件費.mp3]
[sound:k-3205_人件費.mp3]	personnel expenses, labor cost, labour cost; indirect labour costs, indirect labor costs<br> <b>人件費</b> <br> (じんけんひ)
(<b>内容</b>) この本の内容は非常に興味深いです。	[sound:s-3205_この本の内容は非常に興味深いです。.mp3] <br> このほんのないようはひじょうにきょうみぶかいです。 <br> The contents of this book are very interesting.
[sound:s-3195_自動車産業はこの地域の主要産業です。.mp3]	(<b>産業</b>) 自動車産業はこの地域の主要産業です。<br> じどうしゃさんぎょうはこのちいきのしゅようさんぎょうです。 <br>The automobile industry is the main industry in this region.	
会費	[sound:k-3206_会費.mp3]<br>かいひ <br> membership fee
membership fee	<b>会費<b> <br> かいひ <br>[sound:k-3206_会費.mp3]
[sound:k-3206_会費.mp3]	membership fee<br> <b>会費</b> <br> (かいひ)
(<b>以内</b>) 到着は10分以内に予定されています。	[sound:s-3206_到着は10分以内に予定されています。.mp3] <br> とうちゃくはじゅっぷんいないによていされています。 <br> Arrival is scheduled within 10 minutes.
[sound:s-3196_彼は新しい事業を立ち上げました。.mp3]	(<b>事業</b>) 彼は新しい事業を立ち上げました。<br> かれはあたらしいじぎょうをたちあげました。 <br>He started a new business.	
公費	[sound:k-3207_公費.mp3]<br>こうひ <br> public expenditure
public expenditure	<b>公費<b> <br> こうひ <br>[sound:k-3207_公費.mp3]
[sound:k-3207_公費.mp3]	public expenditure<br> <b>公費</b> <br> (こうひ)
(<b>党内</b>) 党内での議論が活発化しています。	[sound:s-3207_党内での議論が活発化しています。.mp3] <br> とうないでのぎろんがかっぱつかしています。 <br> Discussions within the party are becoming lively.
[sound:s-3197_この地域は農業が盛んです。.mp3]	(<b>農業</b>) この地域は農業が盛んです。<br> このちいきはのうぎょうがさかんです。 <br>Agriculture is thriving in this area.	
交際費	[sound:k-3208_交際費.mp3]<br>こうさいひ <br> entertainment expenses
entertainment expenses	<b>交際費<b> <br> こうさいひ <br>[sound:k-3208_交際費.mp3]
[sound:k-3208_交際費.mp3]	entertainment expenses<br> <b>交際費</b> <br> (こうさいひ)
(<b>内部</b>) システムの内部に問題が発生しました。	[sound:s-3208_システムの内部に問題が発生しました。.mp3] <br> しぜむのないぶにもんだいがはっせいしました。 <br> There was an issue within the system.
[sound:s-3198_彼女は営業部長です。.mp3]	(<b>営業</b>) 彼女は営業部長です。<br> かのじょはえいぎょうぶちょうです。 <br>She is the sales manager.	
工費	[sound:k-3209_工費.mp3]<br>こうひ <br> construction cost
construction cost	<b>工費<b> <br> こうひ <br>[sound:k-3209_工費.mp3]
[sound:k-3209_工費.mp3]	construction cost<br> <b>工費</b> <br> (こうひ)
(<b>県内</b>) 県内の交通網を改善する必要があります。	[sound:s-3209_県内の交通網を改善する必要があります。.mp3] <br> けんないのこうつうもうをかいぜんするひつようがあります。 <br> There is a need to improve the transportation network within the prefecture.
[sound:s-3199_その会社は日々の業務を効率的に行っています。.mp3]	(<b>業務</b>) その会社は日々の業務を効率的に行っています。<br> そのかいしゃはひびのぎょうむをこうりつてきにおこなっています。 <br>The company efficiently performs its daily operations.	
付近	[sound:k-3210_付近.mp3]<br>ふきん <br> neighbourhood, neighborhood, vicinity, environs; approaching
neighbourhood, neighborhood, vicinity, environs; approaching	<b>付近<b> <br> ふきん <br>[sound:k-3210_付近.mp3]
[sound:k-3210_付近.mp3]	neighbourhood, neighborhood, vicinity, environs; approaching<br> <b>付近</b> <br> (ふきん)
(<b>外相</b>) 外相は国際関係の調整を行います。	[sound:s-3210_外相は国際関係の調整を行います。.mp3] <br> かいそうはこくさいかんけいのちょうせいをおこないます。 <br> The foreign minister coordinates international relations.
[sound:s-3200_箱の中には何が入っていますか？.mp3]	(<b>内</b>) 箱の中には何が入っていますか？	はこのなかにはなにがはいっていますか？ <br>What's inside the box?
寄付	[sound:k-3211_寄付.mp3]<br>きふ <br> contribution, donation
contribution, donation	<b>寄付<b> <br> きふ <br>[sound:k-3211_寄付.mp3]
[sound:k-3211_寄付.mp3]	contribution, donation<br> <b>寄付</b> <br> (きふ)
(<b>首相</b>) 首相が記者会見を行いました。	[sound:s-3211_首相が記者会見を行いました。.mp3] <br> しゅしょうがきしゃかいけんをおこないました。 <br> The prime minister held a press conference.
[sound:s-3201_この製品は国内で生産されています。.mp3]	(<b>国内</b>) この製品は国内で生産されています。<br> このせいひんはこくないでせいさんされています。 <br>This product is manufactured domestically.	
付属	[sound:k-3212_付属.mp3]<br>ふぞく <br> attached, belonging (to), included, enclosed, affiliated, annexed, associated, subordinate, incidental, dependent, auxiliary
attached, belonging (to), included, enclosed, affiliated, annexed, associated, subordinate, incidental, dependent, auxiliary	<b>付属<b> <br> ふぞく <br>[sound:k-3212_付属.mp3]
[sound:k-3212_付属.mp3]	attached, belonging<br> <b>to), included, enclosed, affiliated, annexed, associated, subordinate, incidental, dependent, auxiliary (付属</b> <br> (ふぞく)
(<b>相手</b>) 相手の意見を尊重することが重要です。	[sound:s-3212_相手の意見を尊重することが重要です。.mp3] <br> あいてのいけんをそんちょうすることがしゅうようです。 <br> It's important to respect the other party's opinion.
[sound:s-3202_町の中心には市内で買い物をします。.mp3]	(<b>市内 (repeated)</b>) 町の中心には市内で買い物をします。<br> まちのちゅうしんにはいちないでかいものをします。 <br>People shop within the city center.	
交付	[sound:k-3213_交付.mp3]<br>こうふ <br> delivering, handing over, furnishing (e.g. with copies), issuance, issuing
delivering, handing over, furnishing (e.g. with copies), issuance, issuing	<b>交付<b> <br> こうふ <br>[sound:k-3213_交付.mp3]
[sound:k-3213_交付.mp3]	delivering, handing over, furnishing<br> <b>e.g. with copies), issuance, issuing (交付</b> <br> (こうふ)
(<b>相談</b>) 彼女は友達と将来の計画について相談しました。	[sound:s-3213_彼女は友達と将来の計画について相談しました。.mp3] <br> かのじょはともだちとしょうらいのけいかくについてそうだんしました。 <br> She discussed future plans with her friends.
[sound:s-3203_雨の日は都内の交通が混雑します。.mp3]	(<b>都内</b>) 雨の日は都内の交通が混雑します。<br> あめのひはとないのこうつうがこんざつします。 <br>Traffic in the city gets congested on rainy days.	
付き合い	[sound:k-3214_付き合い.mp3]<br>つきあい <br> association, socializing, socialising, fellowship
association, socializing, socialising, fellowship	<b>付き合い<b> <br> つきあい <br>[sound:k-3214_付き合い.mp3]
[sound:k-3214_付き合い.mp3]	association, socializing, socialising, fellowship<br> <b>付き合い</b> <br> (つきあい)
(<b>蔵相</b>) 政府は蔵相を任命しました。	[sound:s-3214_政府は蔵相を任命しました。.mp3] <br> せいふはそうしょうをにんめいしました。 <br> The government appointed a minister of finance.
[sound:s-3204_内閣は政府の重要な部分です。.mp3]	(<b>内閣</b>) 内閣は政府の重要な部分です。<br> ないかくはせいふのじゅうようなぶぶんです。 <br>The cabinet is an important part of the government.	
貸付	[sound:k-3215_貸付.mp3]<br>かしつけ <br> loan
loan	<b>貸付<b> <br> かしつけ <br>[sound:k-3215_貸付.mp3]
[sound:k-3215_貸付.mp3]	loan<br> <b>貸付</b> <br> (かしつけ)
(<b>相互</b>) 相互の理解が重要です。	[sound:s-3215_相互の理解が重要です。.mp3] <br> そうごのりかいがしゅうようです。 <br> Mutual understanding is important.
[sound:s-3205_この本の内容は非常に興味深いです。.mp3]	(<b>内容</b>) この本の内容は非常に興味深いです。<br> このほんのないようはひじょうにきょうみぶかいです。 <br>The contents of this book are very interesting.	
日付	[sound:k-3216_日付.mp3]<br>ひづけ <br> date, dating
date, dating	<b>日付<b> <br> ひづけ <br>[sound:k-3216_日付.mp3]
[sound:k-3216_日付.mp3]	date, dating<br> <b>日付</b> <br> (ひづけ)
(<b>相場</b>) 株式市場の相場は日々変動しています。	[sound:s-3216_株式市場の相場は日々変動しています。.mp3] <br> かぶしきしじょうのそうばはひびへんどうしています。 <br> Stock market prices fluctuate daily.
[sound:s-3206_到着は10分以内に予定されています。.mp3]	(<b>以内</b>) 到着は10分以内に予定されています。<br> とうちゃくはじゅっぷんいないによていされています。 <br>Arrival is scheduled within 10 minutes.	
付き	[sound:k-3217_付き.mp3]<br>つき, づき, ツキ <br> furnished with, including; attached to; impression, appearance; luck; sociality; under, assistant (e.g. to a manager); soup base
furnished with, including; attached to; impression, appearance; luck; sociality; under, assistant (e.g. to a manager); soup base	<b>付き<b> <br> つき, づき, ツキ <br>[sound:k-3217_付き.mp3]
[sound:k-3217_付き.mp3]	furnished with, including; attached to; impression, appearance; luck; sociality; under, assistant<br> <b>e.g. to a manager); soup base (付き</b> <br> (つき, づき, ツキ)
(<b>相当</b>) その行動は相当なリスクを伴います。	[sound:s-3217_その行動は相当なリスクを伴います。.mp3] <br> そのこうどうはそうとうなりすくをともないます。 <br> That action involves considerable risk.
[sound:s-3207_党内での議論が活発化しています。.mp3]	(<b>党内</b>) 党内での議論が活発化しています。<br> とうないでのぎろんがかっぱつかしています。 <br>Discussions within the party are becoming lively.	
給付	[sound:k-3218_給付.mp3]<br>きゅうふ <br> payment, provision, benefit, present, delivery; performance
payment, provision, benefit, present, delivery; performance	<b>給付<b> <br> きゅうふ <br>[sound:k-3218_給付.mp3]
[sound:k-3218_給付.mp3]	payment, provision, benefit, present, delivery; performance<br> <b>給付</b> <br> (きゅうふ)
(<b>相撲</b>) 相撲は日本の伝統的なスポーツです。	[sound:s-3218_相撲は日本の伝統的なスポーツです。.mp3] <br> すもうはにほんのでんとうてきなすぽーつです。 <br> Sumo wrestling is a traditional Japanese sport.
[sound:s-3208_システムの内部に問題が発生しました。.mp3]	(<b>内部</b>) システムの内部に問題が発生しました。<br> しぜむのないぶにもんだいがはっせいしました。 <br>There was an issue within the system.	
条件付き	[sound:k-3219_条件付き.mp3]<br>じょうけんつき <br> conditionally, with conditions attached
conditionally, with conditions attached	<b>条件付き<b> <br> じょうけんつき <br>[sound:k-3219_条件付き.mp3]
[sound:k-3219_条件付き.mp3]	conditionally, with conditions attached<br> <b>条件付き</b> <br> (じょうけんつき)
(<b>真相</b>) 事件の真相が明らかにされました。	[sound:s-3219_事件の真相が明らかにされました。.mp3] <br> じけんのしんそうがあきらかにされました。 <br> The truth behind the incident was revealed.
[sound:s-3209_県内の交通網を改善する必要があります。.mp3]	(<b>県内</b>) 県内の交通網を改善する必要があります。<br> けんないのこうつうもうをかいぜんするひつようがあります。 <br>There is a need to improve the transportation network within the prefecture.	
施設	[sound:k-3220_施設.mp3]<br>しせつ <br> institution, establishment, facility; (army) engineer
institution, establishment, facility; (army) engineer	<b>施設<b> <br> しせつ <br>[sound:k-3220_施設.mp3]
[sound:k-3220_施設.mp3]	institution, establishment, facility;<br> <b>army) engineer (施設</b> <br> (しせつ)
(<b>一方</b>) 彼は学校に行く一方、彼女は家で勉強している。	[sound:s-3220_彼は学校に行く一方、彼女は家で勉強している。.mp3] <br> かれはがっこうにいくいっぽう、かのじょはいえでべんきょうしている。 <br> While he goes to school, she studies at home.
[sound:s-3210_外相は国際関係の調整を行います。.mp3]	(<b>外相</b>) 外相は国際関係の調整を行います。<br> かいそうはこくさいかんけいのちょうせいをおこないます。 <br>The foreign minister coordinates international relations.	
実施	[sound:k-3221_実施.mp3]<br>じっし <br> enforcement, implementation, putting into practice (practise), carrying out, operation, working (e.g. working parameters), enactment
enforcement, implementation, putting into practice (practise), carrying out, operation, working (e.g. working parameters), enactment	<b>実施<b> <br> じっし <br>[sound:k-3221_実施.mp3]
[sound:k-3221_実施.mp3]	enforcement, implementation, putting into practice<br> <b>practise), carrying out, operation, working (e.g. working parameters), enactment (実施</b> <br> (じっし)
(<b>見方</b>) 問題に対する様々な見方があります。	[sound:s-3221_問題に対する様々な見方があります。.mp3] <br> もんだいにたいするようだんなみかたがあります。 <br> There are various perspectives on the issue.
[sound:s-3211_首相が記者会見を行いました。.mp3]	(<b>首相</b>) 首相が記者会見を行いました。<br> しゅしょうがきしゃかいけんをおこないました。 <br>The prime minister held a press conference.	
布施	[sound:k-3222_布施.mp3]<br>ふせ <br> alms, offerings
alms, offerings	<b>布施<b> <br> ふせ <br>[sound:k-3222_布施.mp3]
[sound:k-3222_布施.mp3]	alms, offerings<br> <b>布施</b> <br> (ふせ)
(<b>地方</b>) 彼らは地方の文化に興味を持っています。	[sound:s-3222_彼らは地方の文化に興味を持っています。.mp3] <br> かれらはちほうのぶんかにきょうみをもっています。 <br> They are interested in the local culture.
[sound:s-3212_相手の意見を尊重することが重要です。.mp3]	(<b>相手</b>) 相手の意見を尊重することが重要です。<br> あいてのいけんをそんちょうすることがしゅうようです。 <br>It's important to respect the other party's opinion.	
施策	[sound:k-3223_施策.mp3]<br>しさく <br> policy, measure
policy, measure	<b>施策<b> <br> しさく <br>[sound:k-3223_施策.mp3]
[sound:k-3223_施策.mp3]	policy, measure<br> <b>施策</b> <br> (しさく)
(<b>方向</b>) この道を進んで左の方向に曲がってください。	[sound:s-3223_この道を進んで左の方向に曲がってください。.mp3] <br> このみちをすすんでひだりのほうこうにまがってください。 <br> Proceed down this road and turn left.
[sound:s-3213_彼女は友達と将来の計画について相談しました。.mp3]	(<b>相談</b>) 彼女は友達と将来の計画について相談しました。<br> かのじょはともだちとしょうらいのけいかくについてそうだんしました。 <br>She discussed future plans with her friends.	
施行	[sound:k-3224_施行.mp3]<br>しこう, せぎょう, せこう, しぎょう <br> execution, enforcing, carrying out; giving alms, giving food to the poor or monks
execution, enforcing, carrying out; giving alms, giving food to the poor or monks	<b>施行<b> <br> しこう, せぎょう, せこう, しぎょう <br>[sound:k-3224_施行.mp3]
[sound:k-3224_施行.mp3]	execution, enforcing, carrying out; giving alms, giving food to the poor or monks<br> <b>施行</b> <br> (しこう, せぎょう, せこう, しぎょう)
(<b>方針</b>) 新しい方針を採用することになりました。	[sound:s-3224_新しい方針を採用することになりました。.mp3] <br> あたらしいほうしんをさいようすることになりました。 <br> It has been decided to adopt a new policy.
[sound:s-3214_政府は蔵相を任命しました。.mp3]	(<b>蔵相</b>) 政府は蔵相を任命しました。<br> せいふはそうしょうをにんめいしました。 <br>The government appointed a minister of finance.	
施政	[sound:k-3225_施政.mp3]<br>しせい <br> government, administration, statesmanship
government, administration, statesmanship	<b>施政<b> <br> しせい <br>[sound:k-3225_施政.mp3]
[sound:k-3225_施政.mp3]	government, administration, statesmanship<br> <b>施政</b> <br> (しせい)
(<b>方法</b>) この問題を解決する方法は何ですか？	[sound:s-3225_この問題を解決する方法は何ですか？.mp3] <br> このもんだいをかいけつするほうほうはなんですか？	What is the method to solve this problem?
[sound:s-3215_相互の理解が重要です。.mp3]	(<b>相互</b>) 相互の理解が重要です。<br> そうごのりかいがしゅうようです。 <br>Mutual understanding is important.	
施工	[sound:k-3226_施工.mp3]<br>せこう, しこう <br> execution (building contract), carrying out
execution (building contract), carrying out	<b>施工<b> <br> せこう, しこう <br>[sound:k-3226_施工.mp3]
[sound:k-3226_施工.mp3]	execution<br> <b>building contract), carrying out (施工</b> <br> (せこう, しこう)
(<b>考え方</b>) 彼の考え方は独特です。	[sound:s-3226_彼の考え方は独特です。.mp3] <br> かれのかんがえかたはとくとくてきです。 <br> His way of thinking is unique.
[sound:s-3216_株式市場の相場は日々変動しています。.mp3]	(<b>相場</b>) 株式市場の相場は日々変動しています。<br> かぶしきしじょうのそうばはひびへんどうしています。 <br>Stock market prices fluctuate daily.	
施す	[sound:k-3227_施す.mp3]<br>ほどこす <br> to donate, to give, to conduct, to apply, to perform
to donate, to give, to conduct, to apply, to perform	<b>施す<b> <br> ほどこす <br>[sound:k-3227_施す.mp3]
[sound:k-3227_施す.mp3]	to donate, to give, to conduct, to apply, to perform<br> <b>施す</b> <br> (ほどこす)
(<b>行方</b>) 彼の行方はまだわかりません。	[sound:s-3227_彼の行方はまだわかりません。.mp3] <br> かれのゆくえはまだわかりません。 <br> His whereabouts are still unknown.
[sound:s-3217_その行動は相当なリスクを伴います。.mp3]	(<b>相当</b>) その行動は相当なリスクを伴います。<br> そのこうどうはそうとうなりすくをともないます。 <br>That action involves considerable risk.	
防衛施設庁	[sound:k-3228_防衛施設庁.mp3]<br>ぼうえいしせつちょう <br> (Japanese) Defense Facilities Administration Agency (Defence)
(Japanese) Defense Facilities Administration Agency (Defence)	<b>防衛施設庁<b> <br> ぼうえいしせつちょう <br>[sound:k-3228_防衛施設庁.mp3]
[sound:k-3228_防衛施設庁.mp3]	(Japanese) Defense Facilities Administration Agency<br> <b>Defence) (防衛施設庁</b> <br> (ぼうえいしせつちょう)
(<b>双方</b>) 両者は双方の利益を考慮して交渉しました。	[sound:s-3228_両者は双方の利益を考慮して交渉しました。.mp3] <br> りょうしゃはそうほうのりえきをこうりょしてこうしょうしました。 <br> Both parties negotiated considering each other's interests.
[sound:s-3218_相撲は日本の伝統的なスポーツです。.mp3]	(<b>相撲</b>) 相撲は日本の伝統的なスポーツです。<br> すもうはにほんのでんとうてきなすぽーつです。 <br>Sumo wrestling is a traditional Japanese sport.	
施錠	[sound:k-3229_施錠.mp3]<br>せじょう <br> locking
locking	<b>施錠<b> <br> せじょう <br>[sound:k-3229_施錠.mp3]
[sound:k-3229_施錠.mp3]	locking<br> <b>施錠</b> <br> (せじょう)
(<b>方</b>) 駅の方に行きましょう。	[sound:s-3229_駅の方に行きましょう。.mp3] <br> えきのほうにいきましょう。 <br> Let's go towards the station.
[sound:s-3219_事件の真相が明らかにされました。.mp3]	(<b>真相</b>) 事件の真相が明らかにされました。<br> じけんのしんそうがあきらかにされました。 <br>The truth behind the incident was revealed.	
大切	[sound:k-3230_大切.mp3]<br>たいせつ <br> important, valuable, worthy of care
important, valuable, worthy of care	<b>大切<b> <br> たいせつ <br>[sound:k-3230_大切.mp3]
[sound:k-3230_大切.mp3]	important, valuable, worthy of care<br> <b>大切</b> <br> (たいせつ)
(<b>四</b>) 彼は四つのリンゴを持っています。	[sound:s-3230_彼は四つのリンゴを持っています。.mp3] <br> かれはよっつのりんごをもっています。 <br> He has four apples.
[sound:s-3220_彼は学校に行く一方、彼女は家で勉強している。.mp3]	(<b>一方</b>) 彼は学校に行く一方、彼女は家で勉強している。<br> かれはがっこうにいくいっぽう、かのじょはいえでべんきょうしている。 <br>While he goes to school, she studies at home.	
切っ掛け	[sound:k-3231_切っ掛け.mp3]<br>きっかけ <br> chance, start, cue, excuse, motive, impetus, occasion
chance, start, cue, excuse, motive, impetus, occasion	<b>切っ掛け<b> <br> きっかけ <br>[sound:k-3231_切っ掛け.mp3]
[sound:k-3231_切っ掛け.mp3]	chance, start, cue, excuse, motive, impetus, occasion<br> <b>切っ掛け</b> <br> (きっかけ)
(<b>四つ</b>) 机の上に鉛筆が四つあります。	[sound:s-3231_机の上に鉛筆が四つあります。.mp3] <br> つくえのうえにえんぴつがよっつあります。 <br> There are four pencils on the desk.
[sound:s-3221_問題に対する様々な見方があります。.mp3]	(<b>見方</b>) 問題に対する様々な見方があります。<br> もんだいにたいするようだんなみかたがあります。 <br>There are various perspectives on the issue.	
一切	[sound:k-3232_一切.mp3]<br>いっさい <br> all, everything, without exception, the whole, entirely, absolutely
all, everything, without exception, the whole, entirely, absolutely	<b>一切<b> <br> いっさい <br>[sound:k-3232_一切.mp3]
[sound:k-3232_一切.mp3]	all, everything, without exception, the whole, entirely, absolutely<br> <b>一切</b> <br> (いっさい)
(<b>四月</b>) 四月に桜の花が咲きます。	[sound:s-3232_四月に桜の花が咲きます。.mp3] <br> しがつにさくらのはながさきます。 <br> Cherry blossoms bloom in April.
[sound:s-3222_彼らは地方の文化に興味を持っています。.mp3]	(<b>地方</b>) 彼らは地方の文化に興味を持っています。<br> かれらはちほうのぶんかにきょうみをもっています。 <br>They are interested in the local culture.	
適切	[sound:k-3233_適切.mp3]<br>てきせつ <br> pertinent, appropriate, adequate, relevance
pertinent, appropriate, adequate, relevance	<b>適切<b> <br> てきせつ <br>[sound:k-3233_適切.mp3]
[sound:k-3233_適切.mp3]	pertinent, appropriate, adequate, relevance<br> <b>適切</b> <br> (てきせつ)
(<b>十四</b>) 彼の誕生日は十四日です。	[sound:s-3233_彼の誕生日は十四日です。.mp3] <br> かれのたんじょうびはじゅうよっかです。 <br> His birthday is on the fourteenth.
[sound:s-3223_この道を進んで左の方向に曲がってください。.mp3]	(<b>方向</b>) この道を進んで左の方向に曲がってください。<br> このみちをすすんでひだりのほうこうにまがってください。 <br>Proceed down this road and turn left.	
切り	[sound:k-3234_切り.mp3]<br>きり <br> limits, end, bounds, period, place to leave off, closing sentence, all there is, only, since
limits, end, bounds, period, place to leave off, closing sentence, all there is, only, since	<b>切り<b> <br> きり <br>[sound:k-3234_切り.mp3]
[sound:k-3234_切り.mp3]	limits, end, bounds, period, place to leave off, closing sentence, all there is, only, since<br> <b>切り</b> <br> (きり)
(<b>四十</b>) 彼女は今年四十歳になります。	[sound:s-3234_彼女は今年四十歳になります。.mp3] <br> かのじょはことしよんじゅっさいになります。 <br> She will turn forty this year.
[sound:s-3224_新しい方針を採用することになりました。.mp3]	(<b>方針</b>) 新しい方針を採用することになりました。<br> あたらしいほうしんをさいようすることになりました。 <br>It has been decided to adopt a new policy.	
思い切って	[sound:k-3235_思い切って.mp3]<br>おもいきって <br> resolutely, boldly, daringly
resolutely, boldly, daringly	<b>思い切って<b> <br> おもいきって <br>[sound:k-3235_思い切って.mp3]
[sound:k-3235_思い切って.mp3]	resolutely, boldly, daringly<br> <b>思い切って</b> <br> (おもいきって)
(<b>四百</b>) その本棚には四百冊以上の本があります。	[sound:s-3235_その本棚には四百冊以上の本があります。.mp3] <br> そのほんだなにはよんびゃくさついじょうのほんがあります。 <br> There are over four hundred books on that bookshelf.
[sound:s-3225_この問題を解決する方法は何ですか？.mp3]	(<b>方法</b>) この問題を解決する方法は何ですか？	このもんだいをかいけつするほうほうはなんですか？ <br>What is the method to solve this problem?
切らす	[sound:k-3236_切らす.mp3]<br>きらす <br> to be out of, to run out of, to be short of, to be out of stock
to be out of, to run out of, to be short of, to be out of stock	<b>切らす<b> <br> きらす <br>[sound:k-3236_切らす.mp3]
[sound:k-3236_切らす.mp3]	to be out of, to run out of, to be short of, to be out of stock<br> <b>切らす</b> <br> (きらす)
(<b>四球</b>) 彼はその試合で四球を与えました。	[sound:s-3236_彼はその試合で四球を与えました。.mp3] <br> かれはそのしあいでよんきゅうをあたえました。 <br> He gave up four walks in the game.
[sound:s-3226_彼の考え方は独特です。.mp3]	(<b>考え方</b>) 彼の考え方は独特です。<br> かれのかんがえかたはとくとくてきです。 <br>His way of thinking is unique.	
切る	[sound:k-3237_切る.mp3]<br>きる <br> to cut (usu. to cut through); to sever (connections, ties); to turn off (i.e. the light); to terminate (i.e. a conversation), to hang up (the phone), to disconnect; to punch (a ticket), to tear off (a stub); to open (something sealed); to start; to set (a limit); to reduce, to decrease, to discount; to shake off (water, etc.), to let drip-dry (or drain); to cross; to do (something noticeable); to turn (a vehicle); to cut (the ball); to shuffle (cards); to trump; (in Go) to isolate (an opponent's stone); (after the -masu stem of a verb) to finish, to complete
to cut (usu. to cut through); to sever (connections, ties); to turn off (i.e. the light); to terminate (i.e. a conversation), to hang up (the phone), to disconnect; to punch (a ticket), to tear off (a stub); to open (something sealed); to start; to set (a limit); to reduce, to decrease, to discount; to shake off (water, etc.), to let drip-dry (or drain); to cross; to do (something noticeable); to turn (a vehicle); to cut (the ball); to shuffle (cards); to trump; (in Go) to isolate (an opponent's stone); (after the -masu stem of a verb) to finish, to complete	<b>切る<b> <br> きる <br>[sound:k-3237_切る.mp3]
[sound:k-3237_切る.mp3]	to cut<br> <b>usu. to cut through); to sever (connections, ties); to turn off (i.e. the light); to terminate (i.e. a conversation), to hang up (the phone), to disconnect; to punch (a ticket), to tear off (a stub); to open (something sealed); to start; to set (a limit); to reduce, to decrease, to discount; to shake off (water, etc.), to let drip-dry (or drain); to cross; to do (something noticeable); to turn (a vehicle); to cut (the ball); to shuffle (cards); to trump; (in Go) to isolate (an opponent's stone); (after the -masu stem of a verb) to finish, to complete (切る</b> <br> (きる)
(<b>四千</b>) その橋の建設には四千万円かかりました。	[sound:s-3237_その橋の建設には四千万円かかりました。.mp3] <br> そのはしのけんせつにはよんせんまんえんかかりました。 <br> The construction of the bridge cost forty million yen.
[sound:s-3227_彼の行方はまだわかりません。.mp3]	(<b>行方</b>) 彼の行方はまだわかりません。<br> かれのゆくえはまだわかりません。 <br>His whereabouts are still unknown.	
締め切り	[sound:k-3238_締め切り.mp3]<br>しめきり <br> closing, cut-off, end, deadline, Closed, No Entrance
closing, cut-off, end, deadline, Closed, No Entrance	<b>締め切り<b> <br> しめきり <br>[sound:k-3238_締め切り.mp3]
[sound:k-3238_締め切り.mp3]	closing, cut-off, end, deadline, Closed, No Entrance<br> <b>締め切り</b> <br> (しめきり)
(<b>四十七士</b>) 四十七士は忠義の士として知られています。	[sound:s-3238_四十七士は忠義の士として知られています。.mp3] <br> よんじゅうしちしはちゅうぎのしとしてしられています。 <br> The forty-seven loyal retainers are known for their loyalty.
[sound:s-3228_両者は双方の利益を考慮して交渉しました。.mp3]	(<b>双方</b>) 両者は双方の利益を考慮して交渉しました。<br> りょうしゃはそうほうのりえきをこうりょしてこうしょうしました。 <br>Both parties negotiated considering each other's interests.	
切手	[sound:k-3239_切手.mp3]<br>きって <br> stamp (postage), merchandise certificate
stamp (postage), merchandise certificate	<b>切手<b> <br> きって <br>[sound:k-3239_切手.mp3]
[sound:k-3239_切手.mp3]	stamp<br> <b>postage), merchandise certificate (切手</b> <br> (きって)
(<b>四半期</b>) 会社は四半期ごとに業績を報告します。	[sound:s-3239_会社は四半期ごとに業績を報告します。.mp3] <br> かいしゃはしさんぎごとにぎょうせきをほうこくします。 <br> The company reports its performance every quarter.
[sound:s-3229_駅の方に行きましょう。.mp3]	(<b>方</b>) 駅の方に行きましょう。<br> えきのほうにいきましょう。 <br>Let's go towards the station.	
由	[sound:k-3240_由.mp3]<br>よし <br> reason, significance, cause
reason, significance, cause	<b>由<b> <br> よし <br>[sound:k-3240_由.mp3]
[sound:k-3240_由.mp3]	reason, significance, cause<br> <b>由</b> <br> (よし)
(<b>協定</b>) 両国は平和協定に署名しました。	[sound:s-3240_両国は平和協定に署名しました。.mp3] <br> りょうこくはへいわきょうていにしょめいしました。 <br> The two countries signed a peace agreement.
[sound:s-3230_彼は四つのリンゴを持っています。.mp3]	(<b>四</b>) 彼は四つのリンゴを持っています。<br> かれはよっつのりんごをもっています。 <br>He has four apples.	
自由	[sound:k-3241_自由.mp3]<br>じゆう <br> freedom, liberty, as it pleases you
freedom, liberty, as it pleases you	<b>自由<b> <br> じゆう <br>[sound:k-3241_自由.mp3]
[sound:k-3241_自由.mp3]	freedom, liberty, as it pleases you<br> <b>自由</b> <br> (じゆう)
(<b>決定</b>) 彼の選択は最終的な決定です。	[sound:s-3241_彼の選択は最終的な決定です。.mp3] <br> かれのせんたくはさいしゅうてきなけっていです。 <br> His decision is final.
[sound:s-3231_机の上に鉛筆が四つあります。.mp3]	(<b>四つ</b>) 机の上に鉛筆が四つあります。<br> つくえのうえにえんぴつがよっつあります。 <br>There are four pencils on the desk.	
理由	[sound:k-3242_理由.mp3]<br>りゆう <br> reason, pretext, motive
reason, pretext, motive	<b>理由<b> <br> りゆう <br>[sound:k-3242_理由.mp3]
[sound:k-3242_理由.mp3]	reason, pretext, motive<br> <b>理由</b> <br> (りゆう)
(<b>予定</b>) 明日の予定を教えてください。	[sound:s-3242_明日の予定を教えてください。.mp3] <br> あしたのよていをおしえてください。 <br> Please tell me tomorrow's schedule.
[sound:s-3232_四月に桜の花が咲きます。.mp3]	(<b>四月</b>) 四月に桜の花が咲きます。<br> しがつにさくらのはながさきます。 <br>Cherry blossoms bloom in April.	
経由	[sound:k-3243_経由.mp3]<br>けいゆ <br> go by the way, via
go by the way, via	<b>経由<b> <br> けいゆ <br>[sound:k-3243_経由.mp3]
[sound:k-3243_経由.mp3]	go by the way, via<br> <b>経由</b> <br> (けいゆ)
(<b>安定</b>) 政府は経済の安定を目指しています。	[sound:s-3243_政府は経済の安定を目指しています。.mp3] <br> せいふはけいざいのあんていをめざしています。 <br> The government aims for economic stability.
[sound:s-3233_彼の誕生日は十四日です。.mp3]	(<b>十四</b>) 彼の誕生日は十四日です。<br> かれのたんじょうびはじゅうよっかです。 <br>His birthday is on the fourteenth.	
不自由	[sound:k-3244_不自由.mp3]<br>ふじゆう <br> discomfort, inconvenience; poverty, want, destitution; disability, impairment (physical, mental, etc.)
discomfort, inconvenience; poverty, want, destitution; disability, impairment (physical, mental, etc.)	<b>不自由<b> <br> ふじゆう <br>[sound:k-3244_不自由.mp3]
[sound:k-3244_不自由.mp3]	discomfort, inconvenience; poverty, want, destitution; disability, impairment<br> <b>physical, mental, etc.) (不自由</b> <br> (ふじゆう)
(<b>暫定</b>) 暫定的な解決策を見つけなければなりません。	[sound:s-3244_暫定的な解決策を見つけなければなりません。.mp3] <br> さんていてきなかいけつさくをみつけなければなりません。 <br> We need to find a temporary solution.
[sound:s-3234_彼女は今年四十歳になります。.mp3]	(<b>四十</b>) 彼女は今年四十歳になります。<br> かのじょはことしよんじゅっさいになります。 <br>She will turn forty this year.	
自由化	[sound:k-3245_自由化.mp3]<br>じゆうか <br> liberalization, liberalisation, freeing
liberalization, liberalisation, freeing	<b>自由化<b> <br> じゆうか <br>[sound:k-3245_自由化.mp3]
[sound:k-3245_自由化.mp3]	liberalization, liberalisation, freeing<br> <b>自由化</b> <br> (じゆうか)
(<b>定数</b>) この容器には定数の量しか入れられません。	[sound:s-3245_この容器には定数の量しか入れられません。.mp3] <br> このようきにはていすうのりょうしかいれられません。 <br> Only a fixed amount can be put into this container.
[sound:s-3235_その本棚には四百冊以上の本があります。.mp3]	(<b>四百</b>) その本棚には四百冊以上の本があります。<br> そのほんだなにはよんびゃくさついじょうのほんがあります。 <br>There are over four hundred books on that bookshelf.	
自由形	[sound:k-3246_自由形.mp3]<br>じゆうがた <br> freestyle (e.g. swimming event)
freestyle (e.g. swimming event)	<b>自由形<b> <br> じゆうがた <br>[sound:k-3246_自由形.mp3]
[sound:k-3246_自由形.mp3]	freestyle<br> <b>e.g. swimming event) (自由形</b> <br> (じゆうがた)
(<b>一定</b>) 成功するためには一定の努力が必要です。	[sound:s-3246_成功するためには一定の努力が必要です。.mp3] <br> せいこうするためにはいっていのどりょくがひつようです。 <br> A certain level of effort is required to succeed.
[sound:s-3236_彼はその試合で四球を与えました。.mp3]	(<b>四球</b>) 彼はその試合で四球を与えました。<br> かれはそのしあいでよんきゅうをあたえました。 <br>He gave up four walks in the game.	
自由主義	[sound:k-3247_自由主義.mp3]<br>じゆうしゅぎ <br> liberalism
liberalism	<b>自由主義<b> <br> じゆうしゅぎ <br>[sound:k-3247_自由主義.mp3]
[sound:k-3247_自由主義.mp3]	liberalism<br> <b>自由主義</b> <br> (じゆうしゅぎ)
(<b>規定</b>) その会社は厳格な規定を持っています。	[sound:s-3247_その会社は厳格な規定を持っています。.mp3] <br> そのかいしゃはけんかくなきていをもっています。 <br> The company has strict regulations.
[sound:s-3237_その橋の建設には四千万円かかりました。.mp3]	(<b>四千</b>) その橋の建設には四千万円かかりました。<br> そのはしのけんせつにはよんせんまんえんかかりました。 <br>The construction of the bridge cost forty million yen.	
由来	[sound:k-3248_由来.mp3]<br>ゆらい <br> origin, source, history, derivation, reason, destiny
origin, source, history, derivation, reason, destiny	<b>由来<b> <br> ゆらい <br>[sound:k-3248_由来.mp3]
[sound:k-3248_由来.mp3]	origin, source, history, derivation, reason, destiny<br> <b>由来</b> <br> (ゆらい)
(<b>指定</b>) 彼は指定された場所に到着しました。	[sound:s-3248_彼は指定された場所に到着しました。.mp3] <br> かれはしていされたばしょにとうちゃくしました。 <br> He arrived at the designated location.
[sound:s-3238_四十七士は忠義の士として知られています。.mp3]	(<b>四十七士</b>) 四十七士は忠義の士として知られています。<br> よんじゅうしちしはちゅうぎのしとしてしられています。 <br>The forty-seven loyal retainers are known for their loyalty.	
自由経済	[sound:k-3249_自由経済.mp3]<br>じゆうけいざい <br> free economy
free economy	<b>自由経済<b> <br> じゆうけいざい <br>[sound:k-3249_自由経済.mp3]
[sound:k-3249_自由経済.mp3]	free economy<br> <b>自由経済</b> <br> (じゆうけいざい)
(<b>定期</b>) 彼は定期的にジムに通っています。	[sound:s-3249_彼は定期的にジムに通っています。.mp3] <br> かれはていきてきにじむにかよっています。 <br> He goes to the gym regularly.
[sound:s-3239_会社は四半期ごとに業績を報告します。.mp3]	(<b>四半期</b>) 会社は四半期ごとに業績を報告します。<br> かいしゃはしさんぎごとにぎょうせきをほうこくします。 <br>The company reports its performance every quarter.	
演説	[sound:k-3250_演説.mp3]<br>えんぜつ <br> speech, address
speech, address	<b>演説<b> <br> えんぜつ <br>[sound:k-3250_演説.mp3]
[sound:k-3250_演説.mp3]	speech, address<br> <b>演説</b> <br> (えんぜつ)
(<b>今</b>) 今、何をしていますか？	[sound:s-3250_今、何をしていますか？.mp3] <br> いま、なにをしていますか？	What are you doing now?
[sound:s-3240_両国は平和協定に署名しました。.mp3]	(<b>協定</b>) 両国は平和協定に署名しました。<br> りょうこくはへいわきょうていにしょめいしました。 <br>The two countries signed a peace agreement.	
説明	[sound:k-3251_説明.mp3]<br>せつめい <br> explanation, exposition
explanation, exposition	<b>説明<b> <br> せつめい <br>[sound:k-3251_説明.mp3]
[sound:k-3251_説明.mp3]	explanation, exposition<br> <b>説明</b> <br> (せつめい)
(<b>今や</b>) この地域は今や観光名所となっています。	[sound:s-3251_この地域は今や観光名所となっています。.mp3] <br> このちいきはいまやかんこうめいしょとなっています。 <br> This area has now become a tourist attraction.
[sound:s-3241_彼の選択は最終的な決定です。.mp3]	(<b>決定</b>) 彼の選択は最終的な決定です。<br> かれのせんたくはさいしゅうてきなけっていです。 <br>His decision is final.	
小説	[sound:k-3252_小説.mp3]<br>しょうせつ <br> novel, (short) story
novel, (short) story	<b>小説<b> <br> しょうせつ <br>[sound:k-3252_小説.mp3]
[sound:k-3252_小説.mp3]	novel,<br> <b>short) story (小説</b> <br> (しょうせつ)
(<b>今回</b>) 今回のイベントは大成功でした。	[sound:s-3252_今回のイベントは大成功でした。.mp3] <br> こんかいのいべんとはたいせいこうでした。 <br> This event was a great success.
[sound:s-3242_明日の予定を教えてください。.mp3]	(<b>予定</b>) 明日の予定を教えてください。<br> あしたのよていをおしえてください。 <br>Please tell me tomorrow's schedule.	
解説	[sound:k-3253_解説.mp3]<br>かいせつ <br> explanation, commentary, exposition, elucidation
explanation, commentary, exposition, elucidation	<b>解説<b> <br> かいせつ <br>[sound:k-3253_解説.mp3]
[sound:k-3253_解説.mp3]	explanation, commentary, exposition, elucidation<br> <b>解説</b> <br> (かいせつ)
(<b>今月</b>) 今月の予定を確認しましょう。	[sound:s-3253_今月の予定を確認しましょう。.mp3] <br> こんげつのよていをかくにんしましょう。 <br> Let's check this month's schedule.
[sound:s-3243_政府は経済の安定を目指しています。.mp3]	(<b>安定</b>) 政府は経済の安定を目指しています。<br> せいふはけいざいのあんていをめざしています。 <br>The government aims for economic stability.	
説得	[sound:k-3254_説得.mp3]<br>せっとく <br> persuasion
persuasion	<b>説得<b> <br> せっとく <br>[sound:k-3254_説得.mp3]
[sound:k-3254_説得.mp3]	persuasion<br> <b>説得</b> <br> (せっとく)
(<b>今後</b>) このプロジェクトの今後の展望を考えましょう。	[sound:s-3254_このプロジェクトの今後の展望を考えましょう。.mp3] <br> このぷろじぇくとのこんごのてんぼうをかんがえましょう。 <br> Let's think about the future prospects of this project.
[sound:s-3244_暫定的な解決策を見つけなければなりません。.mp3]	(<b>暫定</b>) 暫定的な解決策を見つけなければなりません。<br> さんていてきなかいけつさくをみつけなければなりません。 <br>We need to find a temporary solution.	
伝説	[sound:k-3255_伝説.mp3]<br>でんせつ <br> tradition, legend, folklore
tradition, legend, folklore	<b>伝説<b> <br> でんせつ <br>[sound:k-3255_伝説.mp3]
[sound:k-3255_伝説.mp3]	tradition, legend, folklore<br> <b>伝説</b> <br> (でんせつ)
(<b>今年</b>) 今年は暑い夏になるかもしれません。	[sound:s-3255_今年は暑い夏になるかもしれません。.mp3] <br> ことしはあついなつになるかもしれません。 <br> This year might be a hot summer.
[sound:s-3245_この容器には定数の量しか入れられません。.mp3]	(<b>定数</b>) この容器には定数の量しか入れられません。<br> このようきにはていすうのりょうしかいれられません。 <br>Only a fixed amount can be put into this container.	
遊説	[sound:k-3256_遊説.mp3]<br>ゆうぜい <br> election tour, election campaign, stumping
election tour, election campaign, stumping	<b>遊説<b> <br> ゆうぜい <br>[sound:k-3256_遊説.mp3]
[sound:k-3256_遊説.mp3]	election tour, election campaign, stumping<br> <b>遊説</b> <br> (ゆうぜい)
(<b>今度</b>) 今度の週末は友達と旅行します。	[sound:s-3256_今度の週末は友達と旅行します。.mp3] <br> こんどのしゅうまつはともだちとりょこうします。 <br> I'm going on a trip with friends this weekend.
[sound:s-3246_成功するためには一定の努力が必要です。.mp3]	(<b>一定</b>) 成功するためには一定の努力が必要です。<br> せいこうするためにはいっていのどりょくがひつようです。 <br>A certain level of effort is required to succeed.	
力説	[sound:k-3257_力説.mp3]<br>りきせつ <br> insistence, (major) emphasis, stress
insistence, (major) emphasis, stress	<b>力説<b> <br> りきせつ <br>[sound:k-3257_力説.mp3]
[sound:k-3257_力説.mp3]	insistence,<br> <b>major) emphasis, stress (力説</b> <br> (りきせつ)
(<b>今日</b>) 今日は忙しい一日でした。	[sound:s-3257_今日は忙しい一日でした。.mp3] <br> きょうはいそがしいいちにちでした。 <br> Today was a busy day.
[sound:s-3247_その会社は厳格な規定を持っています。.mp3]	(<b>規定</b>) その会社は厳格な規定を持っています。<br> そのかいしゃはけんかくなきていをもっています。 <br>The company has strict regulations.	
社説	[sound:k-3258_社説.mp3]<br>しゃせつ <br> editorial, leading article
editorial, leading article	<b>社説<b> <br> しゃせつ <br>[sound:k-3258_社説.mp3]
[sound:k-3258_社説.mp3]	editorial, leading article<br> <b>社説</b> <br> (しゃせつ)
(<b>今季</b>) 今季のトレンドは花柄です。	[sound:s-3258_今季のトレンドは花柄です。.mp3] <br> こんきのとれんどははながらです。 <br> The trend this season is floral patterns.
[sound:s-3248_彼は指定された場所に到着しました。.mp3]	(<b>指定</b>) 彼は指定された場所に到着しました。<br> かれはしていされたばしょにとうちゃくしました。 <br>He arrived at the designated location.	
論説	[sound:k-3259_論説.mp3]<br>ろんせつ <br> editorial, dissertation
editorial, dissertation	<b>論説<b> <br> ろんせつ <br>[sound:k-3259_論説.mp3]
[sound:k-3259_論説.mp3]	editorial, dissertation<br> <b>論説</b> <br> (ろんせつ)
(<b>今春</b>) 今春は暖かい天気が続いています。	[sound:s-3259_今春は暖かい天気が続いています。.mp3] <br> こんしゅんはあたたかいてんきがつづいています。 <br> Warm weather has continued this spring.
[sound:s-3249_彼は定期的にジムに通っています。.mp3]	(<b>定期</b>) 彼は定期的にジムに通っています。<br> かれはていきてきにじむにかよっています。 <br>He goes to the gym regularly.	
運転	[sound:k-3260_運転.mp3]<br>うんてん <br> operation, motion, driving
operation, motion, driving	<b>運転<b> <br> うんてん <br>[sound:k-3260_運転.mp3]
[sound:k-3260_運転.mp3]	operation, motion, driving<br> <b>運転</b> <br> (うんてん)
(<b>回</b>) 今日は何回目の訪問ですか？	[sound:s-3260_今日は何回目の訪問ですか？.mp3] <br> きょうはなんかいめのほうもんですか？	How many times have you visited today?
[sound:s-3250_今、何をしていますか？.mp3]	(<b>今</b>) 今、何をしていますか？	いま、なにをしていますか？ <br>What are you doing now?
転換	[sound:k-3261_転換.mp3]<br>てんかん <br> convert, divert
convert, divert	<b>転換<b> <br> てんかん <br>[sound:k-3261_転換.mp3]
[sound:k-3261_転換.mp3]	convert, divert<br> <b>転換</b> <br> (てんかん)
(<b>回復</b>) 彼の健康は回復しています。	[sound:s-3261_彼の健康は回復しています。.mp3] <br> かれのけんこうはかいふくしています。 <br> His health is improving.
[sound:s-3251_この地域は今や観光名所となっています。.mp3]	(<b>今や</b>) この地域は今や観光名所となっています。<br> このちいきはいまやかんこうめいしょとなっています。 <br>This area has now become a tourist attraction.	
逆転	[sound:k-3262_逆転.mp3]<br>ぎゃくてん <br> (sudden) change, reversal, turn-around, coming from behind (baseball)
(sudden) change, reversal, turn-around, coming from behind (baseball)	<b>逆転<b> <br> ぎゃくてん <br>[sound:k-3262_逆転.mp3]
[sound:k-3262_逆転.mp3]	(sudden) change, reversal, turn-around, coming from behind<br> <b>baseball) (逆転</b> <br> (ぎゃくてん)
(<b>回答</b>) 彼は質問に丁寧に回答しました。	[sound:s-3262_彼は質問に丁寧に回答しました。.mp3] <br> かれはしつもんにていねいにかいとうしました。 <br> He answered the question politely.
[sound:s-3252_今回のイベントは大成功でした。.mp3]	(<b>今回</b>) 今回のイベントは大成功でした。<br> こんかいのいべんとはたいせいこうでした。 <br>This event was a great success.	
移転	[sound:k-3263_移転.mp3]<br>いてん <br> moving, transfer, demise
moving, transfer, demise	<b>移転<b> <br> いてん <br>[sound:k-3263_移転.mp3]
[sound:k-3263_移転.mp3]	moving, transfer, demise<br> <b>移転</b> <br> (いてん)
(<b>前回</b>) 前回の会議の議事録を見直しましたか？	[sound:s-3263_前回の会議の議事録を見直しましたか？.mp3] <br> ぜんかいのかいぎのぎしろくをみなおしましたか？	Did you review the minutes of the previous meeting?
[sound:s-3253_今月の予定を確認しましょう。.mp3]	(<b>今月</b>) 今月の予定を確認しましょう。<br> こんげつのよていをかくにんしましょう。 <br>Let's check this month's schedule.	
運転手	[sound:k-3264_運転手.mp3]<br>うんてんしゅ <br> driver, chauffeur
driver, chauffeur	<b>運転手<b> <br> うんてんしゅ <br>[sound:k-3264_運転手.mp3]
[sound:k-3264_運転手.mp3]	driver, chauffeur<br> <b>運転手</b> <br> (うんてんしゅ)
(<b>回戦</b>) 彼らは次の回戦に向けて練習しています。	[sound:s-3264_彼らは次の回戦に向けて練習しています。.mp3] <br> かれらはつきのかいせんにむけてれんしゅうしています。 <br> They are practicing for the next match.
[sound:s-3254_このプロジェクトの今後の展望を考えましょう。.mp3]	(<b>今後</b>) このプロジェクトの今後の展望を考えましょう。<br> このぷろじぇくとのこんごのてんぼうをかんがえましょう。 <br>Let's think about the future prospects of this project.	
自転車	[sound:k-3265_自転車.mp3]<br>じてんしゃ, じでんしゃ <br> bicycle
bicycle	<b>自転車<b> <br> じてんしゃ, じでんしゃ <br>[sound:k-3265_自転車.mp3]
[sound:k-3265_自転車.mp3]	bicycle<br> <b>自転車</b> <br> (じてんしゃ, じでんしゃ)
(<b>一回</b>) 一回だけチャンスを与えてください。	[sound:s-3265_一回だけチャンスを与えてください。.mp3] <br> いっかいだけちゃんすをあたえてください。 <br> Please give me only one chance.
[sound:s-3255_今年は暑い夏になるかもしれません。.mp3]	(<b>今年</b>) 今年は暑い夏になるかもしれません。<br> ことしはあついなつになるかもしれません。 <br>This year might be a hot summer.	
回転	[sound:k-3266_回転.mp3]<br>かいてん <br> rotation (usu. around something), revolution, turning
rotation (usu. around something), revolution, turning	<b>回転<b> <br> かいてん <br>[sound:k-3266_回転.mp3]
[sound:k-3266_回転.mp3]	rotation<br> <b>usu. around something), revolution, turning (回転</b> <br> (かいてん)
(<b>回収</b>) ごみの回収は毎週金曜日です。	[sound:s-3266_ごみの回収は毎週金曜日です。.mp3] <br> ごみのかいしゅうはまいしゅうきんようびです。 <br> Garbage collection is every Friday.
[sound:s-3256_今度の週末は友達と旅行します。.mp3]	(<b>今度</b>) 今度の週末は友達と旅行します。<br> こんどのしゅうまつはともだちとりょこうします。 <br>I'm going on a trip with friends this weekend.	
転じる	[sound:k-3267_転じる.mp3]<br>てんじる <br> to turn, to shift, to alter, to distract
to turn, to shift, to alter, to distract	<b>転じる<b> <br> てんじる <br>[sound:k-3267_転じる.mp3]
[sound:k-3267_転じる.mp3]	to turn, to shift, to alter, to distract<br> <b>転じる</b> <br> (てんじる)
(<b>回数</b>) その試験は一回のみ受けることができます。	[sound:s-3267_その試験は一回のみ受けることができます。.mp3] <br> そのしけんはいっかいのみうけることができます。 <br> You can only take the exam once.
[sound:s-3257_今日は忙しい一日でした。.mp3]	(<b>今日</b>) 今日は忙しい一日でした。<br> きょうはいそがしいいちにちでした。 <br>Today was a busy day.	
逆転勝ち	[sound:k-3268_逆転勝ち.mp3]<br>ぎゃくてんがち <br> winning after defeat seems certain, coming from behind to win
winning after defeat seems certain, coming from behind to win	<b>逆転勝ち<b> <br> ぎゃくてんがち <br>[sound:k-3268_逆転勝ち.mp3]
[sound:k-3268_逆転勝ち.mp3]	winning after defeat seems certain, coming from behind to win<br> <b>逆転勝ち</b> <br> (ぎゃくてんがち)
(<b>次回</b>) 次回の会議は来週火曜日に予定されています。	[sound:s-3268_次回の会議は来週火曜日に予定されています。.mp3] <br> じかいのかいぎはらいしゅうかようびによていされています。 <br> The next meeting is scheduled for next Tuesday.
[sound:s-3258_今季のトレンドは花柄です。.mp3]	(<b>今季</b>) 今季のトレンドは花柄です。<br> こんきのとれんどははながらです。 <br>The trend this season is floral patterns.	
転勤	[sound:k-3269_転勤.mp3]<br>てんきん <br> job transfer, job relocation, intra-company transfer
job transfer, job relocation, intra-company transfer	<b>転勤<b> <br> てんきん <br>[sound:k-3269_転勤.mp3]
[sound:k-3269_転勤.mp3]	job transfer, job relocation, intra-company transfer<br> <b>転勤</b> <br> (てんきん)
(<b>新た</b>) 彼は新たな挑戦を始めました。	[sound:s-3269_彼は新たな挑戦を始めました。.mp3] <br> かれはあらたなちょうせんをはじめました。 <br> He embarked on a new challenge.
[sound:s-3259_今春は暖かい天気が続いています。.mp3]	(<b>今春</b>) 今春は暖かい天気が続いています。<br> こんしゅんはあたたかいてんきがつづいています。 <br>Warm weather has continued this spring.	
食	[sound:k-3270_食.mp3]<br>しょく <br> meal, (one's) diet, food, foodstuff(s); eclipse (solar, lunar, etc.)
meal, (one's) diet, food, foodstuff(s); eclipse (solar, lunar, etc.)	<b>食<b> <br> しょく <br>[sound:k-3270_食.mp3]
[sound:k-3270_食.mp3]	meal,<br> <b>one's) diet, food, foodstuff(s); eclipse (solar, lunar, etc.) (食</b> <br> (しょく)
(<b>新党</b>) 新党は政治的な変化をもたらすかもしれません。	[sound:s-3270_新党は政治的な変化をもたらすかもしれません。.mp3] <br> しんとうはせいじてきなへんかをもたらすかもしれません。 <br> The new party may bring about political change.
[sound:s-3260_今日は何回目の訪問ですか？.mp3]	(<b>回</b>) 今日は何回目の訪問ですか？	きょうはなんかいめのほうもんですか？ <br>How many times have you visited today?
食事	[sound:k-3271_食事.mp3]<br>しょくじ <br> meal; to eat
meal; to eat	<b>食事<b> <br> しょくじ <br>[sound:k-3271_食事.mp3]
[sound:k-3271_食事.mp3]	meal; to eat<br> <b>食事</b> <br> (しょくじ)
(<b>新聞</b>) 朝日新聞は日本で最も有名な新聞の一つです。	[sound:s-3271_朝日新聞は日本で最も有名な新聞の一つです。.mp3] <br> あさひしんぶんはにほんでもともゆうめいなしんぶんのひとつです。 <br> The Asahi Shimbun is one of the most famous newspapers in Japan.
[sound:s-3261_彼の健康は回復しています。.mp3]	(<b>回復</b>) 彼の健康は回復しています。<br> かれのけんこうはかいふくしています。 <br>His health is improving.	
食品	[sound:k-3272_食品.mp3]<br>しょくひん <br> commodity, foodstuff
commodity, foodstuff	<b>食品<b> <br> しょくひん <br>[sound:k-3272_食品.mp3]
[sound:k-3272_食品.mp3]	commodity, foodstuff<br> <b>食品</b> <br> (しょくひん)
(<b>新人</b>) 新人の社員はまだ会社のルールを学んでいます。	[sound:s-3272_新人の社員はまだ会社のルールを学んでいます。.mp3] <br> しんじんのしゃいんはまだかいしゃのるーるをまなんでいます。 <br> The new employee is still learning the company's rules.
[sound:s-3262_彼は質問に丁寧に回答しました。.mp3]	(<b>回答</b>) 彼は質問に丁寧に回答しました。<br> かれはしつもんにていねいにかいとうしました。 <br>He answered the question politely.	
食料	[sound:k-3273_食料.mp3]<br>しょくりょう <br> food
food	<b>食料<b> <br> しょくりょう <br>[sound:k-3273_食料.mp3]
[sound:k-3273_食料.mp3]	food<br> <b>食料</b> <br> (しょくりょう)
(<b>新生</b>) その学校は新生児の保育に特化しています。	[sound:s-3273_その学校は新生児の保育に特化しています。.mp3] <br> そのがっこうはしんせいじのほいくにとくかしています。 <br> The school specializes in childcare for newborns.
[sound:s-3263_前回の会議の議事録を見直しましたか？.mp3]	(<b>前回</b>) 前回の会議の議事録を見直しましたか？	ぜんかいのかいぎのぎしろくをみなおしましたか？ <br>Did you review the minutes of the previous meeting?
食糧	[sound:k-3274_食糧.mp3]<br>しょくりょう <br> provisions, rations, food supply
provisions, rations, food supply	<b>食糧<b> <br> しょくりょう <br>[sound:k-3274_食糧.mp3]
[sound:k-3274_食糧.mp3]	provisions, rations, food supply<br> <b>食糧</b> <br> (しょくりょう)
(<b>新しい</b>) 彼女は新しい仕事を始めました。	[sound:s-3274_彼女は新しい仕事を始めました。.mp3] <br> かのじょはあたらしいしごとをはじめました。 <br> She started a new job.
[sound:s-3264_彼らは次の回戦に向けて練習しています。.mp3]	(<b>回戦</b>) 彼らは次の回戦に向けて練習しています。<br> かれらはつきのかいせんにむけてれんしゅうしています。 <br>They are practicing for the next match.	
昼食	[sound:k-3275_昼食.mp3]<br>ちゅうしょく, ちゅうじき, ひるげ <br> lunch, midday meal; food served at a tea party (tea ceremony)
lunch, midday meal; food served at a tea party (tea ceremony)	<b>昼食<b> <br> ちゅうしょく, ちゅうじき, ひるげ <br>[sound:k-3275_昼食.mp3]
[sound:k-3275_昼食.mp3]	lunch, midday meal; food served at a tea party<br> <b>tea ceremony) (昼食</b> <br> (ちゅうしょく, ちゅうじき, ひるげ)
(<b>新幹線</b>) 東京から大阪まで新幹線で行くのはとても便利です。	[sound:s-3275_東京から大阪まで新幹線で行くのはとても便利です。.mp3] <br> とうきょうからおおさかまでしんかんせんでいくのはとてもべんりです。 <br> Taking the Shinkansen from Tokyo to Osaka is very convenient.
[sound:s-3265_一回だけチャンスを与えてください。.mp3]	(<b>一回</b>) 一回だけチャンスを与えてください。<br> いっかいだけちゃんすをあたえてください。 <br>Please give me only one chance.	
飲食	[sound:k-3276_飲食.mp3]<br>いんしょく <br> food and drink, eating and drinking
food and drink, eating and drinking	<b>飲食<b> <br> いんしょく <br>[sound:k-3276_飲食.mp3]
[sound:k-3276_飲食.mp3]	food and drink, eating and drinking<br> <b>飲食</b> <br> (いんしょく)
(<b>革新</b>) 新しいアイデアが産業に革新をもたらしました。	[sound:s-3276_新しいアイデアが産業に革新をもたらしました。.mp3] <br> あたらしいあいであがさんぎょうにかくしんをもたらしました。 <br> New ideas have brought innovation to the industry.
[sound:s-3266_ごみの回収は毎週金曜日です。.mp3]	(<b>回収</b>) ごみの回収は毎週金曜日です。<br> ごみのかいしゅうはまいしゅうきんようびです。 <br>Garbage collection is every Friday.	
給食	[sound:k-3277_給食.mp3]<br>きゅうしょく <br> school lunch, providing a meal
school lunch, providing a meal	<b>給食<b> <br> きゅうしょく <br>[sound:k-3277_給食.mp3]
[sound:k-3277_給食.mp3]	school lunch, providing a meal<br> <b>給食</b> <br> (きゅうしょく)
(<b>最新</b>) そのスマートフォンは最新のテクノロジーを搭載しています。	[sound:s-3277_そのスマートフォンは最新のテクノロジーを搭載しています。.mp3] <br> そのすまーとふぉんはさいしんのてくのろじーをとうさいしています。 <br> The smartphone is equipped with the latest technology.
[sound:s-3267_その試験は一回のみ受けることができます。.mp3]	(<b>回数</b>) その試験は一回のみ受けることができます。<br> そのしけんはいっかいのみうけることができます。 <br>You can only take the exam once.	
夕食	[sound:k-3278_夕食.mp3]<br>ゆうしょく <br> evening meal, dinner
evening meal, dinner	<b>夕食<b> <br> ゆうしょく <br>[sound:k-3278_夕食.mp3]
[sound:k-3278_夕食.mp3]	evening meal, dinner<br> <b>夕食</b> <br> (ゆうしょく)
(<b>新規</b>) 新規のプロジェクトに参加することになりました。	[sound:s-3278_新規のプロジェクトに参加することになりました。.mp3] <br> しんきのぷろじぇくとにさんかすることになりました。 <br> I've decided to participate in the new project.
[sound:s-3268_次回の会議は来週火曜日に予定されています。.mp3]	(<b>次回</b>) 次回の会議は来週火曜日に予定されています。<br> じかいのかいぎはらいしゅうかようびによていされています。 <br>The next meeting is scheduled for next Tuesday.	
食べ物	[sound:k-3279_食べ物.mp3]<br>たべもの <br> food
food	<b>食べ物<b> <br> たべもの <br>[sound:k-3279_食べ物.mp3]
[sound:k-3279_食べ物.mp3]	food<br> <b>食べ物</b> <br> (たべもの)
(<b>現場</b>) 火災現場の調査が行われています。	[sound:s-3279_火災現場の調査が行われています。.mp3] <br> かさいげんばのちょうさがおこなわれています。 <br> Investigation at the scene of the fire is underway.
[sound:s-3269_彼は新たな挑戦を始めました。.mp3]	(<b>新た</b>) 彼は新たな挑戦を始めました。<br> かれはあらたなちょうせんをはじめました。 <br>He embarked on a new challenge.	
比べる	[sound:k-3280_比べる.mp3]<br>くらべる <br> to compare, to make a comparison; to compete, to vie
to compare, to make a comparison; to compete, to vie	<b>比べる<b> <br> くらべる <br>[sound:k-3280_比べる.mp3]
[sound:k-3280_比べる.mp3]	to compare, to make a comparison; to compete, to vie<br> <b>比べる</b> <br> (くらべる)
(<b>場所</b>) 会議の場所はどこですか？	[sound:s-3280_会議の場所はどこですか？.mp3] <br> かいぎのばしょはどこですか？	Where is the location of the meeting?
[sound:s-3270_新党は政治的な変化をもたらすかもしれません。.mp3]	(<b>新党</b>) 新党は政治的な変化をもたらすかもしれません。<br> しんとうはせいじてきなへんかをもたらすかもしれません。 <br>The new party may bring about political change.	
比例	[sound:k-3281_比例.mp3]<br>ひれい <br> proportion
proportion	<b>比例<b> <br> ひれい <br>[sound:k-3281_比例.mp3]
[sound:k-3281_比例.mp3]	proportion<br> <b>比例</b> <br> (ひれい)
(<b>立場</b>) 彼はこの問題に対して異なる立場を持っています。	[sound:s-3281_彼はこの問題に対して異なる立場を持っています。.mp3] <br> かれはこのもんだいにたいしてことなるたちばしょをもっています。 <br> He has a different stance on this issue.
[sound:s-3271_朝日新聞は日本で最も有名な新聞の一つです。.mp3]	(<b>新聞</b>) 朝日新聞は日本で最も有名な新聞の一つです。<br> あさひしんぶんはにほんでもともゆうめいなしんぶんのひとつです。 <br>The Asahi Shimbun is one of the most famous newspapers in Japan.	
比率	[sound:k-3282_比率.mp3]<br>ひりつ <br> ratio, proportion, percentage
ratio, proportion, percentage	<b>比率<b> <br> ひりつ <br>[sound:k-3282_比率.mp3]
[sound:k-3282_比率.mp3]	ratio, proportion, percentage<br> <b>比率</b> <br> (ひりつ)
(<b>工場</b>) その地域には多くの自動車工場があります。	[sound:s-3282_その地域には多くの自動車工場があります。.mp3] <br> そのちいきにはおおくのじどうしゃこうじょうがあります。 <br> There are many automobile factories in that area.
[sound:s-3272_新人の社員はまだ会社のルールを学んでいます。.mp3]	(<b>新人</b>) 新人の社員はまだ会社のルールを学んでいます。<br> しんじんのしゃいんはまだかいしゃのるーるをまなんでいます。 <br>The new employee is still learning the company's rules.	
比較	[sound:k-3283_比較.mp3]<br>ひかく <br> comparison
comparison	<b>比較<b> <br> ひかく <br>[sound:k-3283_比較.mp3]
[sound:k-3283_比較.mp3]	comparison<br> <b>比較</b> <br> (ひかく)
(<b>会場</b>) コンサートの会場に着きました。	[sound:s-3283_コンサートの会場に着きました。.mp3] <br> こんさーとのかいじょうにつきました。 <br> We arrived at the concert venue.
[sound:s-3273_その学校は新生児の保育に特化しています。.mp3]	(<b>新生</b>) その学校は新生児の保育に特化しています。<br> そのがっこうはしんせいじのほいくにとくかしています。 <br>The school specializes in childcare for newborns.	
比べ	[sound:k-3284_比べ.mp3]<br>くらべ <br> contest, comparison, competition
contest, comparison, competition	<b>比べ<b> <br> くらべ <br>[sound:k-3284_比べ.mp3]
[sound:k-3284_比べ.mp3]	contest, comparison, competition<br> <b>比べ</b> <br> (くらべ)
(<b>劇場</b>) 彼はその劇場で有名な俳優として活躍しています。	[sound:s-3284_彼はその劇場で有名な俳優として活躍しています。.mp3] <br> かれはそのげきじょうでゆうめいなはいゆうとしてかつやくしています。 <br> He is active as a famous actor in that theater.
[sound:s-3274_彼女は新しい仕事を始めました。.mp3]	(<b>新しい</b>) 彼女は新しい仕事を始めました。<br> かのじょはあたらしいしごとをはじめました。 <br>She started a new job.	
比	[sound:k-3285_比.mp3]<br>ひ <br> ratio, proportion; match, equal; explicit comparison (style of the Shi Jing); Philippines
ratio, proportion; match, equal; explicit comparison (style of the Shi Jing); Philippines	<b>比<b> <br> ひ <br>[sound:k-3285_比.mp3]
[sound:k-3285_比.mp3]	ratio, proportion; match, equal; explicit comparison<br> <b>style of the Shi Jing); Philippines (比</b> <br> (ひ)
(<b>出場</b>) 彼は明日の試合に出場する予定です。	[sound:s-3285_彼は明日の試合に出場する予定です。.mp3] <br> かれはあしたのしあいにしゅつじょうするよていです。 <br> He is scheduled to participate in tomorrow's game.
[sound:s-3275_東京から大阪まで新幹線で行くのはとても便利です。.mp3]	(<b>新幹線</b>) 東京から大阪まで新幹線で行くのはとても便利です。<br> とうきょうからおおさかまでしんかんせんでいくのはとてもべんりです。 <br>Taking the Shinkansen from Tokyo to Osaka is very convenient.	
比重	[sound:k-3286_比重.mp3]<br>ひじゅう <br> specific gravity, weight, part; relative weight, relative importance
specific gravity, weight, part; relative weight, relative importance	<b>比重<b> <br> ひじゅう <br>[sound:k-3286_比重.mp3]
[sound:k-3286_比重.mp3]	specific gravity, weight, part; relative weight, relative importance<br> <b>比重</b> <br> (ひじゅう)
(<b>場面</b>) 映画の中で感動的な場面がたくさんあります。	[sound:s-3286_映画の中で感動的な場面がたくさんあります。.mp3] <br> えいがのなかでかんどうてきなばめんがたくさんあります。 <br> There are many moving scenes in the movie.
[sound:s-3276_新しいアイデアが産業に革新をもたらしました。.mp3]	(<b>革新</b>) 新しいアイデアが産業に革新をもたらしました。<br> あたらしいあいであがさんぎょうにかくしんをもたらしました。 <br>New ideas have brought innovation to the industry.	
恵比寿	[sound:k-3287_恵比寿.mp3]<br>えびす, ゑびす, えべす, ひるこ <br> Ebisu (god of fishing and commerce)
Ebisu (god of fishing and commerce)	<b>恵比寿<b> <br> えびす, ゑびす, えべす, ひるこ <br>[sound:k-3287_恵比寿.mp3]
[sound:k-3287_恵比寿.mp3]	Ebisu<br> <b>god of fishing and commerce) (恵比寿</b> <br> (えびす, ゑびす, えべす, ひるこ)
(<b>職場</b>) 彼女は忙しい職場で働いています。	[sound:s-3287_彼女は忙しい職場で働いています。.mp3] <br> かのじょはいそがしいしょくばではたらいています。 <br> She works in a busy workplace.
[sound:s-3277_そのスマートフォンは最新のテクノロジーを搭載しています。.mp3]	(<b>最新</b>) そのスマートフォンは最新のテクノロジーを搭載しています。<br> そのすまーとふぉんはさいしんのてくのろじーをとうさいしています。 <br>The smartphone is equipped with the latest technology.	
対比	[sound:k-3288_対比.mp3]<br>たいひ <br> contrast, comparison
contrast, comparison	<b>対比<b> <br> たいひ <br>[sound:k-3288_対比.mp3]
[sound:k-3288_対比.mp3]	contrast, comparison<br> <b>対比</b> <br> (たいひ)
(<b>お金</b>) お金を貯めるために節約する必要があります。	[sound:s-3288_お金を貯めるために節約する必要があります。.mp3] <br> おかねをためるためにせつやくするひつようがあります。 <br> We need to save money by cutting expenses.
[sound:s-3278_新規のプロジェクトに参加することになりました。.mp3]	(<b>新規</b>) 新規のプロジェクトに参加することになりました。<br> しんきのぷろじぇくとにさんかすることになりました。 <br>I've decided to participate in the new project.	
反比例	[sound:k-3289_反比例.mp3]<br>はんぴれい <br> inverse proportion
inverse proportion	<b>反比例<b> <br> はんぴれい <br>[sound:k-3289_反比例.mp3]
[sound:k-3289_反比例.mp3]	inverse proportion<br> <b>反比例</b> <br> (はんぴれい)
(<b>金融</b>) 金融市場は経済の重要な要素です。	[sound:s-3289_金融市場は経済の重要な要素です。.mp3] <br> きんゆうしじょうはけいざいのじゅうようなようそです。 <br> The financial market is a crucial element of the economy.
[sound:s-3279_火災現場の調査が行われています。.mp3]	(<b>現場</b>) 火災現場の調査が行われています。<br> かさいげんばのちょうさがおこなわれています。 <br>Investigation at the scene of the fire is underway.	
難	[sound:k-3290_難.mp3]<br>なん <br> difficulty, hardships, defect
difficulty, hardships, defect	<b>難<b> <br> なん <br>[sound:k-3290_難.mp3]
[sound:k-3290_難.mp3]	difficulty, hardships, defect<br> <b>難</b> <br> (なん)
(<b>金利</b>) 銀行の金利は年に一度変更されます。	[sound:s-3290_銀行の金利は年に一度変更されます。.mp3] <br> きんこうのきんりはとしにいちどへんこうされます。 <br> The bank's interest rates are changed once a year.
[sound:s-3280_会議の場所はどこですか？.mp3]	(<b>場所</b>) 会議の場所はどこですか？	かいぎのばしょはどこですか？ <br>Where is the location of the meeting?
難しい	[sound:k-3291_難しい.mp3]<br>むずかしい, むつかしい <br> difficult
difficult	<b>難しい<b> <br> むずかしい, むつかしい <br>[sound:k-3291_難しい.mp3]
[sound:k-3291_難しい.mp3]	difficult<br> <b>難しい</b> <br> (むずかしい, むつかしい)
(<b>献金</b>) 彼は慈善団体に献金しました。	[sound:s-3291_彼は慈善団体に献金しました。.mp3] <br> かれはじせんだんたいにけんきんしました。 <br> He donated money to the charity organization.
[sound:s-3281_彼はこの問題に対して異なる立場を持っています。.mp3]	(<b>立場</b>) 彼はこの問題に対して異なる立場を持っています。<br> かれはこのもんだいにたいしてことなるたちばしょをもっています。 <br>He has a different stance on this issue.	
難民	[sound:k-3292_難民.mp3]<br>なんみん <br> refugees
refugees	<b>難民<b> <br> なんみん <br>[sound:k-3292_難民.mp3]
[sound:k-3292_難民.mp3]	refugees<br> <b>難民</b> <br> (なんみん)
(<b>資金</b>) その事業には多額の資金が必要です。	[sound:s-3292_その事業には多額の資金が必要です。.mp3] <br> そのじぎょうにはたがくのしきんがひつようです。 <br> A large amount of funds is needed for that project.
[sound:s-3282_その地域には多くの自動車工場があります。.mp3]	(<b>工場</b>) その地域には多くの自動車工場があります。<br> そのちいきにはおおくのじどうしゃこうじょうがあります。 <br>There are many automobile factories in that area.	
困難	[sound:k-3293_困難.mp3]<br>こんなん <br> difficulty, distress
difficulty, distress	<b>困難<b> <br> こんなん <br>[sound:k-3293_困難.mp3]
[sound:k-3293_困難.mp3]	difficulty, distress<br> <b>困難</b> <br> (こんなん)
(<b>基金</b>) 彼は教育基金を設立しました。	[sound:s-3293_彼は教育基金を設立しました。.mp3] <br> かれはきょういくききんをせつりつしました。 <br> He established an education fund.
[sound:s-3283_コンサートの会場に着きました。.mp3]	(<b>会場</b>) コンサートの会場に着きました。<br> こんさーとのかいじょうにつきました。 <br>We arrived at the concert venue.	
避難	[sound:k-3294_避難.mp3]<br>ひなん <br> taking refuge, finding shelter, evacuation, escape
taking refuge, finding shelter, evacuation, escape	<b>避難<b> <br> ひなん <br>[sound:k-3294_避難.mp3]
[sound:k-3294_避難.mp3]	taking refuge, finding shelter, evacuation, escape<br> <b>避難</b> <br> (ひなん)
(<b>年金</b>) 年金は老後の生活費を支える重要な収入源です。	[sound:s-3294_年金は老後の生活費を支える重要な収入源です。.mp3] <br> ねんきんはろうごのせいかつひをささえるじゅうようなしゅうにゅうげんです。 <br> Pension is an important source of income to support life after retirement.
[sound:s-3284_彼はその劇場で有名な俳優として活躍しています。.mp3]	(<b>劇場</b>) 彼はその劇場で有名な俳優として活躍しています。<br> かれはそのげきじょうでゆうめいなはいゆうとしてかつやくしています。 <br>He is active as a famous actor in that theater.	
非難	[sound:k-3295_非難.mp3]<br>ひなん <br> blame, attack, criticism
blame, attack, criticism	<b>非難<b> <br> ひなん <br>[sound:k-3295_非難.mp3]
[sound:k-3295_非難.mp3]	blame, attack, criticism<br> <b>非難</b> <br> (ひなん)
(<b>料金</b>) 電車の料金は改定されました。	[sound:s-3295_電車の料金は改定されました。.mp3] <br> でんしゃのりょうきんはかいていされました。 <br> The train fare has been revised.
[sound:s-3285_彼は明日の試合に出場する予定です。.mp3]	(<b>出場</b>) 彼は明日の試合に出場する予定です。<br> かれはあしたのしあいにしゅつじょうするよていです。 <br>He is scheduled to participate in tomorrow's game.	
難色	[sound:k-3296_難色.mp3]<br>なんしょく <br> disapproval
disapproval	<b>難色<b> <br> なんしょく <br>[sound:k-3296_難色.mp3]
[sound:k-3296_難色.mp3]	disapproval<br> <b>難色</b> <br> (なんしょく)
(<b>金額</b>) その請求書の金額が間違っています。	[sound:s-3296_その請求書の金額が間違っています。.mp3] <br> そのせいきゅうしょのきんがくがまちがっています。 <br> The amount on the invoice is incorrect.
[sound:s-3286_映画の中で感動的な場面がたくさんあります。.mp3]	(<b>場面</b>) 映画の中で感動的な場面がたくさんあります。<br> えいがのなかでかんどうてきなばめんがたくさんあります。 <br>There are many moving scenes in the movie.	
避難民	[sound:k-3297_避難民.mp3]<br>ひなんみん <br> refugees, evacuees
refugees, evacuees	<b>避難民<b> <br> ひなんみん <br>[sound:k-3297_避難民.mp3]
[sound:k-3297_避難民.mp3]	refugees, evacuees<br> <b>避難民</b> <br> (ひなんみん)
(<b>金融機関</b>) この町には多くの金融機関があります。	[sound:s-3297_この町には多くの金融機関があります。.mp3] <br> このまちにはおおくのきんゆうきかんがあります。 <br> There are many financial institutions in this town.
[sound:s-3287_彼女は忙しい職場で働いています。.mp3]	(<b>職場</b>) 彼女は忙しい職場で働いています。<br> かのじょはいそがしいしょくばではたらいています。 <br>She works in a busy workplace.	
難問	[sound:k-3298_難問.mp3]<br>なんもん <br> perplexity, difficult question, difficult problem
perplexity, difficult question, difficult problem	<b>難問<b> <br> なんもん <br>[sound:k-3298_難問.mp3]
[sound:k-3298_難問.mp3]	perplexity, difficult question, difficult problem<br> <b>難問</b> <br> (なんもん)
(<b>委員</b>) 委員会のメンバーには専門家が含まれています。	[sound:s-3298_委員会のメンバーには専門家が含まれています。.mp3] <br> いいんかいのめんばーにはせんもんかがふくまれています。 <br> The committee members include experts.
[sound:s-3288_お金を貯めるために節約する必要があります。.mp3]	(<b>お金</b>) お金を貯めるために節約する必要があります。<br> おかねをためるためにせつやくするひつようがあります。 <br>We need to save money by cutting expenses.	
難航	[sound:k-3299_難航.mp3]<br>なんこう <br> difficult voyage, hard flight; rough going, rough passage, running into trouble, stormy passage
difficult voyage, hard flight; rough going, rough passage, running into trouble, stormy passage	<b>難航<b> <br> なんこう <br>[sound:k-3299_難航.mp3]
[sound:k-3299_難航.mp3]	difficult voyage, hard flight; rough going, rough passage, running into trouble, stormy passage<br> <b>難航</b> <br> (なんこう)
(<b>委員会</b>) この問題を解決するために委員会が設置されました。	[sound:s-3299_この問題を解決するために委員会が設置されました。.mp3] <br> このもんだいをかいけつするためにいいんかいがせっちされました。 <br> A committee has been set up to resolve this issue.
[sound:s-3289_金融市場は経済の重要な要素です。.mp3]	(<b>金融</b>) 金融市場は経済の重要な要素です。<br> きんゆうしじょうはけいざいのじゅうようなようそです。 <br>The financial market is a crucial element of the economy.	
防衛	[sound:k-3300_防衛.mp3]<br>ぼうえい <br> defense, defence, protection, self-defense, self-defence
defense, defence, protection, self-defense, self-defence	<b>防衛<b> <br> ぼうえい <br>[sound:k-3300_防衛.mp3]
[sound:k-3300_防衛.mp3]	defense, defence, protection, self-defense, self-defence<br> <b>防衛</b> <br> (ぼうえい)
(<b>委員長</b>) 彼は委員長としてその委員会を率いています。	[sound:s-3300_彼は委員長としてその委員会を率いています。.mp3] <br> かれはいいんちょうとしてそのいいんかいをひきいています。 <br> He leads the committee as the chairman.
[sound:s-3290_銀行の金利は年に一度変更されます。.mp3]	(<b>金利</b>) 銀行の金利は年に一度変更されます。<br> きんこうのきんりはとしにいちどへんこうされます。 <br>The bank's interest rates are changed once a year.	
国防	[sound:k-3301_国防.mp3]<br>こくぼう <br> national defence, national defense
national defence, national defense	<b>国防<b> <br> こくぼう <br>[sound:k-3301_国防.mp3]
[sound:k-3301_国防.mp3]	national defence, national defense<br> <b>国防</b> <br> (こくぼう)
(<b>会員</b>) 私はそのクラブの会員です。	[sound:s-3301_私はそのクラブの会員です。.mp3] <br> わたしはそのくらぶのかいいんです。 <br> I am a member of the club.
[sound:s-3291_彼は慈善団体に献金しました。.mp3]	(<b>献金</b>) 彼は慈善団体に献金しました。<br> かれはじせんだんたいにけんきんしました。 <br>He donated money to the charity organization.	
防止	[sound:k-3302_防止.mp3]<br>ぼうし <br> prevention, check
prevention, check	<b>防止<b> <br> ぼうし <br>[sound:k-3302_防止.mp3]
[sound:k-3302_防止.mp3]	prevention, check<br> <b>防止</b> <br> (ぼうし)
(<b>議員</b>) 彼は市議会の議員です。	[sound:s-3302_彼は市議会の議員です。.mp3] <br> かれはしぎかいのぎいんです。 <br> He is a member of the city council.
[sound:s-3292_その事業には多額の資金が必要です。.mp3]	(<b>資金</b>) その事業には多額の資金が必要です。<br> そのじぎょうにはたがくのしきんがひつようです。 <br>A large amount of funds is needed for that project.	
防衛庁	[sound:k-3303_防衛庁.mp3]<br>ぼうえいちょう <br> Japan Defense Agency (Defence) (became Japanese Ministry of Defense in Jan. 2007)
Japan Defense Agency (Defence) (became Japanese Ministry of Defense in Jan. 2007)	<b>防衛庁<b> <br> ぼうえいちょう <br>[sound:k-3303_防衛庁.mp3]
[sound:k-3303_防衛庁.mp3]	Japan Defense Agency<br> <b>Defence) (became Japanese Ministry of Defense in Jan. 2007) (防衛庁</b> <br> (ぼうえいちょう)
(<b>職員</b>) 彼女は病院の職員です。	[sound:s-3303_彼女は病院の職員です。.mp3] <br> かのじょはびょういんのしょくいんです。 <br> She is a staff member at the hospital.
[sound:s-3293_彼は教育基金を設立しました。.mp3]	(<b>基金</b>) 彼は教育基金を設立しました。<br> かれはきょういくききんをせつりつしました。 <br>He established an education fund.	
予防	[sound:k-3304_予防.mp3]<br>よぼう <br> prevention, precaution, protection against
prevention, precaution, protection against	<b>予防<b> <br> よぼう <br>[sound:k-3304_予防.mp3]
[sound:k-3304_予防.mp3]	prevention, precaution, protection against<br> <b>予防</b> <br> (よぼう)
(<b>国会議員</b>) 彼は国会議員として活動しています。	[sound:s-3304_彼は国会議員として活動しています。.mp3] <br> かれはこっかいぎいんとしてかつどうしています。 <br> He is active as a member of the national parliament.
[sound:s-3294_年金は老後の生活費を支える重要な収入源です。.mp3]	(<b>年金</b>) 年金は老後の生活費を支える重要な収入源です。<br> ねんきんはろうごのせいかつひをささえるじゅうようなしゅうにゅうげんです。 <br>Pension is an important source of income to support life after retirement.	
攻防	[sound:k-3305_攻防.mp3]<br>こうぼう <br> offense and defense, offence and defence
offense and defense, offence and defence	<b>攻防<b> <br> こうぼう <br>[sound:k-3305_攻防.mp3]
[sound:k-3305_攻防.mp3]	offense and defense, offence and defence<br> <b>攻防</b> <br> (こうぼう)
(<b>社員</b>) 彼はその会社の社員です。	[sound:s-3305_彼はその会社の社員です。.mp3] <br> かれはそのかいしゃのしゃいんです。 <br> He is an employee of the company.
[sound:s-3295_電車の料金は改定されました。.mp3]	(<b>料金</b>) 電車の料金は改定されました。<br> でんしゃのりょうきんはかいていされました。 <br>The train fare has been revised.	
消防	[sound:k-3306_消防.mp3]<br>しょうぼう <br> fire fighting, fire department
fire fighting, fire department	<b>消防<b> <br> しょうぼう <br>[sound:k-3306_消防.mp3]
[sound:k-3306_消防.mp3]	fire fighting, fire department<br> <b>消防</b> <br> (しょうぼう)
(<b>全員</b>) 全員がその計画に賛成しました。	[sound:s-3306_全員がその計画に賛成しました。.mp3] <br> ぜんいんがそのけいかくにさんせいしました。 <br> Everyone agreed to the plan.
[sound:s-3296_その請求書の金額が間違っています。.mp3]	(<b>金額</b>) その請求書の金額が間違っています。<br> そのせいきゅうしょのきんがくがまちがっています。 <br>The amount on the invoice is incorrect.	
防災	[sound:k-3307_防災.mp3]<br>ぼうさい <br> disaster prevention
disaster prevention	<b>防災<b> <br> ぼうさい <br>[sound:k-3307_防災.mp3]
[sound:k-3307_防災.mp3]	disaster prevention<br> <b>防災</b> <br> (ぼうさい)
(<b>役員</b>) 彼はその会社の役員です。	[sound:s-3307_彼はその会社の役員です。.mp3] <br> かれはそのかいしゃのやくいんです。 <br> He is an officer of the company.
[sound:s-3297_この町には多くの金融機関があります。.mp3]	(<b>金融機関</b>) この町には多くの金融機関があります。<br> このまちにはおおくのきんゆうきかんがあります。 <br>There are many financial institutions in this town.	
防御	[sound:k-3308_防御.mp3]<br>ぼうぎょ <br> defense, defence, safeguard, protection
defense, defence, safeguard, protection	<b>防御<b> <br> ぼうぎょ <br>[sound:k-3308_防御.mp3]
[sound:k-3308_防御.mp3]	defense, defence, safeguard, protection<br> <b>防御</b> <br> (ぼうぎょ)
(<b>九</b>) 九は数字の中で一番小さい奇数です。	[sound:s-3308_九は数字の中で一番小さい奇数です。.mp3] <br> きゅうはすうじのなかでいちばんちいさいきすうです。 <br> Nine is the smallest odd number among the digits.
[sound:s-3298_委員会のメンバーには専門家が含まれています。.mp3]	(<b>委員</b>) 委員会のメンバーには専門家が含まれています。<br> いいんかいのめんばーにはせんもんかがふくまれています。 <br>The committee members include experts.	
防護	[sound:k-3309_防護.mp3]<br>ぼうご <br> protection
protection	<b>防護<b> <br> ぼうご <br>[sound:k-3309_防護.mp3]
[sound:k-3309_防護.mp3]	protection<br> <b>防護</b> <br> (ぼうご)
(<b>九月</b>) 私の誕生日は九月にあります。	[sound:s-3309_私の誕生日は九月にあります。.mp3] <br> わたしのたんじょうびはぐがつにあります。 <br> My birthday is in September.
[sound:s-3299_この問題を解決するために委員会が設置されました。.mp3]	(<b>委員会</b>) この問題を解決するために委員会が設置されました。<br> このもんだいをかいけつするためにいいんかいがせっちされました。 <br>A committee has been set up to resolve this issue.	
候補	[sound:k-3310_候補.mp3]<br>こうほ <br> candidate, contender, prospect, pick, choice, list; candidacy, candidature, nomination
candidate, contender, prospect, pick, choice, list; candidacy, candidature, nomination	<b>候補<b> <br> こうほ <br>[sound:k-3310_候補.mp3]
[sound:k-3310_候補.mp3]	candidate, contender, prospect, pick, choice, list; candidacy, candidature, nomination<br> <b>候補</b> <br> (こうほ)
(<b>十九</b>) 彼女は今年で十九歳になります。	[sound:s-3310_彼女は今年で十九歳になります。.mp3] <br> かのじょはことしでじゅうきゅうさいになります。 <br> She will be nineteen years old this year.
[sound:s-3300_彼は委員長としてその委員会を率いています。.mp3]	(<b>委員長</b>) 彼は委員長としてその委員会を率いています。<br> かれはいいんちょうとしてそのいいんかいをひきいています。 <br>He leads the committee as the chairman.	
補助	[sound:k-3311_補助.mp3]<br>ほじょ <br> assistance, support, aid, auxiliary
assistance, support, aid, auxiliary	<b>補助<b> <br> ほじょ <br>[sound:k-3311_補助.mp3]
[sound:k-3311_補助.mp3]	assistance, support, aid, auxiliary<br> <b>補助</b> <br> (ほじょ)
(<b>九州</b>) 九州は日本の南西に位置しています。	[sound:s-3311_九州は日本の南西に位置しています。.mp3] <br> きゅうしゅうはにほんのなんせいにいちしています。 <br> Kyushu is located in the southwest of Japan.
[sound:s-3301_私はそのクラブの会員です。.mp3]	(<b>会員</b>) 私はそのクラブの会員です。<br> わたしはそのくらぶのかいいんです。 <br>I am a member of the club.	
補償	[sound:k-3312_補償.mp3]<br>ほしょう <br> compensation, reparation
compensation, reparation	<b>補償<b> <br> ほしょう <br>[sound:k-3312_補償.mp3]
[sound:k-3312_補償.mp3]	compensation, reparation<br> <b>補償</b> <br> (ほしょう)
(<b>九十</b>) 彼の祖母は九十歳になりました。	[sound:s-3312_彼の祖母は九十歳になりました。.mp3] <br> かれのそぼはぐじゅうさいになりました。 <br> His grandmother turned ninety years old.
[sound:s-3302_彼は市議会の議員です。.mp3]	(<b>議員</b>) 彼は市議会の議員です。<br> かれはしぎかいのぎいんです。 <br>He is a member of the city council.	
立候補	[sound:k-3313_立候補.mp3]<br>りっこうほ <br> announcing candidacy
announcing candidacy	<b>立候補<b> <br> りっこうほ <br>[sound:k-3313_立候補.mp3]
[sound:k-3313_立候補.mp3]	announcing candidacy<br> <b>立候補</b> <br> (りっこうほ)
(<b>九九</b>) 子供たちは九九を覚えるのが大変です。	[sound:s-3313_子供たちは九九を覚えるのが大変です。.mp3] <br> こどもたちはくぐぐをおぼえるのがたいへんです。 <br> Children find it difficult to memorize multiplication tables.
[sound:s-3303_彼女は病院の職員です。.mp3]	(<b>職員</b>) 彼女は病院の職員です。<br> かのじょはびょういんのしょくいんです。 <br>She is a staff member at the hospital.	
補正予算	[sound:k-3314_補正予算.mp3]<br>ほせいよさん <br> revised or supplementary budget
revised or supplementary budget	<b>補正予算<b> <br> ほせいよさん <br>[sound:k-3314_補正予算.mp3]
[sound:k-3314_補正予算.mp3]	revised or supplementary budget<br> <b>補正予算</b> <br> (ほせいよさん)
(<b>九つ</b>) その木には九つの枝があります。	[sound:s-3314_その木には九つの枝があります。.mp3] <br> そのきにはここのつのえだがあります。 <br> There are nine branches on that tree.
[sound:s-3304_彼は国会議員として活動しています。.mp3]	(<b>国会議員</b>) 彼は国会議員として活動しています。<br> かれはこっかいぎいんとしてかつどうしています。 <br>He is active as a member of the national parliament.	
補佐	[sound:k-3315_補佐.mp3]<br>ほさ <br> aid, help, assistance, assistant, counselor, counsellor, adviser, advisor
aid, help, assistance, assistant, counselor, counsellor, adviser, advisor	<b>補佐<b> <br> ほさ <br>[sound:k-3315_補佐.mp3]
[sound:k-3315_補佐.mp3]	aid, help, assistance, assistant, counselor, counsellor, adviser, advisor<br> <b>補佐</b> <br> (ほさ)
(<b>一一九番</b>) この列車は一一九番ホームに停車します。	[sound:s-3315_この列車は一一九番ホームに停車します。.mp3] <br> このれっしゃはいちいちきゅうばんほーむにていしゃします。 <br> This train stops at platform one one nine.
[sound:s-3305_彼はその会社の社員です。.mp3]	(<b>社員</b>) 彼はその会社の社員です。<br> かれはそのかいしゃのしゃいんです。 <br>He is an employee of the company.	
補給	[sound:k-3316_補給.mp3]<br>ほきゅう <br> supply, supplying, replenishment
supply, supplying, replenishment	<b>補給<b> <br> ほきゅう <br>[sound:k-3316_補給.mp3]
[sound:k-3316_補給.mp3]	supply, supplying, replenishment<br> <b>補給</b> <br> (ほきゅう)
(<b>千九百年代</b>) 千九百年代は20世紀の最後の十年です。	[sound:s-3316_千九百年代は20世紀の最後の十年です。.mp3] <br> せんきゅうひゃくねんだいはにせんじゅっせいきのさいごのじゅうねんです。 <br> The 1900s is the last decade of the 20th century.
[sound:s-3306_全員がその計画に賛成しました。.mp3]	(<b>全員</b>) 全員がその計画に賛成しました。<br> ぜんいんがそのけいかくにさんせいしました。 <br>Everyone agreed to the plan.	
補強	[sound:k-3317_補強.mp3]<br>ほきょう <br> compensation, reinforcement
compensation, reinforcement	<b>補強<b> <br> ほきょう <br>[sound:k-3317_補強.mp3]
[sound:k-3317_補強.mp3]	compensation, reinforcement<br> <b>補強</b> <br> (ほきょう)
(<b>九重</b>) 九重の塔は古代の建築物です。	[sound:s-3317_九重の塔は古代の建築物です。.mp3] <br> ここのえのとうはこだいのけんちくぶつです。 <br> The Nine-Storied Pagoda is an ancient architectural structure.
[sound:s-3307_彼はその会社の役員です。.mp3]	(<b>役員</b>) 彼はその会社の役員です。<br> かれはそのかいしゃのやくいんです。 <br>He is an officer of the company.	
補正	[sound:k-3318_補正.mp3]<br>ほせい <br> correction
correction	<b>補正<b> <br> ほせい <br>[sound:k-3318_補正.mp3]
[sound:k-3318_補正.mp3]	correction<br> <b>補正</b> <br> (ほせい)
(<b>入り</b>) 入り口はこちらです。	[sound:s-3318_入り口はこちらです。.mp3] <br> いりくちはこちらです。 <br> The entrance is here.
[sound:s-3308_九は数字の中で一番小さい奇数です。.mp3]	(<b>九</b>) 九は数字の中で一番小さい奇数です。<br> きゅうはすうじのなかでいちばんちいさいきすうです。 <br>Nine is the smallest odd number among the digits.	
補欠	[sound:k-3319_補欠.mp3]<br>ほけつ <br> filling a vacancy, supplementation; substitute, deputy, alternate, spare
filling a vacancy, supplementation; substitute, deputy, alternate, spare	<b>補欠<b> <br> ほけつ <br>[sound:k-3319_補欠.mp3]
[sound:k-3319_補欠.mp3]	filling a vacancy, supplementation; substitute, deputy, alternate, spare<br> <b>補欠</b> <br> (ほけつ)
(<b>輸入</b>) その製品は外国から輸入されました。	[sound:s-3319_その製品は外国から輸入されました。.mp3] <br> そのせいひんはがいこくからゆにゅうされました。 <br> The product was imported from abroad.
[sound:s-3309_私の誕生日は九月にあります。.mp3]	(<b>九月</b>) 私の誕生日は九月にあります。<br> わたしのたんじょうびはぐがつにあります。 <br>My birthday is in September.	
車	[sound:k-3320_車.mp3]<br>くるま <br> car, automobile, vehicle; wheel
car, automobile, vehicle; wheel	<b>車<b> <br> くるま <br>[sound:k-3320_車.mp3]
[sound:k-3320_車.mp3]	car, automobile, vehicle; wheel<br> <b>車</b> <br> (くるま)
(<b>購入</b>) 彼は新しい車を購入しました。	[sound:s-3320_彼は新しい車を購入しました。.mp3] <br> かれはあたらしいくるまをこうにゅうしました。 <br> He bought a new car.
[sound:s-3310_彼女は今年で十九歳になります。.mp3]	(<b>十九</b>) 彼女は今年で十九歳になります。<br> かのじょはことしでじゅうきゅうさいになります。 <br>She will be nineteen years old this year.	
自動車	[sound:k-3321_自動車.mp3]<br>じどうしゃ <br> automobile
automobile	<b>自動車<b> <br> じどうしゃ <br>[sound:k-3321_自動車.mp3]
[sound:k-3321_自動車.mp3]	automobile<br> <b>自動車</b> <br> (じどうしゃ)
(<b>収入</b>) 彼の収入は安定しています。	[sound:s-3321_彼の収入は安定しています。.mp3] <br> かれのしゅうにゅうはあんていしています。 <br> His income is stable.
[sound:s-3311_九州は日本の南西に位置しています。.mp3]	(<b>九州</b>) 九州は日本の南西に位置しています。<br> きゅうしゅうはにほんのなんせいにいちしています。 <br>Kyushu is located in the southwest of Japan.	
下車	[sound:k-3322_下車.mp3]<br>げしゃ <br> alighting (from train, bus, etc.), getting off
alighting (from train, bus, etc.), getting off	<b>下車<b> <br> げしゃ <br>[sound:k-3322_下車.mp3]
[sound:k-3322_下車.mp3]	alighting<br> <b>from train, bus, etc.), getting off (下車</b> <br> (げしゃ)
(<b>導入</b>) 新しいシステムの導入が計画されています。	[sound:s-3322_新しいシステムの導入が計画されています。.mp3] <br> あたらしいしすてむのどうにゅうがけいかくされています。 <br> The introduction of a new system is being planned.
[sound:s-3312_彼の祖母は九十歳になりました。.mp3]	(<b>九十</b>) 彼の祖母は九十歳になりました。<br> かれのそぼはぐじゅうさいになりました。 <br>His grandmother turned ninety years old.	
乗用車	[sound:k-3323_乗用車.mp3]<br>じょうようしゃ <br> passenger vehicle, automobile
passenger vehicle, automobile	<b>乗用車<b> <br> じょうようしゃ <br>[sound:k-3323_乗用車.mp3]
[sound:k-3323_乗用車.mp3]	passenger vehicle, automobile<br> <b>乗用車</b> <br> (じょうようしゃ)
(<b>介入</b>) 外国の政府が内政に介入することは許されません。	[sound:s-3323_外国の政府が内政に介入することは許されません。.mp3] <br> がいこくのせいふがないせいにかいにゅうすることはゆるされません。 <br> Foreign governments are not allowed to intervene in domestic affairs.
[sound:s-3313_子供たちは九九を覚えるのが大変です。.mp3]	(<b>九九</b>) 子供たちは九九を覚えるのが大変です。<br> こどもたちはくぐぐをおぼえるのがたいへんです。 <br>Children find it difficult to memorize multiplication tables.	
自転車	[sound:k-3324_自転車.mp3]<br>じてんしゃ, じでんしゃ <br> bicycle
bicycle	<b>自転車<b> <br> じてんしゃ, じでんしゃ <br>[sound:k-3324_自転車.mp3]
[sound:k-3324_自転車.mp3]	bicycle<br> <b>自転車</b> <br> (じてんしゃ, じでんしゃ)
(<b>受け入れ</b>) 彼は私の提案を受け入れました。	[sound:s-3324_彼は私の提案を受け入れました。.mp3] <br> かれはわたしのていあんをうけいれました。 <br> He accepted my proposal.
[sound:s-3314_その木には九つの枝があります。.mp3]	(<b>九つ</b>) その木には九つの枝があります。<br> そのきにはここのつのえだがあります。 <br>There are nine branches on that tree.	
車両	[sound:k-3325_車両.mp3]<br>しゃりょう <br> rolling stock, railroad cars, vehicles
rolling stock, railroad cars, vehicles	<b>車両<b> <br> しゃりょう <br>[sound:k-3325_車両.mp3]
[sound:k-3325_車両.mp3]	rolling stock, railroad cars, vehicles<br> <b>車両</b> <br> (しゃりょう)
(<b>入札</b>) 建設会社は新しいプロジェクトに入札しました。	[sound:s-3325_建設会社は新しいプロジェクトに入札しました。.mp3] <br> けんせつかいしゃはあたらしいぷろじぇくとににゅうさつしました。 <br> The construction company bid for the new project.
[sound:s-3315_この列車は一一九番ホームに停車します。.mp3]	(<b>一一九番</b>) この列車は一一九番ホームに停車します。<br> このれっしゃはいちいちきゅうばんほーむにていしゃします。 <br>This train stops at platform one one nine.	
電車	[sound:k-3326_電車.mp3]<br>でんしゃ <br> (electric) train
(electric) train	<b>電車<b> <br> でんしゃ <br>[sound:k-3326_電車.mp3]
[sound:k-3326_電車.mp3]	(electric) train<br> <b>電車</b> <br> (でんしゃ)
(<b>加入</b>) 彼はクラブに加入しました。	[sound:s-3326_彼はクラブに加入しました。.mp3] <br> かれはくらぶにかにゅうしました。 <br> He joined the club.
[sound:s-3316_千九百年代は20世紀の最後の十年です。.mp3]	(<b>千九百年代</b>) 千九百年代は20世紀の最後の十年です。<br> せんきゅうひゃくねんだいはにせんじゅっせいきのさいごのじゅうねんです。 <br>The 1900s is the last decade of the 20th century.	
列車	[sound:k-3327_列車.mp3]<br>れっしゃ <br> train (ordinary)
train (ordinary)	<b>列車<b> <br> れっしゃ <br>[sound:k-3327_列車.mp3]
[sound:k-3327_列車.mp3]	train<br> <b>ordinary) (列車</b> <br> (れっしゃ)
(<b>参入</b>) その企業は新しい市場への参入を計画しています。	[sound:s-3327_その企業は新しい市場への参入を計画しています。.mp3] <br> そのききょうはあたらしいしじょうへのさんにゅうをけいかくしています。 <br> The company is planning to enter the new market.
[sound:s-3317_九重の塔は古代の建築物です。.mp3]	(<b>九重</b>) 九重の塔は古代の建築物です。<br> ここのえのとうはこだいのけんちくぶつです。 <br>The Nine-Storied Pagoda is an ancient architectural structure.	
駐車場	[sound:k-3328_駐車場.mp3]<br>ちゅうしゃじょう <br> parking lot, parking place
parking lot, parking place	<b>駐車場<b> <br> ちゅうしゃじょう <br>[sound:k-3328_駐車場.mp3]
[sound:k-3328_駐車場.mp3]	parking lot, parking place<br> <b>駐車場</b> <br> (ちゅうしゃじょう)
(<b>選</b>) 彼は大統領選に出馬します。	[sound:s-3328_彼は大統領選に出馬します。.mp3] <br> かれはたいとうりょうせんにしゅつばします。 <br> He will run for president.
[sound:s-3318_入り口はこちらです。.mp3]	(<b>入り</b>) 入り口はこちらです。<br> いりくちはこちらです。 <br>The entrance is here.	
戦車	[sound:k-3329_戦車.mp3]<br>せんしゃ <br> tank (military vehicle)
tank (military vehicle)	<b>戦車<b> <br> せんしゃ <br>[sound:k-3329_戦車.mp3]
[sound:k-3329_戦車.mp3]	tank<br> <b>military vehicle) (戦車</b> <br> (せんしゃ)
(<b>選ぶ</b>) 彼は自分の将来のキャリアを選ぶのが難しいです。	[sound:s-3329_彼は自分の将来のキャリアを選ぶのが難しいです。.mp3] <br> かれはじぶんのしょうらいのきゃりあをえらぶのがむずかしいです。 <br> It's difficult for him to choose his future career.
[sound:s-3319_その製品は外国から輸入されました。.mp3]	(<b>輸入</b>) その製品は外国から輸入されました。<br> そのせいひんはがいこくからゆにゅうされました。 <br>The product was imported from abroad.	
優勝	[sound:k-3330_優勝.mp3]<br>ゆうしょう <br> overall victory, championship
overall victory, championship	<b>優勝<b> <br> ゆうしょう <br>[sound:k-3330_優勝.mp3]
[sound:k-3330_優勝.mp3]	overall victory, championship<br> <b>優勝</b> <br> (ゆうしょう)
(<b>選挙</b>) 来月、地方選挙が行われます。	[sound:s-3330_来月、地方選挙が行われます。.mp3] <br> らいげつ、ちほうせんきょがおこなわれます。 <br> Local elections will be held next month.
[sound:s-3320_彼は新しい車を購入しました。.mp3]	(<b>購入</b>) 彼は新しい車を購入しました。<br> かれはあたらしいくるまをこうにゅうしました。 <br>He bought a new car.	
俳優	[sound:k-3331_俳優.mp3]<br>はいゆう <br> actor, actress, player, performer
actor, actress, player, performer	<b>俳優<b> <br> はいゆう <br>[sound:k-3331_俳優.mp3]
[sound:k-3331_俳優.mp3]	actor, actress, player, performer<br> <b>俳優</b> <br> (はいゆう)
(<b>選手</b>) 彼は優れた選手です。	[sound:s-3331_彼は優れた選手です。.mp3] <br> かれはすぐれたせんしゅです。 <br> He is an excellent athlete.
[sound:s-3321_彼の収入は安定しています。.mp3]	(<b>収入</b>) 彼の収入は安定しています。<br> かれのしゅうにゅうはあんていしています。 <br>His income is stable.	
優先	[sound:k-3332_優先.mp3]<br>ゆうせん <br> preference, priority, precedence
preference, priority, precedence	<b>優先<b> <br> ゆうせん <br>[sound:k-3332_優先.mp3]
[sound:k-3332_優先.mp3]	preference, priority, precedence<br> <b>優先</b> <br> (ゆうせん)
(<b>選手権</b>) そのチームは全国大会で優勝しました。	[sound:s-3332_そのチームは全国大会で優勝しました。.mp3] <br> そのちーむはぜんこくたいかいでゆうしょうしました。 <br> The team won the national championship.
[sound:s-3322_新しいシステムの導入が計画されています。.mp3]	(<b>導入</b>) 新しいシステムの導入が計画されています。<br> あたらしいしすてむのどうにゅうがけいかくされています。 <br>The introduction of a new system is being planned.	
女優	[sound:k-3333_女優.mp3]<br>じょゆう <br> actress
actress	<b>女優<b> <br> じょゆう <br>[sound:k-3333_女優.mp3]
[sound:k-3333_女優.mp3]	actress<br> <b>女優</b> <br> (じょゆう)
(<b>総選挙</b>) 総選挙では新しい政府が選出されます。	[sound:s-3333_総選挙では新しい政府が選出されます。.mp3] <br> そうせんきょではあたらしいせいふがせんしゅつされます。 <br> A new government will be elected in the general election.
[sound:s-3323_外国の政府が内政に介入することは許されません。.mp3]	(<b>介入</b>) 外国の政府が内政に介入することは許されません。<br> がいこくのせいふがないせいにかいにゅうすることはゆるされません。 <br>Foreign governments are not allowed to intervene in domestic affairs.	
優秀	[sound:k-3334_優秀.mp3]<br>ゆうしゅう <br> superiority, excellence
superiority, excellence	<b>優秀<b> <br> ゆうしゅう <br>[sound:k-3334_優秀.mp3]
[sound:k-3334_優秀.mp3]	superiority, excellence<br> <b>優秀</b> <br> (ゆうしゅう)
(<b>当選</b>) 彼は市長に当選しました。	[sound:s-3334_彼は市長に当選しました。.mp3] <br> かれはしちょうにとうせんしました。 <br> He was elected as the mayor.
[sound:s-3324_彼は私の提案を受け入れました。.mp3]	(<b>受け入れ</b>) 彼は私の提案を受け入れました。<br> かれはわたしのていあんをうけいれました。 <br>He accepted my proposal.	
優遇	[sound:k-3335_優遇.mp3]<br>ゆうぐう <br> favorable treatment, favourable treatment, hospitality, warm reception, good treatment, hearty welcome
favorable treatment, favourable treatment, hospitality, warm reception, good treatment, hearty welcome	<b>優遇<b> <br> ゆうぐう <br>[sound:k-3335_優遇.mp3]
[sound:k-3335_優遇.mp3]	favorable treatment, favourable treatment, hospitality, warm reception, good treatment, hearty welcome<br> <b>優遇</b> <br> (ゆうぐう)
(<b>予選</b>) ワールドカップの予選が始まりました。	[sound:s-3335_ワールドカップの予選が始まりました。.mp3] <br> わーるどかっぷのよせんがはじまりました。 <br> The World Cup qualifiers have started.
[sound:s-3325_建設会社は新しいプロジェクトに入札しました。.mp3]	(<b>入札</b>) 建設会社は新しいプロジェクトに入札しました。<br> けんせつかいしゃはあたらしいぷろじぇくとににゅうさつしました。 <br>The construction company bid for the new project.	
優しい	[sound:k-3336_優しい.mp3]<br>やさしい <br> tender, kind, gentle, graceful, affectionate, amiable, suave
tender, kind, gentle, graceful, affectionate, amiable, suave	<b>優しい<b> <br> やさしい <br>[sound:k-3336_優しい.mp3]
[sound:k-3336_優しい.mp3]	tender, kind, gentle, graceful, affectionate, amiable, suave<br> <b>優しい</b> <br> (やさしい)
(<b>小選挙区</b>) 小選挙区での選挙は激しい競争が予想されます。	[sound:s-3336_小選挙区での選挙は激しい競争が予想されます。.mp3] <br> しょうせんきょくでのせんきょははげしいきょうそうがよそうされます。 <br> Fierce competition is expected in the single-member constituency.
[sound:s-3326_彼はクラブに加入しました。.mp3]	(<b>加入</b>) 彼はクラブに加入しました。<br> かれはくらぶにかにゅうしました。 <br>He joined the club.	
優位	[sound:k-3337_優位.mp3]<br>ゆうい <br> predominance, ascendancy, superiority
predominance, ascendancy, superiority	<b>優位<b> <br> ゆうい <br>[sound:k-3337_優位.mp3]
[sound:k-3337_優位.mp3]	predominance, ascendancy, superiority<br> <b>優位</b> <br> (ゆうい)
(<b>選考</b>) 採用の選考が厳しいです。	[sound:s-3337_採用の選考が厳しいです。.mp3] <br> さいようのせんこうがきびしいです。 <br> The selection process for recruitment is rigorous.
[sound:s-3327_その企業は新しい市場への参入を計画しています。.mp3]	(<b>参入</b>) その企業は新しい市場への参入を計画しています。<br> そのききょうはあたらしいしじょうへのさんにゅうをけいかくしています。 <br>The company is planning to enter the new market.	
優良	[sound:k-3338_優良.mp3]<br>ゆうりょう <br> superior, excellent, fine
superior, excellent, fine	<b>優良<b> <br> ゆうりょう <br>[sound:k-3338_優良.mp3]
[sound:k-3338_優良.mp3]	superior, excellent, fine<br> <b>優良</b> <br> (ゆうりょう)
(<b>立場</b>) 彼女はその問題に対して明確な立場を持っています。	[sound:s-3338_彼女はその問題に対して明確な立場を持っています。.mp3] <br> かのじょはそのもんだいにたいしてめいかくなたちばしょをもっています。 <br> She has a clear stance on the issue.
[sound:s-3328_彼は大統領選に出馬します。.mp3]	(<b>選</b>) 彼は大統領選に出馬します。<br> かれはたいとうりょうせんにしゅつばします。 <br>He will run for president.	
優勢	[sound:k-3339_優勢.mp3]<br>ゆうせい <br> superiority, superior power, predominance, preponderance
superiority, superior power, predominance, preponderance	<b>優勢<b> <br> ゆうせい <br>[sound:k-3339_優勢.mp3]
[sound:k-3339_優勢.mp3]	superiority, superior power, predominance, preponderance<br> <b>優勢</b> <br> (ゆうせい)
(<b>連立</b>) 二つの政党が連立政権を形成しました。	[sound:s-3339_二つの政党が連立政権を形成しました。.mp3] <br> ふたつのせいとうがれんりつせいけんをけいせいしました。 <br> Two political parties formed a coalition government.
[sound:s-3329_彼は自分の将来のキャリアを選ぶのが難しいです。.mp3]	(<b>選ぶ</b>) 彼は自分の将来のキャリアを選ぶのが難しいです。<br> かれはじぶんのしょうらいのきゃりあをえらぶのがむずかしいです。 <br>It's difficult for him to choose his future career.	
夫	[sound:k-3340_夫.mp3]<br>おっと <br> husband
husband	<b>夫<b> <br> おっと <br>[sound:k-3340_夫.mp3]
[sound:k-3340_夫.mp3]	husband<br> <b>夫</b> <br> (おっと)
(<b>国立</b>) この大学は国立の研究機関と提携しています。	[sound:s-3340_この大学は国立の研究機関と提携しています。.mp3] <br> このだいがくはこくりつのけんきゅうきかんとていけいしています。 <br> This university collaborates with national research institutions.
[sound:s-3330_来月、地方選挙が行われます。.mp3]	(<b>選挙</b>) 来月、地方選挙が行われます。<br> らいげつ、ちほうせんきょがおこなわれます。 <br>Local elections will be held next month.	
夫人	[sound:k-3341_夫人.mp3]<br>ふじん, ぶにん, はしかし <br> wife, Mrs, madam; wife of a nobleman (aristocrat, etc.); consort of the emperor
wife, Mrs, madam; wife of a nobleman (aristocrat, etc.); consort of the emperor	<b>夫人<b> <br> ふじん, ぶにん, はしかし <br>[sound:k-3341_夫人.mp3]
[sound:k-3341_夫人.mp3]	wife, Mrs, madam; wife of a nobleman<br> <b>aristocrat, etc.); consort of the emperor (夫人</b> <br> (ふじん, ぶにん, はしかし)
(<b>成立</b>) 新しい法律が成立しました。	[sound:s-3341_新しい法律が成立しました。.mp3] <br> あたらしいほうりつがせいりつしました。 <br> The new law has been enacted.
[sound:s-3331_彼は優れた選手です。.mp3]	(<b>選手</b>) 彼は優れた選手です。<br> かれはすぐれたせんしゅです。 <br>He is an excellent athlete.	
夫婦	[sound:k-3342_夫婦.mp3]<br>ふうふ, めおと, みょうと <br> married couple, spouses, husband and wife, couple, pair
married couple, spouses, husband and wife, couple, pair	<b>夫婦<b> <br> ふうふ, めおと, みょうと <br>[sound:k-3342_夫婦.mp3]
[sound:k-3342_夫婦.mp3]	married couple, spouses, husband and wife, couple, pair<br> <b>夫婦</b> <br> (ふうふ, めおと, みょうと)
(<b>対立</b>) 両者の間で意見の対立があります。	[sound:s-3342_両者の間で意見の対立があります。.mp3] <br> りょうしゃのあいだでいけんのたいりつがあります。 <br> There is a disagreement between both parties.
[sound:s-3332_そのチームは全国大会で優勝しました。.mp3]	(<b>選手権</b>) そのチームは全国大会で優勝しました。<br> そのちーむはぜんこくたいかいでゆうしょうしました。 <br>The team won the national championship.	
夫妻	[sound:k-3343_夫妻.mp3]<br>ふさい <br> man and wife, married couple
man and wife, married couple	<b>夫妻<b> <br> ふさい <br>[sound:k-3343_夫妻.mp3]
[sound:k-3343_夫妻.mp3]	man and wife, married couple<br> <b>夫妻</b> <br> (ふさい)
(<b>独立</b>) この国は独立国です。	[sound:s-3343_この国は独立国です。.mp3] <br> このくにはどくりつこくです。 <br> This country is an independent nation.
[sound:s-3333_総選挙では新しい政府が選出されます。.mp3]	(<b>総選挙</b>) 総選挙では新しい政府が選出されます。<br> そうせんきょではあたらしいせいふがせんしゅつされます。 <br>A new government will be elected in the general election.	
工夫	[sound:k-3344_工夫.mp3]<br>くふう <br> scheme, device, scheming, devising, figuring out, coming up with, solving ingeniously; dedication to spiritual improvement (esp. through Zen meditation)
scheme, device, scheming, devising, figuring out, coming up with, solving ingeniously; dedication to spiritual improvement (esp. through Zen meditation)	<b>工夫<b> <br> くふう <br>[sound:k-3344_工夫.mp3]
[sound:k-3344_工夫.mp3]	scheme, device, scheming, devising, figuring out, coming up with, solving ingeniously; dedication to spiritual improvement<br> <b>esp. through Zen meditation) (工夫</b> <br> (くふう)
(<b>私立</b>) 彼は私立大学で勉強しています。	[sound:s-3344_彼は私立大学で勉強しています。.mp3] <br> かれはしりつだいがくでべんきょうしています。 <br> He is studying at a private university.
[sound:s-3334_彼は市長に当選しました。.mp3]	(<b>当選</b>) 彼は市長に当選しました。<br> かれはしちょうにとうせんしました。 <br>He was elected as the mayor.	
大丈夫	[sound:k-3345_大丈夫.mp3]<br>だいじょうぶ <br> safe, all right, OK, okay
safe, all right, OK, okay	<b>大丈夫<b> <br> だいじょうぶ <br>[sound:k-3345_大丈夫.mp3]
[sound:k-3345_大丈夫.mp3]	safe, all right, OK, okay<br> <b>大丈夫</b> <br> (だいじょうぶ)
(<b>設立</b>) その会社は昨年設立されました。	[sound:s-3345_その会社は昨年設立されました。.mp3] <br> そのかいしゃはさくねんせつりつされました。 <br> The company was established last year.
[sound:s-3335_ワールドカップの予選が始まりました。.mp3]	(<b>予選</b>) ワールドカップの予選が始まりました。<br> わーるどかっぷのよせんがはじまりました。 <br>The World Cup qualifiers have started.	
丈夫	[sound:k-3346_丈夫.mp3]<br>じょうぶ <br> healthy, robust, strong, solid, durable
healthy, robust, strong, solid, durable	<b>丈夫<b> <br> じょうぶ <br>[sound:k-3346_丈夫.mp3]
[sound:k-3346_丈夫.mp3]	healthy, robust, strong, solid, durable<br> <b>丈夫</b> <br> (じょうぶ)
(<b>並立</b>) この地域には公立と私立の学校が並立しています。	[sound:s-3346_この地域には公立と私立の学校が並立しています。.mp3] <br> このちいきにはこうりつとしりつのがっこうがへいりつしています。 <br> In this area, public and private schools coexist.
[sound:s-3336_小選挙区での選挙は激しい競争が予想されます。.mp3]	(<b>小選挙区</b>) 小選挙区での選挙は激しい競争が予想されます。<br> しょうせんきょくでのせんきょははげしいきょうそうがよそうされます。 <br>Fierce competition is expected in the single-member constituency.	
義太夫	[sound:k-3347_義太夫.mp3]<br>ぎだゆう <br> gidayuu (form of ballad drama)
gidayuu (form of ballad drama)	<b>義太夫<b> <br> ぎだゆう <br>[sound:k-3347_義太夫.mp3]
[sound:k-3347_義太夫.mp3]	gidayuu<br> <b>form of ballad drama) (義太夫</b> <br> (ぎだゆう)
(<b>確立</b>) その組織は良好な関係を確立しました。	[sound:s-3347_その組織は良好な関係を確立しました。.mp3] <br> そのそしきはりょうこうなかんけいをかくりつしました。 <br> The organization established good relations.
[sound:s-3337_採用の選考が厳しいです。.mp3]	(<b>選考</b>) 採用の選考が厳しいです。<br> さいようのせんこうがきびしいです。 <br>The selection process for recruitment is rigorous.	
老夫婦	[sound:k-3348_老夫婦.mp3]<br>ろうふうふ <br> an old couple
an old couple	<b>老夫婦<b> <br> ろうふうふ <br>[sound:k-3348_老夫婦.mp3]
[sound:k-3348_老夫婦.mp3]	an old couple<br> <b>老夫婦</b> <br> (ろうふうふ)
(<b>開発</b>) 新製品の開発が進行中です。	[sound:s-3348_新製品の開発が進行中です。.mp3] <br> しんせいひんのかいはつがしんこうちゅうです。 <br> Development of the new product is underway.
[sound:s-3338_彼女はその問題に対して明確な立場を持っています。.mp3]	(<b>立場</b>) 彼女はその問題に対して明確な立場を持っています。<br> かのじょはそのもんだいにたいしてめいかくなたちばしょをもっています。 <br>She has a clear stance on the issue.	
亡夫	[sound:k-3349_亡夫.mp3]<br>ぼうふ <br> my deceased husband, my late husband
my deceased husband, my late husband	<b>亡夫<b> <br> ぼうふ <br>[sound:k-3349_亡夫.mp3]
[sound:k-3349_亡夫.mp3]	my deceased husband, my late husband<br> <b>亡夫</b> <br> (ぼうふ)
(<b>開催</b>) そのイベントは来週開催されます。	[sound:s-3349_そのイベントは来週開催されます。.mp3] <br> そのいべんとはらいしゅうかいさいされます。 <br> The event will be held next week.
[sound:s-3339_二つの政党が連立政権を形成しました。.mp3]	(<b>連立</b>) 二つの政党が連立政権を形成しました。<br> ふたつのせいとうがれんりつせいけんをけいせいしました。 <br>Two political parties formed a coalition government.	
研究	[sound:k-3350_研究.mp3]<br>けんきゅう <br> study, research, investigation
study, research, investigation	<b>研究<b> <br> けんきゅう <br>[sound:k-3350_研究.mp3]
[sound:k-3350_研究.mp3]	study, research, investigation<br> <b>研究</b> <br> (けんきゅう)
(<b>開始</b>) プロジェクトの開始が遅れています。	[sound:s-3350_プロジェクトの開始が遅れています。.mp3] <br> ぷろじぇくとのかいじがおくれています。 <br> The start of the project is delayed.
[sound:s-3340_この大学は国立の研究機関と提携しています。.mp3]	(<b>国立</b>) この大学は国立の研究機関と提携しています。<br> このだいがくはこくりつのけんきゅうきかんとていけいしています。 <br>This university collaborates with national research institutions.	
研究所	[sound:k-3351_研究所.mp3]<br>けんきゅうしょ, けんきゅうじょ <br> research establishment (institute, laboratory, etc.)
research establishment (institute, laboratory, etc.)	<b>研究所<b> <br> けんきゅうしょ, けんきゅうじょ <br>[sound:k-3351_研究所.mp3]
[sound:k-3351_研究所.mp3]	research establishment<br> <b>institute, laboratory, etc.) (研究所</b> <br> (けんきゅうしょ, けんきゅうじょ)
(<b>開放</b>) 公園は一般に開放されています。	[sound:s-3351_公園は一般に開放されています。.mp3] <br> こうえんはいっぱんにかいほうされています。 <br> The park is generally open to the public.
[sound:s-3341_新しい法律が成立しました。.mp3]	(<b>成立</b>) 新しい法律が成立しました。<br> あたらしいほうりつがせいりつしました。 <br>The new law has been enacted.	
研修	[sound:k-3352_研修.mp3]<br>けんしゅう <br> training (esp. in-service), induction course
training (esp. in-service), induction course	<b>研修<b> <br> けんしゅう <br>[sound:k-3352_研修.mp3]
[sound:k-3352_研修.mp3]	training<br> <b>esp. in-service), induction course (研修</b> <br> (けんしゅう)
(<b>公開</b>) 新しい映画は来週公開されます。	[sound:s-3352_新しい映画は来週公開されます。.mp3] <br> あたらしいえいがはらいしゅうこうかいされます。 <br> The new movie will be released next week.
[sound:s-3342_両者の間で意見の対立があります。.mp3]	(<b>対立</b>) 両者の間で意見の対立があります。<br> りょうしゃのあいだでいけんのたいりつがあります。 <br>There is a disagreement between both parties.	
研究者	[sound:k-3353_研究者.mp3]<br>けんきゅうしゃ <br> researcher
researcher	<b>研究者<b> <br> けんきゅうしゃ <br>[sound:k-3353_研究者.mp3]
[sound:k-3353_研究者.mp3]	researcher<br> <b>研究者</b> <br> (けんきゅうしゃ)
(<b>展開</b>) この計画は順調に展開しています。	[sound:s-3353_この計画は順調に展開しています。.mp3] <br> このけいかくはじゅんちょうにてんかいしています。 <br> This plan is progressing smoothly.
[sound:s-3343_この国は独立国です。.mp3]	(<b>独立</b>) この国は独立国です。<br> このくにはどくりつこくです。 <br>This country is an independent nation.	
研究員	[sound:k-3354_研究員.mp3]<br>けんきゅういん <br> researcher
researcher	<b>研究員<b> <br> けんきゅういん <br>[sound:k-3354_研究員.mp3]
[sound:k-3354_研究員.mp3]	researcher<br> <b>研究員</b> <br> (けんきゅういん)
(<b>開幕</b>) 今年の野球シーズンの開幕は来週です。	[sound:s-3354_今年の野球シーズンの開幕は来週です。.mp3] <br> ことしのやきゅうしーずんのかいまくはらいしゅうです。 <br> The opening of this year's baseball season is next week.
[sound:s-3344_彼は私立大学で勉強しています。.mp3]	(<b>私立</b>) 彼は私立大学で勉強しています。<br> かれはしりつだいがくでべんきょうしています。 <br>He is studying at a private university.	
研究室	[sound:k-3355_研究室.mp3]<br>けんきゅうしつ <br> laboratory; seminar room; professor's office
laboratory; seminar room; professor's office	<b>研究室<b> <br> けんきゅうしつ <br>[sound:k-3355_研究室.mp3]
[sound:k-3355_研究室.mp3]	laboratory; seminar room; professor's office<br> <b>研究室</b> <br> (けんきゅうしつ)
(<b>再開</b>) 交渉は再開される予定です。	[sound:s-3355_交渉は再開される予定です。.mp3] <br> こうしょうはさいかいされるよていです。 <br> Negotiations are scheduled to resume.
[sound:s-3345_その会社は昨年設立されました。.mp3]	(<b>設立</b>) その会社は昨年設立されました。<br> そのかいしゃはさくねんせつりつされました。 <br>The company was established last year.	
研究家	[sound:k-3356_研究家.mp3]<br>けんきゅうか <br> researcher, student (of)
researcher, student (of)	<b>研究家<b> <br> けんきゅうか <br>[sound:k-3356_研究家.mp3]
[sound:k-3356_研究家.mp3]	researcher, student<br> <b>of) (研究家</b> <br> (けんきゅうか)
(<b>開き</b>) 式の開きには多くの人々が参加しました。	[sound:s-3356_式の開きには多くの人々が参加しました。.mp3] <br> しきのひらきにはおおくのひとびとがさんかしました。 <br> Many people attended the opening ceremony.
[sound:s-3346_この地域には公立と私立の学校が並立しています。.mp3]	(<b>並立</b>) この地域には公立と私立の学校が並立しています。<br> このちいきにはこうりつとしりつのがっこうがへいりつしています。 <br>In this area, public and private schools coexist.	
経済研究所	[sound:k-3357_経済研究所.mp3]<br>けいざいけんきゅうしょ <br> economics research centre, economics research center
economics research centre, economics research center	<b>経済研究所<b> <br> けいざいけんきゅうしょ <br>[sound:k-3357_経済研究所.mp3]
[sound:k-3357_経済研究所.mp3]	economics research centre, economics research center<br> <b>経済研究所</b> <br> (けいざいけんきゅうしょ)
(<b>開会</b>) 大会の開会式は明日行われます。	[sound:s-3357_大会の開会式は明日行われます。.mp3] <br> たいかいのかいかいしきはあしたおこなわれます。 <br> The opening ceremony of the conference will be held tomorrow.
[sound:s-3347_その組織は良好な関係を確立しました。.mp3]	(<b>確立</b>) その組織は良好な関係を確立しました。<br> そのそしきはりょうこうなかんけいをかくりつしました。 <br>The organization established good relations.	
研究官	[sound:k-3358_研究官.mp3]<br>けんきゅうかん <br> research officer
research officer	<b>研究官<b> <br> けんきゅうかん <br>[sound:k-3358_研究官.mp3]
[sound:k-3358_研究官.mp3]	research officer<br> <b>研究官</b> <br> (けんきゅうかん)
(<b>手</b>) 彼は手を振って挨拶しました。	[sound:s-3358_彼は手を振って挨拶しました。.mp3] <br> かれはてをふってあいさつしました。 <br> He waved his hand and greeted.
[sound:s-3348_新製品の開発が進行中です。.mp3]	(<b>開発</b>) 新製品の開発が進行中です。<br> しんせいひんのかいはつがしんこうちゅうです。 <br>Development of the new product is underway.	
国立予防衛生研究所	[sound:k-3359_国立予防衛生研究所.mp3]<br>こくりつよぼうえいせいけんきゅうしょ <br> National Institute of Health
National Institute of Health	<b>国立予防衛生研究所<b> <br> こくりつよぼうえいせいけんきゅうしょ <br>[sound:k-3359_国立予防衛生研究所.mp3]
[sound:k-3359_国立予防衛生研究所.mp3]	National Institute of Health<br> <b>国立予防衛生研究所</b> <br> (こくりつよぼうえいせいけんきゅうしょ)
(<b>選手</b>) 彼は優れた選手です。	[sound:s-3359_彼は優れた選手です。.mp3] <br> かれはすぐれたせんしゅです。 <br> He is an excellent athlete.
[sound:s-3349_そのイベントは来週開催されます。.mp3]	(<b>開催</b>) そのイベントは来週開催されます。<br> そのいべんとはらいしゅうかいさいされます。 <br>The event will be held next week.	
収入	[sound:k-3360_収入.mp3]<br>しゅうにゅう <br> income, receipts, revenue
income, receipts, revenue	<b>収入<b> <br> しゅうにゅう <br>[sound:k-3360_収入.mp3]
[sound:k-3360_収入.mp3]	income, receipts, revenue<br> <b>収入</b> <br> (しゅうにゅう)
(<b>選手権</b>) そのチームは全国大会で優勝しました。	[sound:s-3360_そのチームは全国大会で優勝しました。.mp3] <br> そのちーむはぜんこくたいかいでゆうしょうしました。 <br> The team won the national championship.
[sound:s-3350_プロジェクトの開始が遅れています。.mp3]	(<b>開始</b>) プロジェクトの開始が遅れています。<br> ぷろじぇくとのかいじがおくれています。 <br>The start of the project is delayed.	
収支	[sound:k-3361_収支.mp3]<br>しゅうし <br> income and expenditure
income and expenditure	<b>収支<b> <br> しゅうし <br>[sound:k-3361_収支.mp3]
[sound:k-3361_収支.mp3]	income and expenditure<br> <b>収支</b> <br> (しゅうし)
(<b>相手</b>) 彼は強力な相手です。	[sound:s-3361_彼は強力な相手です。.mp3] <br> かれはきょうりょくなあいてです。 <br> He is a formidable opponent.
[sound:s-3351_公園は一般に開放されています。.mp3]	(<b>開放</b>) 公園は一般に開放されています。<br> こうえんはいっぱんにかいほうされています。 <br>The park is generally open to the public.	
回収	[sound:k-3362_回収.mp3]<br>かいしゅう <br> collection, recovery
collection, recovery	<b>回収<b> <br> かいしゅう <br>[sound:k-3362_回収.mp3]
[sound:k-3362_回収.mp3]	collection, recovery<br> <b>回収</b> <br> (かいしゅう)
(<b>大手</b>) その企業は業界の大手企業です。	[sound:s-3362_その企業は業界の大手企業です。.mp3] <br> そのききょうはぎょうかいのおおてききょうぎょうです。 <br> The company is a major player in the industry.
[sound:s-3352_新しい映画は来週公開されます。.mp3]	(<b>公開</b>) 新しい映画は来週公開されます。<br> あたらしいえいがはらいしゅうこうかいされます。 <br>The new movie will be released next week.	
収益	[sound:k-3363_収益.mp3]<br>しゅうえき <br> earnings, proceeds, returns
earnings, proceeds, returns	<b>収益<b> <br> しゅうえき <br>[sound:k-3363_収益.mp3]
[sound:k-3363_収益.mp3]	earnings, proceeds, returns<br> <b>収益</b> <br> (しゅうえき)
(<b>投手</b>) 彼は野球の投手です。	[sound:s-3363_彼は野球の投手です。.mp3] <br> かれはやきゅうのとうしゅです。 <br> He is a baseball pitcher.
[sound:s-3353_この計画は順調に展開しています。.mp3]	(<b>展開</b>) この計画は順調に展開しています。<br> このけいかくはじゅんちょうにてんかいしています。 <br>This plan is progressing smoothly.	
収賄	[sound:k-3364_収賄.mp3]<br>しゅうわい <br> accepting bribes, corruption, graft
accepting bribes, corruption, graft	<b>収賄<b> <br> しゅうわい <br>[sound:k-3364_収賄.mp3]
[sound:k-3364_収賄.mp3]	accepting bribes, corruption, graft<br> <b>収賄</b> <br> (しゅうわい)
(<b>若手</b>) そのチームは若手選手を育てています。	[sound:s-3364_そのチームは若手選手を育てています。.mp3] <br> そのちーむはわかてせんしゅをそだてています。 <br> The team is nurturing young players.
[sound:s-3354_今年の野球シーズンの開幕は来週です。.mp3]	(<b>開幕</b>) 今年の野球シーズンの開幕は来週です。<br> ことしのやきゅうしーずんのかいまくはらいしゅうです。 <br>The opening of this year's baseball season is next week.	
税収	[sound:k-3365_税収.mp3]<br>ぜいしゅう <br> tax yields, revenue
tax yields, revenue	<b>税収<b> <br> ぜいしゅう <br>[sound:k-3365_税収.mp3]
[sound:k-3365_税収.mp3]	tax yields, revenue<br> <b>税収</b> <br> (ぜいしゅう)
(<b>手続き</b>) 入国手続きに時間がかかります。	[sound:s-3365_入国手続きに時間がかかります。.mp3] <br> にゅうこくてつつきにじかんがかかります。 <br> Immigration procedures take time.
[sound:s-3355_交渉は再開される予定です。.mp3]	(<b>再開</b>) 交渉は再開される予定です。<br> こうしょうはさいかいされるよていです。 <br>Negotiations are scheduled to resume.	
買収	[sound:k-3366_買収.mp3]<br>ばいしゅう <br> buying, purchase; corruption, bribery
buying, purchase; corruption, bribery	<b>買収<b> <br> ばいしゅう <br>[sound:k-3366_買収.mp3]
[sound:k-3366_買収.mp3]	buying, purchase; corruption, bribery<br> <b>買収</b> <br> (ばいしゅう)
(<b>取っ手</b>) テーブルの取っ手が壊れました。	[sound:s-3366_テーブルの取っ手が壊れました。.mp3] <br> てーぶるのとってがこわれました。 <br> The handle of the table broke.
[sound:s-3356_式の開きには多くの人々が参加しました。.mp3]	(<b>開き</b>) 式の開きには多くの人々が参加しました。<br> しきのひらきにはおおくのひとびとがさんかしました。 <br>Many people attended the opening ceremony.	
収集	[sound:k-3367_収集.mp3]<br>しゅうしゅう <br> gathering up, collection, accumulation
gathering up, collection, accumulation	<b>収集<b> <br> しゅうしゅう <br>[sound:k-3367_収集.mp3]
[sound:k-3367_収集.mp3]	gathering up, collection, accumulation<br> <b>収集</b> <br> (しゅうしゅう)
(<b>歌手</b>) 彼女は有名な歌手です。	[sound:s-3367_彼女は有名な歌手です。.mp3] <br> かのじょはゆうめいなかしゅです。 <br> She is a famous singer.
[sound:s-3357_大会の開会式は明日行われます。.mp3]	(<b>開会</b>) 大会の開会式は明日行われます。<br> たいかいのかいかいしきはあしたおこなわれます。 <br>The opening ceremony of the conference will be held tomorrow.	
収穫	[sound:k-3368_収穫.mp3]<br>しゅうかく <br> harvest, crop, ingathering
harvest, crop, ingathering	<b>収穫<b> <br> しゅうかく <br>[sound:k-3368_収穫.mp3]
[sound:k-3368_収穫.mp3]	harvest, crop, ingathering<br> <b>収穫</b> <br> (しゅうかく)
(<b>日米</b>) 日米関係は重要です。	[sound:s-3368_日米関係は重要です。.mp3] <br> にちべいかんけいはじゅうようです。 <br> Japan-US relations are important.
[sound:s-3358_彼は手を振って挨拶しました。.mp3]	(<b>手</b>) 彼は手を振って挨拶しました。<br> かれはてをふってあいさつしました。 <br>He waved his hand and greeted.	
年収	[sound:k-3369_年収.mp3]<br>ねんしゅう <br> annual income
annual income	<b>年収<b> <br> ねんしゅう <br>[sound:k-3369_年収.mp3]
[sound:k-3369_年収.mp3]	annual income<br> <b>年収</b> <br> (ねんしゅう)
(<b>米国</b>) 米国は経済大国です。	[sound:s-3369_米国は経済大国です。.mp3] <br> べいこくはけいざいたいこくです。 <br> The United States is an economic superpower.
[sound:s-3359_彼は優れた選手です。.mp3]	(<b>選手</b>) 彼は優れた選手です。<br> かれはすぐれたせんしゅです。 <br>He is an excellent athlete.	
断	[sound:k-3370_断.mp3]<br>だん <br> failure
failure	<b>断<b> <br> だん <br>[sound:k-3370_断.mp3]
[sound:k-3370_断.mp3]	failure<br> <b>断</b> <br> (だん)
(<b>全米</b>) 全米チャンピオンになることが彼の夢です。	[sound:s-3370_全米チャンピオンになることが彼の夢です。.mp3] <br> ぜんべいちゃんぴおんになることがかれのゆめです。 <br> Becoming the national champion is his dream.
[sound:s-3360_そのチームは全国大会で優勝しました。.mp3]	(<b>選手権</b>) そのチームは全国大会で優勝しました。<br> そのちーむはぜんこくたいかいでゆうしょうしました。 <br>The team won the national championship.	
判断	[sound:k-3371_判断.mp3]<br>はんだん <br> judgement, judgment, decision, adjudication, conclusion, decipherment, divination
judgement, judgment, decision, adjudication, conclusion, decipherment, divination	<b>判断<b> <br> はんだん <br>[sound:k-3371_判断.mp3]
[sound:k-3371_判断.mp3]	judgement, judgment, decision, adjudication, conclusion, decipherment, divination<br> <b>判断</b> <br> (はんだん)
(<b>対米</b>) その会議は対米貿易についての議論でした。	[sound:s-3371_その会議は対米貿易についての議論でした。.mp3] <br> そのかいぎはたいべいほうえきについてのぎろんでした。 <br> The meeting was about discussions on trade with the United States.
[sound:s-3361_彼は強力な相手です。.mp3]	(<b>相手</b>) 彼は強力な相手です。<br> かれはきょうりょくなあいてです。 <br>He is a formidable opponent.	
決断	[sound:k-3372_決断.mp3]<br>けつだん <br> decision, determination
decision, determination	<b>決断<b> <br> けつだん <br>[sound:k-3372_決断.mp3]
[sound:k-3372_決断.mp3]	decision, determination<br> <b>決断</b> <br> (けつだん)
(<b>訪米</b>) 彼は訪米する予定です。	[sound:s-3372_彼は訪米する予定です。.mp3] <br> かれはほうべいするよていです。 <br> He plans to visit the United States.
[sound:s-3362_その企業は業界の大手企業です。.mp3]	(<b>大手</b>) その企業は業界の大手企業です。<br> そのききょうはぎょうかいのおおてききょうぎょうです。 <br>The company is a major player in the industry.	
診断	[sound:k-3373_診断.mp3]<br>しんだん <br> diagnosis
diagnosis	<b>診断<b> <br> しんだん <br>[sound:k-3373_診断.mp3]
[sound:k-3373_診断.mp3]	diagnosis<br> <b>診断</b> <br> (しんだん)
(<b>中南米</b>) 中南米地域には豊富な自然資源があります。	[sound:s-3373_中南米地域には豊富な自然資源があります。.mp3] <br> ちゅうなんべいちいきにはほうふなしぜんしげんがあります。 <br> The Central and South American region has abundant natural resources.
[sound:s-3363_彼は野球の投手です。.mp3]	(<b>投手</b>) 彼は野球の投手です。<br> かれはやきゅうのとうしゅです。 <br>He is a baseball pitcher.	
断る	[sound:k-3374_断る.mp3]<br>ことわる <br> to refuse, to reject, to dismiss, to turn down, to decline; to inform, to give notice; to ask leave, to excuse oneself (from)
to refuse, to reject, to dismiss, to turn down, to decline; to inform, to give notice; to ask leave, to excuse oneself (from)	<b>断る<b> <br> ことわる <br>[sound:k-3374_断る.mp3]
[sound:k-3374_断る.mp3]	to refuse, to reject, to dismiss, to turn down, to decline; to inform, to give notice; to ask leave, to excuse oneself<br> <b>from) (断る</b> <br> (ことわる)
(<b>南米</b>) ブラジルは南米に位置しています。	[sound:s-3374_ブラジルは南米に位置しています。.mp3] <br> ぶらじるはなんべいにいちしています。 <br> Brazil is located in South America.
[sound:s-3364_そのチームは若手選手を育てています。.mp3]	(<b>若手</b>) そのチームは若手選手を育てています。<br> そのちーむはわかてせんしゅをそだてています。 <br>The team is nurturing young players.	
断らず	[sound:k-3375_断らず.mp3]<br>ことわらず <br> without permission
without permission	<b>断らず<b> <br> ことわらず <br>[sound:k-3375_断らず.mp3]
[sound:k-3375_断らず.mp3]	without permission<br> <b>断らず</b> <br> (ことわらず)
(<b>米価</b>) 米価は昨年から上昇しています。	[sound:s-3375_米価は昨年から上昇しています。.mp3] <br> べいかはさくねんからじょうしょうしています。 <br> The price of rice has been rising since last year.
[sound:s-3365_入国手続きに時間がかかります。.mp3]	(<b>手続き</b>) 入国手続きに時間がかかります。<br> にゅうこくてつつきにじかんがかかります。 <br>Immigration procedures take time.	
断念	[sound:k-3376_断念.mp3]<br>だんねん <br> abandoning (hope, plans), giving up
abandoning (hope, plans), giving up	<b>断念<b> <br> だんねん <br>[sound:k-3376_断念.mp3]
[sound:k-3376_断念.mp3]	abandoning<br> <b>hope, plans), giving up (断念</b> <br> (だんねん)
(<b>反米</b>) その運動は反米感情に基づいています。	[sound:s-3376_その運動は反米感情に基づいています。.mp3] <br> そのうんどうははんべいかんじょうにもとづいています。 <br> The movement is based on anti-American sentiment.
[sound:s-3366_テーブルの取っ手が壊れました。.mp3]	(<b>取っ手</b>) テーブルの取っ手が壊れました。<br> てーぶるのとってがこわれました。 <br>The handle of the table broke.	
横断	[sound:k-3377_横断.mp3]<br>おうだん <br> crossing; transverse
crossing; transverse	<b>横断<b> <br> おうだん <br>[sound:k-3377_横断.mp3]
[sound:k-3377_横断.mp3]	crossing; transverse<br> <b>横断</b> <br> (おうだん)
(<b>米穀</b>) 米穀は私たちの主食です。	[sound:s-3377_米穀は私たちの主食です。.mp3] <br> べいこくはわたしたちのしゅしょくです。 <br> Rice is our staple food.
[sound:s-3367_彼女は有名な歌手です。.mp3]	(<b>歌手</b>) 彼女は有名な歌手です。<br> かのじょはゆうめいなかしゅです。 <br>She is a famous singer.	
断言	[sound:k-3378_断言.mp3]<br>だんげん <br> assertion, declaration, affirmation
assertion, declaration, affirmation	<b>断言<b> <br> だんげん <br>[sound:k-3378_断言.mp3]
[sound:k-3378_断言.mp3]	assertion, declaration, affirmation<br> <b>断言</b> <br> (だんげん)
(<b>勢力</b>) 彼らは政治的な勢力を持っています。	[sound:s-3378_彼らは政治的な勢力を持っています。.mp3] <br> かれらはせいじてきなせいりょくをもっています。 <br> They have political influence.
[sound:s-3368_日米関係は重要です。.mp3]	(<b>日米</b>) 日米関係は重要です。<br> にちべいかんけいはじゅうようです。 <br>Japan-US relations are important.	
予断	[sound:k-3379_予断.mp3]<br>よだん <br> guessing, prediction, conclusion
guessing, prediction, conclusion	<b>予断<b> <br> よだん <br>[sound:k-3379_予断.mp3]
[sound:k-3379_予断.mp3]	guessing, prediction, conclusion<br> <b>予断</b> <br> (よだん)
(<b>努力</b>) 努力すれば報われると信じています。	[sound:s-3379_努力すれば報われると信じています。.mp3] <br> どりょくすればむくわれるとしんじています。 <br> I believe that hard work pays off.
[sound:s-3369_米国は経済大国です。.mp3]	(<b>米国</b>) 米国は経済大国です。<br> べいこくはけいざいたいこくです。 <br>The United States is an economic superpower.	
井	[sound:k-3380_井.mp3]<br>い <br> well
well	<b>井<b> <br> い <br>[sound:k-3380_井.mp3]
[sound:k-3380_井.mp3]	well<br> <b>井</b> <br> (い)
(<b>協力</b>) チームワークと協力が重要です。	[sound:s-3380_チームワークと協力が重要です。.mp3] <br> ちーむわーくときょうりょくがじゅうようです。 <br> Teamwork and cooperation are important.
[sound:s-3370_全米チャンピオンになることが彼の夢です。.mp3]	(<b>全米</b>) 全米チャンピオンになることが彼の夢です。<br> ぜんべいちゃんぴおんになることがかれのゆめです。 <br>Becoming the national champion is his dream.	
天井	[sound:k-3381_天井.mp3]<br>てんじょう <br> ceiling, ceiling price
ceiling, ceiling price	<b>天井<b> <br> てんじょう <br>[sound:k-3381_天井.mp3]
[sound:k-3381_天井.mp3]	ceiling, ceiling price<br> <b>天井</b> <br> (てんじょう)
