[sound:s-1680_彼は異なる価値観を持つ人々と理解し合うことができる。.mp3]	(<b>価値観</b>) 彼は異なる価値観を持つ人々と理解し合うことができる。<br> かれはことなるかちかんをもつひとびととりかいしゃうことができる。 <br>He can understand and empathize with people who hold different values.	
都道府県	[sound:k-1691_都道府県.mp3]<br>とどうふけん <br> administrative divisions of Japan: Tokyo-to, Hokkai-do, Osaka-fu, Kyoto-fu and remaining prefectures
administrative divisions of Japan: Tokyo-to, Hokkai-do, Osaka-fu, Kyoto-fu and remaining prefectures	<b>都道府県<b> <br> とどうふけん <br>[sound:k-1691_都道府県.mp3]
[sound:k-1691_都道府県.mp3]	administrative divisions of Japan: Tokyo-to, Hokkai-do, Osaka-fu, Kyoto-fu and remaining prefectures<br> <b>都道府県</b> <br> (とどうふけん)
(<b>式典</b>) 結婚式典に出席する。	[sound:s-1691_結婚式典に出席する。.mp3] <br> けっこんしきでんにしゅっせきする。 <br> Attend the wedding ceremony.
[sound:s-1681_株式は代表的な有価証券の一つだ。.mp3]	(<b>有価証券</b>) 株式は代表的な有価証券の一つだ。<br> かぶしきはだいひょうてきなゆうかしょうけんのひとつだ。 <br>Stocks are one of the representative securities.	
総理府	[sound:k-1692_総理府.mp3]<br>そうりふ <br> Prime Minister's office, PMO
Prime Minister's office, PMO	<b>総理府<b> <br> そうりふ <br>[sound:k-1692_総理府.mp3]
[sound:k-1692_総理府.mp3]	Prime Minister's office, PMO<br> <b>総理府</b> <br> (そうりふ)
(<b>結婚式</b>) 彼らは美しい結婚式を挙げた。	[sound:s-1692_彼らは美しい結婚式を挙げた。.mp3] <br> かれらはうつくしいけっこんしきをあげた。 <br> They had a beautiful wedding ceremony.
[sound:s-1682_米価の上昇が農家にとって好ましくない影響を与える。.mp3]	(<b>米価</b>) 米価の上昇が農家にとって好ましくない影響を与える。<br> べいかのじょうしょうがのうかにとってこのましくないえいきょうをあたえる。 <br>The rise in rice prices has undesirable effects on farmers.	
府警	[sound:k-1693_府警.mp3]<br>ふけい <br> prefectural police
prefectural police	<b>府警<b> <br> ふけい <br>[sound:k-1693_府警.mp3]
[sound:k-1693_府警.mp3]	prefectural police<br> <b>府警</b> <br> (ふけい)
(<b>株式会社</b>) 株式会社は株主から資本を調達する。	[sound:s-1693_株式会社は株主から資本を調達する。.mp3] <br> かぶしきがいしゃはかぶぬしからしほんをちょうたつする。 <br> A corporation raises capital from shareholders.
[sound:s-1683_不動産の時価は市況に左右される。.mp3]	(<b>時価</b>) 不動産の時価は市況に左右される。<br> ふどうさんのじかはしきょうにさゆうされる。 <br>The market value of real estate is influenced by market conditions.	
府立	[sound:k-1694_府立.mp3]<br>ふりつ <br> managed by an urban prefecture
managed by an urban prefecture	<b>府立<b> <br> ふりつ <br>[sound:k-1694_府立.mp3]
[sound:k-1694_府立.mp3]	managed by an urban prefecture<br> <b>府立</b> <br> (ふりつ)
(<b>儀式</b>) 彼らは古代の儀式を再現した。	[sound:s-1694_彼らは古代の儀式を再現した。.mp3] <br> かれらはこだいのぎしきをさいげんした。 <br> They reenacted an ancient ritual.
[sound:s-1684_彼の才能は高く評価されている。.mp3]	(<b>評価</b>) 彼の才能は高く評価されている。<br> かれのさいのうはたかくひょうかされている。 <br>His talent is highly appreciated.	
府中	[sound:k-1695_府中.mp3]<br>ふちゅう <br> Fuchuu (in Tokyo)
Fuchuu (in Tokyo)	<b>府中<b> <br> ふちゅう <br>[sound:k-1695_府中.mp3]
[sound:k-1695_府中.mp3]	Fuchuu<br> <b>in Tokyo) (府中</b> <br> (ふちゅう)
(<b>確か</b>) その情報は確かではない。	[sound:s-1695_その情報は確かではない。.mp3] <br> そのじょうほうはたしかではない。 <br> That information is not certain.
[sound:s-1685_彼は株式投資で成功した。.mp3]	(<b>株式</b>) 彼は株式投資で成功した。<br> かれはかぶしきとうしみでせいこうした。 <br>He succeeded in stock investment.	
州政府	[sound:k-1696_州政府.mp3]<br>しゅうせいふ <br> state government
state government	<b>州政府<b> <br> しゅうせいふ <br>[sound:k-1696_州政府.mp3]
[sound:k-1696_州政府.mp3]	state government<br> <b>州政府</b> <br> (しゅうせいふ)
(<b>確実</b>) 彼は確実に成功するだろう。	[sound:s-1696_彼は確実に成功するだろう。.mp3] <br> かれはかくじつにせいこうするだろう。 <br> He will surely succeed.
[sound:s-1686_この手紙は公式の文書です。.mp3]	(<b>公式</b>) この手紙は公式の文書です。<br> このてがみはこうしきのぶんしょです。 <br>This letter is an official document.	
幕府	[sound:k-1697_幕府.mp3]<br>ばくふ <br> bakufu, shogunate
bakufu, shogunate	<b>幕府<b> <br> ばくふ <br>[sound:k-1697_幕府.mp3]
[sound:k-1697_幕府.mp3]	bakufu, shogunate<br> <b>幕府</b> <br> (ばくふ)
(<b>確保</b>) 安全を確保するために対策を講じる。	[sound:s-1697_安全を確保するために対策を講じる。.mp3] <br> あんぜんをかくほするためにたいさくをこうじる。 <br> Take measures to ensure safety.
[sound:s-1687_正式な手続きを踏む必要があります。.mp3]	(<b>正式</b>) 正式な手続きを踏む必要があります。<br> せいしきなてつづきをふむひつようがあります。 <br>Formal procedures need to be followed.	
府県	[sound:k-1698_府県.mp3]<br>ふけん <br> prefecture
prefecture	<b>府県<b> <br> ふけん <br>[sound:k-1698_府県.mp3]
[sound:k-1698_府県.mp3]	prefecture<br> <b>府県</b> <br> (ふけん)
(<b>明確</b>) 彼の意図は明確ではない。	[sound:s-1698_彼の意図は明確ではない。.mp3] <br> かれのいとはめいかくではない。 <br> His intentions are not clear.
[sound:s-1688_新しい料理の作り方を学ぶ。.mp3]	(<b>方式</b>) 新しい料理の作り方を学ぶ。<br> あたらしいりょうりのつくりかたをまなぶ。 <br>Learn how to cook a new dish.	
立法府	[sound:k-1699_立法府.mp3]<br>りっぽうふ <br> assize, court; legislature
assize, court; legislature	<b>立法府<b> <br> りっぽうふ <br>[sound:k-1699_立法府.mp3]
[sound:k-1699_立法府.mp3]	assize, court; legislature<br> <b>立法府</b> <br> (りっぽうふ)
(<b>確認</b>) 予約内容を確認する。	[sound:s-1699_予約内容を確認する。.mp3] <br> よやくないようをかくにんする。 <br> Confirm the reservation details.
[sound:s-1689_会議は形式を守って行われた。.mp3]	(<b>形式</b>) 会議は形式を守って行われた。<br> かいぎはけいしきをまもっておこなわれた。 <br>The meeting was conducted following the formalities.	
活動	[sound:k-1700_活動.mp3]<br>かつどう <br> action, activity
action, activity	<b>活動<b> <br> かつどう <br>[sound:k-1700_活動.mp3]
[sound:k-1700_活動.mp3]	action, activity<br> <b>活動</b> <br> (かつどう)
(<b>確立</b>) 友情を確立するには時間がかかる。	[sound:s-1700_友情を確立するには時間がかかる。.mp3] <br> ゆうじょうをかくりつするにはじかんがかかる。 <br> It takes time to establish friendship.
[sound:s-1690_非公式の情報が流れている。.mp3]	(<b>非公式</b>) 非公式の情報が流れている。<br> ひこうしきのじょうほうがながれている。 <br>Unofficial information is circulating.	
生活	[sound:k-1701_生活.mp3]<br>せいかつ <br> living, life (one's daily existence), livelihood
living, life (one's daily existence), livelihood	<b>生活<b> <br> せいかつ <br>[sound:k-1701_生活.mp3]
[sound:k-1701_生活.mp3]	living, life<br> <b>one's daily existence), livelihood (生活</b> <br> (せいかつ)
(<b>確定</b>) 日程を確定する必要があります。	[sound:s-1701_日程を確定する必要があります。.mp3] <br> にっていをかくていするひつようがあります。 <br> We need to finalize the schedule.
[sound:s-1691_結婚式典に出席する。.mp3]	(<b>式典</b>) 結婚式典に出席する。<br> けっこんしきでんにしゅっせきする。 <br>Attend the wedding ceremony.	
活発	[sound:k-1702_活発.mp3]<br>かっぱつ <br> vigor, vigour, active, lively
vigor, vigour, active, lively	<b>活発<b> <br> かっぱつ <br>[sound:k-1702_活発.mp3]
[sound:k-1702_活発.mp3]	vigor, vigour, active, lively<br> <b>活発</b> <br> (かっぱつ)
(<b>的確</b>) 的確な解決策を見つける。	[sound:s-1702_的確な解決策を見つける。.mp3] <br> てきかくなかいけつさくをみつける。 <br> Find a precise solution.
[sound:s-1692_彼らは美しい結婚式を挙げた。.mp3]	(<b>結婚式</b>) 彼らは美しい結婚式を挙げた。<br> かれらはうつくしいけっこんしきをあげた。 <br>They had a beautiful wedding ceremony.	
活性	[sound:k-1703_活性.mp3]<br>かっせい <br> activity
activity	<b>活性<b> <br> かっせい <br>[sound:k-1703_活性.mp3]
[sound:k-1703_活性.mp3]	activity<br> <b>活性</b> <br> (かっせい)
(<b>確率</b>) 勝利の確率は50％だ。	[sound:s-1703_勝利の確率は50％だ。.mp3] <br> しょうりのかくりつは50%だ。 <br> The probability of winning is 50%.
[sound:s-1693_株式会社は株主から資本を調達する。.mp3]	(<b>株式会社</b>) 株式会社は株主から資本を調達する。<br> かぶしきがいしゃはかぶぬしからしほんをちょうたつする。 <br>A corporation raises capital from shareholders.	
活躍	[sound:k-1704_活躍.mp3]<br>かつやく <br> activity (esp. energetic), great efforts, conspicuous service; to flourish, to participate actively, to play an active role
activity (esp. energetic), great efforts, conspicuous service; to flourish, to participate actively, to play an active role	<b>活躍<b> <br> かつやく <br>[sound:k-1704_活躍.mp3]
[sound:k-1704_活躍.mp3]	activity<br> <b>esp. energetic), great efforts, conspicuous service; to flourish, to participate actively, to play an active role (活躍</b> <br> (かつやく)
(<b>確執</b>) 二人の間には確執がある。	[sound:s-1704_二人の間には確執がある。.mp3] <br> ふたりのあいだにはかくしつがある。 <br> There is a conflict between the two.
[sound:s-1694_彼らは古代の儀式を再現した。.mp3]	(<b>儀式</b>) 彼らは古代の儀式を再現した。<br> かれらはこだいのぎしきをさいげんした。 <br>They reenacted an ancient ritual.	
復活	[sound:k-1705_復活.mp3]<br>ふっかつ <br> revival (e.g. musical), come-back; restoration, rebirth, resurrection
revival (e.g. musical), come-back; restoration, rebirth, resurrection	<b>復活<b> <br> ふっかつ <br>[sound:k-1705_復活.mp3]
[sound:k-1705_復活.mp3]	revival<br> <b>e.g. musical), come-back; restoration, rebirth, resurrection (復活</b> <br> (ふっかつ)
(<b>村</b>) 村には自然が豊かだ。	[sound:s-1705_村には自然が豊かだ。.mp3] <br> むらにはしぜんがゆたかだ。 <br> The village is abundant in nature.
[sound:s-1695_その情報は確かではない。.mp3]	(<b>確か</b>) その情報は確かではない。<br> そのじょうほうはたしかではない。 <br>That information is not certain.	
活用	[sound:k-1706_活用.mp3]<br>かつよう <br> practical use, application; conjugation, declension, inflection
practical use, application; conjugation, declension, inflection	<b>活用<b> <br> かつよう <br>[sound:k-1706_活用.mp3]
[sound:k-1706_活用.mp3]	practical use, application; conjugation, declension, inflection<br> <b>活用</b> <br> (かつよう)
(<b>市町村</b>) 市町村の合併が進められている。	[sound:s-1706_市町村の合併が進められている。.mp3] <br> しちょうそんのがっぺいがすすめられている。 <br> Municipal mergers are being promoted.
[sound:s-1696_彼は確実に成功するだろう。.mp3]	(<b>確実</b>) 彼は確実に成功するだろう。<br> かれはかくじつにせいこうするだろう。 <br>He will surely succeed.	
活力	[sound:k-1707_活力.mp3]<br>かつりょく <br> vitality, energy
vitality, energy	<b>活力<b> <br> かつりょく <br>[sound:k-1707_活力.mp3]
[sound:k-1707_活力.mp3]	vitality, energy<br> <b>活力</b> <br> (かつりょく)
(<b>農村</b>) 農村地帯では農業が主要産業だ。	[sound:s-1707_農村地帯では農業が主要産業だ。.mp3] <br> のうそんちたいではのうぎょうがしゅようさんぎょうだ。 <br> Agriculture is the primary industry in rural areas.
[sound:s-1697_安全を確保するために対策を講じる。.mp3]	(<b>確保</b>) 安全を確保するために対策を講じる。<br> あんぜんをかくほするためにたいさくをこうじる。 <br>Take measures to ensure safety.	
活動家	[sound:k-1708_活動家.mp3]<br>かつどうか <br> (anti-war) activist
(anti-war) activist	<b>活動家<b> <br> かつどうか <br>[sound:k-1708_活動家.mp3]
[sound:k-1708_活動家.mp3]	(anti-war) activist<br> <b>活動家</b> <br> (かつどうか)
(<b>山村</b>) 山村での生活は静かでのんびりしている。	[sound:s-1708_山村での生活は静かでのんびりしている。.mp3] <br> やまむらでのせいかつはしずかでのんびりしている。 <br> Life in the mountain village is quiet and relaxed.
[sound:s-1698_彼の意図は明確ではない。.mp3]	(<b>明確</b>) 彼の意図は明確ではない。<br> かれのいとはめいかくではない。 <br>His intentions are not clear.	
食生活	[sound:k-1709_食生活.mp3]<br>しょくせいかつ <br> eating habits
eating habits	<b>食生活<b> <br> しょくせいかつ <br>[sound:k-1709_食生活.mp3]
[sound:k-1709_食生活.mp3]	eating habits<br> <b>食生活</b> <br> (しょくせいかつ)
(<b>村長</b>) 村長は地域の発展に尽力している。	[sound:s-1709_村長は地域の発展に尽力している。.mp3] <br> そんちょうはちいきのはってんにじんりょくしている。 <br> The village chief is working hard for the development of the area.
[sound:s-1699_予約内容を確認する。.mp3]	(<b>確認</b>) 予約内容を確認する。<br> よやくないようをかくにんする。 <br>Confirm the reservation details.	
原因	[sound:k-1710_原因.mp3]<br>げんいん <br> cause, origin, source
cause, origin, source	<b>原因<b> <br> げんいん <br>[sound:k-1710_原因.mp3]
[sound:k-1710_原因.mp3]	cause, origin, source<br> <b>原因</b> <br> (げんいん)
(<b>町村</b>) 彼は町村の行政を担当している。	[sound:s-1710_彼は町村の行政を担当している。.mp3] <br> かれはちょうそんのぎょうせいをたんとうしている。 <br> He is in charge of municipal administration.
[sound:s-1700_友情を確立するには時間がかかる。.mp3]	(<b>確立</b>) 友情を確立するには時間がかかる。<br> ゆうじょうをかくりつするにはじかんがかかる。 <br>It takes time to establish friendship.	
原則	[sound:k-1711_原則.mp3]<br>げんそく <br> principle, general rule
principle, general rule	<b>原則<b> <br> げんそく <br>[sound:k-1711_原則.mp3]
[sound:k-1711_原則.mp3]	principle, general rule<br> <b>原則</b> <br> (げんそく)
(<b>村人</b>) 村人たちは地域の伝統を守っている。	[sound:s-1711_村人たちは地域の伝統を守っている。.mp3] <br> むらびとたちはちいきのでんとうをまもっている。 <br> Villagers are preserving the traditions of the region.
[sound:s-1701_日程を確定する必要があります。.mp3]	(<b>確定</b>) 日程を確定する必要があります。<br> にっていをかくていするひつようがあります。 <br>We need to finalize the schedule.	
原子力	[sound:k-1712_原子力.mp3]<br>げんしりょく <br> atomic energy
atomic energy	<b>原子力<b> <br> げんしりょく <br>[sound:k-1712_原子力.mp3]
[sound:k-1712_原子力.mp3]	atomic energy<br> <b>原子力</b> <br> (げんしりょく)
(<b>選手村</b>) 選手村には多くの国からのアスリートが宿泊する。	[sound:s-1712_選手村には多くの国からのアスリートが宿泊する。.mp3] <br> せんしゅそんにはおおくのくにからのあすりーとがしゅくはくする。 <br> Athletes from many countries stay in the athletes' village.
[sound:s-1702_的確な解決策を見つける。.mp3]	(<b>的確</b>) 的確な解決策を見つける。<br> てきかくなかいけつさくをみつける。 <br>Find a precise solution.	
原告	[sound:k-1713_原告.mp3]<br>げんこく <br> plaintiff, accuser, prosecutor
plaintiff, accuser, prosecutor	<b>原告<b> <br> げんこく <br>[sound:k-1713_原告.mp3]
[sound:k-1713_原告.mp3]	plaintiff, accuser, prosecutor<br> <b>原告</b> <br> (げんこく)
(<b>村民</b>) 村民たちは地域の発展に貢献している。	[sound:s-1713_村民たちは地域の発展に貢献している。.mp3] <br> むらみんたちはちいきのはってんにこうけんしている。 <br> Villagers are contributing to the development of the region.
[sound:s-1703_勝利の確率は50％だ。.mp3]	(<b>確率</b>) 勝利の確率は50％だ。<br> しょうりのかくりつは50%だ。 <br>The probability of winning is 50%.	
原発	[sound:k-1714_原発.mp3]<br>げんぱつ <br> nuclear power plant, nuclear power supply
nuclear power plant, nuclear power supply	<b>原発<b> <br> げんぱつ <br>[sound:k-1714_原発.mp3]
[sound:k-1714_原発.mp3]	nuclear power plant, nuclear power supply<br> <b>原発</b> <br> (げんぱつ)
(<b>村議会</b>) 村議会は地域の問題を協議する。	[sound:s-1714_村議会は地域の問題を協議する。.mp3] <br> むらぎかいはちいきのもんだいをきょうぎする。 <br> The village council discusses local issues.
[sound:s-1704_二人の間には確執がある。.mp3]	(<b>確執</b>) 二人の間には確執がある。<br> ふたりのあいだにはかくしつがある。 <br>There is a conflict between the two.	
原油	[sound:k-1715_原油.mp3]<br>げんゆ <br> crude oil
crude oil	<b>原油<b> <br> げんゆ <br>[sound:k-1715_原油.mp3]
[sound:k-1715_原油.mp3]	crude oil<br> <b>原油</b> <br> (げんゆ)
(<b>前提</b>) その計画の成功にはいくつかの前提条件がある。	[sound:s-1715_その計画の成功にはいくつかの前提条件がある。.mp3] <br> そのけいかくのせいこうにはいくつかのぜんていじょうけんがある。 <br> There are several prerequisite conditions for the success of the plan.
[sound:s-1705_村には自然が豊かだ。.mp3]	(<b>村</b>) 村には自然が豊かだ。<br> むらにはしぜんがゆたかだ。 <br>The village is abundant in nature.	
原理	[sound:k-1716_原理.mp3]<br>げんり <br> principle, theory, fundamental truth
principle, theory, fundamental truth	<b>原理<b> <br> げんり <br>[sound:k-1716_原理.mp3]
[sound:k-1716_原理.mp3]	principle, theory, fundamental truth<br> <b>原理</b> <br> (げんり)
(<b>提案</b>) 彼は新しいアイデアを提案した。	[sound:s-1716_彼は新しいアイデアを提案した。.mp3] <br> かれはあたらしいあいであをていあんした。 <br> He proposed a new idea.
[sound:s-1706_市町村の合併が進められている。.mp3]	(<b>市町村</b>) 市町村の合併が進められている。<br> しちょうそんのがっぺいがすすめられている。 <br>Municipal mergers are being promoted.	
原点	[sound:k-1717_原点.mp3]<br>げんてん <br> origin (coordinates), starting point
origin (coordinates), starting point	<b>原点<b> <br> げんてん <br>[sound:k-1717_原点.mp3]
[sound:k-1717_原点.mp3]	origin<br> <b>coordinates), starting point (原点</b> <br> (げんてん)
(<b>提供</b>) 彼女は寄付金を提供した。	[sound:s-1717_彼女は寄付金を提供した。.mp3] <br> かのじょはきふきんをていきょうした。 <br> She donated money.
[sound:s-1707_農村地帯では農業が主要産業だ。.mp3]	(<b>農村</b>) 農村地帯では農業が主要産業だ。<br> のうそんちたいではのうぎょうがしゅようさんぎょうだ。 <br>Agriculture is the primary industry in rural areas.	
原爆	[sound:k-1718_原爆.mp3]<br>げんばく <br> atomic bomb, A-bomb
atomic bomb, A-bomb	<b>原爆<b> <br> げんばく <br>[sound:k-1718_原爆.mp3]
[sound:k-1718_原爆.mp3]	atomic bomb, A-bomb<br> <b>原爆</b> <br> (げんばく)
(<b>提出</b>) 書類を提出する締め切りが近づいています。	[sound:s-1718_書類を提出する締め切りが近づいています。.mp3] <br> しょるいをていしゅつするしめきりがちかづいています。 <br> The deadline for submitting documents is approaching.
[sound:s-1708_山村での生活は静かでのんびりしている。.mp3]	(<b>山村</b>) 山村での生活は静かでのんびりしている。<br> やまむらでのせいかつはしずかでのんびりしている。 <br>Life in the mountain village is quiet and relaxed.	
原案	[sound:k-1719_原案.mp3]<br>げんあん <br> original plan, original bill, motion, draft, draught
original plan, original bill, motion, draft, draught	<b>原案<b> <br> げんあん <br>[sound:k-1719_原案.mp3]
[sound:k-1719_原案.mp3]	original plan, original bill, motion, draft, draught<br> <b>原案</b> <br> (げんあん)
(<b>提言</b>) 彼は問題の解決策を提言した。	[sound:s-1719_彼は問題の解決策を提言した。.mp3] <br> かれはもんだいのかいけつさくをていげんした。 <br> He suggested a solution to the problem.
[sound:s-1709_村長は地域の発展に尽力している。.mp3]	(<b>村長</b>) 村長は地域の発展に尽力している。<br> そんちょうはちいきのはってんにじんりょくしている。 <br>The village chief is working hard for the development of the area.	
先に	[sound:k-1720_先に.mp3]<br>さきに <br> before, earlier than, ahead, beyond, away, previously, recently
before, earlier than, ahead, beyond, away, previously, recently	<b>先に<b> <br> さきに <br>[sound:k-1720_先に.mp3]
[sound:k-1720_先に.mp3]	before, earlier than, ahead, beyond, away, previously, recently<br> <b>先に</b> <br> (さきに)
(<b>提携</b>) 両社は業務提携を結んだ。	[sound:s-1720_両社は業務提携を結んだ。.mp3] <br> りょうしゃはぎょうむていけいをむすんだ。 <br> The two companies formed a business partnership.
[sound:s-1710_彼は町村の行政を担当している。.mp3]	(<b>町村</b>) 彼は町村の行政を担当している。<br> かれはちょうそんのぎょうせいをたんとうしている。 <br>He is in charge of municipal administration.	
先月	[sound:k-1721_先月.mp3]<br>せんげつ <br> last month
last month	<b>先月<b> <br> せんげつ <br>[sound:k-1721_先月.mp3]
[sound:k-1721_先月.mp3]	last month<br> <b>先月</b> <br> (せんげつ)
(<b>提訴</b>) 彼は訴訟を提訴した。	[sound:s-1721_彼は訴訟を提訴した。.mp3] <br> かれはそしょうをていそした。 <br> He filed a lawsuit.
[sound:s-1711_村人たちは地域の伝統を守っている。.mp3]	(<b>村人</b>) 村人たちは地域の伝統を守っている。<br> むらびとたちはちいきのでんとうをまもっている。 <br>Villagers are preserving the traditions of the region.	
先進国	[sound:k-1722_先進国.mp3]<br>せんしんこく <br> advanced (developed) country, advanced nations
advanced (developed) country, advanced nations	<b>先進国<b> <br> せんしんこく <br>[sound:k-1722_先進国.mp3]
[sound:k-1722_先進国.mp3]	advanced<br> <b>developed) country, advanced nations (先進国</b> <br> (せんしんこく)
(<b>提示</b>) 資料を提示してください。	[sound:s-1722_資料を提示してください。.mp3] <br> しりょうをていじしてください。 <br> Please present the materials.
[sound:s-1712_選手村には多くの国からのアスリートが宿泊する。.mp3]	(<b>選手村</b>) 選手村には多くの国からのアスリートが宿泊する。<br> せんしゅそんにはおおくのくにからのあすりーとがしゅくはくする。 <br>Athletes from many countries stay in the athletes' village.	
先生	[sound:k-1723_先生.mp3]<br>せんせい <br> teacher, master, doctor; with names of teachers, etc. as an honorific
teacher, master, doctor; with names of teachers, etc. as an honorific	<b>先生<b> <br> せんせい <br>[sound:k-1723_先生.mp3]
[sound:k-1723_先生.mp3]	teacher, master, doctor; with names of teachers, etc. as an honorific<br> <b>先生</b> <br> (せんせい)
(<b>提供者</b>) 寄付金の提供者に感謝の意を示した。	[sound:s-1723_寄付金の提供者に感謝の意を示した。.mp3] <br> きふきんのていきょうしゃにかんしゃのいをしめした。 <br> We expressed our gratitude to the donors.
[sound:s-1713_村民たちは地域の発展に貢献している。.mp3]	(<b>村民</b>) 村民たちは地域の発展に貢献している。<br> むらみんたちはちいきのはってんにこうけんしている。 <br>Villagers are contributing to the development of the region.	
先発	[sound:k-1724_先発.mp3]<br>せんぱつ <br> forerunner, advance party, going on ahead; being in a (team sports) match or game from the start, starting
forerunner, advance party, going on ahead; being in a (team sports) match or game from the start, starting	<b>先発<b> <br> せんぱつ <br>[sound:k-1724_先発.mp3]
[sound:k-1724_先発.mp3]	forerunner, advance party, going on ahead; being in a<br> <b>team sports) match or game from the start, starting (先発</b> <br> (せんぱつ)
(<b>提起</b>) 問題提起をする。	[sound:s-1724_問題提起をする。.mp3] <br> もんだいていきをする。 <br> Raise an issue.
[sound:s-1714_村議会は地域の問題を協議する。.mp3]	(<b>村議会</b>) 村議会は地域の問題を協議する。<br> むらぎかいはちいきのもんだいをきょうぎする。 <br>The village council discusses local issues.	
優先	[sound:k-1725_優先.mp3]<br>ゆうせん <br> preference, priority, precedence
preference, priority, precedence	<b>優先<b> <br> ゆうせん <br>[sound:k-1725_優先.mp3]
[sound:k-1725_優先.mp3]	preference, priority, precedence<br> <b>優先</b> <br> (ゆうせん)
(<b>運</b>) 成功には運も必要だ。	[sound:s-1725_成功には運も必要だ。.mp3] <br> せいこうにはうんもひつようだ。 <br> Luck is also necessary for success.
[sound:s-1715_その計画の成功にはいくつかの前提条件がある。.mp3]	(<b>前提</b>) その計画の成功にはいくつかの前提条件がある。<br> そのけいかくのせいこうにはいくつかのぜんていじょうけんがある。 <br>There are several prerequisite conditions for the success of the plan.	
先進	[sound:k-1726_先進.mp3]<br>せんしん <br> seniority, advance, leadership
seniority, advance, leadership	<b>先進<b> <br> せんしん <br>[sound:k-1726_先進.mp3]
[sound:k-1726_先進.mp3]	seniority, advance, leadership<br> <b>先進</b> <br> (せんしん)
(<b>運ぶ</b>) 荷物を運ぶのに手伝ってください。	[sound:s-1726_荷物を運ぶのに手伝ってください。.mp3] <br> にもつをはこぶのにてつだってください。 <br> Please help carry the luggage.
[sound:s-1716_彼は新しいアイデアを提案した。.mp3]	(<b>提案</b>) 彼は新しいアイデアを提案した。<br> かれはあたらしいあいであをていあんした。 <br>He proposed a new idea.	
先頭	[sound:k-1727_先頭.mp3]<br>せんとう <br> head, lead, vanguard, first
head, lead, vanguard, first	<b>先頭<b> <br> せんとう <br>[sound:k-1727_先頭.mp3]
[sound:k-1727_先頭.mp3]	head, lead, vanguard, first<br> <b>先頭</b> <br> (せんとう)
(<b>運動</b>) 日常的な運動は健康に良い。	[sound:s-1727_日常的な運動は健康に良い。.mp3] <br> にちじょうてきなうんどうはけんこうによい。 <br> Regular exercise is good for health.
[sound:s-1717_彼女は寄付金を提供した。.mp3]	(<b>提供</b>) 彼女は寄付金を提供した。<br> かのじょはきふきんをていきょうした。 <br>She donated money.	
先行	[sound:k-1728_先行.mp3]<br>せんこう <br> preceding, going first, leading, going ahead, taking priority
preceding, going first, leading, going ahead, taking priority	<b>先行<b> <br> せんこう <br>[sound:k-1728_先行.mp3]
[sound:k-1728_先行.mp3]	preceding, going first, leading, going ahead, taking priority<br> <b>先行</b> <br> (せんこう)
(<b>運営</b>) このイベントの運営を担当しています。	[sound:s-1728_このイベントの運営を担当しています。.mp3] <br> このいべんとのうんえいをたんとうしています。 <br> I'm in charge of managing this event.
[sound:s-1718_書類を提出する締め切りが近づいています。.mp3]	(<b>提出</b>) 書類を提出する締め切りが近づいています。<br> しょるいをていしゅつするしめきりがちかづいています。 <br>The deadline for submitting documents is approaching.	
先週	[sound:k-1729_先週.mp3]<br>せんしゅう <br> last week, the week before
last week, the week before	<b>先週<b> <br> せんしゅう <br>[sound:k-1729_先週.mp3]
[sound:k-1729_先週.mp3]	last week, the week before<br> <b>先週</b> <br> (せんしゅう)
(<b>運転</b>) 車の運転が得意です。	[sound:s-1729_車の運転が得意です。.mp3] <br> くるまのうんてんがとくいです。 <br> I am good at driving.
[sound:s-1719_彼は問題の解決策を提言した。.mp3]	(<b>提言</b>) 彼は問題の解決策を提言した。<br> かれはもんだいのかいけつさくをていげんした。 <br>He suggested a solution to the problem.	
共産党	[sound:k-1730_共産党.mp3]<br>きょうさんとう <br> Communist Party
Communist Party	<b>共産党<b> <br> きょうさんとう <br>[sound:k-1730_共産党.mp3]
[sound:k-1730_共産党.mp3]	Communist Party<br> <b>共産党</b> <br> (きょうさんとう)
(<b>運輸</b>) 商品の運輸が円滑に進んだ。	[sound:s-1730_商品の運輸が円滑に進んだ。.mp3] <br> しょうひんのうんゆがえんかつにすすんだ。 <br> The transportation of goods proceeded smoothly.
[sound:s-1720_両社は業務提携を結んだ。.mp3]	(<b>提携</b>) 両社は業務提携を結んだ。<br> りょうしゃはぎょうむていけいをむすんだ。 <br>The two companies formed a business partnership.	
共同	[sound:k-1731_共同.mp3]<br>きょうどう <br> doing together (as equals), sharing, common (land, etc.), joint (statement, etc.), cooperation, co-operation, collaboration, association
doing together (as equals), sharing, common (land, etc.), joint (statement, etc.), cooperation, co-operation, collaboration, association	<b>共同<b> <br> きょうどう <br>[sound:k-1731_共同.mp3]
[sound:k-1731_共同.mp3]	doing together<br> <b>as equals), sharing, common (land, etc.), joint (statement, etc.), cooperation, co-operation, collaboration, association (共同</b> <br> (きょうどう)
(<b>運輸省</b>) 運輸省は国の交通政策を担当している。	[sound:s-1731_運輸省は国の交通政策を担当している。.mp3] <br> うんゆしょうはくにのこうつうせいさくをたんとうしている。 <br> The Ministry of Transport is in charge of the country's transportation policies.
[sound:s-1721_彼は訴訟を提訴した。.mp3]	(<b>提訴</b>) 彼は訴訟を提訴した。<br> かれはそしょうをていそした。 <br>He filed a lawsuit.	
グアテマラ共和国	[sound:k-1732_グアテマラ共和国.mp3]<br>グアテマラきょうわこく <br> Republic of Guatemala
Republic of Guatemala	<b>グアテマラ共和国<b> <br> グアテマラきょうわこく <br>[sound:k-1732_グアテマラ共和国.mp3]
[sound:k-1732_グアテマラ共和国.mp3]	Republic of Guatemala<br> <b>グアテマラ共和国</b> <br> (グアテマラきょうわこく)
(<b>運用</b>) 資金を効果的に運用する。	[sound:s-1732_資金を効果的に運用する。.mp3] <br> しきんをこうかてきにうんようする。 <br> Manage funds effectively.
[sound:s-1722_資料を提示してください。.mp3]	(<b>提示</b>) 資料を提示してください。<br> しりょうをていじしてください。 <br>Please present the materials.	
共に	[sound:k-1733_共に.mp3]<br>ともに <br> sharing with, participate in, both, alike, together, along with, with, including
sharing with, participate in, both, alike, together, along with, with, including	<b>共に<b> <br> ともに <br>[sound:k-1733_共に.mp3]
[sound:k-1733_共に.mp3]	sharing with, participate in, both, alike, together, along with, with, including<br> <b>共に</b> <br> (ともに)
(<b>運び</b>) 荷物の運び方を教えてください。	[sound:s-1733_荷物の運び方を教えてください。.mp3] <br> にもつのはこびかたをおしえてください。 <br> Please teach me how to carry luggage.
[sound:s-1723_寄付金の提供者に感謝の意を示した。.mp3]	(<b>提供者</b>) 寄付金の提供者に感謝の意を示した。<br> きふきんのていきょうしゃにかんしゃのいをしめした。 <br>We expressed our gratitude to the donors.	
共通	[sound:k-1734_共通.mp3]<br>きょうつう <br> commonness, community
commonness, community	<b>共通<b> <br> きょうつう <br>[sound:k-1734_共通.mp3]
[sound:k-1734_共通.mp3]	commonness, community<br> <b>共通</b> <br> (きょうつう)
(<b>運転手</b>) 彼はプロの運転手だ。	[sound:s-1734_彼はプロの運転手だ。.mp3] <br> かれはぷろのうんてんしゅだ。 <br> He is a professional driver.
[sound:s-1724_問題提起をする。.mp3]	(<b>提起</b>) 問題提起をする。<br> もんだいていきをする。 <br>Raise an issue.	
共同体	[sound:k-1735_共同体.mp3]<br>きょうどうたい <br> cooperative body, cooperative system, collective, community
cooperative body, cooperative system, collective, community	<b>共同体<b> <br> きょうどうたい <br>[sound:k-1735_共同体.mp3]
[sound:k-1735_共同体.mp3]	cooperative body, cooperative system, collective, community<br> <b>共同体</b> <br> (きょうどうたい)
(<b>終わり</b>) 今日の仕事が終わりました。	[sound:s-1735_今日の仕事が終わりました。.mp3] <br> きょうのしごとがおわりました。 <br> Today's work is finished.
[sound:s-1725_成功には運も必要だ。.mp3]	(<b>運</b>) 成功には運も必要だ。<br> せいこうにはうんもひつようだ。 <br>Luck is also necessary for success.	
公共	[sound:k-1736_公共.mp3]<br>こうきょう <br> public, community, public service, society, communal
public, community, public service, society, communal	<b>公共<b> <br> こうきょう <br>[sound:k-1736_公共.mp3]
[sound:k-1736_公共.mp3]	public, community, public service, society, communal<br> <b>公共</b> <br> (こうきょう)
(<b>最終</b>) 最終バスに間に合った。	[sound:s-1736_最終バスに間に合った。.mp3] <br> さいしゅうバスにまにあった。 <br> I caught the last bus.
[sound:s-1726_荷物を運ぶのに手伝ってください。.mp3]	(<b>運ぶ</b>) 荷物を運ぶのに手伝ってください。<br> にもつをはこぶのにてつだってください。 <br>Please help carry the luggage.	
朝鮮民主主義人民共和国	[sound:k-1737_朝鮮民主主義人民共和国.mp3]<br>ちょうせんみんしゅしゅぎじんみんきょうわこく <br> Democratic People's Republic of Korea (North Korea), DPRK
Democratic People's Republic of Korea (North Korea), DPRK	<b>朝鮮民主主義人民共和国<b> <br> ちょうせんみんしゅしゅぎじんみんきょうわこく <br>[sound:k-1737_朝鮮民主主義人民共和国.mp3]
[sound:k-1737_朝鮮民主主義人民共和国.mp3]	Democratic People's Republic of Korea<br> <b>North Korea), DPRK (朝鮮民主主義人民共和国</b> <br> (ちょうせんみんしゅしゅぎじんみんきょうわこく)
(<b>終える</b>) 仕事を終えて家に帰る。	[sound:s-1737_仕事を終えて家に帰る。.mp3] <br> しごとをおえていえにかえる。 <br> Finish work and go home.
[sound:s-1727_日常的な運動は健康に良い。.mp3]	(<b>運動</b>) 日常的な運動は健康に良い。<br> にちじょうてきなうんどうはけんこうによい。 <br>Regular exercise is good for health.	
共和	[sound:k-1738_共和.mp3]<br>きょうわ <br> republicanism, cooperation
republicanism, cooperation	<b>共和<b> <br> きょうわ <br>[sound:k-1738_共和.mp3]
[sound:k-1738_共和.mp3]	republicanism, cooperation<br> <b>共和</b> <br> (きょうわ)
(<b>終結</b>) 長い交渉が終結した。	[sound:s-1738_長い交渉が終結した。.mp3] <br> ながいこうしょうがしゅうけつした。 <br> The long negotiation has concluded.
[sound:s-1728_このイベントの運営を担当しています。.mp3]	(<b>運営</b>) このイベントの運営を担当しています。<br> このいべんとのうんえいをたんとうしています。 <br>I'm in charge of managing this event.	
共産	[sound:k-1739_共産.mp3]<br>きょうさん <br> communism; Communist Party
communism; Communist Party	<b>共産<b> <br> きょうさん <br>[sound:k-1739_共産.mp3]
[sound:k-1739_共産.mp3]	communism; Communist Party<br> <b>共産</b> <br> (きょうさん)
(<b>最終的</b>) 最終的な決定は彼に委ねられた。	[sound:s-1739_最終的な決定は彼に委ねられた。.mp3] <br> さいしゅうてきなけっていはかれにゆだねられた。 <br> The final decision was entrusted to him.
[sound:s-1729_車の運転が得意です。.mp3]	(<b>運転</b>) 車の運転が得意です。<br> くるまのうんてんがとくいです。 <br>I am good at driving.	
所得	[sound:k-1740_所得.mp3]<br>しょとく <br> income, earnings
income, earnings	<b>所得<b> <br> しょとく <br>[sound:k-1740_所得.mp3]
[sound:k-1740_所得.mp3]	income, earnings<br> <b>所得</b> <br> (しょとく)
(<b>終値</b>) 株価の終値を確認する。	[sound:s-1740_株価の終値を確認する。.mp3] <br> かぶかのしゅうちをかくにんする。 <br> Check the closing price of stocks.
[sound:s-1730_商品の運輸が円滑に進んだ。.mp3]	(<b>運輸</b>) 商品の運輸が円滑に進んだ。<br> しょうひんのうんゆがえんかつにすすんだ。 <br>The transportation of goods proceeded smoothly.	
得	[sound:k-1741_得.mp3]<br>とく <br> profit, advantage, benefit, gain; rebirth in paradise, entering nirvana
profit, advantage, benefit, gain; rebirth in paradise, entering nirvana	<b>得<b> <br> とく <br>[sound:k-1741_得.mp3]
[sound:k-1741_得.mp3]	profit, advantage, benefit, gain; rebirth in paradise, entering nirvana<br> <b>得</b> <br> (とく)
(<b>終了後</b>) 講義終了後、質問に答える。	[sound:s-1741_講義終了後、質問に答える。.mp3] <br> こうぎしゅうりょうご、しつもんにこたえる。 <br> Answer questions after the lecture ends.
[sound:s-1731_運輸省は国の交通政策を担当している。.mp3]	(<b>運輸省</b>) 運輸省は国の交通政策を担当している。<br> うんゆしょうはくにのこうつうせいさくをたんとうしている。 <br>The Ministry of Transport is in charge of the country's transportation policies.	
所得税	[sound:k-1742_所得税.mp3]<br>しょとくぜい <br> income tax
income tax	<b>所得税<b> <br> しょとくぜい <br>[sound:k-1742_所得税.mp3]
[sound:k-1742_所得税.mp3]	income tax<br> <b>所得税</b> <br> (しょとくぜい)
(<b>終戦</b>) 二次世界大戦の終戦記念日。	[sound:s-1742_二次世界大戦の終戦記念日。.mp3] <br> にじせかいたいせんのしゅうせんきねんび。 <br> The anniversary of the end of World War II.
[sound:s-1732_資金を効果的に運用する。.mp3]	(<b>運用</b>) 資金を効果的に運用する。<br> しきんをこうかてきにうんようする。 <br>Manage funds effectively.	
得点	[sound:k-1743_得点.mp3]<br>とくてん <br> score, points made, marks obtained, runs
score, points made, marks obtained, runs	<b>得点<b> <br> とくてん <br>[sound:k-1743_得点.mp3]
[sound:k-1743_得点.mp3]	score, points made, marks obtained, runs<br> <b>得点</b> <br> (とくてん)
(<b>終日</b>) 終日部屋にこもって本を読んだ。	[sound:s-1743_終日部屋にこもって本を読んだ。.mp3] <br> しゅうじつへやにこもってほんをよんだ。 <br> I spent the whole day indoors reading a book.
[sound:s-1733_荷物の運び方を教えてください。.mp3]	(<b>運び</b>) 荷物の運び方を教えてください。<br> にもつのはこびかたをおしえてください。 <br>Please teach me how to carry luggage.	
獲得	[sound:k-1744_獲得.mp3]<br>かくとく <br> acquisition, possession
acquisition, possession	<b>獲得<b> <br> かくとく <br>[sound:k-1744_獲得.mp3]
[sound:k-1744_獲得.mp3]	acquisition, possession<br> <b>獲得</b> <br> (かくとく)
(<b>終盤</b>) 試合の終盤で逆転した。	[sound:s-1744_試合の終盤で逆転した。.mp3] <br> しあいのしゅうばんでぎゃくてんした。 <br> They turned the game around in the final stages.
[sound:s-1734_彼はプロの運転手だ。.mp3]	(<b>運転手</b>) 彼はプロの運転手だ。<br> かれはぷろのうんてんしゅだ。 <br>He is a professional driver.	
説得	[sound:k-1745_説得.mp3]<br>せっとく <br> persuasion
persuasion	<b>説得<b> <br> せっとく <br>[sound:k-1745_説得.mp3]
[sound:k-1745_説得.mp3]	persuasion<br> <b>説得</b> <br> (せっとく)
(<b>挙げる</b>) 成功事例を挙げて説明する。	[sound:s-1745_成功事例を挙げて説明する。.mp3] <br> せいこうじれいをあげてせつめいする。 <br> Give examples of success and explain.
[sound:s-1735_今日の仕事が終わりました。.mp3]	(<b>終わり</b>) 今日の仕事が終わりました。<br> きょうのしごとがおわりました。 <br>Today's work is finished.	
得票	[sound:k-1746_得票.mp3]<br>とくひょう <br> number of votes polled, poll votes
number of votes polled, poll votes	<b>得票<b> <br> とくひょう <br>[sound:k-1746_得票.mp3]
[sound:k-1746_得票.mp3]	number of votes polled, poll votes<br> <b>得票</b> <br> (とくひょう)
(<b>選挙</b>) 来月、地方選挙が行われる。	[sound:s-1746_来月、地方選挙が行われる。.mp3] <br> らいげつ、ちほうせんきょがおこなわれる。 <br> Local elections will be held next month.
[sound:s-1736_最終バスに間に合った。.mp3]	(<b>最終</b>) 最終バスに間に合った。<br> さいしゅうバスにまにあった。 <br>I caught the last bus.	
取得	[sound:k-1747_取得.mp3]<br>しゅとく <br> acquisition
acquisition	<b>取得<b> <br> しゅとく <br>[sound:k-1747_取得.mp3]
[sound:k-1747_取得.mp3]	acquisition<br> <b>取得</b> <br> (しゅとく)
(<b>総選挙</b>) 総選挙の結果が発表された。	[sound:s-1747_総選挙の結果が発表された。.mp3] <br> そうせんきょのけっかがはっぴょうされた。 <br> The results of the general election were announced.
[sound:s-1737_仕事を終えて家に帰る。.mp3]	(<b>終える</b>) 仕事を終えて家に帰る。<br> しごとをおえていえにかえる。 <br>Finish work and go home.	
得意	[sound:k-1748_得意.mp3]<br>とくい <br> triumph, prosperity; pride; one's strong point, one's forte, one's specialty; frequent customer (client, etc.)
triumph, prosperity; pride; one's strong point, one's forte, one's specialty; frequent customer (client, etc.)	<b>得意<b> <br> とくい <br>[sound:k-1748_得意.mp3]
[sound:k-1748_得意.mp3]	triumph, prosperity; pride; one's strong point, one's forte, one's specialty; frequent customer<br> <b>client, etc.) (得意</b> <br> (とくい)
(<b>小選挙区</b>) 小選挙区で激しい選挙戦が繰り広げられた。	[sound:s-1748_小選挙区で激しい選挙戦が繰り広げられた。.mp3] <br> しょうせんきょくではげしいせんきょせんがくりひろげられた。 <br> Fierce electoral battles took place in the single-member constituencies.
[sound:s-1738_長い交渉が終結した。.mp3]	(<b>終結</b>) 長い交渉が終結した。<br> ながいこうしょうがしゅうけつした。 <br>The long negotiation has concluded.	
納得	[sound:k-1749_納得.mp3]<br>なっとく <br> consent, assent, understanding, agreement, comprehension, grasp
consent, assent, understanding, agreement, comprehension, grasp	<b>納得<b> <br> なっとく <br>[sound:k-1749_納得.mp3]
[sound:k-1749_納得.mp3]	consent, assent, understanding, agreement, comprehension, grasp<br> <b>納得</b> <br> (なっとく)
(<b>一挙</b>) 大掃除で一挙に部屋を片付ける。	[sound:s-1749_大掃除で一挙に部屋を片付ける。.mp3] <br> おおそうじでいっきょにへやをかたづける。 <br> Tidy up the room in one go during the big cleanup.
[sound:s-1739_最終的な決定は彼に委ねられた。.mp3]	(<b>最終的</b>) 最終的な決定は彼に委ねられた。<br> さいしゅうてきなけっていはかれにゆだねられた。 <br>The final decision was entrusted to him.	
解決	[sound:k-1750_解決.mp3]<br>かいけつ <br> settlement, solution, resolution
settlement, solution, resolution	<b>解決<b> <br> かいけつ <br>[sound:k-1750_解決.mp3]
[sound:k-1750_解決.mp3]	settlement, solution, resolution<br> <b>解決</b> <br> (かいけつ)
(<b>選挙戦</b>) 激しい選挙戦が繰り広げられた。	[sound:s-1750_激しい選挙戦が繰り広げられた。.mp3] <br> はげしいせんきょせんがくりひろげられた。 <br> A fierce election campaign was waged.
[sound:s-1740_株価の終値を確認する。.mp3]	(<b>終値</b>) 株価の終値を確認する。<br> かぶかのしゅうちをかくにんする。 <br>Check the closing price of stocks.	
解散	[sound:k-1751_解散.mp3]<br>かいさん <br> breakup, dissolution
breakup, dissolution	<b>解散<b> <br> かいさん <br>[sound:k-1751_解散.mp3]
[sound:k-1751_解散.mp3]	breakup, dissolution<br> <b>解散</b> <br> (かいさん)
(<b>挙がる</b>) 彼の名前が挙がった。	[sound:s-1751_彼の名前が挙がった。.mp3] <br> かれのなまえがあがった。 <br> His name came up.
[sound:s-1741_講義終了後、質問に答える。.mp3]	(<b>終了後</b>) 講義終了後、質問に答える。<br> こうぎしゅうりょうご、しつもんにこたえる。 <br>Answer questions after the lecture ends.	
見解	[sound:k-1752_見解.mp3]<br>けんかい <br> opinion, point of view
opinion, point of view	<b>見解<b> <br> けんかい <br>[sound:k-1752_見解.mp3]
[sound:k-1752_見解.mp3]	opinion, point of view<br> <b>見解</b> <br> (けんかい)
(<b>選挙運動</b>) 選挙運動中に有権者に訴える。	[sound:s-1752_選挙運動中に有権者に訴える。.mp3] <br> せんきょうんどうちゅうにゆうけんしゃにうったえる。 <br> Appeal to voters during the election campaign.
[sound:s-1742_二次世界大戦の終戦記念日。.mp3]	(<b>終戦</b>) 二次世界大戦の終戦記念日。<br> にじせかいたいせんのしゅうせんきねんび。 <br>The anniversary of the end of World War II.	
理解	[sound:k-1753_理解.mp3]<br>りかい <br> understanding, comprehension
understanding, comprehension	<b>理解<b> <br> りかい <br>[sound:k-1753_理解.mp3]
[sound:k-1753_理解.mp3]	understanding, comprehension<br> <b>理解</b> <br> (りかい)
(<b>快挙</b>) その選手は快挙を成し遂げた。	[sound:s-1753_その選手は快挙を成し遂げた。.mp3] <br> そのせんしゅはかいきょをなしとげた。 <br> The athlete achieved a remarkable feat.
[sound:s-1743_終日部屋にこもって本を読んだ。.mp3]	(<b>終日</b>) 終日部屋にこもって本を読んだ。<br> しゅうじつへやにこもってほんをよんだ。 <br>I spent the whole day indoors reading a book.	
解除	[sound:k-1754_解除.mp3]<br>かいじょ <br> cancellation, rescinding, release, calling off, lifting (sanctions), delisting
cancellation, rescinding, release, calling off, lifting (sanctions), delisting	<b>解除<b> <br> かいじょ <br>[sound:k-1754_解除.mp3]
[sound:k-1754_解除.mp3]	cancellation, rescinding, release, calling off, lifting<br> <b>sanctions), delisting (解除</b> <br> (かいじょ)
(<b>選挙権</b>) 18歳以上に選挙権が与えられる。	[sound:s-1754_18歳以上に選挙権が与えられる。.mp3] <br> 18さいいじょうにせんきょけんがあたえられる。 <br> Those aged 18 and over are granted the right to vote.
[sound:s-1744_試合の終盤で逆転した。.mp3]	(<b>終盤</b>) 試合の終盤で逆転した。<br> しあいのしゅうばんでぎゃくてんした。 <br>They turned the game around in the final stages.	
解放	[sound:k-1755_解放.mp3]<br>かいほう <br> release, unleashing, liberation, emancipation, setting free; deallocation (of computer memory)
release, unleashing, liberation, emancipation, setting free; deallocation (of computer memory)	<b>解放<b> <br> かいほう <br>[sound:k-1755_解放.mp3]
[sound:k-1755_解放.mp3]	release, unleashing, liberation, emancipation, setting free; deallocation<br> <b>of computer memory) (解放</b> <br> (かいほう)
(<b>結果</b>) 努力の結果、目標を達成した。	[sound:s-1755_努力の結果、目標を達成した。.mp3] <br> どりょくのけっか、もくひょうをたっせいした。 <br> As a result of hard work, the goal was achieved.
[sound:s-1745_成功事例を挙げて説明する。.mp3]	(<b>挙げる</b>) 成功事例を挙げて説明する。<br> せいこうじれいをあげてせつめいする。 <br>Give examples of success and explain.	
解明	[sound:k-1756_解明.mp3]<br>かいめい <br> clarification, elucidation, explication
clarification, elucidation, explication	<b>解明<b> <br> かいめい <br>[sound:k-1756_解明.mp3]
[sound:k-1756_解明.mp3]	clarification, elucidation, explication<br> <b>解明</b> <br> (かいめい)
(<b>効果</b>) 新しい広告戦略の効果を評価する。	[sound:s-1756_新しい広告戦略の効果を評価する。.mp3] <br> あたらしいこうこくせんりゃくのこうかをひょうかする。 <br> Evaluate the effectiveness of the new advertising strategy.
[sound:s-1746_来月、地方選挙が行われる。.mp3]	(<b>選挙</b>) 来月、地方選挙が行われる。<br> らいげつ、ちほうせんきょがおこなわれる。 <br>Local elections will be held next month.	
和解	[sound:k-1757_和解.mp3]<br>わかい, わげ <br> reconciliation, settlement, accommodation, compromise, mediation, rapprochement; (legal) settlement; translation of a foreign language into Japanese
reconciliation, settlement, accommodation, compromise, mediation, rapprochement; (legal) settlement; translation of a foreign language into Japanese	<b>和解<b> <br> わかい, わげ <br>[sound:k-1757_和解.mp3]
[sound:k-1757_和解.mp3]	reconciliation, settlement, accommodation, compromise, mediation, rapprochement;<br> <b>legal) settlement; translation of a foreign language into Japanese (和解</b> <br> (わかい, わげ)
(<b>果たして</b>) 彼がその任務を果たしてくれるだろうか。	[sound:s-1757_彼がその任務を果たしてくれるだろうか。.mp3] <br> かれがそのにんむをはたしてくれるだろうか。 <br> Will he fulfill the task?
[sound:s-1747_総選挙の結果が発表された。.mp3]	(<b>総選挙</b>) 総選挙の結果が発表された。<br> そうせんきょのけっかがはっぴょうされた。 <br>The results of the general election were announced.	
解消	[sound:k-1758_解消.mp3]<br>かいしょう <br> cancellation, liquidation, resolution, reduction (e.g. of stress)
cancellation, liquidation, resolution, reduction (e.g. of stress)	<b>解消<b> <br> かいしょう <br>[sound:k-1758_解消.mp3]
[sound:k-1758_解消.mp3]	cancellation, liquidation, resolution, reduction<br> <b>e.g. of stress) (解消</b> <br> (かいしょう)
(<b>成果</b>) プロジェクトの成果を発表する。	[sound:s-1758_プロジェクトの成果を発表する。.mp3] <br> プロジェクトのせいかをはっぴょうする。 <br> Announce the results of the project.
[sound:s-1748_小選挙区で激しい選挙戦が繰り広げられた。.mp3]	(<b>小選挙区</b>) 小選挙区で激しい選挙戦が繰り広げられた。<br> しょうせんきょくではげしいせんきょせんがくりひろげられた。 <br>Fierce electoral battles took place in the single-member constituencies.	
解説	[sound:k-1759_解説.mp3]<br>かいせつ <br> explanation, commentary, exposition, elucidation
explanation, commentary, exposition, elucidation	<b>解説<b> <br> かいせつ <br>[sound:k-1759_解説.mp3]
[sound:k-1759_解説.mp3]	explanation, commentary, exposition, elucidation<br> <b>解説</b> <br> (かいせつ)
(<b>効果的</b>) 効果的な解決策を見つける。	[sound:s-1759_効果的な解決策を見つける。.mp3] <br> こうかてきなかいけつさくをみつける。 <br> Find an effective solution.
[sound:s-1749_大掃除で一挙に部屋を片付ける。.mp3]	(<b>一挙</b>) 大掃除で一挙に部屋を片付ける。<br> おおそうじでいっきょにへやをかたづける。 <br>Tidy up the room in one go during the big cleanup.	
名	[sound:k-1760_名.mp3]<br>な <br> name, reputation
name, reputation	<b>名<b> <br> な <br>[sound:k-1760_名.mp3]
[sound:k-1760_名.mp3]	name, reputation<br> <b>名</b> <br> (な)
(<b>果物</b>) 果物の栄養価は高い。	[sound:s-1760_果物の栄養価は高い。.mp3] <br> くだもののえいようかはたかい。 <br> Fruits are nutritious.
[sound:s-1750_激しい選挙戦が繰り広げられた。.mp3]	(<b>選挙戦</b>) 激しい選挙戦が繰り広げられた。<br> はげしいせんきょせんがくりひろげられた。 <br>A fierce election campaign was waged.	
名前	[sound:k-1761_名前.mp3]<br>なまえ <br> name, full name; given name, first name
name, full name; given name, first name	<b>名前<b> <br> なまえ <br>[sound:k-1761_名前.mp3]
[sound:k-1761_名前.mp3]	name, full name; given name, first name<br> <b>名前</b> <br> (なまえ)
(<b>果て</b>) その旅は果てしなく続いた。	[sound:s-1761_その旅は果てしなく続いた。.mp3] <br> そのたびははてしなくつづいた。 <br> The journey seemed endless.
[sound:s-1751_彼の名前が挙がった。.mp3]	(<b>挙がる</b>) 彼の名前が挙がった。<br> かれのなまえがあがった。 <br>His name came up.	
名誉	[sound:k-1762_名誉.mp3]<br>めいよ <br> honor, honour, credit, prestige
honor, honour, credit, prestige	<b>名誉<b> <br> めいよ <br>[sound:k-1762_名誉.mp3]
[sound:k-1762_名誉.mp3]	honor, honour, credit, prestige<br> <b>名誉</b> <br> (めいよ)
(<b>因果</b>) 行動とその結果の因果関係を考える。	[sound:s-1762_行動とその結果の因果関係を考える。.mp3] <br> こうどうとそのけっかのいんがかんけいをかんがえる。 <br> Consider the cause-and-effect relationship between actions and their results.
[sound:s-1752_選挙運動中に有権者に訴える。.mp3]	(<b>選挙運動</b>) 選挙運動中に有権者に訴える。<br> せんきょうんどうちゅうにゆうけんしゃにうったえる。 <br>Appeal to voters during the election campaign.	
指名	[sound:k-1763_指名.mp3]<br>しめい <br> name, nominate, designate
name, nominate, designate	<b>指名<b> <br> しめい <br>[sound:k-1763_指名.mp3]
[sound:k-1763_指名.mp3]	name, nominate, designate<br> <b>指名</b> <br> (しめい)
(<b>果実</b>) 努力の結果が実を結ぶ。	[sound:s-1763_努力の結果が実を結ぶ。.mp3] <br> どりょくのけっかがみをむすぶ。 <br> Efforts bear fruit.
[sound:s-1753_その選手は快挙を成し遂げた。.mp3]	(<b>快挙</b>) その選手は快挙を成し遂げた。<br> そのせんしゅはかいきょをなしとげた。 <br>The athlete achieved a remarkable feat.	
氏名	[sound:k-1764_氏名.mp3]<br>しめい <br> full name, identity
full name, identity	<b>氏名<b> <br> しめい <br>[sound:k-1764_氏名.mp3]
[sound:k-1764_氏名.mp3]	full name, identity<br> <b>氏名</b> <br> (しめい)
(<b>果敢</b>) 果敢な行動を起こす。	[sound:s-1764_果敢な行動を起こす。.mp3] <br> かかんなこうどうをおこす。 <br> Take bold action.
[sound:s-1754_18歳以上に選挙権が与えられる。.mp3]	(<b>選挙権</b>) 18歳以上に選挙権が与えられる。<br> 18さいいじょうにせんきょけんがあたえられる。 <br>Those aged 18 and over are granted the right to vote.	
有名	[sound:k-1765_有名.mp3]<br>ゆうめい <br> famous; fame
famous; fame	<b>有名<b> <br> ゆうめい <br>[sound:k-1765_有名.mp3]
[sound:k-1765_有名.mp3]	famous; fame<br> <b>有名</b> <br> (ゆうめい)
(<b>西</b>) 西の空に夕日が沈む。	[sound:s-1765_西の空に夕日が沈む。.mp3] <br> にしのそらにゆうひがしずむ。 <br> The sun sets in the western sky.
[sound:s-1755_努力の結果、目標を達成した。.mp3]	(<b>結果</b>) 努力の結果、目標を達成した。<br> どりょくのけっか、もくひょうをたっせいした。 <br>As a result of hard work, the goal was achieved.	
署名	[sound:k-1766_署名.mp3]<br>しょめい <br> signature
signature	<b>署名<b> <br> しょめい <br>[sound:k-1766_署名.mp3]
[sound:k-1766_署名.mp3]	signature<br> <b>署名</b> <br> (しょめい)
(<b>関西</b>) 関西地方は観光地が多い。	[sound:s-1766_関西地方は観光地が多い。.mp3] <br> かんさいちほうはかんこうちがおおい。 <br> The Kansai region has many tourist attractions.
[sound:s-1756_新しい広告戦略の効果を評価する。.mp3]	(<b>効果</b>) 新しい広告戦略の効果を評価する。<br> あたらしいこうこくせんりゃくのこうかをひょうかする。 <br>Evaluate the effectiveness of the new advertising strategy.	
本名	[sound:k-1767_本名.mp3]<br>ほんみょう, ほんめい <br> real name
real name	<b>本名<b> <br> ほんみょう, ほんめい <br>[sound:k-1767_本名.mp3]
[sound:k-1767_本名.mp3]	real name<br> <b>本名</b> <br> (ほんみょう, ほんめい)
(<b>西側</b>) 家の西側に庭がある。	[sound:s-1767_家の西側に庭がある。.mp3] <br> いえのにしがわににわがある。 <br> There is a garden on the west side of the house.
[sound:s-1757_彼がその任務を果たしてくれるだろうか。.mp3]	(<b>果たして</b>) 彼がその任務を果たしてくれるだろうか。<br> かれがそのにんむをはたしてくれるだろうか。 <br>Will he fulfill the task?	
名人	[sound:k-1768_名人.mp3]<br>めいじん <br> master, expert
master, expert	<b>名人<b> <br> めいじん <br>[sound:k-1768_名人.mp3]
[sound:k-1768_名人.mp3]	master, expert<br> <b>名人</b> <br> (めいじん)
(<b>東西</b>) 東西の文化の違いを感じる。	[sound:s-1768_東西の文化の違いを感じる。.mp3] <br> とうざいのぶんかのちがいをかんじる。 <br> Feel the differences between Eastern and Western cultures.
[sound:s-1758_プロジェクトの成果を発表する。.mp3]	(<b>成果</b>) プロジェクトの成果を発表する。<br> プロジェクトのせいかをはっぴょうする。 <br>Announce the results of the project.	
名簿	[sound:k-1769_名簿.mp3]<br>めいぼ <br> register of names
register of names	<b>名簿<b> <br> めいぼ <br>[sound:k-1769_名簿.mp3]
[sound:k-1769_名簿.mp3]	register of names<br> <b>名簿</b> <br> (めいぼ)
(<b>西欧</b>) 西欧諸国での生活経験を持つ。	[sound:s-1769_西欧諸国での生活経験を持つ。.mp3] <br> せいおうしょこくでのせいかつけいけんをもつ。 <br> Have experience living in Western European countries.
[sound:s-1759_効果的な解決策を見つける。.mp3]	(<b>効果的</b>) 効果的な解決策を見つける。<br> こうかてきなかいけつさくをみつける。 <br>Find an effective solution.	
外交	[sound:k-1770_外交.mp3]<br>がいこう <br> diplomacy
diplomacy	<b>外交<b> <br> がいこう <br>[sound:k-1770_外交.mp3]
[sound:k-1770_外交.mp3]	diplomacy<br> <b>外交</b> <br> (がいこう)
(<b>大西洋</b>) 大西洋には多くの島がある。	[sound:s-1770_大西洋には多くの島がある。.mp3] <br> たいせいようにはおおくのしまがある。 <br> The Atlantic Ocean has many islands.
[sound:s-1760_果物の栄養価は高い。.mp3]	(<b>果物</b>) 果物の栄養価は高い。<br> くだもののえいようかはたかい。 <br>Fruits are nutritious.	
交渉	[sound:k-1771_交渉.mp3]<br>こうしょう <br> negotiations, discussions; connection
negotiations, discussions; connection	<b>交渉<b> <br> こうしょう <br>[sound:k-1771_交渉.mp3]
[sound:k-1771_交渉.mp3]	negotiations, discussions; connection<br> <b>交渉</b> <br> (こうしょう)
(<b>西部</b>) アメリカの西部には広大な草原が広がる。	[sound:s-1771_アメリカの西部には広大な草原が広がる。.mp3] <br> アメリカのせいぶにはこうだいなそうげんがひろがる。 <br> Vast grasslands stretch across the western United States.
[sound:s-1761_その旅は果てしなく続いた。.mp3]	(<b>果て</b>) その旅は果てしなく続いた。<br> そのたびははてしなくつづいた。 <br>The journey seemed endless.	
交流	[sound:k-1772_交流.mp3]<br>こうりゅう <br> intercourse, (cultural) exchange, intermingling; alternating current, AC
intercourse, (cultural) exchange, intermingling; alternating current, AC	<b>交流<b> <br> こうりゅう <br>[sound:k-1772_交流.mp3]
[sound:k-1772_交流.mp3]	intercourse,<br> <b>cultural) exchange, intermingling; alternating current, AC (交流</b> <br> (こうりゅう)
(<b>南西</b>) 南西方向に進む。	[sound:s-1772_南西方向に進む。.mp3] <br> なんせいほうこうにすすむ。 <br> Proceed in the southwest direction.
[sound:s-1762_行動とその結果の因果関係を考える。.mp3]	(<b>因果</b>) 行動とその結果の因果関係を考える。<br> こうどうとそのけっかのいんがかんけいをかんがえる。 <br>Consider the cause-and-effect relationship between actions and their results.	
交換	[sound:k-1773_交換.mp3]<br>こうかん <br> exchange, interchange, switching, reciprocity, barter, substitution, replacement, clearing (of checks, cheques)
exchange, interchange, switching, reciprocity, barter, substitution, replacement, clearing (of checks, cheques)	<b>交換<b> <br> こうかん <br>[sound:k-1773_交換.mp3]
[sound:k-1773_交換.mp3]	exchange, interchange, switching, reciprocity, barter, substitution, replacement, clearing<br> <b>of checks, cheques) (交換</b> <br> (こうかん)
(<b>西日本</b>) 西日本ではお好み焼きが有名だ。	[sound:s-1773_西日本ではお好み焼きが有名だ。.mp3] <br> にしにほんではおこのみやきがゆうめいだ。 <br> Okonomiyaki is famous in western Japan.
[sound:s-1763_努力の結果が実を結ぶ。.mp3]	(<b>果実</b>) 努力の結果が実を結ぶ。<br> どりょくのけっかがみをむすぶ。 <br>Efforts bear fruit.	
交通	[sound:k-1774_交通.mp3]<br>こうつう <br> communication, transportation, traffic, intercourse
communication, transportation, traffic, intercourse	<b>交通<b> <br> こうつう <br>[sound:k-1774_交通.mp3]
[sound:k-1774_交通.mp3]	communication, transportation, traffic, intercourse<br> <b>交通</b> <br> (こうつう)
(<b>西洋</b>) 西洋の文化に興味を持っている。	[sound:s-1774_西洋の文化に興味を持っている。.mp3] <br> せいようのぶんかにきょうみをもっている。 <br> Interested in Western culture.
[sound:s-1764_果敢な行動を起こす。.mp3]	(<b>果敢</b>) 果敢な行動を起こす。<br> かかんなこうどうをおこす。 <br>Take bold action.	
国交	[sound:k-1775_国交.mp3]<br>こっこう <br> diplomatic relations
diplomatic relations	<b>国交<b> <br> こっこう <br>[sound:k-1775_国交.mp3]
[sound:k-1775_国交.mp3]	diplomatic relations<br> <b>国交</b> <br> (こっこう)
(<b>勢い</b>) そのプロジェクトは勢いよく進んでいる。	[sound:s-1775_そのプロジェクトは勢いよく進んでいる。.mp3] <br> そのプロジェクトはいきおいよくすすんでいる。 <br> The project is progressing with momentum.
[sound:s-1765_西の空に夕日が沈む。.mp3]	(<b>西</b>) 西の空に夕日が沈む。<br> にしのそらにゆうひがしずむ。 <br>The sun sets in the western sky.	
交代	[sound:k-1776_交代.mp3]<br>こうたい <br> alternation, change, relief, relay, shift, substitution (sports, etc.)
alternation, change, relief, relay, shift, substitution (sports, etc.)	<b>交代<b> <br> こうたい <br>[sound:k-1776_交代.mp3]
[sound:k-1776_交代.mp3]	alternation, change, relief, relay, shift, substitution<br> <b>sports, etc.) (交代</b> <br> (こうたい)
(<b>勢み</b>) 彼の提案は勢みを増してきた。	[sound:s-1776_彼の提案は勢みを増してきた。.mp3] <br> かれのていあんはいきおいをますしてきた。 <br> His proposal has gained momentum.
[sound:s-1766_関西地方は観光地が多い。.mp3]	(<b>関西</b>) 関西地方は観光地が多い。<br> かんさいちほうはかんこうちがおおい。 <br>The Kansai region has many tourist attractions.	
交付	[sound:k-1777_交付.mp3]<br>こうふ <br> delivering, handing over, furnishing (e.g. with copies), issuance, issuing
delivering, handing over, furnishing (e.g. with copies), issuance, issuing	<b>交付<b> <br> こうふ <br>[sound:k-1777_交付.mp3]
[sound:k-1777_交付.mp3]	delivering, handing over, furnishing<br> <b>e.g. with copies), issuance, issuing (交付</b> <br> (こうふ)
(<b>姿勢</b>) 正しい姿勢を保つ。	[sound:s-1777_正しい姿勢を保つ。.mp3] <br> ただしいしせいをたもつ。 <br> Maintain proper posture.
[sound:s-1767_家の西側に庭がある。.mp3]	(<b>西側</b>) 家の西側に庭がある。<br> いえのにしがわににわがある。 <br>There is a garden on the west side of the house.	
外交官	[sound:k-1778_外交官.mp3]<br>がいこうかん <br> diplomat
diplomat	<b>外交官<b> <br> がいこうかん <br>[sound:k-1778_外交官.mp3]
[sound:k-1778_外交官.mp3]	diplomat<br> <b>外交官</b> <br> (がいこうかん)
(<b>情勢</b>) 現地の情勢を把握する。	[sound:s-1778_現地の情勢を把握する。.mp3] <br> げんちのじょうせいをはあくする。 <br> Grasp the local situation.
[sound:s-1768_東西の文化の違いを感じる。.mp3]	(<b>東西</b>) 東西の文化の違いを感じる。<br> とうざいのぶんかのちがいをかんじる。 <br>Feel the differences between Eastern and Western cultures.	
交通事故	[sound:k-1779_交通事故.mp3]<br>こうつうじこ <br> traffic accident
traffic accident	<b>交通事故<b> <br> こうつうじこ <br>[sound:k-1779_交通事故.mp3]
[sound:k-1779_交通事故.mp3]	traffic accident<br> <b>交通事故</b> <br> (こうつうじこ)
(<b>勢力</b>) その政党は地域で大きな勢力を持っている。	[sound:s-1779_その政党は地域で大きな勢力を持っている。.mp3] <br> そのせいとうはちいきでおおきなせいりょくをもっている。 <br> The party has significant influence in the region.
[sound:s-1769_西欧諸国での生活経験を持つ。.mp3]	(<b>西欧</b>) 西欧諸国での生活経験を持つ。<br> せいおうしょこくでのせいかつけいけんをもつ。 <br>Have experience living in Western European countries.	
資金	[sound:k-1780_資金.mp3]<br>しきん <br> funds, capital
funds, capital	<b>資金<b> <br> しきん <br>[sound:k-1780_資金.mp3]
[sound:k-1780_資金.mp3]	funds, capital<br> <b>資金</b> <br> (しきん)
(<b>態勢</b>) 災害に備えて適切な態勢を整える。	[sound:s-1780_災害に備えて適切な態勢を整える。.mp3] <br> さいがいにそなえててきせつなたいせいをととのえる。 <br> Prepare appropriate measures for disasters.
[sound:s-1770_大西洋には多くの島がある。.mp3]	(<b>大西洋</b>) 大西洋には多くの島がある。<br> たいせいようにはおおくのしまがある。 <br>The Atlantic Ocean has many islands.	
投資	[sound:k-1781_投資.mp3]<br>とうし <br> investment
investment	<b>投資<b> <br> とうし <br>[sound:k-1781_投資.mp3]
[sound:k-1781_投資.mp3]	investment<br> <b>投資</b> <br> (とうし)
(<b>大勢</b>) 会議室は大勢の人で埋まっていた。	[sound:s-1781_会議室は大勢の人で埋まっていた。.mp3] <br> かいぎしつはおおぜいのひとでうまっていた。 <br> The meeting room was filled with many people.
[sound:s-1771_アメリカの西部には広大な草原が広がる。.mp3]	(<b>西部</b>) アメリカの西部には広大な草原が広がる。<br> アメリカのせいぶにはこうだいなそうげんがひろがる。 <br>Vast grasslands stretch across the western United States.	
融資	[sound:k-1782_融資.mp3]<br>ゆうし <br> financing, loan
financing, loan	<b>融資<b> <br> ゆうし <br>[sound:k-1782_融資.mp3]
[sound:k-1782_融資.mp3]	financing, loan<br> <b>融資</b> <br> (ゆうし)
(<b>攻勢</b>) 攻勢をかけて敵を追い詰める。	[sound:s-1782_攻勢をかけて敵を追い詰める。.mp3] <br> こうせいをかけててきをおいつめる。 <br> Launch an offensive and corner the enemy.
[sound:s-1772_南西方向に進む。.mp3]	(<b>南西</b>) 南西方向に進む。<br> なんせいほうこうにすすむ。 <br>Proceed in the southwest direction.	
資産	[sound:k-1783_資産.mp3]<br>しさん <br> property, fortune, means, assets
property, fortune, means, assets	<b>資産<b> <br> しさん <br>[sound:k-1783_資産.mp3]
[sound:k-1783_資産.mp3]	property, fortune, means, assets<br> <b>資産</b> <br> (しさん)
(<b>伊勢丹</b>) 伊勢丹のショッピングモールで買い物をする。	[sound:s-1783_伊勢丹のショッピングモールで買い物をする。.mp3] <br> いせたんのショッピングモールでかいものをする。 <br> Go shopping at the Isetan shopping mall.
[sound:s-1773_西日本ではお好み焼きが有名だ。.mp3]	(<b>西日本</b>) 西日本ではお好み焼きが有名だ。<br> にしにほんではおこのみやきがゆうめいだ。 <br>Okonomiyaki is famous in western Japan.	
資料	[sound:k-1784_資料.mp3]<br>しりょう <br> materials, data, document
materials, data, document	<b>資料<b> <br> しりょう <br>[sound:k-1784_資料.mp3]
[sound:k-1784_資料.mp3]	materials, data, document<br> <b>資料</b> <br> (しりょう)
(<b>優勢</b>) 彼は競技で優勢だ。	[sound:s-1784_彼は競技で優勢だ。.mp3] <br> かれはきょうぎでゆうせいだ。 <br> He is dominant in the competition.
[sound:s-1774_西洋の文化に興味を持っている。.mp3]	(<b>西洋</b>) 西洋の文化に興味を持っている。<br> せいようのぶんかにきょうみをもっている。 <br>Interested in Western culture.	
資格	[sound:k-1785_資格.mp3]<br>しかく <br> qualifications, requirements, capabilities
qualifications, requirements, capabilities	<b>資格<b> <br> しかく <br>[sound:k-1785_資格.mp3]
[sound:k-1785_資格.mp3]	qualifications, requirements, capabilities<br> <b>資格</b> <br> (しかく)
(<b>削減</b>) エネルギーの削減に取り組む。	[sound:s-1785_エネルギーの削減に取り組む。.mp3] <br> エネルギーのさくげんにとりくむ。 <br> Work on reducing energy consumption.
[sound:s-1775_そのプロジェクトは勢いよく進んでいる。.mp3]	(<b>勢い</b>) そのプロジェクトは勢いよく進んでいる。<br> そのプロジェクトはいきおいよくすすんでいる。 <br>The project is progressing with momentum.	
資源	[sound:k-1786_資源.mp3]<br>しげん <br> resources
resources	<b>資源<b> <br> しげん <br>[sound:k-1786_資源.mp3]
[sound:k-1786_資源.mp3]	resources<br> <b>資源</b> <br> (しげん)
(<b>減税</b>) 政府は所得税の減税を発表した。	[sound:s-1786_政府は所得税の減税を発表した。.mp3] <br> せいふはしょとくぜいのげんぜいをはっぴょうした。 <br> The government announced a reduction in income tax.
[sound:s-1776_彼の提案は勢みを増してきた。.mp3]	(<b>勢み</b>) 彼の提案は勢みを増してきた。<br> かれのていあんはいきおいをますしてきた。 <br>His proposal has gained momentum.	
資本	[sound:k-1787_資本.mp3]<br>しほん <br> funds, capital
funds, capital	<b>資本<b> <br> しほん <br>[sound:k-1787_資本.mp3]
[sound:k-1787_資本.mp3]	funds, capital<br> <b>資本</b> <br> (しほん)
(<b>減少</b>) 環境汚染の減少が求められている。	[sound:s-1787_環境汚染の減少が求められている。.mp3] <br> かんきょうおせんのげんしょうがもとめられている。 <br> Reduction of environmental pollution is required.
[sound:s-1777_正しい姿勢を保つ。.mp3]	(<b>姿勢</b>) 正しい姿勢を保つ。<br> ただしいしせいをたもつ。 <br>Maintain proper posture.	
物資	[sound:k-1788_物資.mp3]<br>ぶっし <br> goods, materials
goods, materials	<b>物資<b> <br> ぶっし <br>[sound:k-1788_物資.mp3]
[sound:k-1788_物資.mp3]	goods, materials<br> <b>物資</b> <br> (ぶっし)
(<b>減益</b>) 今年の利益は減益となった。	[sound:s-1788_今年の利益は減益となった。.mp3] <br> ことしのりえきはげんえきとなった。 <br> Profits for this year decreased.
[sound:s-1778_現地の情勢を把握する。.mp3]	(<b>情勢</b>) 現地の情勢を把握する。<br> げんちのじょうせいをはあくする。 <br>Grasp the local situation.	
出資	[sound:k-1789_出資.mp3]<br>しゅっし <br> investment, contribution, financing
investment, contribution, financing	<b>出資<b> <br> しゅっし <br>[sound:k-1789_出資.mp3]
[sound:k-1789_出資.mp3]	investment, contribution, financing<br> <b>出資</b> <br> (しゅっし)
(<b>減速</b>) 自動車が減速して交差点に近づいた。	[sound:s-1789_自動車が減速して交差点に近づいた。.mp3] <br> じどうしゃがげんそくしてこうさてんにちかづいた。 <br> The car slowed down as it approached the intersection.
[sound:s-1779_その政党は地域で大きな勢力を持っている。.mp3]	(<b>勢力</b>) その政党は地域で大きな勢力を持っている。<br> そのせいとうはちいきでおおきなせいりょくをもっている。 <br>The party has significant influence in the region.	
予算	[sound:k-1790_予算.mp3]<br>よさん <br> estimate, budget
estimate, budget	<b>予算<b> <br> よさん <br>[sound:k-1790_予算.mp3]
[sound:k-1790_予算.mp3]	estimate, budget<br> <b>予算</b> <br> (よさん)
(<b>軽減</b>) 負担を軽減するための施策を検討する。	[sound:s-1790_負担を軽減するための施策を検討する。.mp3] <br> ふたんをけいげんするためのしさくをけんとうする。 <br> Consider measures to reduce the burden.
[sound:s-1780_災害に備えて適切な態勢を整える。.mp3]	(<b>態勢</b>) 災害に備えて適切な態勢を整える。<br> さいがいにそなえててきせつなたいせいをととのえる。 <br>Prepare appropriate measures for disasters.	
予定	[sound:k-1791_予定.mp3]<br>よてい <br> plans, arrangement, schedule, program, programme, expectation, estimate
plans, arrangement, schedule, program, programme, expectation, estimate	<b>予定<b> <br> よてい <br>[sound:k-1791_予定.mp3]
[sound:k-1791_予定.mp3]	plans, arrangement, schedule, program, programme, expectation, estimate<br> <b>予定</b> <br> (よてい)
(<b>減収</b>) 開発計画の変更により、売上が減収した。	[sound:s-1791_開発計画の変更により、売上が減収した。.mp3] <br> かいはつけいかくのへんこうにより、うりあげがげんしゅうした。 <br> Due to changes in the development plan, sales decreased.
[sound:s-1781_会議室は大勢の人で埋まっていた。.mp3]	(<b>大勢</b>) 会議室は大勢の人で埋まっていた。<br> かいぎしつはおおぜいのひとでうまっていた。 <br>The meeting room was filled with many people.	
予選	[sound:k-1792_予選.mp3]<br>よせん <br> nomination, primary, preliminary contest
nomination, primary, preliminary contest	<b>予選<b> <br> よせん <br>[sound:k-1792_予選.mp3]
[sound:k-1792_予選.mp3]	nomination, primary, preliminary contest<br> <b>予選</b> <br> (よせん)
(<b>減反</b>) 農業の減反政策が影響を与えた。	[sound:s-1792_農業の減反政策が影響を与えた。.mp3] <br> のうぎょうのげんはんせいさくがえいきょうをあたえた。 <br> Agricultural acreage reduction policies had an impact.
[sound:s-1782_攻勢をかけて敵を追い詰める。.mp3]	(<b>攻勢</b>) 攻勢をかけて敵を追い詰める。<br> こうせいをかけててきをおいつめる。 <br>Launch an offensive and corner the enemy.	
予想	[sound:k-1793_予想.mp3]<br>よそう <br> expectation, anticipation, prediction, forecast
expectation, anticipation, prediction, forecast	<b>予想<b> <br> よそう <br>[sound:k-1793_予想.mp3]
[sound:k-1793_予想.mp3]	expectation, anticipation, prediction, forecast<br> <b>予想</b> <br> (よそう)
(<b>減額</b>) 予算の減額を余儀なくされた。	[sound:s-1793_予算の減額を余儀なくされた。.mp3] <br> よさんのげんがくをよぎなくされた。 <br> Budget cuts were unavoidable.
[sound:s-1783_伊勢丹のショッピングモールで買い物をする。.mp3]	(<b>伊勢丹</b>) 伊勢丹のショッピングモールで買い物をする。<br> いせたんのショッピングモールでかいものをする。 <br>Go shopping at the Isetan shopping mall.	
予測	[sound:k-1794_予測.mp3]<br>よそく <br> prediction, estimation
prediction, estimation	<b>予測<b> <br> よそく <br>[sound:k-1794_予測.mp3]
[sound:k-1794_予測.mp3]	prediction, estimation<br> <b>予測</b> <br> (よそく)
(<b>減産</b>) 農作物の減産が予想される。	[sound:s-1794_農作物の減産が予想される。.mp3] <br> のうさくぶつのげんさんがよそうされる。 <br> A decrease in agricultural production is anticipated.
[sound:s-1784_彼は競技で優勢だ。.mp3]	(<b>優勢</b>) 彼は競技で優勢だ。<br> かれはきょうぎでゆうせいだ。 <br>He is dominant in the competition.	
予備	[sound:k-1795_予備.mp3]<br>よび <br> preparation, preliminaries, reserve, spare
preparation, preliminaries, reserve, spare	<b>予備<b> <br> よび <br>[sound:k-1795_予備.mp3]
[sound:k-1795_予備.mp3]	preparation, preliminaries, reserve, spare<br> <b>予備</b> <br> (よび)
(<b>台</b>) 会議には多くの人が参加した。	[sound:s-1795_会議には多くの人が参加した。.mp3] <br> かいぎにはおおくのひとがさんかした。 <br> Many people participated in the meeting.
[sound:s-1785_エネルギーの削減に取り組む。.mp3]	(<b>削減</b>) エネルギーの削減に取り組む。<br> エネルギーのさくげんにとりくむ。 <br>Work on reducing energy consumption.	
予防	[sound:k-1796_予防.mp3]<br>よぼう <br> prevention, precaution, protection against
prevention, precaution, protection against	<b>予防<b> <br> よぼう <br>[sound:k-1796_予防.mp3]
[sound:k-1796_予防.mp3]	prevention, precaution, protection against<br> <b>予防</b> <br> (よぼう)
(<b>台湾</b>) 台湾には美しい景色がたくさんある。	[sound:s-1796_台湾には美しい景色がたくさんある。.mp3] <br> たいわんにはうつくしいけしきがたくさんある。 <br> Taiwan has many beautiful landscapes.
[sound:s-1786_政府は所得税の減税を発表した。.mp3]	(<b>減税</b>) 政府は所得税の減税を発表した。<br> せいふはしょとくぜいのげんぜいをはっぴょうした。 <br>The government announced a reduction in income tax.	
補正予算	[sound:k-1797_補正予算.mp3]<br>ほせいよさん <br> revised or supplementary budget
revised or supplementary budget	<b>補正予算<b> <br> ほせいよさん <br>[sound:k-1797_補正予算.mp3]
[sound:k-1797_補正予算.mp3]	revised or supplementary budget<br> <b>補正予算</b> <br> (ほせいよさん)
(<b>舞台</b>) 新しい演劇が舞台で上演された。	[sound:s-1797_新しい演劇が舞台で上演された。.mp3] <br> あたらしいえんげきがぶたいでじょうえんされた。 <br> A new play was performed on stage.
[sound:s-1787_環境汚染の減少が求められている。.mp3]	(<b>減少</b>) 環境汚染の減少が求められている。<br> かんきょうおせんのげんしょうがもとめられている。 <br>Reduction of environmental pollution is required.	
予約	[sound:k-1798_予約.mp3]<br>よやく <br> reservation, appointment, booking, advance order; contract, subscription, pledge
reservation, appointment, booking, advance order; contract, subscription, pledge	<b>予約<b> <br> よやく <br>[sound:k-1798_予約.mp3]
[sound:k-1798_予約.mp3]	reservation, appointment, booking, advance order; contract, subscription, pledge<br> <b>予約</b> <br> (よやく)
(<b>台風</b>) 台風が沿岸地域に接近している。	[sound:s-1798_台風が沿岸地域に接近している。.mp3] <br> たいふうがえんがんちいきにせっきんしている。 <br> A typhoon is approaching coastal areas.
[sound:s-1788_今年の利益は減益となった。.mp3]	(<b>減益</b>) 今年の利益は減益となった。<br> ことしのりえきはげんえきとなった。 <br>Profits for this year decreased.	
予報	[sound:k-1799_予報.mp3]<br>よほう <br> forecast, prediction
forecast, prediction	<b>予報<b> <br> よほう <br>[sound:k-1799_予報.mp3]
[sound:k-1799_予報.mp3]	forecast, prediction<br> <b>予報</b> <br> (よほう)
(<b>台所</b>) 台所で料理をするのが好きだ。	[sound:s-1799_台所で料理をするのが好きだ。.mp3] <br> だいどころでりょうりをするのがすきだ。 <br> I enjoy cooking in the kitchen.
[sound:s-1789_自動車が減速して交差点に近づいた。.mp3]	(<b>減速</b>) 自動車が減速して交差点に近づいた。<br> じどうしゃがげんそくしてこうさてんにちかづいた。 <br>The car slowed down as it approached the intersection.	
川	[sound:k-1800_川.mp3]<br>かわ, がわ <br> river, stream; the .... river, (suffix used with the names of rivers)
river, stream; the .... river, (suffix used with the names of rivers)	<b>川<b> <br> かわ, がわ <br>[sound:k-1800_川.mp3]
[sound:k-1800_川.mp3]	river, stream; the .... river,<br> <b>suffix used with the names of rivers) (川</b> <br> (かわ, がわ)
(<b>大台</b>) 株価が大台を突破した。	[sound:s-1800_株価が大台を突破した。.mp3] <br> かぶかがおおだいをとっぱした。 <br> Stock prices broke through the major threshold.
[sound:s-1790_負担を軽減するための施策を検討する。.mp3]	(<b>軽減</b>) 負担を軽減するための施策を検討する。<br> ふたんをけいげんするためのしさくをけんとうする。 <br>Consider measures to reduce the burden.	
小川	[sound:k-1801_小川.mp3]<br>おがわ <br> streamlet, brook
streamlet, brook	<b>小川<b> <br> おがわ <br>[sound:k-1801_小川.mp3]
[sound:k-1801_小川.mp3]	streamlet, brook<br> <b>小川</b> <br> (おがわ)
(<b>台頭</b>) 新しい政党が台頭してきた。	[sound:s-1801_新しい政党が台頭してきた。.mp3] <br> あたらしいせいとうがたいとうしてきた。 <br> A new political party has emerged.
[sound:s-1791_開発計画の変更により、売上が減収した。.mp3]	(<b>減収</b>) 開発計画の変更により、売上が減収した。<br> かいはつけいかくのへんこうにより、うりあげがげんしゅうした。 <br>Due to changes in the development plan, sales decreased.	
河川	[sound:k-1802_河川.mp3]<br>かせん <br> rivers
rivers	<b>河川<b> <br> かせん <br>[sound:k-1802_河川.mp3]
[sound:k-1802_河川.mp3]	rivers<br> <b>河川</b> <br> (かせん)
(<b>台本</b>) 彼は新しいドラマの台本を書いた。	[sound:s-1802_彼は新しいドラマの台本を書いた。.mp3] <br> かれはあたらしいどらまのだい
[sound:s-1792_農業の減反政策が影響を与えた。.mp3]	(<b>減反</b>) 農業の減反政策が影響を与えた。<br> のうぎょうのげんはんせいさくがえいきょうをあたえた。 <br>Agricultural acreage reduction policies had an impact.	
谷川	[sound:k-1803_谷川.mp3]<br>たにがわ <br> mountain stream
mountain stream	<b>谷川<b> <br> たにがわ <br>[sound:k-1803_谷川.mp3]
[sound:k-1803_谷川.mp3]	mountain stream<br> <b>谷川</b> <br> (たにがわ)
ほんをかいた。 	 He wrote the script for a new drama.	s-1803_He wrote the script for a new drama..mp3
[sound:s-1793_予算の減額を余儀なくされた。.mp3]	(<b>減額</b>) 予算の減額を余儀なくされた。<br> よさんのげんがくをよぎなくされた。 <br>Budget cuts were unavoidable.	
江戸川	[sound:k-1804_江戸川.mp3]<br>えどがわ <br> Edo River
Edo River	<b>江戸川<b> <br> えどがわ <br>[sound:k-1804_江戸川.mp3]
[sound:k-1804_江戸川.mp3]	Edo River<br> <b>江戸川</b> <br> (えどがわ)
(<b>土台</b>) 計画の土台をしっかりと築く。	[sound:s-1804_計画の土台をしっかりと築く。.mp3] <br> けいかくのどだいをしっかりときずく。 <br> Establish a solid foundation for the plan.
[sound:s-1794_農作物の減産が予想される。.mp3]	(<b>減産</b>) 農作物の減産が予想される。<br> のうさくぶつのげんさんがよそうされる。 <br>A decrease in agricultural production is anticipated.	
川口	[sound:k-1805_川口.mp3]<br>かわぐち, かこう <br> mouth of river, estuary
mouth of river, estuary	<b>川口<b> <br> かわぐち, かこう <br>[sound:k-1805_川口.mp3]
[sound:k-1805_川口.mp3]	mouth of river, estuary<br> <b>川口</b> <br> (かわぐち, かこう)
(<b>屋台</b>) 祭りでたくさんの屋台が出ていた。	[sound:s-1805_祭りでたくさんの屋台が出ていた。.mp3] <br> まつりでたくさんのやたいがでていた。 <br> There were many stalls at the festival.
[sound:s-1795_会議には多くの人が参加した。.mp3]	(<b>台</b>) 会議には多くの人が参加した。<br> かいぎにはおおくのひとがさんかした。 <br>Many people participated in the meeting.	
川上	[sound:k-1806_川上.mp3]<br>かわかみ <br> upper reaches of a river
upper reaches of a river	<b>川上<b> <br> かわかみ <br>[sound:k-1806_川上.mp3]
[sound:k-1806_川上.mp3]	upper reaches of a river<br> <b>川上</b> <br> (かわかみ)
(<b>広い</b>) 彼の家はとても広い。	[sound:s-1806_彼の家はとても広い。.mp3] <br> かれのいえはとてもひろい。 <br> His house is very spacious.
[sound:s-1796_台湾には美しい景色がたくさんある。.mp3]	(<b>台湾</b>) 台湾には美しい景色がたくさんある。<br> たいわんにはうつくしいけしきがたくさんある。 <br>Taiwan has many beautiful landscapes.	
川柳	[sound:k-1807_川柳.mp3]<br>せんりゅう <br> comic haiku
comic haiku	<b>川柳<b> <br> せんりゅう <br>[sound:k-1807_川柳.mp3]
[sound:k-1807_川柳.mp3]	comic haiku<br> <b>川柳</b> <br> (せんりゅう)
(<b>広がり</b>) 幸せの笑顔が広がりますように。	[sound:s-1807_幸せの笑顔が広がりますように。.mp3] <br> しあわせのえがおがひろがりますように。 <br> May smiles of happiness spread.
[sound:s-1797_新しい演劇が舞台で上演された。.mp3]	(<b>舞台</b>) 新しい演劇が舞台で上演された。<br> あたらしいえんげきがぶたいでじょうえんされた。 <br>A new play was performed on stage.	
川端	[sound:k-1808_川端.mp3]<br>かわばた <br> riverbank
riverbank	<b>川端<b> <br> かわばた <br>[sound:k-1808_川端.mp3]
[sound:k-1808_川端.mp3]	riverbank<br> <b>川端</b> <br> (かわばた)
(<b>広告</b>) 新製品の広告を打ち出す。	[sound:s-1808_新製品の広告を打ち出す。.mp3] <br> しんせいひんのこうこくをうちだす。 <br> Launch advertising for the new product.
[sound:s-1798_台風が沿岸地域に接近している。.mp3]	(<b>台風</b>) 台風が沿岸地域に接近している。<br> たいふうがえんがんちいきにせっきんしている。 <br>A typhoon is approaching coastal areas.	
河川敷	[sound:k-1809_河川敷.mp3]<br>かせんしき, かせんじき <br> (dry) riverbed
(dry) riverbed	<b>河川敷<b> <br> かせんしき, かせんじき <br>[sound:k-1809_河川敷.mp3]
[sound:k-1809_河川敷.mp3]	(dry) riverbed<br> <b>河川敷</b> <br> (かせんしき, かせんじき)
(<b>広げる</b>) 地図を広げて目的地を確認する。	[sound:s-1809_地図を広げて目的地を確認する。.mp3] <br> ちずをひろげてもくてきちをかくにんする。 <br> Spread out the map and confirm the destination.
[sound:s-1799_台所で料理をするのが好きだ。.mp3]	(<b>台所</b>) 台所で料理をするのが好きだ。<br> だいどころでりょうりをするのがすきだ。 <br>I enjoy cooking in the kitchen.	
方向	[sound:k-1810_方向.mp3]<br>ほうこう <br> direction, orientation, bearing, way; course (e.g. of action)
direction, orientation, bearing, way; course (e.g. of action)	<b>方向<b> <br> ほうこう <br>[sound:k-1810_方向.mp3]
[sound:k-1810_方向.mp3]	direction, orientation, bearing, way; course<br> <b>e.g. of action) (方向</b> <br> (ほうこう)
(<b>広がった枝</b>) 庭の木に広がった枝を切る。	[sound:s-1810_庭の木に広がった枝を切る。.mp3] <br> にわのきにひろがったえだをきる。 <br> Trim the branches that have spread in the garden.
[sound:s-1800_株価が大台を突破した。.mp3]	(<b>大台</b>) 株価が大台を突破した。<br> かぶかがおおだいをとっぱした。 <br>Stock prices broke through the major threshold.	
意向	[sound:k-1811_意向.mp3]<br>いこう <br> intention, idea, inclination
intention, idea, inclination	<b>意向<b> <br> いこう <br>[sound:k-1811_意向.mp3]
[sound:k-1811_意向.mp3]	intention, idea, inclination<br> <b>意向</b> <br> (いこう)
(<b>広さ</b>) この部屋の広さは十畳ほどだ。	[sound:s-1811_この部屋の広さは十畳ほどだ。.mp3] <br> このへやのひろさはじゅうじょうほどだ。 <br> The size of this room is about ten tatami mats.
[sound:s-1801_新しい政党が台頭してきた。.mp3]	(<b>台頭</b>) 新しい政党が台頭してきた。<br> あたらしいせいとうがたいとうしてきた。 <br>A new political party has emerged.	
傾向	[sound:k-1812_傾向.mp3]<br>けいこう <br> tendency, trend, inclination
tendency, trend, inclination	<b>傾向<b> <br> けいこう <br>[sound:k-1812_傾向.mp3]
[sound:k-1812_傾向.mp3]	tendency, trend, inclination<br> <b>傾向</b> <br> (けいこう)
(<b>広報</b>) 新しいプロジェクトの広報を行う。	[sound:s-1812_新しいプロジェクトの広報を行う。.mp3] <br> あたらしいぷろじぇくとのこうほうをおこなう。 <br> Carry out public relations for the new project.
[sound:s-1802_彼は新しいドラマの台本を書いた。.mp3]	(<b>台本</b>) 彼は新しいドラマの台本を書いた。<br> かれはあたらしいどらまのだい <br>	
向き	[sound:k-1813_向き.mp3]<br>むき <br> direction, orientation, aspect, situation, exposure, suitability, tendency
direction, orientation, aspect, situation, exposure, suitability, tendency	<b>向き<b> <br> むき <br>[sound:k-1813_向き.mp3]
[sound:k-1813_向き.mp3]	direction, orientation, aspect, situation, exposure, suitability, tendency<br> <b>向き</b> <br> (むき)
(<b>広場</b>) 公園の中に広場がある。	[sound:s-1813_公園の中に広場がある。.mp3] <br> こうえんのなかにひろばがある。 <br> There is a square in the park.
[sound:s-1803_He wrote the script for a new drama..mp3]	ほんをかいた。<br> He wrote the script for a new drama.	
向上	[sound:k-1814_向上.mp3]<br>こうじょう <br> elevation, rise, improvement, advancement, progress
elevation, rise, improvement, advancement, progress	<b>向上<b> <br> こうじょう <br>[sound:k-1814_向上.mp3]
[sound:k-1814_向上.mp3]	elevation, rise, improvement, advancement, progress<br> <b>向上</b> <br> (こうじょう)
(<b>幅広い</b>) 彼は幅広い知識を持っている。	[sound:s-1814_彼は幅広い知識を持っている。.mp3] <br> かれははばひろいちしきをもっている。 <br> He has a wide range of knowledge.
[sound:s-1804_計画の土台をしっかりと築く。.mp3]	(<b>土台</b>) 計画の土台をしっかりと築く。<br> けいかくのどだいをしっかりときずく。 <br>Establish a solid foundation for the plan.	
動向	[sound:k-1815_動向.mp3]<br>どうこう <br> trend, tendency, movement, attitude
trend, tendency, movement, attitude	<b>動向<b> <br> どうこう <br>[sound:k-1815_動向.mp3]
[sound:k-1815_動向.mp3]	trend, tendency, movement, attitude<br> <b>動向</b> <br> (どうこう)
(<b>広大</b>) 彼らは広大な土地を所有している。	[sound:s-1815_彼らは広大な土地を所有している。.mp3] <br> かれらはこうだいなとちをしょゆうしている。 <br> They own vast lands.
[sound:s-1805_祭りでたくさんの屋台が出ていた。.mp3]	(<b>屋台</b>) 祭りでたくさんの屋台が出ていた。<br> まつりでたくさんのやたいがでていた。 <br>There were many stalls at the festival.	
向い	[sound:k-1816_向い.mp3]<br>むかい <br> facing, opposite, across the street, other side
facing, opposite, across the street, other side	<b>向い<b> <br> むかい <br>[sound:k-1816_向い.mp3]
[sound:k-1816_向い.mp3]	facing, opposite, across the street, other side<br> <b>向い</b> <br> (むかい)
(<b>内容</b>) この本の内容を要約する。	[sound:s-1816_この本の内容を要約する。.mp3] <br> このほんのないようをようやくする。 <br> Summarize the contents of this book.
[sound:s-1806_彼の家はとても広い。.mp3]	(<b>広い</b>) 彼の家はとても広い。<br> かれのいえはとてもひろい。 <br>His house is very spacious.	
向かって左	[sound:k-1817_向かって左.mp3]<br>むかってひだり <br> on the left as one faces (it)
on the left as one faces (it)	<b>向かって左<b> <br> むかってひだり <br>[sound:k-1817_向かって左.mp3]
[sound:k-1817_向かって左.mp3]	on the left as one faces<br> <b>it) (向かって左</b> <br> (むかってひだり)
(<b>容疑者</b>) 警察は容疑者を逮捕した。	[sound:s-1817_警察は容疑者を逮捕した。.mp3] <br> けいさつはようぎしゃをたいほした。 <br> The police arrested the suspect.
[sound:s-1807_幸せの笑顔が広がりますように。.mp3]	(<b>広がり</b>) 幸せの笑顔が広がりますように。<br> しあわせのえがおがひろがりますように。 <br>May smiles of happiness spread.	
志向	[sound:k-1818_志向.mp3]<br>しこう <br> intention, aim
intention, aim	<b>志向<b> <br> しこう <br>[sound:k-1818_志向.mp3]
[sound:k-1818_志向.mp3]	intention, aim<br> <b>志向</b> <br> (しこう)
(<b>容疑</b>) 彼に殺人容疑がかけられた。	[sound:s-1818_彼に殺人容疑がかけられた。.mp3] <br> かれにさつじんようぎがかけられた。 <br> He was accused of murder.
[sound:s-1808_新製品の広告を打ち出す。.mp3]	(<b>広告</b>) 新製品の広告を打ち出す。<br> しんせいひんのこうこくをうちだす。 <br>Launch advertising for the new product.	
前向き	[sound:k-1819_前向き.mp3]<br>まえむき <br> facing forward, front-facing, positive
facing forward, front-facing, positive	<b>前向き<b> <br> まえむき <br>[sound:k-1819_前向き.mp3]
[sound:k-1819_前向き.mp3]	facing forward, front-facing, positive<br> <b>前向き</b> <br> (まえむき)
(<b>容易</b>) その問題は容易に解決できる。	[sound:s-1819_その問題は容易に解決できる。.mp3] <br> そのもんだいはよういにかいけつできる。 <br> The problem can be easily solved.
[sound:s-1809_地図を広げて目的地を確認する。.mp3]	(<b>広げる</b>) 地図を広げて目的地を確認する。<br> ちずをひろげてもくてきちをかくにんする。 <br>Spread out the map and confirm the destination.	
際	[sound:k-1820_際.mp3]<br>さい <br> on the occasion of, circumstances
on the occasion of, circumstances	<b>際<b> <br> さい <br>[sound:k-1820_際.mp3]
[sound:k-1820_際.mp3]	on the occasion of, circumstances<br> <b>際</b> <br> (さい)
(<b>容認</b>) その行動を容認するつもりはない。	[sound:s-1820_その行動を容認するつもりはない。.mp3] <br> そのこうどうをようにんするつもりはない。 <br> I do not intend to condone that behavior.
[sound:s-1810_庭の木に広がった枝を切る。.mp3]	(<b>広がった枝</b>) 庭の木に広がった枝を切る。<br> にわのきにひろがったえだをきる。 <br>Trim the branches that have spread in the garden.	
国際	[sound:k-1821_国際.mp3]<br>こくさい <br> international
international	<b>国際<b> <br> こくさい <br>[sound:k-1821_国際.mp3]
[sound:k-1821_国際.mp3]	international<br> <b>国際</b> <br> (こくさい)
(<b>容器</b>) 飲み物を入れる容器を用意する。	[sound:s-1821_飲み物を入れる容器を用意する。.mp3] <br> のみものをいれるようきをよういする。 <br> Prepare a container for drinks.
[sound:s-1811_この部屋の広さは十畳ほどだ。.mp3]	(<b>広さ</b>) この部屋の広さは十畳ほどだ。<br> このへやのひろさはじゅうじょうほどだ。 <br>The size of this room is about ten tatami mats.	
国際的	[sound:k-1822_国際的.mp3]<br>こくさいてき <br> international
international	<b>国際的<b> <br> こくさいてき <br>[sound:k-1822_国際的.mp3]
[sound:k-1822_国際的.mp3]	international<br> <b>国際的</b> <br> (こくさいてき)
(<b>収容</b>) その施設には多くの人が収容されている。	[sound:s-1822_その施設には多くの人が収容されている。.mp3] <br> そのしせつにはおおくのひとがしゅうようされている。 <br> Many people are housed in the facility.
[sound:s-1812_新しいプロジェクトの広報を行う。.mp3]	(<b>広報</b>) 新しいプロジェクトの広報を行う。<br> あたらしいぷろじぇくとのこうほうをおこなう。 <br>Carry out public relations for the new project.	
実際	[sound:k-1823_実際.mp3]<br>じっさい <br> practicality, practical; reality, actuality, actual conditions; bhutakoti (limit of reality)
practicality, practical; reality, actuality, actual conditions; bhutakoti (limit of reality)	<b>実際<b> <br> じっさい <br>[sound:k-1823_実際.mp3]
[sound:k-1823_実際.mp3]	practicality, practical; reality, actuality, actual conditions; bhutakoti<br> <b>limit of reality) (実際</b> <br> (じっさい)
(<b>収容所</b>) 戦争で収容所に送られた。	[sound:s-1823_戦争で収容所に送られた。.mp3] <br> せんそうでしゅうようじょにおくられた。 <br> Sent to a detention camp during the war.
[sound:s-1813_公園の中に広場がある。.mp3]	(<b>広場</b>) 公園の中に広場がある。<br> こうえんのなかにひろばがある。 <br>There is a square in the park.	
国際化	[sound:k-1824_国際化.mp3]<br>こくさいか <br> internationalization, internationalisation, i18n (in IT)
internationalization, internationalisation, i18n (in IT)	<b>国際化<b> <br> こくさいか <br>[sound:k-1824_国際化.mp3]
[sound:k-1824_国際化.mp3]	internationalization, internationalisation, i18n<br> <b>in IT) (国際化</b> <br> (こくさいか)
(<b>全容</b>) 事故の全容が明らかになった。	[sound:s-1824_事故の全容が明らかになった。.mp3] <br> じこのぜんようがあきらかになった。 <br> The full extent of the accident became clear.
[sound:s-1814_彼は幅広い知識を持っている。.mp3]	(<b>幅広い</b>) 彼は幅広い知識を持っている。<br> かれははばひろいちしきをもっている。 <br>He has a wide range of knowledge.	
国際法	[sound:k-1825_国際法.mp3]<br>こくさいほう <br> international laws
international laws	<b>国際法<b> <br> こくさいほう <br>[sound:k-1825_国際法.mp3]
[sound:k-1825_国際法.mp3]	international laws<br> <b>国際法</b> <br> (こくさいほう)
(<b>容量</b>) USBメモリの容量が不足している。	[sound:s-1825_USBメモリの容量が不足している。.mp3] <br> USBメモリのようりょうがふそくしている。 <br> The capacity of the USB memory is insufficient.
[sound:s-1815_彼らは広大な土地を所有している。.mp3]	(<b>広大</b>) 彼らは広大な土地を所有している。<br> かれらはこうだいなとちをしょゆうしている。 <br>They own vast lands.	
交際	[sound:k-1826_交際.mp3]<br>こうさい <br> company, friendship, association, society, acquaintance
company, friendship, association, society, acquaintance	<b>交際<b> <br> こうさい <br>[sound:k-1826_交際.mp3]
[sound:k-1826_交際.mp3]	company, friendship, association, society, acquaintance<br> <b>交際</b> <br> (こうさい)
(<b>必ず</b>) 予定通りに必ず会議に出席します。	[sound:s-1826_予定通りに必ず会議に出席します。.mp3] <br> よていどおりにかならずかいぎにしゅっせきします。 <br> I will definitely attend the meeting as scheduled.
[sound:s-1816_この本の内容を要約する。.mp3]	(<b>内容</b>) この本の内容を要約する。<br> このほんのないようをようやくする。 <br>Summarize the contents of this book.	
交際費	[sound:k-1827_交際費.mp3]<br>こうさいひ <br> entertainment expenses
entertainment expenses	<b>交際費<b> <br> こうさいひ <br>[sound:k-1827_交際費.mp3]
[sound:k-1827_交際費.mp3]	entertainment expenses<br> <b>交際費</b> <br> (こうさいひ)
(<b>必ずしも</b>) 雨が降るとは限らないが、必ずしも晴れるとも限らない。	[sound:s-1827_雨が降るとは限らないが、必ずしも晴れるとも限らない。.mp3] <br> あめがふるとはかぎらないが、かならずしもはれるともかぎらない。 <br> It's not necessarily going to rain, but it's also not necessarily going to be sunny.
[sound:s-1817_警察は容疑者を逮捕した。.mp3]	(<b>容疑者</b>) 警察は容疑者を逮捕した。<br> けいさつはようぎしゃをたいほした。 <br>The police arrested the suspect.	
国際人	[sound:k-1828_国際人.mp3]<br>こくさいじん <br> international celebrity, cosmopolitan, citizen of the world
international celebrity, cosmopolitan, citizen of the world	<b>国際人<b> <br> こくさいじん <br>[sound:k-1828_国際人.mp3]
[sound:k-1828_国際人.mp3]	international celebrity, cosmopolitan, citizen of the world<br> <b>国際人</b> <br> (こくさいじん)
(<b>必要</b>) これらの書類は手続きに必要です。	[sound:s-1828_これらの書類は手続きに必要です。.mp3] <br> これらのしょるいはてつづきにひつようです。 <br> These documents are necessary for the procedure.
[sound:s-1818_彼に殺人容疑がかけられた。.mp3]	(<b>容疑</b>) 彼に殺人容疑がかけられた。<br> かれにさつじんようぎがかけられた。 <br>He was accused of murder.	
国際協力事業団	[sound:k-1829_国際協力事業団.mp3]<br>こくさいきょうりょくじぎょうだん <br> Japan International Cooperation Agency (1974), JICA
Japan International Cooperation Agency (1974), JICA	<b>国際協力事業団<b> <br> こくさいきょうりょくじぎょうだん <br>[sound:k-1829_国際協力事業団.mp3]
[sound:k-1829_国際協力事業団.mp3]	Japan International Cooperation Agency<br> <b>1974), JICA (国際協力事業団</b> <br> (こくさいきょうりょくじぎょうだん)
(<b>必要性</b>) この問題に対する解決策の必要性を認識しています。	[sound:s-1829_この問題に対する解決策の必要性を認識しています。.mp3] <br> このもんだいにたいするかいけつさくのひつようせいをにんしきしています。 <br> I recognize the necessity of solutions to this problem.
[sound:s-1819_その問題は容易に解決できる。.mp3]	(<b>容易</b>) その問題は容易に解決できる。<br> そのもんだいはよういにかいけつできる。 <br>The problem can be easily solved.	
捜査	[sound:k-1830_捜査.mp3]<br>そうさ <br> search (esp. in criminal investigations), investigation, inquiry, enquiry
search (esp. in criminal investigations), investigation, inquiry, enquiry	<b>捜査<b> <br> そうさ <br>[sound:k-1830_捜査.mp3]
[sound:k-1830_捜査.mp3]	search<br> <b>esp. in criminal investigations), investigation, inquiry, enquiry (捜査</b> <br> (そうさ)
(<b>必死</b>) 彼は必死に助けを求めた。	[sound:s-1830_彼は必死に助けを求めた。.mp3] <br> かれはひっしにたすけをもとめた。 <br> He desperately sought help.
[sound:s-1820_その行動を容認するつもりはない。.mp3]	(<b>容認</b>) その行動を容認するつもりはない。<br> そのこうどうをようにんするつもりはない。 <br>I do not intend to condone that behavior.	
調査	[sound:k-1831_調査.mp3]<br>ちょうさ <br> investigation, examination, inquiry, enquiry, survey
investigation, examination, inquiry, enquiry, survey	<b>調査<b> <br> ちょうさ <br>[sound:k-1831_調査.mp3]
[sound:k-1831_調査.mp3]	investigation, examination, inquiry, enquiry, survey<br> <b>調査</b> <br> (ちょうさ)
(<b>必着</b>) 期限までに必着で提出してください。	[sound:s-1831_期限までに必着で提出してください。.mp3] <br> きげんまでにひっちゃくでていしゅつしてください。 <br> Please submit it by the deadline without fail.
[sound:s-1821_飲み物を入れる容器を用意する。.mp3]	(<b>容器</b>) 飲み物を入れる容器を用意する。<br> のみものをいれるようきをよういする。 <br>Prepare a container for drinks.	
検査	[sound:k-1832_検査.mp3]<br>けんさ <br> inspection (e.g. customs, factory), examination
inspection (e.g. customs, factory), examination	<b>検査<b> <br> けんさ <br>[sound:k-1832_検査.mp3]
[sound:k-1832_検査.mp3]	inspection<br> <b>e.g. customs, factory), examination (検査</b> <br> (けんさ)
(<b>必需</b>) 水は人間にとって必需品だ。	[sound:s-1832_水は人間にとって必需品だ。.mp3] <br> みずはにんげんにとってひつじゅひんだ。 <br> Water is a necessity for human beings.
[sound:s-1822_その施設には多くの人が収容されている。.mp3]	(<b>収容</b>) その施設には多くの人が収容されている。<br> そのしせつにはおおくのひとがしゅうようされている。 <br>Many people are housed in the facility.	
査察	[sound:k-1833_査察.mp3]<br>ささつ <br> inspection (for compliance), investigation (tax, etc.)
inspection (for compliance), investigation (tax, etc.)	<b>査察<b> <br> ささつ <br>[sound:k-1833_査察.mp3]
[sound:k-1833_査察.mp3]	inspection<br> <b>for compliance), investigation (tax, etc.) (査察</b> <br> (ささつ)
(<b>不必要</b>) 不必要な荷物を処分する。	[sound:s-1833_不必要な荷物を処分する。.mp3] <br> ふひつようなにもつをしょぶんする。 <br> Dispose of unnecessary items.
[sound:s-1823_戦争で収容所に送られた。.mp3]	(<b>収容所</b>) 戦争で収容所に送られた。<br> せんそうでしゅうようじょにおくられた。 <br>Sent to a detention camp during the war.	
審査	[sound:k-1834_審査.mp3]<br>しんさ <br> judging, inspection, examination, investigation
judging, inspection, examination, investigation	<b>審査<b> <br> しんさ <br>[sound:k-1834_審査.mp3]
[sound:k-1834_審査.mp3]	judging, inspection, examination, investigation<br> <b>審査</b> <br> (しんさ)
(<b>必勝</b>) 我々はこの試合で必勝を誓う。	[sound:s-1834_我々はこの試合で必勝を誓う。.mp3] <br> われわれはこのしあいでひっしょうをちかう。 <br> We pledge victory in this match.
[sound:s-1824_事故の全容が明らかになった。.mp3]	(<b>全容</b>) 事故の全容が明らかになった。<br> じこのぜんようがあきらかになった。 <br>The full extent of the accident became clear.	
実態調査	[sound:k-1835_実態調査.mp3]<br>じったいちょうさ <br> factual investigation
factual investigation	<b>実態調査<b> <br> じったいちょうさ <br>[sound:k-1835_実態調査.mp3]
[sound:k-1835_実態調査.mp3]	factual investigation<br> <b>実態調査</b> <br> (じったいちょうさ)
(<b>必然的</b>) 成功するためには必然的な努力が必要だ。	[sound:s-1835_成功するためには必然的な努力が必要だ。.mp3] <br> せいこうするためにはひつぜんてきなどりょくがひつようだ。 <br> Necessary effort is essential for success.
[sound:s-1825_USBメモリの容量が不足している。.mp3]	(<b>容量</b>) USBメモリの容量が不足している。<br> USBメモリのようりょうがふそくしている。 <br>The capacity of the USB memory is insufficient.	
監査役	[sound:k-1836_監査役.mp3]<br>かんさやく <br> auditor, inspector
auditor, inspector	<b>監査役<b> <br> かんさやく <br>[sound:k-1836_監査役.mp3]
[sound:k-1836_監査役.mp3]	auditor, inspector<br> <b>監査役</b> <br> (かんさやく)
(<b>応じる</b>) 要求に応じて必要な手続きを行う。	[sound:s-1836_要求に応じて必要な手続きを行う。.mp3] <br> ようきゅうにおうじてひつようなてつづきをおこなう。 <br> Perform necessary procedures in response to requests.
[sound:s-1826_予定通りに必ず会議に出席します。.mp3]	(<b>必ず</b>) 予定通りに必ず会議に出席します。<br> よていどおりにかならずかいぎにしゅっせきします。 <br>I will definitely attend the meeting as scheduled.	
巡査	[sound:k-1837_巡査.mp3]<br>じゅんさ <br> police, policeman
police, policeman	<b>巡査<b> <br> じゅんさ <br>[sound:k-1837_巡査.mp3]
[sound:k-1837_巡査.mp3]	police, policeman<br> <b>巡査</b> <br> (じゅんさ)
(<b>対応</b>) 顧客の要望に迅速に対応する。	[sound:s-1837_顧客の要望に迅速に対応する。.mp3] <br> こきゃくのようぼうにじんそくにたいおうする。 <br> Respond promptly to customer demands.
[sound:s-1827_雨が降るとは限らないが、必ずしも晴れるとも限らない。.mp3]	(<b>必ずしも</b>) 雨が降るとは限らないが、必ずしも晴れるとも限らない。<br> あめがふるとはかぎらないが、かならずしもはれるともかぎらない。 <br>It's not necessarily going to rain, but it's also not necessarily going to be sunny.	
監査	[sound:k-1838_監査.mp3]<br>かんさ <br> inspection, audit, judgement, judgment
inspection, audit, judgement, judgment	<b>監査<b> <br> かんさ <br>[sound:k-1838_監査.mp3]
[sound:k-1838_監査.mp3]	inspection, audit, judgement, judgment<br> <b>監査</b> <br> (かんさ)
(<b>応える</b>) 質問に的確に応える。	[sound:s-1838_質問に的確に応える。.mp3] <br> しつもんにてきかくにこたえる。 <br> Respond accurately to the question.
[sound:s-1828_これらの書類は手続きに必要です。.mp3]	(<b>必要</b>) これらの書類は手続きに必要です。<br> これらのしょるいはてつづきにひつようです。 <br>These documents are necessary for the procedure.	
探査	[sound:k-1839_探査.mp3]<br>たんさ <br> probe, inquiry, enquiry, investigation
probe, inquiry, enquiry, investigation	<b>探査<b> <br> たんさ <br>[sound:k-1839_探査.mp3]
[sound:k-1839_探査.mp3]	probe, inquiry, enquiry, investigation<br> <b>探査</b> <br> (たんさ)
(<b>応援</b>) 野球チームを熱心に応援する。	[sound:s-1839_野球チームを熱心に応援する。.mp3] <br> やきゅうちーむをねっしんにおうえんする。 <br> Cheer enthusiastically for the baseball team.
[sound:s-1829_この問題に対する解決策の必要性を認識しています。.mp3]	(<b>必要性</b>) この問題に対する解決策の必要性を認識しています。<br> このもんだいにたいするかいけつさくのひつようせいをにんしきしています。 <br>I recognize the necessity of solutions to this problem.	
勝る	[sound:k-1840_勝る.mp3]<br>まさる <br> to excel, to surpass, to exceed, to have an edge, to be superior, to outrival; to outweigh, to preponderate
to excel, to surpass, to exceed, to have an edge, to be superior, to outrival; to outweigh, to preponderate	<b>勝る<b> <br> まさる <br>[sound:k-1840_勝る.mp3]
[sound:k-1840_勝る.mp3]	to excel, to surpass, to exceed, to have an edge, to be superior, to outrival; to outweigh, to preponderate<br> <b>勝る</b> <br> (まさる)
(<b>応募</b>) その求人広告に応募した。	[sound:s-1840_その求人広告に応募した。.mp3] <br> そのきゅうじんこうこくにおうぼした。 <br> Applied for the job advertised.
[sound:s-1830_彼は必死に助けを求めた。.mp3]	(<b>必死</b>) 彼は必死に助けを求めた。<br> かれはひっしにたすけをもとめた。 <br>He desperately sought help.	
勝ち	[sound:k-1841_勝ち.mp3]<br>かち <br> win, victory
win, victory	<b>勝ち<b> <br> かち <br>[sound:k-1841_勝ち.mp3]
[sound:k-1841_勝ち.mp3]	win, victory<br> <b>勝ち</b> <br> (かち)
(<b>反応</b>) 新しい政策に市民からの反応が様々だ。	[sound:s-1841_新しい政策に市民からの反応が様々だ。.mp3] <br> あたらしいせいさくにしみんからのはんのうがさまざまだ。 <br> The response from citizens to the new policy varies.
[sound:s-1831_期限までに必着で提出してください。.mp3]	(<b>必着</b>) 期限までに必着で提出してください。<br> きげんまでにひっちゃくでていしゅつしてください。 <br>Please submit it by the deadline without fail.	
優勝	[sound:k-1842_優勝.mp3]<br>ゆうしょう <br> overall victory, championship
overall victory, championship	<b>優勝<b> <br> ゆうしょう <br>[sound:k-1842_優勝.mp3]
[sound:k-1842_優勝.mp3]	overall victory, championship<br> <b>優勝</b> <br> (ゆうしょう)
(<b>一応</b>) 一応、問題は解決したようだ。	[sound:s-1842_一応、問題は解決したようだ。.mp3] <br> いちおう、もんだいはかいけつしたようだ。 <br> For now, it seems like the problem has been resolved.
[sound:s-1832_水は人間にとって必需品だ。.mp3]	(<b>必需</b>) 水は人間にとって必需品だ。<br> みずはにんげんにとってひつじゅひんだ。 <br>Water is a necessity for human beings.	
決勝	[sound:k-1843_決勝.mp3]<br>けっしょう <br> decision of a contest, finals (in sports)
decision of a contest, finals (in sports)	<b>決勝<b> <br> けっしょう <br>[sound:k-1843_決勝.mp3]
[sound:k-1843_決勝.mp3]	decision of a contest, finals<br> <b>in sports) (決勝</b> <br> (けっしょう)
(<b>応用</b>) 学んだ知識を実践に応用する。	[sound:s-1843_学んだ知識を実践に応用する。.mp3] <br> まなんだちしきをじっせんにおうようする。 <br> Apply learned knowledge in practice.
[sound:s-1833_不必要な荷物を処分する。.mp3]	(<b>不必要</b>) 不必要な荷物を処分する。<br> ふひつようなにもつをしょぶんする。 <br>Dispose of unnecessary items.	
勝利	[sound:k-1844_勝利.mp3]<br>しょうり <br> victory, triumph, conquest, success, win
victory, triumph, conquest, success, win	<b>勝利<b> <br> しょうり <br>[sound:k-1844_勝利.mp3]
[sound:k-1844_勝利.mp3]	victory, triumph, conquest, success, win<br> <b>勝利</b> <br> (しょうり)
(<b>適応</b>) 環境に適応する能力が必要だ。	[sound:s-1844_環境に適応する能力が必要だ。.mp3] <br> かんきょうにてきおうするのうりょくがひつようだ。 <br> The ability to adapt to the environment is necessary.
[sound:s-1834_我々はこの試合で必勝を誓う。.mp3]	(<b>必勝</b>) 我々はこの試合で必勝を誓う。<br> われわれはこのしあいでひっしょうをちかう。 <br>We pledge victory in this match.	
勝負	[sound:k-1845_勝負.mp3]<br>しょうぶ <br> victory or defeat, match, contest, game, bout
victory or defeat, match, contest, game, bout	<b>勝負<b> <br> しょうぶ <br>[sound:k-1845_勝負.mp3]
[sound:k-1845_勝負.mp3]	victory or defeat, match, contest, game, bout<br> <b>勝負</b> <br> (しょうぶ)
(<b>応答</b>) 問い合わせに適切に応答する。	[sound:s-1845_問い合わせに適切に応答する。.mp3] <br> といあわせにてきせつにおうとうする。 <br> Respond appropriately to inquiries.
[sound:s-1835_成功するためには必然的な努力が必要だ。.mp3]	(<b>必然的</b>) 成功するためには必然的な努力が必要だ。<br> せいこうするためにはひつぜんてきなどりょくがひつようだ。 <br>Necessary effort is essential for success.	
連勝	[sound:k-1846_連勝.mp3]<br>れんしょう <br> consecutive victories, series of victories
consecutive victories, series of victories	<b>連勝<b> <br> れんしょう <br>[sound:k-1846_連勝.mp3]
[sound:k-1846_連勝.mp3]	consecutive victories, series of victories<br> <b>連勝</b> <br> (れんしょう)
(<b>演説</b>) 政治家が演説を行った。	[sound:s-1846_政治家が演説を行った。.mp3] <br> せいじかがえんぜつをおこなった。 <br> The politician gave a speech.
[sound:s-1836_要求に応じて必要な手続きを行う。.mp3]	(<b>応じる</b>) 要求に応じて必要な手続きを行う。<br> ようきゅうにおうじてひつようなてつづきをおこなう。 <br>Perform necessary procedures in response to requests.	
準決勝	[sound:k-1847_準決勝.mp3]<br>じゅんけっしょう <br> semifinal (in sports)
semifinal (in sports)	<b>準決勝<b> <br> じゅんけっしょう <br>[sound:k-1847_準決勝.mp3]
[sound:k-1847_準決勝.mp3]	semifinal<br> <b>in sports) (準決勝</b> <br> (じゅんけっしょう)
(<b>公演</b>) 劇団が新作の公演を始める。	[sound:s-1847_劇団が新作の公演を始める。.mp3] <br> げきだんがしんさくのこうえんをはじめる。 <br> The theater company is starting a performance of their new work.
[sound:s-1837_顧客の要望に迅速に対応する。.mp3]	(<b>対応</b>) 顧客の要望に迅速に対応する。<br> こきゃくのようぼうにじんそくにたいおうする。 <br>Respond promptly to customer demands.	
勝ち越し	[sound:k-1848_勝ち越し.mp3]<br>かちこし <br> more wins than losses (sport)
more wins than losses (sport)	<b>勝ち越し<b> <br> かちこし <br>[sound:k-1848_勝ち越し.mp3]
[sound:k-1848_勝ち越し.mp3]	more wins than losses<br> <b>sport) (勝ち越し</b> <br> (かちこし)
(<b>講演</b>) 専門家が講演を行った。	[sound:s-1848_専門家が講演を行った。.mp3] <br> せんもんかがこうえんをおこなった。 <br> The expert delivered a lecture.
[sound:s-1838_質問に的確に応える。.mp3]	(<b>応える</b>) 質問に的確に応える。<br> しつもんにてきかくにこたえる。 <br>Respond accurately to the question.	
全勝	[sound:k-1849_全勝.mp3]<br>ぜんしょう <br> complete victory, winning the sumo tournament with no losses
complete victory, winning the sumo tournament with no losses	<b>全勝<b> <br> ぜんしょう <br>[sound:k-1849_全勝.mp3]
[sound:k-1849_全勝.mp3]	complete victory, winning the sumo tournament with no losses<br> <b>全勝</b> <br> (ぜんしょう)
(<b>演出</b>) 彼女は舞台の演出を担当した。	[sound:s-1849_彼女は舞台の演出を担当した。.mp3] <br> かのじょはぶたいのえんしゅつをたんとうした。 <br> She was in charge of the stage direction.
[sound:s-1839_野球チームを熱心に応援する。.mp3]	(<b>応援</b>) 野球チームを熱心に応援する。<br> やきゅうちーむをねっしんにおうえんする。 <br>Cheer enthusiastically for the baseball team.	
面	[sound:k-1850_面.mp3]<br>つら <br> face (often derog. or vulg.), mug; surface; surrounding area; cheek(s)
face (often derog. or vulg.), mug; surface; surrounding area; cheek(s)	<b>面<b> <br> つら <br>[sound:k-1850_面.mp3]
[sound:k-1850_面.mp3]	face<br> <b>often derog. or vulg.), mug; surface; surrounding area; cheek(s) (面</b> <br> (つら)
(<b>出演</b>) 有名俳優がその映画に出演する。	[sound:s-1850_有名俳優がその映画に出演する。.mp3] <br> ゆうめいはいゆうがそのえいがにしゅつえんする。 <br> A famous actor appears in the movie.
[sound:s-1840_その求人広告に応募した。.mp3]	(<b>応募</b>) その求人広告に応募した。<br> そのきゅうじんこうこくにおうぼした。 <br>Applied for the job advertised.	
全面	[sound:k-1851_全面.mp3]<br>ぜんめん <br> whole surface, entire
whole surface, entire	<b>全面<b> <br> ぜんめん <br>[sound:k-1851_全面.mp3]
[sound:k-1851_全面.mp3]	whole surface, entire<br> <b>全面</b> <br> (ぜんめん)
(<b>演奏</b>) 彼は美しい曲をピアノで演奏した。	[sound:s-1851_彼は美しい曲をピアノで演奏した。.mp3] <br> かれはうつくしいきょくをぴあのでえんそうした。 <br> He performed a beautiful piece on the piano.
[sound:s-1841_新しい政策に市民からの反応が様々だ。.mp3]	(<b>反応</b>) 新しい政策に市民からの反応が様々だ。<br> あたらしいせいさくにしみんからのはんのうがさまざまだ。 <br>The response from citizens to the new policy varies.	
当面	[sound:k-1852_当面.mp3]<br>とうめん <br> current, urgent, pressing, impending; to confront (an issue), to face (up to something); for the meantime, at present
current, urgent, pressing, impending; to confront (an issue), to face (up to something); for the meantime, at present	<b>当面<b> <br> とうめん <br>[sound:k-1852_当面.mp3]
[sound:k-1852_当面.mp3]	current, urgent, pressing, impending; to confront<br> <b>an issue), to face (up to something); for the meantime, at present (当面</b> <br> (とうめん)
(<b>演劇</b>) 彼女は学校の演劇部に所属している。	[sound:s-1852_彼女は学校の演劇部に所属している。.mp3] <br> かのじょはがっこうのえんげきぶにしょぞくしている。 <br> She belongs to the school's drama club.
[sound:s-1842_一応、問題は解決したようだ。.mp3]	(<b>一応</b>) 一応、問題は解決したようだ。<br> いちおう、もんだいはかいけつしたようだ。 <br>For now, it seems like the problem has been resolved.	
場面	[sound:k-1853_場面.mp3]<br>ばめん <br> scene, setting (e.g. of novel)
scene, setting (e.g. of novel)	<b>場面<b> <br> ばめん <br>[sound:k-1853_場面.mp3]
[sound:k-1853_場面.mp3]	scene, setting<br> <b>e.g. of novel) (場面</b> <br> (ばめん)
(<b>演技</b>) その俳優の演技は素晴らしかった。	[sound:s-1853_その俳優の演技は素晴らしかった。.mp3] <br> そのはいゆうのえんぎはすばらしかった。 <br> The actor's performance was wonderful.
[sound:s-1843_学んだ知識を実践に応用する。.mp3]	(<b>応用</b>) 学んだ知識を実践に応用する。<br> まなんだちしきをじっせんにおうようする。 <br>Apply learned knowledge in practice.	
画面	[sound:k-1854_画面.mp3]<br>がめん <br> terminal screen, scene, picture, the field (in TV), photo
terminal screen, scene, picture, the field (in TV), photo	<b>画面<b> <br> がめん <br>[sound:k-1854_画面.mp3]
[sound:k-1854_画面.mp3]	terminal screen, scene, picture, the field<br> <b>in TV), photo (画面</b> <br> (がめん)
(<b>演習</b>) 今日は数学の演習を行います。	[sound:s-1854_今日は数学の演習を行います。.mp3] <br> きょうはすうがくのえんしゅうをおこないます。 <br> We will do math exercises today.
[sound:s-1844_環境に適応する能力が必要だ。.mp3]	(<b>適応</b>) 環境に適応する能力が必要だ。<br> かんきょうにてきおうするのうりょくがひつようだ。 <br>The ability to adapt to the environment is necessary.	
局面	[sound:k-1855_局面.mp3]<br>きょくめん <br> checkerboard, aspect, situation
checkerboard, aspect, situation	<b>局面<b> <br> きょくめん <br>[sound:k-1855_局面.mp3]
[sound:k-1855_局面.mp3]	checkerboard, aspect, situation<br> <b>局面</b> <br> (きょくめん)
(<b>主演</b>) 彼はその映画の主演を務めた。	[sound:s-1855_彼はその映画の主演を務めた。.mp3] <br> かれはそのえいがのしゅえんをつとめた。 <br> He played the leading role in the movie.
[sound:s-1845_問い合わせに適切に応答する。.mp3]	(<b>応答</b>) 問い合わせに適切に応答する。<br> といあわせにてきせつにおうとうする。 <br>Respond appropriately to inquiries.	
社会面	[sound:k-1856_社会面.mp3]<br>しゃかいめん <br> society or local news page
society or local news page	<b>社会面<b> <br> しゃかいめん <br>[sound:k-1856_社会面.mp3]
[sound:k-1856_社会面.mp3]	society or local news page<br> <b>社会面</b> <br> (しゃかいめん)
(<b>電話</b>) 電話が鳴り、彼は驚いた。	[sound:s-1856_電話が鳴り、彼は驚いた。.mp3] <br> でんわがなり、かれはおどろいた。 <br> The phone rang, and he was surprised.
[sound:s-1846_政治家が演説を行った。.mp3]	(<b>演説</b>) 政治家が演説を行った。<br> せいじかがえんぜつをおこなった。 <br>The politician gave a speech.	
正面	[sound:k-1857_正面.mp3]<br>しょうめん <br> front, frontage, facade, main
front, frontage, facade, main	<b>正面<b> <br> しょうめん <br>[sound:k-1857_正面.mp3]
[sound:k-1857_正面.mp3]	front, frontage, facade, main<br> <b>正面</b> <br> (しょうめん)
(<b>電気</b>) 部屋の電気を消してください。	[sound:s-1857_部屋の電気を消してください。.mp3] <br> へやのでんきをけしてください。 <br> Please turn off the lights in the room.
[sound:s-1847_劇団が新作の公演を始める。.mp3]	(<b>公演</b>) 劇団が新作の公演を始める。<br> げきだんがしんさくのこうえんをはじめる。 <br>The theater company is starting a performance of their new work.	
全面的	[sound:k-1858_全面的.mp3]<br>ぜんめんてき <br> all-out, general, over-all, complete, extensive, full-scale
all-out, general, over-all, complete, extensive, full-scale	<b>全面的<b> <br> ぜんめんてき <br>[sound:k-1858_全面的.mp3]
[sound:k-1858_全面的.mp3]	all-out, general, over-all, complete, extensive, full-scale<br> <b>全面的</b> <br> (ぜんめんてき)
(<b>電力</b>) 大規模な停電で電力供給が止まった。	[sound:s-1858_大規模な停電で電力供給が止まった。.mp3] <br> だいきぼなていでんででんりょくきょうきゅうがとまった。 <br> Power supply stopped due to a large-scale blackout.
[sound:s-1848_専門家が講演を行った。.mp3]	(<b>講演</b>) 専門家が講演を行った。<br> せんもんかがこうえんをおこなった。 <br>The expert delivered a lecture.	
表面	[sound:k-1859_表面.mp3]<br>ひょうめん <br> surface, outside, face, appearance
surface, outside, face, appearance	<b>表面<b> <br> ひょうめん <br>[sound:k-1859_表面.mp3]
[sound:k-1859_表面.mp3]	surface, outside, face, appearance<br> <b>表面</b> <br> (ひょうめん)
(<b>電子</b>) 電子メールを送信する。	[sound:s-1859_電子メールを送信する。.mp3] <br> でんしメールをそうしんする。 <br> Send an email.
[sound:s-1849_彼女は舞台の演出を担当した。.mp3]	(<b>演出</b>) 彼女は舞台の演出を担当した。<br> かのじょはぶたいのえんしゅつをたんとうした。 <br>She was in charge of the stage direction.	
委員	[sound:k-1860_委員.mp3]<br>いいん <br> committee member
committee member	<b>委員<b> <br> いいん <br>[sound:k-1860_委員.mp3]
[sound:k-1860_委員.mp3]	committee member<br> <b>委員</b> <br> (いいん)
(<b>電車</b>) 電車が遅れています。	[sound:s-1860_電車が遅れています。.mp3] <br> でんしゃがおくれています。 <br> The train is delayed.
[sound:s-1850_有名俳優がその映画に出演する。.mp3]	(<b>出演</b>) 有名俳優がその映画に出演する。<br> ゆうめいはいゆうがそのえいがにしゅつえんする。 <br>A famous actor appears in the movie.	
委員会	[sound:k-1861_委員会.mp3]<br>いいんかい <br> committee, commission, board, panel, committee meeting
committee, commission, board, panel, committee meeting	<b>委員会<b> <br> いいんかい <br>[sound:k-1861_委員会.mp3]
[sound:k-1861_委員会.mp3]	committee, commission, board, panel, committee meeting<br> <b>委員会</b> <br> (いいんかい)
(<b>家電</b>) 家電製品を買う時、性能を確認しよう。	[sound:s-1861_家電製品を買う時、性能を確認しよう。.mp3] <br> かでんせいひんをかうとき、せいのうをかくにんしよう。 <br> When buying home appliances, let's check their performance.
[sound:s-1851_彼は美しい曲をピアノで演奏した。.mp3]	(<b>演奏</b>) 彼は美しい曲をピアノで演奏した。<br> かれはうつくしいきょくをぴあのでえんそうした。 <br>He performed a beautiful piece on the piano.	
委員長	[sound:k-1862_委員長.mp3]<br>いいんちょう <br> committee chairman
committee chairman	<b>委員長<b> <br> いいんちょう <br>[sound:k-1862_委員長.mp3]
[sound:k-1862_委員長.mp3]	committee chairman<br> <b>委員長</b> <br> (いいんちょう)
(<b>電機</b>) 電機メーカーの新製品が発売された。	[sound:s-1862_電機メーカーの新製品が発売された。.mp3] <br> でんきメーカーのしんせいひんがはつばいされた。 <br> The electrical appliance manufacturer released a new product.
[sound:s-1852_彼女は学校の演劇部に所属している。.mp3]	(<b>演劇</b>) 彼女は学校の演劇部に所属している。<br> かのじょはがっこうのえんげきぶにしょぞくしている。 <br>She belongs to the school's drama club.	
公取委	[sound:k-1863_公取委.mp3]<br>こうとりい <br> Fair Trade Commission
Fair Trade Commission	<b>公取委<b> <br> こうとりい <br>[sound:k-1863_公取委.mp3]
[sound:k-1863_公取委.mp3]	Fair Trade Commission<br> <b>公取委</b> <br> (こうとりい)
(<b>電波</b>) 電波の届く範囲内にいます。	[sound:s-1863_電波の届く範囲内にいます。.mp3] <br> でんぱのとどくはんいないにいます。 <br> I'm within the range of the radio waves.
[sound:s-1853_その俳優の演技は素晴らしかった。.mp3]	(<b>演技</b>) その俳優の演技は素晴らしかった。<br> そのはいゆうのえんぎはすばらしかった。 <br>The actor's performance was wonderful.	
委託	[sound:k-1864_委託.mp3]<br>いたく <br> consign (goods (for sale) to a firm), entrust (person with something), commit
consign (goods (for sale) to a firm), entrust (person with something), commit	<b>委託<b> <br> いたく <br>[sound:k-1864_委託.mp3]
[sound:k-1864_委託.mp3]	consign<br> <b>goods (for sale) to a firm), entrust (person with something), commit (委託</b> <br> (いたく)
(<b>発電</b>) 太陽光パネルで電気を発電する。	[sound:s-1864_太陽光パネルで電気を発電する。.mp3] <br> たいようこうパネルででんきをはつでんする。 <br> Generate electricity with solar panels.
[sound:s-1854_今日は数学の演習を行います。.mp3]	(<b>演習</b>) 今日は数学の演習を行います。<br> きょうはすうがくのえんしゅうをおこないます。 <br>We will do math exercises today.	
教育委員会	[sound:k-1865_教育委員会.mp3]<br>きょういくいいんかい <br> Board of Education
Board of Education	<b>教育委員会<b> <br> きょういくいいんかい <br>[sound:k-1865_教育委員会.mp3]
[sound:k-1865_教育委員会.mp3]	Board of Education<br> <b>教育委員会</b> <br> (きょういくいいんかい)
(<b>発電所</b>) 近くに新しい発電所が建設された。	[sound:s-1865_近くに新しい発電所が建設された。.mp3] <br> ちかくにあたらしいはつでんじょがけんせつされた。 <br> A new power plant was constructed nearby.
[sound:s-1855_彼はその映画の主演を務めた。.mp3]	(<b>主演</b>) 彼はその映画の主演を務めた。<br> かれはそのえいがのしゅえんをつとめた。 <br>He played the leading role in the movie.	
執行委員	[sound:k-1866_執行委員.mp3]<br>しっこういいん <br> executive committee
executive committee	<b>執行委員<b> <br> しっこういいん <br>[sound:k-1866_執行委員.mp3]
[sound:k-1866_執行委員.mp3]	executive committee<br> <b>執行委員</b> <br> (しっこういいん)
(<b>歳出</b>) 今年の予算の歳出は増加している。	[sound:s-1866_今年の予算の歳出は増加している。.mp3] <br> ことしのよさんのさいしゅつはぞうかしている。 <br> This year's budget expenditure is increasing.
[sound:s-1856_電話が鳴り、彼は驚いた。.mp3]	(<b>電話</b>) 電話が鳴り、彼は驚いた。<br> でんわがなり、かれはおどろいた。 <br>The phone rang, and he was surprised.	
公安委員会	[sound:k-1867_公安委員会.mp3]<br>こうあんいいんかい <br> public safety commission
public safety commission	<b>公安委員会<b> <br> こうあんいいんかい <br>[sound:k-1867_公安委員会.mp3]
[sound:k-1867_公安委員会.mp3]	public safety commission<br> <b>公安委員会</b> <br> (こうあんいいんかい)
(<b>歳入</b>) 歳入が予想を上回った。	[sound:s-1867_歳入が予想を上回った。.mp3] <br> さいにゅうがよそうをうわまわった。 <br> The revenue exceeded expectations.
[sound:s-1857_部屋の電気を消してください。.mp3]	(<b>電気</b>) 部屋の電気を消してください。<br> へやのでんきをけしてください。 <br>Please turn off the lights in the room.	
議院運営委員会	[sound:k-1868_議院運営委員会.mp3]<br>ぎいんうんえいいいんかい <br> Committee on Rules and Administration (Diet)
Committee on Rules and Administration (Diet)	<b>議院運営委員会<b> <br> ぎいんうんえいいいんかい <br>[sound:k-1868_議院運営委員会.mp3]
[sound:k-1868_議院運営委員会.mp3]	Committee on Rules and Administration<br> <b>Diet) (議院運営委員会</b> <br> (ぎいんうんえいいいんかい)
(<b>歳</b>) 彼女は二十歳になった。	[sound:s-1868_彼女は二十歳になった。.mp3] <br> かのじょはにじゅっさいになった。 <br> She turned twenty years old.
[sound:s-1858_大規模な停電で電力供給が止まった。.mp3]	(<b>電力</b>) 大規模な停電で電力供給が止まった。<br> だいきぼなていでんででんりょくきょうきゅうがとまった。 <br>Power supply stopped due to a large-scale blackout.	
委縮	[sound:k-1869_委縮.mp3]<br>いしゅく <br> withering, atrophy, contraction, dwarf
withering, atrophy, contraction, dwarf	<b>委縮<b> <br> いしゅく <br>[sound:k-1869_委縮.mp3]
[sound:k-1869_委縮.mp3]	withering, atrophy, contraction, dwarf<br> <b>委縮</b> <br> (いしゅく)
(<b>歳月</b>) 二人は歳月を重ねて、結婚した。	[sound:s-1869_二人は歳月を重ねて、結婚した。.mp3] <br> ふたりはさいげつをかさねて、けっこんした。 <br> The two got married after spending years together.
[sound:s-1859_電子メールを送信する。.mp3]	(<b>電子</b>) 電子メールを送信する。<br> でんしメールをそうしんする。 <br>Send an email.	
告別	[sound:k-1870_告別.mp3]<br>こくべつ <br> farewell, leave-taking
farewell, leave-taking	<b>告別<b> <br> こくべつ <br>[sound:k-1870_告別.mp3]
[sound:k-1870_告別.mp3]	farewell, leave-taking<br> <b>告別</b> <br> (こくべつ)
(<b>千歳</b>) 彼女は千歳飴を食べている。	[sound:s-1870_彼女は千歳飴を食べている。.mp3] <br> かのじょはちとせあめをたべている。 <br> She is eating a thousand-year-old candy.
[sound:s-1860_電車が遅れています。.mp3]	(<b>電車</b>) 電車が遅れています。<br> でんしゃがおくれています。 <br>The train is delayed.	
被告	[sound:k-1871_被告.mp3]<br>ひこく <br> defendant, the accused
defendant, the accused	<b>被告<b> <br> ひこく <br>[sound:k-1871_被告.mp3]
[sound:k-1871_被告.mp3]	defendant, the accused<br> <b>被告</b> <br> (ひこく)
(<b>歳暮</b>) 歳暮には家族で集まるのが楽しみだ。	[sound:s-1871_歳暮には家族で集まるのが楽しみだ。.mp3] <br> せいぼにはかぞくであつまるのがたのしみだ。 <br> I look forward to gathering with family for the year-end.
[sound:s-1861_家電製品を買う時、性能を確認しよう。.mp3]	(<b>家電</b>) 家電製品を買う時、性能を確認しよう。<br> かでんせいひんをかうとき、せいのうをかくにんしよう。 <br>When buying home appliances, let's check their performance.	
報告	[sound:k-1872_報告.mp3]<br>ほうこく <br> report, information
report, information	<b>報告<b> <br> ほうこく <br>[sound:k-1872_報告.mp3]
[sound:k-1872_報告.mp3]	report, information<br> <b>報告</b> <br> (ほうこく)
(<b>万歳</b>) 万歳をする人々の声が聞こえた。	[sound:s-1872_万歳をする人々の声が聞こえた。.mp3] <br> ばんざいをするひとびとのこえがきこえた。 <br> The voices of people cheering "banzai" could be heard.
[sound:s-1862_電機メーカーの新製品が発売された。.mp3]	(<b>電機</b>) 電機メーカーの新製品が発売された。<br> でんきメーカーのしんせいひんがはつばいされた。 <br>The electrical appliance manufacturer released a new product.	
広告	[sound:k-1873_広告.mp3]<br>こうこく <br> advertisement
advertisement	<b>広告<b> <br> こうこく <br>[sound:k-1873_広告.mp3]
[sound:k-1873_広告.mp3]	advertisement<br> <b>広告</b> <br> (こうこく)
(<b>歳費</b>) そのプロジェクトの歳費は多額だ。	[sound:s-1873_そのプロジェクトの歳費は多額だ。.mp3] <br> そのプロジェクトのさいひはたがくだ。 <br> The project's annual expenses are significant.
[sound:s-1863_電波の届く範囲内にいます。.mp3]	(<b>電波</b>) 電波の届く範囲内にいます。<br> でんぱのとどくはんいないにいます。 <br>I'm within the range of the radio waves.	
報告書	[sound:k-1874_報告書.mp3]<br>ほうこくしょ <br> (written) report
(written) report	<b>報告書<b> <br> ほうこくしょ <br>[sound:k-1874_報告書.mp3]
[sound:k-1874_報告書.mp3]	(written) report<br> <b>報告書</b> <br> (ほうこくしょ)
(<b>歳末</b>) 歳末セールでお得な買い物ができる。	[sound:s-1874_歳末セールでお得な買い物ができる。.mp3] <br> さいまつセールでおとくなかいものができる。 <br> You can get good deals at the year-end sale.
[sound:s-1864_太陽光パネルで電気を発電する。.mp3]	(<b>発電</b>) 太陽光パネルで電気を発電する。<br> たいようこうパネルででんきをはつでんする。 <br>Generate electricity with solar panels.	
原告	[sound:k-1875_原告.mp3]<br>げんこく <br> plaintiff, accuser, prosecutor
plaintiff, accuser, prosecutor	<b>原告<b> <br> げんこく <br>[sound:k-1875_原告.mp3]
[sound:k-1875_原告.mp3]	plaintiff, accuser, prosecutor<br> <b>原告</b> <br> (げんこく)
(<b>歳時記</b>) 私は毎年歳時記を楽しんで読む。	[sound:s-1875_私は毎年歳時記を楽しんで読む。.mp3] <br> わたしはまいねんさいじきをたのしんでよむ。 <br> I enjoy reading the almanac every year.
[sound:s-1865_近くに新しい発電所が建設された。.mp3]	(<b>発電所</b>) 近くに新しい発電所が建設された。<br> ちかくにあたらしいはつでんじょがけんせつされた。 <br>A new power plant was constructed nearby.	
勧告	[sound:k-1876_勧告.mp3]<br>かんこく <br> advice, counsel, remonstrance, recommendation
advice, counsel, remonstrance, recommendation	<b>勧告<b> <br> かんこく <br>[sound:k-1876_勧告.mp3]
[sound:k-1876_勧告.mp3]	advice, counsel, remonstrance, recommendation<br> <b>勧告</b> <br> (かんこく)
(<b>住</b>) ここに住むことは快適です。	[sound:s-1876_ここに住むことは快適です。.mp3] <br> ここにすむことはかいてきです。 <br> Living here is comfortable.
[sound:s-1866_今年の予算の歳出は増加している。.mp3]	(<b>歳出</b>) 今年の予算の歳出は増加している。<br> ことしのよさんのさいしゅつはぞうかしている。 <br>This year's budget expenditure is increasing.	
申告	[sound:k-1877_申告.mp3]<br>しんこく <br> report, statement, filing a return, notification
report, statement, filing a return, notification	<b>申告<b> <br> しんこく <br>[sound:k-1877_申告.mp3]
[sound:k-1877_申告.mp3]	report, statement, filing a return, notification<br> <b>申告</b> <br> (しんこく)
(<b>住宅</b>) 新しい住宅地が開発された。	[sound:s-1877_新しい住宅地が開発された。.mp3] <br> あたらしいじゅうたくちがかいはつされた。 <br> A new residential area was developed.
[sound:s-1867_歳入が予想を上回った。.mp3]	(<b>歳入</b>) 歳入が予想を上回った。<br> さいにゅうがよそうをうわまわった。 <br>The revenue exceeded expectations.	
警告	[sound:k-1878_警告.mp3]<br>けいこく <br> warning, advice
warning, advice	<b>警告<b> <br> けいこく <br>[sound:k-1878_警告.mp3]
[sound:k-1878_警告.mp3]	warning, advice<br> <b>警告</b> <br> (けいこく)
(<b>住民</b>) この地域の住民はとても親切だ。	[sound:s-1878_この地域の住民はとても親切だ。.mp3] <br> このちいきのじゅうみんはとてもしんせつだ。 <br> The residents of this area are very kind.
[sound:s-1868_彼女は二十歳になった。.mp3]	(<b>歳</b>) 彼女は二十歳になった。<br> かのじょはにじゅっさいになった。 <br>She turned twenty years old.	
告示	[sound:k-1879_告示.mp3]<br>こくじ <br> notice, bulletin
notice, bulletin	<b>告示<b> <br> こくじ <br>[sound:k-1879_告示.mp3]
[sound:k-1879_告示.mp3]	notice, bulletin<br> <b>告示</b> <br> (こくじ)
(<b>住所</b>) 送り先の正確な住所を教えてください。	[sound:s-1879_送り先の正確な住所を教えてください。.mp3] <br> おくりさきのせいかくなじゅうしょをおしえてください。 <br> Please provide the exact address of the destination.
[sound:s-1869_二人は歳月を重ねて、結婚した。.mp3]	(<b>歳月</b>) 二人は歳月を重ねて、結婚した。<br> ふたりはさいげつをかさねて、けっこんした。 <br>The two got married after spending years together.	
軍	[sound:k-1880_軍.mp3]<br>ぐん <br> army, force, troops
army, force, troops	<b>軍<b> <br> ぐん <br>[sound:k-1880_軍.mp3]
[sound:k-1880_軍.mp3]	army, force, troops<br> <b>軍</b> <br> (ぐん)
(<b>在住</b>) 彼はアメリカに在住している。	[sound:s-1880_彼はアメリカに在住している。.mp3] <br> かれはアメリカにざいじゅうしている。 <br> He lives in the United States.
[sound:s-1870_彼女は千歳飴を食べている。.mp3]	(<b>千歳</b>) 彼女は千歳飴を食べている。<br> かのじょはちとせあめをたべている。 <br>She is eating a thousand-year-old candy.	
軍事	[sound:k-1881_軍事.mp3]<br>ぐんじ <br> military affairs
military affairs	<b>軍事<b> <br> ぐんじ <br>[sound:k-1881_軍事.mp3]
[sound:k-1881_軍事.mp3]	military affairs<br> <b>軍事</b> <br> (ぐんじ)
(<b>居住</b>) 彼は地方都市での居住を選んだ。	[sound:s-1881_彼は地方都市での居住を選んだ。.mp3] <br> かれはちほうとしでのきょじゅうをえらんだ。 <br> He chose to reside in a provincial city.
[sound:s-1871_歳暮には家族で集まるのが楽しみだ。.mp3]	(<b>歳暮</b>) 歳暮には家族で集まるのが楽しみだ。<br> せいぼにはかぞくであつまるのがたのしみだ。 <br>I look forward to gathering with family for the year-end.	
海軍	[sound:k-1882_海軍.mp3]<br>かいぐん <br> navy
navy	<b>海軍<b> <br> かいぐん <br>[sound:k-1882_海軍.mp3]
[sound:k-1882_海軍.mp3]	navy<br> <b>海軍</b> <br> (かいぐん)
(<b>住み心地</b>) この家はとても住み心地がいい。	[sound:s-1882_この家はとても住み心地がいい。.mp3] <br> このいえはとてもすみごこちがいい。 <br> This house is very comfortable to live in.
[sound:s-1872_万歳をする人々の声が聞こえた。.mp3]	(<b>万歳</b>) 万歳をする人々の声が聞こえた。<br> ばんざいをするひとびとのこえがきこえた。 <br>The voices of people cheering "banzai" could be heard.	
軍縮	[sound:k-1883_軍縮.mp3]<br>ぐんしゅく <br> disarmament, limitation of arms
disarmament, limitation of arms	<b>軍縮<b> <br> ぐんしゅく <br>[sound:k-1883_軍縮.mp3]
[sound:k-1883_軍縮.mp3]	disarmament, limitation of arms<br> <b>軍縮</b> <br> (ぐんしゅく)
(<b>先住</b>) 先住者による地域の歴史を学ぶ。	[sound:s-1883_先住者による地域の歴史を学ぶ。.mp3] <br> せんじゅうしゃによるちいきのれきしをまなぶ。 <br> Learn about the history of the area from the indigenous people.
[sound:s-1873_そのプロジェクトの歳費は多額だ。.mp3]	(<b>歳費</b>) そのプロジェクトの歳費は多額だ。<br> そのプロジェクトのさいひはたがくだ。 <br>The project's annual expenses are significant.	
空軍	[sound:k-1884_空軍.mp3]<br>くうぐん <br> Air Force
Air Force	<b>空軍<b> <br> くうぐん <br>[sound:k-1884_空軍.mp3]
[sound:k-1884_空軍.mp3]	Air Force<br> <b>空軍</b> <br> (くうぐん)
(<b>住宅地</b>) 彼は閑静な住宅地に住んでいる。	[sound:s-1884_彼は閑静な住宅地に住んでいる。.mp3] <br> かれはかんせいなじゅうたくちにすんでいる。 <br> He lives in a quiet residential area.
[sound:s-1874_歳末セールでお得な買い物ができる。.mp3]	(<b>歳末</b>) 歳末セールでお得な買い物ができる。<br> さいまつセールでおとくなかいものができる。 <br>You can get good deals at the year-end sale.	
軍人	[sound:k-1885_軍人.mp3]<br>ぐんじん <br> military personnel, soldier
military personnel, soldier	<b>軍人<b> <br> ぐんじん <br>[sound:k-1885_軍人.mp3]
[sound:k-1885_軍人.mp3]	military personnel, soldier<br> <b>軍人</b> <br> (ぐんじん)
(<b>住友</b>) 住友グループは多岐にわたる事業を展開している。	[sound:s-1885_住友グループは多岐にわたる事業を展開している。.mp3] <br> すみともグループはたきにわたるじぎょうをてんかいしている。 <br> The Sumitomo Group is engaged in a wide range of businesses.Sure, let's begin:
[sound:s-1875_私は毎年歳時記を楽しんで読む。.mp3]	(<b>歳時記</b>) 私は毎年歳時記を楽しんで読む。<br> わたしはまいねんさいじきをたのしんでよむ。 <br>I enjoy reading the almanac every year.	
軍部	[sound:k-1886_軍部.mp3]<br>ぐんぶ <br> military authorities, army circles
military authorities, army circles	<b>軍部<b> <br> ぐんぶ <br>[sound:k-1886_軍部.mp3]
[sound:k-1886_軍部.mp3]	military authorities, army circles<br> <b>軍部</b> <br> (ぐんぶ)
(<b>争い</b>) 彼らは争いをやめるべきです。	[sound:s-1886_彼らは争いをやめるべきです。.mp3] <br>  They should stop fighting.
[sound:s-1876_ここに住むことは快適です。.mp3]	(<b>住</b>) ここに住むことは快適です。<br> ここにすむことはかいてきです。 <br>Living here is comfortable.	
従軍	[sound:k-1887_従軍.mp3]<br>じゅうぐん <br> campaign
campaign	<b>従軍<b> <br> じゅうぐん <br>[sound:k-1887_従軍.mp3]
[sound:k-1887_従軍.mp3]	campaign<br> <b>従軍</b> <br> (じゅうぐん)
(<b>戦争</b>) 戦争は多くの犠牲者を出します。	[sound:s-1887_戦争は多くの犠牲者を出します。.mp3] <br>  War causes many casualties.
[sound:s-1877_新しい住宅地が開発された。.mp3]	(<b>住宅</b>) 新しい住宅地が開発された。<br> あたらしいじゅうたくちがかいはつされた。 <br>A new residential area was developed.	
軍隊	[sound:k-1888_軍隊.mp3]<br>ぐんたい <br> army, troops
army, troops	<b>軍隊<b> <br> ぐんたい <br>[sound:k-1888_軍隊.mp3]
[sound:k-1888_軍隊.mp3]	army, troops<br> <b>軍隊</b> <br> (ぐんたい)
(<b>競争</b>) 市場での競争は激しいです。	[sound:s-1888_市場での競争は激しいです。.mp3] <br>  Competition in the market is fierce.
[sound:s-1878_この地域の住民はとても親切だ。.mp3]	(<b>住民</b>) この地域の住民はとても親切だ。<br> このちいきのじゅうみんはとてもしんせつだ。 <br>The residents of this area are very kind.	
将軍	[sound:k-1889_将軍.mp3]<br>しょうぐん <br> general, shogun
general, shogun	<b>将軍<b> <br> しょうぐん <br>[sound:k-1889_将軍.mp3]
[sound:k-1889_将軍.mp3]	general, shogun<br> <b>将軍</b> <br> (しょうぐん)
(<b>紛争</b>) 国境紛争は解決が難しいです。	[sound:s-1889_国境紛争は解決が難しいです。.mp3] <br>  Border disputes are difficult to resolve.
[sound:s-1879_送り先の正確な住所を教えてください。.mp3]	(<b>住所</b>) 送り先の正確な住所を教えてください。<br> おくりさきのせいかくなじゅうしょをおしえてください。 <br>Please provide the exact address of the destination.	
文	[sound:k-1890_文.mp3]<br>ふみ <br> letter, writings
letter, writings	<b>文<b> <br> ふみ <br>[sound:k-1890_文.mp3]
[sound:k-1890_文.mp3]	letter, writings<br> <b>文</b> <br> (ふみ)
(<b>闘争</b>) 労働者たちは権利のために闘争しています。	[sound:s-1890_労働者たちは権利のために闘争しています。.mp3] <br>  Workers are fighting for their rights.
[sound:s-1880_彼はアメリカに在住している。.mp3]	(<b>在住</b>) 彼はアメリカに在住している。<br> かれはアメリカにざいじゅうしている。 <br>He lives in the United States.	
文化	[sound:k-1891_文化.mp3]<br>ぶんか <br> culture, civilization, civilisation; Bunka era (1804.2.11-1818.4.22)
culture, civilization, civilisation; Bunka era (1804.2.11-1818.4.22)	<b>文化<b> <br> ぶんか <br>[sound:k-1891_文化.mp3]
[sound:k-1891_文化.mp3]	culture, civilization, civilisation; Bunka era<br> <b>1804.2.11-1818.4.22) (文化</b> <br> (ぶんか)
(<b>抗争</b>) この地域では抗争が続いています。	[sound:s-1891_この地域では抗争が続いています。.mp3] <br>  There is ongoing conflict in this region.
[sound:s-1881_彼は地方都市での居住を選んだ。.mp3]	(<b>居住</b>) 彼は地方都市での居住を選んだ。<br> かれはちほうとしでのきょじゅうをえらんだ。 <br>He chose to reside in a provincial city.	
文学	[sound:k-1892_文学.mp3]<br>ぶんがく <br> literature
literature	<b>文学<b> <br> ぶんがく <br>[sound:k-1892_文学.mp3]
[sound:k-1892_文学.mp3]	literature<br> <b>文学</b> <br> (ぶんがく)
(<b>争点</b>) その問題は争点となっています。	[sound:s-1892_その問題は争点となっています。.mp3] <br>  That issue is the point of contention.
[sound:s-1882_この家はとても住み心地がいい。.mp3]	(<b>住み心地</b>) この家はとても住み心地がいい。<br> このいえはとてもすみごこちがいい。 <br>This house is very comfortable to live in.	
文書	[sound:k-1893_文書.mp3]<br>ぶんしょ, もんじょ <br> document, writing, letter, paperwork, note, records, archives
document, writing, letter, paperwork, note, records, archives	<b>文書<b> <br> ぶんしょ, もんじょ <br>[sound:k-1893_文書.mp3]
[sound:k-1893_文書.mp3]	document, writing, letter, paperwork, note, records, archives<br> <b>文書</b> <br> (ぶんしょ, もんじょ)
(<b>論争</b>) その理論に関して激しい論争があります。	[sound:s-1893_その理論に関して激しい論争があります。.mp3] <br>  There is intense debate about that theory.
[sound:s-1883_先住者による地域の歴史を学ぶ。.mp3]	(<b>先住</b>) 先住者による地域の歴史を学ぶ。<br> せんじゅうしゃによるちいきのれきしをまなぶ。 <br>Learn about the history of the area from the indigenous people.	
文字	[sound:k-1894_文字.mp3]<br>もじ, もんじ <br> letter (of alphabet), character; literal
letter (of alphabet), character; literal	<b>文字<b> <br> もじ, もんじ <br>[sound:k-1894_文字.mp3]
[sound:k-1894_文字.mp3]	letter<br> <b>of alphabet), character; literal (文字</b> <br> (もじ, もんじ)
(<b>争う</b>) 彼らは地位を争っています。	[sound:s-1894_彼らは地位を争っています。.mp3] <br>  They are competing for the position.
[sound:s-1884_彼は閑静な住宅地に住んでいる。.mp3]	(<b>住宅地</b>) 彼は閑静な住宅地に住んでいる。<br> かれはかんせいなじゅうたくちにすんでいる。 <br>He lives in a quiet residential area.	
文部省	[sound:k-1895_文部省.mp3]<br>もんぶしょう <br> Ministry of Education, Culture, Sports, Science and Technology
Ministry of Education, Culture, Sports, Science and Technology	<b>文部省<b> <br> もんぶしょう <br>[sound:k-1895_文部省.mp3]
[sound:k-1895_文部省.mp3]	Ministry of Education, Culture, Sports, Science and Technology<br> <b>文部省</b> <br> (もんぶしょう)
(<b>太平洋戦争</b>) 太平洋戦争は日本の歴史上重要な出来事です。    	[sound:s-1895_太平洋戦争は日本の歴史上重要な出来事です。.mp3] <br> The Pacific War is an important event in Japanese history.
[sound:s-1885_住友グループは多岐にわたる事業を展開している。.mp3]	(<b>住友</b>) 住友グループは多岐にわたる事業を展開している。<br> すみともグループはたきにわたるじぎょうをてんかいしている。 <br>The Sumitomo Group is engaged in a wide range of businesses.Sure, let's begin:	
注文	[sound:k-1896_注文.mp3]<br>ちゅうもん <br> order, request
order, request	<b>注文<b> <br> ちゅうもん <br>[sound:k-1896_注文.mp3]
[sound:k-1896_注文.mp3]	order, request<br> <b>注文</b> <br> (ちゅうもん)
(<b>会談</b>) 政治家たちは会談を行います。    	[sound:s-1896_政治家たちは会談を行います。.mp3] <br> Politicians hold talks.
[sound:s-1886_彼らは争いをやめるべきです。.mp3]	(<b>争い</b>) 彼らは争いをやめるべきです。<br>  They should stop fighting. <br>	
論文	[sound:k-1897_論文.mp3]<br>ろんぶん <br> thesis, essay, treatise, paper, article
thesis, essay, treatise, paper, article	<b>論文<b> <br> ろんぶん <br>[sound:k-1897_論文.mp3]
[sound:k-1897_論文.mp3]	thesis, essay, treatise, paper, article<br> <b>論文</b> <br> (ろんぶん)
(<b>相談</b>) 彼に相談したほうがいいです。    	[sound:s-1897_彼に相談したほうがいいです。.mp3] <br> You should consult with him.
[sound:s-1887_戦争は多くの犠牲者を出します。.mp3]	(<b>戦争</b>) 戦争は多くの犠牲者を出します。<br>  War causes many casualties. <br>	
文庫	[sound:k-1898_文庫.mp3]<br>ぶんこ <br> library, book collection; paperback book
library, book collection; paperback book	<b>文庫<b> <br> ぶんこ <br>[sound:k-1898_文庫.mp3]
[sound:k-1898_文庫.mp3]	library, book collection; paperback book<br> <b>文庫</b> <br> (ぶんこ)
(<b>懇談</b>) 昨日、親睦を深めるために懇談会が開かれました。    	[sound:s-1898_昨日、親睦を深めるために懇談会が開かれました。.mp3] <br> "Yesterday, a friendly discussion was held to strengthen bonds."
[sound:s-1888_市場での競争は激しいです。.mp3]	(<b>競争</b>) 市場での競争は激しいです。<br>  Competition in the market is fierce. <br>	
文章	[sound:k-1899_文章.mp3]<br>ぶんしょう <br> sentence, article, composition; (writing) style
sentence, article, composition; (writing) style	<b>文章<b> <br> ぶんしょう <br>[sound:k-1899_文章.mp3]
[sound:k-1899_文章.mp3]	sentence, article, composition;<br> <b>writing) style (文章</b> <br> (ぶんしょう)
(<b>談合</b>) その契約は談合の結果です。    	[sound:s-1899_その契約は談合の結果です。.mp3] <br> The contract is the result of collusion.
[sound:s-1889_国境紛争は解決が難しいです。.mp3]	(<b>紛争</b>) 国境紛争は解決が難しいです。<br>  Border disputes are difficult to resolve. <br>	
違反	[sound:k-1900_違反.mp3]<br>いはん <br> violation (of law), transgression, infringement, breach
violation (of law), transgression, infringement, breach	<b>違反<b> <br> いはん <br>[sound:k-1900_違反.mp3]
[sound:k-1900_違反.mp3]	violation<br> <b>of law), transgression, infringement, breach (違反</b> <br> (いはん)
(<b>相談役</b>) 彼は私たちの相談役です。    	[sound:s-1900_彼は私たちの相談役です。.mp3] <br> He is our advisor.
[sound:s-1890_労働者たちは権利のために闘争しています。.mp3]	(<b>闘争</b>) 労働者たちは権利のために闘争しています。<br>  Workers are fighting for their rights. <br>	
反対	[sound:k-1901_反対.mp3]<br>はんたい <br> opposition, resistance, antagonism, hostility, contrast, objection, dissension, reverse, opposite, vice versa
opposition, resistance, antagonism, hostility, contrast, objection, dissension, reverse, opposite, vice versa	<b>反対<b> <br> はんたい <br>[sound:k-1901_反対.mp3]
[sound:k-1901_反対.mp3]	opposition, resistance, antagonism, hostility, contrast, objection, dissension, reverse, opposite, vice versa<br> <b>反対</b> <br> (はんたい)
(<b>談話</b>) 彼らは楽しい談話を交わしました。    	[sound:s-1901_彼らは楽しい談話を交わしました。.mp3] <br> They exchanged pleasant conversation.
[sound:s-1891_この地域では抗争が続いています。.mp3]	(<b>抗争</b>) この地域では抗争が続いています。<br>  There is ongoing conflict in this region. <br>	
反発	[sound:k-1902_反発.mp3]<br>はんぱつ <br> to repel, to oppose, to revolt, to react sharply (against); opposition, rebellion, resistance, backlash; rally, recovery (e.g. in stock prices), rebound; to rally, to recover, to rebound
to repel, to oppose, to revolt, to react sharply (against); opposition, rebellion, resistance, backlash; rally, recovery (e.g. in stock prices), rebound; to rally, to recover, to rebound	<b>反発<b> <br> はんぱつ <br>[sound:k-1902_反発.mp3]
[sound:k-1902_反発.mp3]	to repel, to oppose, to revolt, to react sharply<br> <b>against); opposition, rebellion, resistance, backlash; rally, recovery (e.g. in stock prices), rebound; to rally, to recover, to rebound (反発</b> <br> (はんぱつ)
(<b>冗談</b>) 彼の冗談はいつも面白いです。    	[sound:s-1902_彼の冗談はいつも面白いです。.mp3] <br> His jokes are always funny.
[sound:s-1892_その問題は争点となっています。.mp3]	(<b>争点</b>) その問題は争点となっています。<br>  That issue is the point of contention. <br>	
反応	[sound:k-1903_反応.mp3]<br>はんのう <br> reaction, response
reaction, response	<b>反応<b> <br> はんのう <br>[sound:k-1903_反応.mp3]
[sound:k-1903_反応.mp3]	reaction, response<br> <b>反応</b> <br> (はんのう)
(<b>商談</b>) 今日は大切な商談があります。    	[sound:s-1903_今日は大切な商談があります。.mp3] <br> There is an important business negotiation today.
[sound:s-1893_その理論に関して激しい論争があります。.mp3]	(<b>論争</b>) その理論に関して激しい論争があります。<br>  There is intense debate about that theory. <br>	
反省	[sound:k-1904_反省.mp3]<br>はんせい <br> reflection, reconsideration, introspection, meditation, contemplation
reflection, reconsideration, introspection, meditation, contemplation	<b>反省<b> <br> はんせい <br>[sound:k-1904_反省.mp3]
[sound:k-1904_反省.mp3]	reflection, reconsideration, introspection, meditation, contemplation<br> <b>反省</b> <br> (はんせい)
(<b>対談</b>) 二人の著名人が対談しました。    	[sound:s-1904_二人の著名人が対談しました。.mp3] <br> Two prominent figures held a dialogue.
[sound:s-1894_彼らは地位を争っています。.mp3]	(<b>争う</b>) 彼らは地位を争っています。<br>  They are competing for the position. <br>	
反	[sound:k-1905_反.mp3]<br>たん <br> variable measure of fabric (28.8 cm in width), for kimonos: at least 10 m in length, for haori: at least 7.27 m in length, for other clothes: at least 6.06 m in length; 300 tsubo (991.74 meters square, 0.24506 acres); six ken (10.91 m)
variable measure of fabric (28.8 cm in width), for kimonos: at least 10 m in length, for haori: at least 7.27 m in length, for other clothes: at least 6.06 m in length; 300 tsubo (991.74 meters square, 0.24506 acres); six ken (10.91 m)	<b>反<b> <br> たん <br>[sound:k-1905_反.mp3]
[sound:k-1905_反.mp3]	variable measure of fabric<br> <b>28.8 cm in width), for kimonos: at least 10 m in length, for haori: at least 7.27 m in length, for other clothes: at least 6.06 m in length; 300 tsubo (991.74 meters square, 0.24506 acres); six ken (10.91 m) (反</b> <br> (たん)
(<b>座談会</b>) 昨日の座談会で多くのアイデアが出ました。    	[sound:s-1905_昨日の座談会で多くのアイデアが出ました。.mp3] <br> Many ideas came up during yesterday's informal discussion.
[sound:s-1895_太平洋戦争は日本の歴史上重要な出来事です。.mp3]	(<b>太平洋戦争</b>) 	太平洋戦争は日本の歴史上重要な出来事です。    The Pacific War is an important event in Japanese history. <br>
反響	[sound:k-1906_反響.mp3]<br>はんきょう <br> echo, reverberation, repercussion, reaction, influence
echo, reverberation, repercussion, reaction, influence	<b>反響<b> <br> はんきょう <br>[sound:k-1906_反響.mp3]
[sound:k-1906_反響.mp3]	echo, reverberation, repercussion, reaction, influence<br> <b>反響</b> <br> (はんきょう)
(<b>能</b>) 彼は芸能に秀でています。    	[sound:s-1906_彼は芸能に秀でています。.mp3] <br> He excels in the performing arts.
[sound:s-1896_政治家たちは会談を行います。.mp3]	(<b>会談</b>) 	政治家たちは会談を行います。    Politicians hold talks. <br>
反撃	[sound:k-1907_反撃.mp3]<br>はんげき <br> counterattack, counteroffensive, counterblow
counterattack, counteroffensive, counterblow	<b>反撃<b> <br> はんげき <br>[sound:k-1907_反撃.mp3]
[sound:k-1907_反撃.mp3]	counterattack, counteroffensive, counterblow<br> <b>反撃</b> <br> (はんげき)
(<b>可能</b>) それは可能なことですか？    	[sound:s-1907_それは可能なことですか？.mp3] <br> Is that possible?
[sound:s-1897_彼に相談したほうがいいです。.mp3]	(<b>相談</b>) 	彼に相談したほうがいいです。    You should consult with him. <br>
減反	[sound:k-1908_減反.mp3]<br>げんたん <br> reduction (of crop size), reduction of acreage (under cultivation)
reduction (of crop size), reduction of acreage (under cultivation)	<b>減反<b> <br> げんたん <br>[sound:k-1908_減反.mp3]
[sound:k-1908_減反.mp3]	reduction<br> <b>of crop size), reduction of acreage (under cultivation) (減反</b> <br> (げんたん)
(<b>可能性</b>) その計画の実現可能性を検討しています。    	[sound:s-1908_その計画の実現可能性を検討しています。.mp3] <br> We are considering the feasibility of the plan.
[sound:s-1898_昨日、親睦を深めるために懇談会が開かれました。.mp3]	(<b>懇談</b>) 	昨日、親睦を深めるために懇談会が開かれました。    Yesterday, a friendly discussion was held to strengthen bonds. <br>
反戦	[sound:k-1909_反戦.mp3]<br>はんせん <br> anti-war
anti-war	<b>反戦<b> <br> はんせん <br>[sound:k-1909_反戦.mp3]
[sound:k-1909_反戦.mp3]	anti-war<br> <b>反戦</b> <br> (はんせん)
(<b>機能</b>) このアプリの機能は非常に便利です。    	[sound:s-1909_このアプリの機能は非常に便利です。.mp3] <br> The features of this app are very useful.
[sound:s-1899_その契約は談合の結果です。.mp3]	(<b>談合</b>) 	その契約は談合の結果です。    The contract is the result of collusion. <br>
元	[sound:k-1910_元.mp3]<br>もと <br> origin, source; base, foundation; cause; ingredient; (somebody's) side, (somebody's) location; original cost (or capital, principal, etc.); trunk; first section of a waka; counter for blades of grass, tree trunks, etc., and for falcons (in falconry)
origin, source; base, foundation; cause; ingredient; (somebody's) side, (somebody's) location; original cost (or capital, principal, etc.); trunk; first section of a waka; counter for blades of grass, tree trunks, etc., and for falcons (in falconry)	<b>元<b> <br> もと <br>[sound:k-1910_元.mp3]
[sound:k-1910_元.mp3]	origin, source; base, foundation; cause; ingredient;<br> <b>somebody's) side, (somebody's) location; original cost (or capital, principal, etc.); trunk; first section of a waka; counter for blades of grass, tree trunks, etc., and for falcons (in falconry) (元</b> <br> (もと)
(<b>能力</b>) 彼女は優れたリーダーシップ能力を持っています。    	[sound:s-1910_彼女は優れたリーダーシップ能力を持っています。.mp3] <br> She has excellent leadership skills.
[sound:s-1900_彼は私たちの相談役です。.mp3]	(<b>相談役</b>) 	彼は私たちの相談役です。    He is our advisor. <br>
地元	[sound:k-1911_地元.mp3]<br>じもと <br> home area, home town; local
home area, home town; local	<b>地元<b> <br> じもと <br>[sound:k-1911_地元.mp3]
[sound:k-1911_地元.mp3]	home area, home town; local<br> <b>地元</b> <br> (じもと)
(<b>芸能</b>) 彼は芸能界で成功しました。    	[sound:s-1911_彼は芸能界で成功しました。.mp3] <br> He succeeded in the entertainment industry.
[sound:s-1901_彼らは楽しい談話を交わしました。.mp3]	(<b>談話</b>) 	彼らは楽しい談話を交わしました。    They exchanged pleasant conversation. <br>
元首	[sound:k-1912_元首.mp3]<br>げんしゅ <br> ruler, sovereign
ruler, sovereign	<b>元首<b> <br> げんしゅ <br>[sound:k-1912_元首.mp3]
[sound:k-1912_元首.mp3]	ruler, sovereign<br> <b>元首</b> <br> (げんしゅ)
(<b>不可能</b>) それは不可能なことです。    	[sound:s-1912_それは不可能なことです。.mp3] <br> That's impossible.
[sound:s-1902_彼の冗談はいつも面白いです。.mp3]	(<b>冗談</b>) 	彼の冗談はいつも面白いです。    His jokes are always funny. <br>
元気	[sound:k-1913_元気.mp3]<br>げんき <br> health(y), robust, vigor, vigour, energy, vitality, vim, stamina, spirit, courage, pep
health(y), robust, vigor, vigour, energy, vitality, vim, stamina, spirit, courage, pep	<b>元気<b> <br> げんき <br>[sound:k-1913_元気.mp3]
[sound:k-1913_元気.mp3]	health(y), robust, vigor, vigour, energy, vitality, vim, stamina, spirit, courage, pep<br> <b>元気</b> <br> (げんき)
(<b>放射能</b>) 放射能の影響を心配しています。    	[sound:s-1913_放射能の影響を心配しています。.mp3] <br> We are concerned about the effects of radiation.
[sound:s-1903_今日は大切な商談があります。.mp3]	(<b>商談</b>) 	今日は大切な商談があります。    There is an important business negotiation today. <br>
元日	[sound:k-1914_元日.mp3]<br>がんじつ, がんにち <br> New Year's Day
New Year's Day	<b>元日<b> <br> がんじつ, がんにち <br>[sound:k-1914_元日.mp3]
[sound:k-1914_元日.mp3]	New Year's Day<br> <b>元日</b> <br> (がんじつ, がんにち)
(<b>才能</b>) 彼は音楽の才能があります。    	[sound:s-1914_彼は音楽の才能があります。.mp3] <br> He has a talent for music.
[sound:s-1904_二人の著名人が対談しました。.mp3]	(<b>対談</b>) 	二人の著名人が対談しました。    Two prominent figures held a dialogue. <br>
身元	[sound:k-1915_身元.mp3]<br>みもと <br> person's identity, ID, past, background
person's identity, ID, past, background	<b>身元<b> <br> みもと <br>[sound:k-1915_身元.mp3]
[sound:k-1915_身元.mp3]	person's identity, ID, past, background<br> <b>身元</b> <br> (みもと)
(<b>性能</b>) この機械の性能は高いです。    	[sound:s-1915_この機械の性能は高いです。.mp3] <br> The performance of this machine is high.
[sound:s-1905_昨日の座談会で多くのアイデアが出ました。.mp3]	(<b>座談会</b>) 	昨日の座談会で多くのアイデアが出ました。    Many ideas came up during yesterday's informal discussion. <br>
足元	[sound:k-1916_足元.mp3]<br>あしもと, そっか <br> at one's feet, underfoot; gait, pace, step; you, thou
at one's feet, underfoot; gait, pace, step; you, thou	<b>足元<b> <br> あしもと, そっか <br>[sound:k-1916_足元.mp3]
[sound:k-1916_足元.mp3]	at one's feet, underfoot; gait, pace, step; you, thou<br> <b>足元</b> <br> (あしもと, そっか)
(<b>無料</b>) このアプリは無料でダウンロードできます。	[sound:s-1916_このアプリは無料でダウンロードできます。.mp3] <br> This app can be downloaded for free.
[sound:s-1906_彼は芸能に秀でています。.mp3]	(<b>能</b>) 	彼は芸能に秀でています。    He excels in the performing arts. <br>
還元	[sound:k-1917_還元.mp3]<br>かんげん <br> resolution, reduction, return to origins
resolution, reduction, return to origins	<b>還元<b> <br> かんげん <br>[sound:k-1917_還元.mp3]
[sound:k-1917_還元.mp3]	resolution, reduction, return to origins<br> <b>還元</b> <br> (かんげん)
(<b>無職</b>) 彼は現在無職です。	[sound:s-1917_彼は現在無職です。.mp3] <br> He is currently unemployed.
[sound:s-1907_それは可能なことですか？.mp3]	(<b>可能</b>) 	それは可能なことですか？    Is that possible? <br>
元年	[sound:k-1918_元年.mp3]<br>がんねん <br> first year (of a specific reign)
first year (of a specific reign)	<b>元年<b> <br> がんねん <br>[sound:k-1918_元年.mp3]
[sound:k-1918_元年.mp3]	first year<br> <b>of a specific reign) (元年</b> <br> (がんねん)
(<b>無所属</b>) 彼は政党に無所属です。	[sound:s-1918_彼は政党に無所属です。.mp3] <br> He is not affiliated with any political party.
[sound:s-1908_その計画の実現可能性を検討しています。.mp3]	(<b>可能性</b>) 	その計画の実現可能性を検討しています。    We are considering the feasibility of the plan. <br>
次元	[sound:k-1919_次元.mp3]<br>じげん <br> dimension; perspective, point of reference, level (of something)
dimension; perspective, point of reference, level (of something)	<b>次元<b> <br> じげん <br>[sound:k-1919_次元.mp3]
[sound:k-1919_次元.mp3]	dimension; perspective, point of reference, level<br> <b>of something) (次元</b> <br> (じげん)
(<b>無罪</b>) 彼は無罪とされました。	[sound:s-1919_彼は無罪とされました。.mp3] <br> He was acquitted.
[sound:s-1909_このアプリの機能は非常に便利です。.mp3]	(<b>機能</b>) 	このアプリの機能は非常に便利です。    The features of this app are very useful. <br>
重さ	[sound:k-1920_重さ.mp3]<br>おもさ <br> weight
weight	<b>重さ<b> <br> おもさ <br>[sound:k-1920_重さ.mp3]
[sound:k-1920_重さ.mp3]	weight<br> <b>重さ</b> <br> (おもさ)
(<b>無理</b>) それは無理な要求です。	[sound:s-1920_それは無理な要求です。.mp3] <br> That's an unreasonable demand.
[sound:s-1910_彼女は優れたリーダーシップ能力を持っています。.mp3]	(<b>能力</b>) 	彼女は優れたリーダーシップ能力を持っています。    She has excellent leadership skills. <br>
重要	[sound:k-1921_重要.mp3]<br>じゅうよう <br> important, momentous, essential, principal, major
important, momentous, essential, principal, major	<b>重要<b> <br> じゅうよう <br>[sound:k-1921_重要.mp3]
[sound:k-1921_重要.mp3]	important, momentous, essential, principal, major<br> <b>重要</b> <br> (じゅうよう)
(<b>無線</b>) 無線で通信することができます。	[sound:s-1921_無線で通信することができます。.mp3] <br> Communication can be done wirelessly.
[sound:s-1911_彼は芸能界で成功しました。.mp3]	(<b>芸能</b>) 	彼は芸能界で成功しました。    He succeeded in the entertainment industry. <br>
重大	[sound:k-1922_重大.mp3]<br>じゅうだい <br> serious, important, significant, grave, weighty
serious, important, significant, grave, weighty	<b>重大<b> <br> じゅうだい <br>[sound:k-1922_重大.mp3]
[sound:k-1922_重大.mp3]	serious, important, significant, grave, weighty<br> <b>重大</b> <br> (じゅうだい)
(<b>無効</b>) その契約は無効です。	[sound:s-1922_その契約は無効です。.mp3] <br> That contract is invalid.
[sound:s-1912_それは不可能なことです。.mp3]	(<b>不可能</b>) 	それは不可能なことです。    That's impossible. <br>
重み	[sound:k-1923_重み.mp3]<br>おもみ <br> importance, weight, dignity, emphasis
importance, weight, dignity, emphasis	<b>重み<b> <br> おもみ <br>[sound:k-1923_重み.mp3]
[sound:k-1923_重み.mp3]	importance, weight, dignity, emphasis<br> <b>重み</b> <br> (おもみ)
(<b>無償</b>) 彼らは無償でボランティア活動を行っています。	[sound:s-1923_彼らは無償でボランティア活動を行っています。.mp3] <br> They are volunteering without compensation.
[sound:s-1913_放射能の影響を心配しています。.mp3]	(<b>放射能</b>) 	放射能の影響を心配しています。    We are concerned about the effects of radiation. <br>
貴重	[sound:k-1924_貴重.mp3]<br>きちょう <br> precious, valuable
precious, valuable	<b>貴重<b> <br> きちょう <br>[sound:k-1924_貴重.mp3]
[sound:k-1924_貴重.mp3]	precious, valuable<br> <b>貴重</b> <br> (きちょう)
(<b>有無</b>) その商品の有無を確認してください。	[sound:s-1924_その商品の有無を確認してください。.mp3] <br> Please check for the availability of the item.
[sound:s-1914_彼は音楽の才能があります。.mp3]	(<b>才能</b>) 	彼は音楽の才能があります。    He has a talent for music. <br>
重ねる	[sound:k-1925_重ねる.mp3]<br>かさねる <br> to pile up, to put something on another, to heap up, to add, to repeat
to pile up, to put something on another, to heap up, to add, to repeat	<b>重ねる<b> <br> かさねる <br>[sound:k-1925_重ねる.mp3]
[sound:k-1925_重ねる.mp3]	to pile up, to put something on another, to heap up, to add, to repeat<br> <b>重ねる</b> <br> (かさねる)
(<b>無死</b>) その試合では無死満塁の状況が続いていました。	[sound:s-1925_その試合では無死満塁の状況が続いていました。.mp3] <br> "In that game, there was a bases-loaded situation with no outs."
[sound:s-1915_この機械の性能は高いです。.mp3]	(<b>性能</b>) 	この機械の性能は高いです。    The performance of this machine is high. <br>
重視	[sound:k-1926_重視.mp3]<br>じゅうし <br> importance, stress, serious consideration
importance, stress, serious consideration	<b>重視<b> <br> じゅうし <br>[sound:k-1926_重視.mp3]
[sound:k-1926_重視.mp3]	importance, stress, serious consideration<br> <b>重視</b> <br> (じゅうし)
(<b>再び</b>) 彼は再び挑戦することを決意しました。	[sound:s-1926_彼は再び挑戦することを決意しました。.mp3] <br> He decided to challenge again.
[sound:s-1916_このアプリは無料でダウンロードできます。.mp3]	(<b>無料</b>) このアプリは無料でダウンロードできます。<br> This app can be downloaded for free. <br>	
重点	[sound:k-1927_重点.mp3]<br>じゅうてん <br> important point, lay stress on, colon, emphasis
important point, lay stress on, colon, emphasis	<b>重点<b> <br> じゅうてん <br>[sound:k-1927_重点.mp3]
[sound:k-1927_重点.mp3]	important point, lay stress on, colon, emphasis<br> <b>重点</b> <br> (じゅうてん)
(<b>再開</b>) 会議は明日再開されます。	[sound:s-1927_会議は明日再開されます。.mp3] <br> The meeting will resume tomorrow.
[sound:s-1917_彼は現在無職です。.mp3]	(<b>無職</b>) 彼は現在無職です。<br> He is currently unemployed. <br>	
慎重	[sound:k-1928_慎重.mp3]<br>しんちょう <br> discretion, prudence, caution, care
discretion, prudence, caution, care	<b>慎重<b> <br> しんちょう <br>[sound:k-1928_慎重.mp3]
[sound:k-1928_慎重.mp3]	discretion, prudence, caution, care<br> <b>慎重</b> <br> (しんちょう)
(<b>再建</b>) 被災地の再建が進んでいます。	[sound:s-1928_被災地の再建が進んでいます。.mp3] <br> Reconstruction of the disaster area is progressing.
[sound:s-1918_彼は政党に無所属です。.mp3]	(<b>無所属</b>) 彼は政党に無所属です。<br> He is not affiliated with any political party. <br>	
体重	[sound:k-1929_体重.mp3]<br>たいじゅう <br> one's body weight
one's body weight	<b>体重<b> <br> たいじゅう <br>[sound:k-1929_体重.mp3]
[sound:k-1929_体重.mp3]	one's body weight<br> <b>体重</b> <br> (たいじゅう)
(<b>再編</b>) 会社は組織の再編を行いました。	[sound:s-1929_会社は組織の再編を行いました。.mp3] <br> The company underwent organizational restructuring.
[sound:s-1919_彼は無罪とされました。.mp3]	(<b>無罪</b>) 彼は無罪とされました。<br> He was acquitted. <br>	
最近	[sound:k-1930_最近.mp3]<br>さいきん <br> latest, most recent, nowadays
latest, most recent, nowadays	<b>最近<b> <br> さいきん <br>[sound:k-1930_最近.mp3]
[sound:k-1930_最近.mp3]	latest, most recent, nowadays<br> <b>最近</b> <br> (さいきん)
(<b>再生</b>) このプロジェクトは地域の活性化を目指して再生を図っています。	[sound:s-1930_このプロジェクトは地域の活性化を目指して再生を図っています。.mp3] <br> This project aims to revitalize the region.
[sound:s-1920_それは無理な要求です。.mp3]	(<b>無理</b>) それは無理な要求です。<br> That's an unreasonable demand. <br>	
近代	[sound:k-1931_近代.mp3]<br>きんだい <br> present day, modern times
present day, modern times	<b>近代<b> <br> きんだい <br>[sound:k-1931_近代.mp3]
[sound:k-1931_近代.mp3]	present day, modern times<br> <b>近代</b> <br> (きんだい)
(<b>再三</b>) 彼は再三警告されましたが、改善しなかった。	[sound:s-1931_彼は再三警告されましたが、改善しなかった。.mp3] <br> He was warned repeatedly but didn't improve.
[sound:s-1921_無線で通信することができます。.mp3]	(<b>無線</b>) 無線で通信することができます。<br> Communication can be done wirelessly. <br>	
付近	[sound:k-1932_付近.mp3]<br>ふきん <br> neighbourhood, neighborhood, vicinity, environs; approaching
neighbourhood, neighborhood, vicinity, environs; approaching	<b>付近<b> <br> ふきん <br>[sound:k-1932_付近.mp3]
[sound:k-1932_付近.mp3]	neighbourhood, neighborhood, vicinity, environs; approaching<br> <b>付近</b> <br> (ふきん)
(<b>再発</b>) その病気は再発する可能性があります。	[sound:s-1932_その病気は再発する可能性があります。.mp3] <br> There is a possibility of the illness recurring.
[sound:s-1922_その契約は無効です。.mp3]	(<b>無効</b>) その契約は無効です。<br> That contract is invalid. <br>	
近鉄	[sound:k-1933_近鉄.mp3]<br>きんてつ <br> Kinki Nippon Tetsudou (railway co.)
Kinki Nippon Tetsudou (railway co.)	<b>近鉄<b> <br> きんてつ <br>[sound:k-1933_近鉄.mp3]
[sound:k-1933_近鉄.mp3]	Kinki Nippon Tetsudou<br> <b>railway co.) (近鉄</b> <br> (きんてつ)
(<b>再選</b>) 彼は再選されました。	[sound:s-1933_彼は再選されました。.mp3] <br> He was re-elected.
[sound:s-1923_彼らは無償でボランティア活動を行っています。.mp3]	(<b>無償</b>) 彼らは無償でボランティア活動を行っています。<br> They are volunteering without compensation. <br>	
側近	[sound:k-1934_側近.mp3]<br>そっきん <br> close associate, close aide, brains-truster
close associate, close aide, brains-truster	<b>側近<b> <br> そっきん <br>[sound:k-1934_側近.mp3]
[sound:k-1934_側近.mp3]	close associate, close aide, brains-truster<br> <b>側近</b> <br> (そっきん)
(<b>再検討</b>) その提案は再検討する必要があります。	[sound:s-1934_その提案は再検討する必要があります。.mp3] <br> The proposal needs to be reconsidered.
[sound:s-1924_その商品の有無を確認してください。.mp3]	(<b>有無</b>) その商品の有無を確認してください。<br> Please check for the availability of the item. <br>	
近所	[sound:k-1935_近所.mp3]<br>きんじょ <br> neighbourhood, neighborhood
neighbourhood, neighborhood	<b>近所<b> <br> きんじょ <br>[sound:k-1935_近所.mp3]
[sound:k-1935_近所.mp3]	neighbourhood, neighborhood<br> <b>近所</b> <br> (きんじょ)
(<b>再度</b>) 再度チャレンジしてみましょう。	[sound:s-1935_再度チャレンジしてみましょう。.mp3] <br> Let's try again.
[sound:s-1925_その試合では無死満塁の状況が続いていました。.mp3]	(<b>無死</b>) その試合では無死満塁の状況が続いていました。<br> In that game, there was a bases-loaded situation with no outs. <br>	
近年	[sound:k-1936_近年.mp3]<br>きんねん <br> recent years
recent years	<b>近年<b> <br> きんねん <br>[sound:k-1936_近年.mp3]
[sound:k-1936_近年.mp3]	recent years<br> <b>近年</b> <br> (きんねん)
(<b>上位</b>) その選手は大会で上位に入りました。	[sound:s-1936_その選手は大会で上位に入りました。.mp3] <br> That player placed high in the competition.
[sound:s-1926_彼は再び挑戦することを決意しました。.mp3]	(<b>再び</b>) 彼は再び挑戦することを決意しました。<br> He decided to challenge again. <br>	
近畿	[sound:k-1937_近畿.mp3]<br>きんき <br> Kinki (region around Osaka, Kyoto, Nara)
Kinki (region around Osaka, Kyoto, Nara)	<b>近畿<b> <br> きんき <br>[sound:k-1937_近畿.mp3]
[sound:k-1937_近畿.mp3]	Kinki<br> <b>region around Osaka, Kyoto, Nara) (近畿</b> <br> (きんき)
(<b>単位</b>) 大学で十分な単位を取る必要があります。	[sound:s-1937_大学で十分な単位を取る必要があります。.mp3] <br> You need to earn enough credits in university.
[sound:s-1927_会議は明日再開されます。.mp3]	(<b>再開</b>) 会議は明日再開されます。<br> The meeting will resume tomorrow. <br>	
近郊	[sound:k-1938_近郊.mp3]<br>きんこう <br> suburbs, outskirts
suburbs, outskirts	<b>近郊<b> <br> きんこう <br>[sound:k-1938_近郊.mp3]
[sound:k-1938_近郊.mp3]	suburbs, outskirts<br> <b>近郊</b> <br> (きんこう)
(<b>地位</b>) 彼は社会的な地位を高めた。	[sound:s-1938_彼は社会的な地位を高めた。.mp3] <br> He elevated his social status.
[sound:s-1928_被災地の再建が進んでいます。.mp3]	(<b>再建</b>) 被災地の再建が進んでいます。<br> Reconstruction of the disaster area is progressing. <br>	
近隣	[sound:k-1939_近隣.mp3]<br>きんりん <br> neighbourhood, neighborhood, vicinity
neighbourhood, neighborhood, vicinity	<b>近隣<b> <br> きんりん <br>[sound:k-1939_近隣.mp3]
[sound:k-1939_近隣.mp3]	neighbourhood, neighborhood, vicinity<br> <b>近隣</b> <br> (きんりん)
(<b>首位</b>) 彼らはリーグで首位を維持しています。	[sound:s-1939_彼らはリーグで首位を維持しています。.mp3] <br> They are maintaining first place in the league.
[sound:s-1929_会社は組織の再編を行いました。.mp3]	(<b>再編</b>) 会社は組織の再編を行いました。<br> The company underwent organizational restructuring. <br>	
千	[sound:k-1940_千.mp3]<br>せん, ち <br> 1,000, thousand
1,000, thousand	<b>千<b> <br> せん, ち <br>[sound:k-1940_千.mp3]
[sound:k-1940_千.mp3]	1,000, thousand<br> <b>千</b> <br> (せん, ち)
(<b>一位</b>) 彼はレースで一位になりました。	[sound:s-1940_彼はレースで一位になりました。.mp3] <br> He came in first place in the race.
[sound:s-1930_このプロジェクトは地域の活性化を目指して再生を図っています。.mp3]	(<b>再生</b>) このプロジェクトは地域の活性化を目指して再生を図っています。<br> This project aims to revitalize the region. <br>	
三千	[sound:k-1941_三千.mp3]<br>さんぜん <br> 3000; many
3000; many	<b>三千<b> <br> さんぜん <br>[sound:k-1941_三千.mp3]
[sound:k-1941_三千.mp3]	3000; many<br> <b>三千</b> <br> (さんぜん)
(<b>位置</b>) 彼女は地図で自分の位置を確認しました。	[sound:s-1941_彼女は地図で自分の位置を確認しました。.mp3] <br> She checked her position on the map.
[sound:s-1931_彼は再三警告されましたが、改善しなかった。.mp3]	(<b>再三</b>) 彼は再三警告されましたが、改善しなかった。<br> He was warned repeatedly but didn't improve. <br>	
四千	[sound:k-1942_四千.mp3]<br>よんせん <br> four thousand
four thousand	<b>四千<b> <br> よんせん <br>[sound:k-1942_四千.mp3]
[sound:k-1942_四千.mp3]	four thousand<br> <b>四千</b> <br> (よんせん)
(<b>順位</b>) 彼らは大会で上位に入ることを目指しています。	[sound:s-1942_彼らは大会で上位に入ることを目指しています。.mp3] <br> They are aiming to place high in the competition.
[sound:s-1932_その病気は再発する可能性があります。.mp3]	(<b>再発</b>) その病気は再発する可能性があります。<br> There is a possibility of the illness recurring. <br>	
千代	[sound:k-1943_千代.mp3]<br>せんだい, ちよ <br> thousand years; very long period, forever
thousand years; very long period, forever	<b>千代<b> <br> せんだい, ちよ <br>[sound:k-1943_千代.mp3]
[sound:k-1943_千代.mp3]	thousand years; very long period, forever<br> <b>千代</b> <br> (せんだい, ちよ)
(<b>下位</b>) 彼のチームは下位に沈んでいます。	[sound:s-1943_彼のチームは下位に沈んでいます。.mp3] <br> His team is sinking to the bottom.
[sound:s-1933_彼は再選されました。.mp3]	(<b>再選</b>) 彼は再選されました。<br> He was re-elected. <br>	
千里	[sound:k-1944_千里.mp3]<br>せんり <br> 1000 ri, (a) long distance
1000 ri, (a) long distance	<b>千里<b> <br> せんり <br>[sound:k-1944_千里.mp3]
[sound:k-1944_千里.mp3]	1000 ri,<br> <b>a) long distance (千里</b> <br> (せんり)
(<b>本位</b>) 彼は仕事に対して真面目な本位です。	[sound:s-1944_彼は仕事に対して真面目な本位です。.mp3] <br> He has a serious attitude towards work.
[sound:s-1934_その提案は再検討する必要があります。.mp3]	(<b>再検討</b>) その提案は再検討する必要があります。<br> The proposal needs to be reconsidered. <br>	
千秋楽	[sound:k-1945_千秋楽.mp3]<br>せんしゅうらく <br> concluding festivities, final day of a sumo tournament, concluding program, concluding programme
concluding festivities, final day of a sumo tournament, concluding program, concluding programme	<b>千秋楽<b> <br> せんしゅうらく <br>[sound:k-1945_千秋楽.mp3]
[sound:k-1945_千秋楽.mp3]	concluding festivities, final day of a sumo tournament, concluding program, concluding programme<br> <b>千秋楽</b> <br> (せんしゅうらく)
(<b>優位</b>) 彼はその分野で優位を保っています。	[sound:s-1945_彼はその分野で優位を保っています。.mp3] <br> He maintains superiority in that field.
[sound:s-1935_再度チャレンジしてみましょう。.mp3]	(<b>再度</b>) 再度チャレンジしてみましょう。<br> Let's try again. <br>	
千島	[sound:k-1946_千島.mp3]<br>ちしま <br> Kurile Islands
Kurile Islands	<b>千島<b> <br> ちしま <br>[sound:k-1946_千島.mp3]
[sound:k-1946_千島.mp3]	Kurile Islands<br> <b>千島</b> <br> (ちしま)
(<b>措置</b>) 政府は緊急の措置を取りました。	[sound:s-1946_政府は緊急の措置を取りました。.mp3] <br> The government took emergency measures.
[sound:s-1936_その選手は大会で上位に入りました。.mp3]	(<b>上位</b>) その選手は大会で上位に入りました。<br> That player placed high in the competition. <br>	
千歳	[sound:k-1947_千歳.mp3]<br>ちとせ, せんねん <br> millennium, one thousand years
millennium, one thousand years	<b>千歳<b> <br> ちとせ, せんねん <br>[sound:k-1947_千歳.mp3]
[sound:k-1947_千歳.mp3]	millennium, one thousand years<br> <b>千歳</b> <br> (ちとせ, せんねん)
(<b>設置</b>) 新しい監視カメラが公園に設置されました。	[sound:s-1947_新しい監視カメラが公園に設置されました。.mp3] <br> New surveillance cameras have been installed in the park.
[sound:s-1937_大学で十分な単位を取る必要があります。.mp3]	(<b>単位</b>) 大学で十分な単位を取る必要があります。<br> You need to earn enough credits in university. <br>	
千九百年代	[sound:k-1948_千九百年代.mp3]<br>せんきゅうひゃくねんだい <br> the 1900s
the 1900s	<b>千九百年代<b> <br> せんきゅうひゃくねんだい <br>[sound:k-1948_千九百年代.mp3]
[sound:k-1948_千九百年代.mp3]	the 1900s<br> <b>千九百年代</b> <br> (せんきゅうひゃくねんだい)
(<b>装置</b>) その装置は自動的に動作します。	[sound:s-1948_その装置は自動的に動作します。.mp3] <br> That device operates automatically.
[sound:s-1938_彼は社会的な地位を高めた。.mp3]	(<b>地位</b>) 彼は社会的な地位を高めた。<br> He elevated his social status. <br>	
何千	[sound:k-1949_何千.mp3]<br>なんぜん <br> many thousands
many thousands	<b>何千<b> <br> なんぜん <br>[sound:k-1949_何千.mp3]
[sound:k-1949_何千.mp3]	many thousands<br> <b>何千</b> <br> (なんぜん)
(<b>配置</b>) 家具の配置を変えることで部屋が広く見えます。	[sound:s-1949_家具の配置を変えることで部屋が広く見えます。.mp3] <br> Changing the arrangement of furniture makes the room look more spacious.
[sound:s-1939_彼らはリーグで首位を維持しています。.mp3]	(<b>首位</b>) 彼らはリーグで首位を維持しています。<br> They are maintaining first place in the league. <br>	
考え	[sound:k-1950_考え.mp3]<br>かんがえ <br> thinking, thought, ideas, intention
thinking, thought, ideas, intention	<b>考え<b> <br> かんがえ <br>[sound:k-1950_考え.mp3]
[sound:k-1950_考え.mp3]	thinking, thought, ideas, intention<br> <b>考え</b> <br> (かんがえ)
(<b>拘置</b>) 彼は容疑のもとで拘置されました。	[sound:s-1950_彼は容疑のもとで拘置されました。.mp3] <br> He was detained on suspicion.
[sound:s-1940_彼はレースで一位になりました。.mp3]	(<b>一位</b>) 彼はレースで一位になりました。<br> He came in first place in the race. <br>	
考え方	[sound:k-1951_考え方.mp3]<br>かんがえかた <br> way of thinking
way of thinking	<b>考え方<b> <br> かんがえかた <br>[sound:k-1951_考え方.mp3]
[sound:k-1951_考え方.mp3]	way of thinking<br> <b>考え方</b> <br> (かんがえかた)
(<b>処置</b>) その怪我に適切な処置を行いました。	[sound:s-1951_その怪我に適切な処置を行いました。.mp3] <br> Proper treatment was administered to the injury.
[sound:s-1941_彼女は地図で自分の位置を確認しました。.mp3]	(<b>位置</b>) 彼女は地図で自分の位置を確認しました。<br> She checked her position on the map. <br>	
参考	[sound:k-1952_参考.mp3]<br>さんこう <br> reference, consultation
reference, consultation	<b>参考<b> <br> さんこう <br>[sound:k-1952_参考.mp3]
[sound:k-1952_参考.mp3]	reference, consultation<br> <b>参考</b> <br> (さんこう)
(<b>拘置所</b>) 彼は拘置所に収監されました。	[sound:s-1952_彼は拘置所に収監されました。.mp3] <br> He was incarcerated in the detention center.
[sound:s-1942_彼らは大会で上位に入ることを目指しています。.mp3]	(<b>順位</b>) 彼らは大会で上位に入ることを目指しています。<br> They are aiming to place high in the competition. <br>	
選考	[sound:k-1953_選考.mp3]<br>せんこう <br> selection, screening
selection, screening	<b>選考<b> <br> せんこう <br>[sound:k-1953_選考.mp3]
[sound:k-1953_選考.mp3]	selection, screening<br> <b>選考</b> <br> (せんこう)
(<b>据え置き</b>) テレビを据え置き型から壁掛け型に変えました。	[sound:s-1953_テレビを据え置き型から壁掛け型に変えました。.mp3] <br> I changed the TV from a stand-alone to a wall-mounted model.
[sound:s-1943_彼のチームは下位に沈んでいます。.mp3]	(<b>下位</b>) 彼のチームは下位に沈んでいます。<br> His team is sinking to the bottom. <br>	
考える	[sound:k-1954_考える.mp3]<br>かんがえる <br> to consider, to think about
to consider, to think about	<b>考える<b> <br> かんがえる <br>[sound:k-1954_考える.mp3]
[sound:k-1954_考える.mp3]	to consider, to think about<br> <b>考える</b> <br> (かんがえる)
(<b>位置付け</b>) その商品の市場での位置付けが重要です。	[sound:s-1954_その商品の市場での位置付けが重要です。.mp3] <br> The positioning of the product in the market is important.
[sound:s-1944_彼は仕事に対して真面目な本位です。.mp3]	(<b>本位</b>) 彼は仕事に対して真面目な本位です。<br> He has a serious attitude towards work. <br>	
思考	[sound:k-1955_思考.mp3]<br>しこう <br> thought, consideration, thinking
thought, consideration, thinking	<b>思考<b> <br> しこう <br>[sound:k-1955_思考.mp3]
[sound:k-1955_思考.mp3]	thought, consideration, thinking<br> <b>思考</b> <br> (しこう)
(<b>企業</b>) その地域には多くの大手企業があります。	[sound:s-1955_その地域には多くの大手企業があります。.mp3] <br> There are many major companies in that region.
[sound:s-1945_彼はその分野で優位を保っています。.mp3]	(<b>優位</b>) 彼はその分野で優位を保っています。<br> He maintains superiority in that field. <br>	
考古学	[sound:k-1956_考古学.mp3]<br>こうこがく <br> archaeology, archeology
archaeology, archeology	<b>考古学<b> <br> こうこがく <br>[sound:k-1956_考古学.mp3]
[sound:k-1956_考古学.mp3]	archaeology, archeology<br> <b>考古学</b> <br> (こうこがく)
(<b>企画</b>) 彼は新しいプロジェクトの企画を立てています。	[sound:s-1956_彼は新しいプロジェクトの企画を立てています。.mp3] <br> He is devising a plan for a new project.
[sound:s-1946_政府は緊急の措置を取りました。.mp3]	(<b>措置</b>) 政府は緊急の措置を取りました。<br> The government took emergency measures. <br>	
考慮	[sound:k-1957_考慮.mp3]<br>こうりょ <br> consideration, taking into account
consideration, taking into account	<b>考慮<b> <br> こうりょ <br>[sound:k-1957_考慮.mp3]
[sound:k-1957_考慮.mp3]	consideration, taking into account<br> <b>考慮</b> <br> (こうりょ)
(<b>中小企業</b>) 中小企業は経済の重要な役割を果たしています。	[sound:s-1957_中小企業は経済の重要な役割を果たしています。.mp3] <br> Small and medium-sized enterprises play an important role in the economy.
[sound:s-1947_新しい監視カメラが公園に設置されました。.mp3]	(<b>設置</b>) 新しい監視カメラが公園に設置されました。<br> New surveillance cameras have been installed in the park. <br>	
再考	[sound:k-1958_再考.mp3]<br>さいこう <br> reconsideration
reconsideration	<b>再考<b> <br> さいこう <br>[sound:k-1958_再考.mp3]
[sound:k-1958_再考.mp3]	reconsideration<br> <b>再考</b> <br> (さいこう)
(<b>大企業</b>) その地域には多くの大企業が本社を構えています。	[sound:s-1958_その地域には多くの大企業が本社を構えています。.mp3] <br> Many large corporations have their headquarters in that region.
[sound:s-1948_その装置は自動的に動作します。.mp3]	(<b>装置</b>) その装置は自動的に動作します。<br> That device operates automatically. <br>	
考察	[sound:k-1959_考察.mp3]<br>こうさつ <br> consideration, inquiry, enquiry
consideration, inquiry, enquiry	<b>考察<b> <br> こうさつ <br>[sound:k-1959_考察.mp3]
[sound:k-1959_考察.mp3]	consideration, inquiry, enquiry<br> <b>考察</b> <br> (こうさつ)
(<b>経企庁</b>) 経企庁は企業の成長を支援しています。	[sound:s-1959_経企庁は企業の成長を支援しています。.mp3] <br> The Economic and Industrial Policy Bureau supports corporate growth.
[sound:s-1949_家具の配置を変えることで部屋が広く見えます。.mp3]	(<b>配置</b>) 家具の配置を変えることで部屋が広く見えます。<br> Changing the arrangement of furniture makes the room look more spacious. <br>	
裁判	[sound:k-1960_裁判.mp3]<br>さいばん <br> trial, judgement, judgment
trial, judgement, judgment	<b>裁判<b> <br> さいばん <br>[sound:k-1960_裁判.mp3]
[sound:k-1960_裁判.mp3]	trial, judgement, judgment<br> <b>裁判</b> <br> (さいばん)
(<b>経済企画庁</b>) 経済企画庁は経済政策の立案を行っています。	[sound:s-1960_経済企画庁は経済政策の立案を行っています。.mp3] <br> The Economic Planning Agency is responsible for formulating economic policies.
[sound:s-1950_彼は容疑のもとで拘置されました。.mp3]	(<b>拘置</b>) 彼は容疑のもとで拘置されました。<br> He was detained on suspicion. <br>	
判決	[sound:k-1961_判決.mp3]<br>はんけつ <br> judicial decision, judgement, judgment, sentence, decree
judicial decision, judgement, judgment, sentence, decree	<b>判決<b> <br> はんけつ <br>[sound:k-1961_判決.mp3]
[sound:k-1961_判決.mp3]	judicial decision, judgement, judgment, sentence, decree<br> <b>判決</b> <br> (はんけつ)
(<b>企業家</b>) 彼は成功した企業家です。	[sound:s-1961_彼は成功した企業家です。.mp3] <br> He is a successful entrepreneur.
[sound:s-1951_その怪我に適切な処置を行いました。.mp3]	(<b>処置</b>) その怪我に適切な処置を行いました。<br> Proper treatment was administered to the injury. <br>	
判断	[sound:k-1962_判断.mp3]<br>はんだん <br> judgement, judgment, decision, adjudication, conclusion, decipherment, divination
judgement, judgment, decision, adjudication, conclusion, decipherment, divination	<b>判断<b> <br> はんだん <br>[sound:k-1962_判断.mp3]
[sound:k-1962_判断.mp3]	judgement, judgment, decision, adjudication, conclusion, decipherment, divination<br> <b>判断</b> <br> (はんだん)
(<b>企画室</b>) このプロジェクトの企画室でアイデアを練ります。	[sound:s-1962_このプロジェクトの企画室でアイデアを練ります。.mp3] <br> We brainstorm ideas in the planning department for this project.
[sound:s-1952_彼は拘置所に収監されました。.mp3]	(<b>拘置所</b>) 彼は拘置所に収監されました。<br> He was incarcerated in the detention center. <br>	
批判	[sound:k-1963_批判.mp3]<br>ひはん <br> criticism, judgement, judgment, comment
criticism, judgement, judgment, comment	<b>批判<b> <br> ひはん <br>[sound:k-1963_批判.mp3]
[sound:k-1963_批判.mp3]	criticism, judgement, judgment, comment<br> <b>批判</b> <br> (ひはん)
(<b>私企業</b>) その会社は私企業です。	[sound:s-1963_その会社は私企業です。.mp3] <br> The company is privately owned.
[sound:s-1953_テレビを据え置き型から壁掛け型に変えました。.mp3]	(<b>据え置き</b>) テレビを据え置き型から壁掛け型に変えました。<br> I changed the TV from a stand-alone to a wall-mounted model. <br>	
公判	[sound:k-1964_公判.mp3]<br>こうはん <br> public hearing, trial
public hearing, trial	<b>公判<b> <br> こうはん <br>[sound:k-1964_公判.mp3]
[sound:k-1964_公判.mp3]	public hearing, trial<br> <b>公判</b> <br> (こうはん)
(<b>中小企業庁</b>) 中小企業庁は中小企業の支援を行っています。	[sound:s-1964_中小企業庁は中小企業の支援を行っています。.mp3] <br> The Small and Medium Enterprise Agency supports small and medium-sized enterprises.
[sound:s-1954_その商品の市場での位置付けが重要です。.mp3]	(<b>位置付け</b>) その商品の市場での位置付けが重要です。<br> The positioning of the product in the market is important. <br>	
裁判所	[sound:k-1965_裁判所.mp3]<br>さいばんしょ <br> court, courthouse
court, courthouse	<b>裁判所<b> <br> さいばんしょ <br>[sound:k-1965_裁判所.mp3]
[sound:k-1965_裁判所.mp3]	court, courthouse<br> <b>裁判所</b> <br> (さいばんしょ)
(<b>写真</b>) その写真は美しい風景を捉えています。	[sound:s-1965_その写真は美しい風景を捉えています。.mp3] <br> The photograph captures a beautiful landscape.
[sound:s-1955_その地域には多くの大手企業があります。.mp3]	(<b>企業</b>) その地域には多くの大手企業があります。<br> There are many major companies in that region. <br>	
審判	[sound:k-1966_審判.mp3]<br>しんぱん, しんばん <br> refereeing, trial, judgement, judgment, umpire, referee
refereeing, trial, judgement, judgment, umpire, referee	<b>審判<b> <br> しんぱん, しんばん <br>[sound:k-1966_審判.mp3]
[sound:k-1966_審判.mp3]	refereeing, trial, judgement, judgment, umpire, referee<br> <b>審判</b> <br> (しんぱん, しんばん)
(<b> 彼の真の目的は何ですか？	What is his true purpose?	s-1966_What is his true purpose?.mp3
[sound:s-1956_彼は新しいプロジェクトの企画を立てています。.mp3]	(<b>企画</b>) 彼は新しいプロジェクトの企画を立てています。<br> He is devising a plan for a new project. <br>	
判定	[sound:k-1967_判定.mp3]<br>はんてい <br> judgement, judgment, decision, award, verdict
judgement, judgment, decision, award, verdict	<b>判定<b> <br> はんてい <br>[sound:k-1967_判定.mp3]
[sound:k-1967_判定.mp3]	judgement, judgment, decision, award, verdict<br> <b>判定</b> <br> (はんてい)
(<b>真相</b>) 事件の真相が明らかになりました。	[sound:s-1967_事件の真相が明らかになりました。.mp3] <br> The truth behind the incident has been revealed.
[sound:s-1957_中小企業は経済の重要な役割を果たしています。.mp3]	(<b>中小企業</b>) 中小企業は経済の重要な役割を果たしています。<br> Small and medium-sized enterprises play an important role in the economy. <br>	
評判	[sound:k-1968_評判.mp3]<br>ひょうばん <br> fame, reputation, popularity; rumour (rumor), talk
fame, reputation, popularity; rumour (rumor), talk	<b>評判<b> <br> ひょうばん <br>[sound:k-1968_評判.mp3]
[sound:k-1968_評判.mp3]	fame, reputation, popularity; rumour<br> <b>rumor), talk (評判</b> <br> (ひょうばん)
(<b>真実</b>) 彼女はいつも真実を語ります。	[sound:s-1968_彼女はいつも真実を語ります。.mp3] <br> She always speaks the truth.
[sound:s-1958_その地域には多くの大企業が本社を構えています。.mp3]	(<b>大企業</b>) その地域には多くの大企業が本社を構えています。<br> Many large corporations have their headquarters in that region. <br>	
判事	[sound:k-1969_判事.mp3]<br>はんじ <br> judge, judiciary
judge, judiciary	<b>判事<b> <br> はんじ <br>[sound:k-1969_判事.mp3]
[sound:k-1969_判事.mp3]	judge, judiciary<br> <b>判事</b> <br> (はんじ)
(<b>真ん中</b>) その家の真ん中にテーブルがあります。	[sound:s-1969_その家の真ん中にテーブルがあります。.mp3] <br> There is a table in the middle of the room.
[sound:s-1959_経企庁は企業の成長を支援しています。.mp3]	(<b>経企庁</b>) 経企庁は企業の成長を支援しています。<br> The Economic and Industrial Policy Bureau supports corporate growth. <br>	
承認	[sound:k-1970_承認.mp3]<br>しょうにん <br> recognition, acknowledgement, acknowledgment, approval, consent, agreement
recognition, acknowledgement, acknowledgment, approval, consent, agreement	<b>承認<b> <br> しょうにん <br>[sound:k-1970_承認.mp3]
[sound:k-1970_承認.mp3]	recognition, acknowledgement, acknowledgment, approval, consent, agreement<br> <b>承認</b> <br> (しょうにん)
(<b>真意</b>) 彼の真意を知りたいです。	[sound:s-1970_彼の真意を知りたいです。.mp3] <br> I want to know his true intentions.
[sound:s-1960_経済企画庁は経済政策の立案を行っています。.mp3]	(<b>経済企画庁</b>) 経済企画庁は経済政策の立案を行っています。<br> The Economic Planning Agency is responsible for formulating economic policies. <br>	
認識	[sound:k-1971_認識.mp3]<br>にんしき <br> recognition, cognizance, cognisance
recognition, cognizance, cognisance	<b>認識<b> <br> にんしき <br>[sound:k-1971_認識.mp3]
[sound:k-1971_認識.mp3]	recognition, cognizance, cognisance<br> <b>認識</b> <br> (にんしき)
(<b>写真集</b>) 彼女は素晴らしい写真集を出版しました。	[sound:s-1971_彼女は素晴らしい写真集を出版しました。.mp3] <br> She published a wonderful photo album.
[sound:s-1961_彼は成功した企業家です。.mp3]	(<b>企業家</b>) 彼は成功した企業家です。<br> He is a successful entrepreneur. <br>	
確認	[sound:k-1972_確認.mp3]<br>かくにん <br> affirmation, confirmation, validation
affirmation, confirmation, validation	<b>確認<b> <br> かくにん <br>[sound:k-1972_確認.mp3]
[sound:k-1972_確認.mp3]	affirmation, confirmation, validation<br> <b>確認</b> <br> (かくにん)
