相続税	[sound:k-1409_相続税.mp3]<br>そうぞくぜい <br> inheritance tax, death duty
inheritance tax, death duty	<b>相続税<b> <br> そうぞくぜい <br>[sound:k-1409_相続税.mp3]
[sound:k-1409_相続税.mp3]	inheritance tax, death duty<br> <b>相続税</b> <br> (そうぞくぜい)
<b>水準</b> <br> 彼の仕事の水準は非常に高いです。	[sound:s-1409_彼の仕事の水準は非常に高いです。.mp3] <br> The quality of his work is very high. <br>
[sound:s-1409_彼の仕事の水準は非常に高いです。.mp3]	(<b>水準</b>) 彼の仕事の水準は非常に高いです。The quality of his work is very high. <br>
推進	[sound:k-1410_推進.mp3]<br>すいしん <br> propulsion, driving force; implementation, promotion (e.g. of a government policy)
propulsion, driving force; implementation, promotion (e.g. of a government policy)	<b>推進<b> <br> すいしん <br>[sound:k-1410_推進.mp3]
[sound:k-1410_推進.mp3]	propulsion, driving force; implementation, promotion<br> <b>e.g. of a government policy) (推進</b> <br> (すいしん)
<b>水道</b> <br> この家には良い水道設備があります。	[sound:s-1410_この家には良い水道設備があります。.mp3] <br> This house has good plumbing. <br>
[sound:s-1410_この家には良い水道設備があります。.mp3]	(<b>水道</b>) この家には良い水道設備があります。This house has good plumbing. <br>
進出	[sound:k-1411_進出.mp3]<br>しんしゅつ <br> advance, step forward
advance, step forward	<b>進出<b> <br> しんしゅつ <br>[sound:k-1411_進出.mp3]
[sound:k-1411_進出.mp3]	advance, step forward<br> <b>進出</b> <br> (しんしゅつ)
<b>水面</b> <br> 夜空には星が水面に映っていた。	[sound:s-1411_夜空には星が水面に映っていた。.mp3] <br> Stars were reflected on the water's surface in the night sky. <br>
[sound:s-1411_夜空には星が水面に映っていた。.mp3]	(<b>水面</b>) 夜空には星が水面に映っていた。Stars were reflected on the water's surface in the night sky. <br>
先進国	[sound:k-1412_先進国.mp3]<br>せんしんこく <br> advanced (developed) country, advanced nations
advanced (developed) country, advanced nations	<b>先進国<b> <br> せんしんこく <br>[sound:k-1412_先進国.mp3]
[sound:k-1412_先進国.mp3]	advanced<br> <b>developed) country, advanced nations (先進国</b> <br> (せんしんこく)
<b>水泳</b> <br> 彼女は毎日のようにプールで水泳をしています。	[sound:s-1412_彼女は毎日のようにプールで水泳をしています。.mp3] <br> She swims in the pool almost every day. <br>
[sound:s-1412_彼女は毎日のようにプールで水泳をしています。.mp3]	(<b>水泳</b>) 彼女は毎日のようにプールで水泳をしています。She swims in the pool almost every day. <br>
進展	[sound:k-1413_進展.mp3]<br>しんてん <br> progress, development
progress, development	<b>進展<b> <br> しんてん <br>[sound:k-1413_進展.mp3]
[sound:k-1413_進展.mp3]	progress, development<br> <b>進展</b> <br> (しんてん)
<b>水田</b> <br> その地域では水田が主要な農業です。	[sound:s-1413_その地域では水田が主要な農業です。.mp3] <br> Rice paddies are the main agricultural activity in that region. <br>
[sound:s-1413_その地域では水田が主要な農業です。.mp3]	(<b>水田</b>) その地域では水田が主要な農業です。Rice paddies are the main agricultural activity in that region. <br>
促進	[sound:k-1414_促進.mp3]<br>そくしん <br> promotion, acceleration, encouragement, facilitation, spurring on
promotion, acceleration, encouragement, facilitation, spurring on	<b>促進<b> <br> そくしん <br>[sound:k-1414_促進.mp3]
[sound:k-1414_促進.mp3]	promotion, acceleration, encouragement, facilitation, spurring on<br> <b>促進</b> <br> (そくしん)
<b>水俣病</b> <br> 水俣病の被害者は多くの苦しみを経験しました。	[sound:s-1414_水俣病の被害者は多くの苦しみを経験しました。.mp3] <br> Victims of Minamata disease experienced a lot of suffering. <br>
[sound:s-1414_水俣病の被害者は多くの苦しみを経験しました。.mp3]	(<b>水俣病</b>) 水俣病の被害者は多くの苦しみを経験しました。Victims of Minamata disease experienced a lot of suffering. <br>
先進	[sound:k-1415_先進.mp3]<br>せんしん <br> seniority, advance, leadership
seniority, advance, leadership	<b>先進<b> <br> せんしん <br>[sound:k-1415_先進.mp3]
[sound:k-1415_先進.mp3]	seniority, advance, leadership<br> <b>先進</b> <br> (せんしん)
<b>水産</b> <br> その地域の経済は水産業に依存しています。	[sound:s-1415_その地域の経済は水産業に依存しています。.mp3] <br> The economy of that region depends on the fishing industry. <br>
[sound:s-1415_その地域の経済は水産業に依存しています。.mp3]	(<b>水産</b>) その地域の経済は水産業に依存しています。The economy of that region depends on the fishing industry. <br>
進学	[sound:k-1416_進学.mp3]<br>しんがく <br> entering a higher-level school, esp. going on to university
entering a higher-level school, esp. going on to university	<b>進学<b> <br> しんがく <br>[sound:k-1416_進学.mp3]
[sound:k-1416_進学.mp3]	entering a higher-level school, esp. going on to university<br> <b>進学</b> <br> (しんがく)
<b>水質</b> <br> この地域の水質は非常に高いです。	[sound:s-1416_この地域の水質は非常に高いです。.mp3] <br> The water quality in this area is very high. <br>
[sound:s-1416_この地域の水質は非常に高いです。.mp3]	(<b>水質</b>) この地域の水質は非常に高いです。The water quality in this area is very high. <br>
進路	[sound:k-1417_進路.mp3]<br>しんろ <br> route, course; career, university choices, course (of future life)
route, course; career, university choices, course (of future life)	<b>進路<b> <br> しんろ <br>[sound:k-1417_進路.mp3]
[sound:k-1417_進路.mp3]	route, course; career, university choices, course<br> <b>of future life) (進路</b> <br> (しんろ)
<b>下水道</b> <br> 都市部の下水道システムは近代的です。	[sound:s-1417_都市部の下水道システムは近代的です。.mp3] <br> The sewer system in urban areas is modern. <br>
[sound:s-1417_都市部の下水道システムは近代的です。.mp3]	(<b>下水道</b>) 都市部の下水道システムは近代的です。The sewer system in urban areas is modern. <br>
前進	[sound:k-1418_前進.mp3]<br>ぜんしん <br> advance, drive, progress
advance, drive, progress	<b>前進<b> <br> ぜんしん <br>[sound:k-1418_前進.mp3]
[sound:k-1418_前進.mp3]	advance, drive, progress<br> <b>前進</b> <br> (ぜんしん)
<b>半</b> <br> ケーキを半分に切りました。	[sound:s-1418_ケーキを半分に切りました。.mp3] <br> I cut the cake in half. <br>
[sound:s-1418_ケーキを半分に切りました。.mp3]	(<b>半</b>) ケーキを半分に切りました。I cut the cake in half. <br>
昇進	[sound:k-1419_昇進.mp3]<br>しょうしん <br> promotion
promotion	<b>昇進<b> <br> しょうしん <br>[sound:k-1419_昇進.mp3]
[sound:k-1419_昇進.mp3]	promotion<br> <b>昇進</b> <br> (しょうしん)
<b>時半</b> <br> 会議は午前十時半に始まります。	[sound:s-1419_会議は午前十時半に始まります。.mp3] <br> The meeting will start at 10:30 AM. <br>
[sound:s-1419_会議は午前十時半に始まります。.mp3]	(<b>時半</b>) 会議は午前十時半に始まります。The meeting will start at 10:30 AM. <br>
正	[sound:k-1420_正.mp3]<br>せい <br> (logical) true, regular; 10^40; original
(logical) true, regular; 10^40; original	<b>正<b> <br> せい <br>[sound:k-1420_正.mp3]
[sound:k-1420_正.mp3]	(logical) true, regular; 10^40; original<br> <b>正</b> <br> (せい)
<b>後半</b> <br> 試合の後半に反撃が始まりました。	[sound:s-1420_試合の後半に反撃が始まりました。.mp3] <br> The comeback started in the second half of the game. <br>
[sound:s-1420_試合の後半に反撃が始まりました。.mp3]	(<b>後半</b>) 試合の後半に反撃が始まりました。The comeback started in the second half of the game. <br>
改正	[sound:k-1421_改正.mp3]<br>かいせい <br> revision, amendment, alteration
revision, amendment, alteration	<b>改正<b> <br> かいせい <br>[sound:k-1421_改正.mp3]
[sound:k-1421_改正.mp3]	revision, amendment, alteration<br> <b>改正</b> <br> (かいせい)
<b>半ば</b> <br> 仕事の半ばで休憩しました。	[sound:s-1421_仕事の半ばで休憩しました。.mp3] <br> We took a break halfway through the work. <br>
[sound:s-1421_仕事の半ばで休憩しました。.mp3]	(<b>半ば</b>) 仕事の半ばで休憩しました。We took a break halfway through the work. <br>
修正	[sound:k-1422_修正.mp3]<br>しゅうせい <br> amendment, correction, revision, modification, alteration, retouching, update, fix
amendment, correction, revision, modification, alteration, retouching, update, fix	<b>修正<b> <br> しゅうせい <br>[sound:k-1422_修正.mp3]
[sound:k-1422_修正.mp3]	amendment, correction, revision, modification, alteration, retouching, update, fix<br> <b>修正</b> <br> (しゅうせい)
<b>半分</b> <br> ピザを半分にカットしてください。	[sound:s-1422_ピザを半分にカットしてください。.mp3] <br> Please cut the pizza in half. <br>
[sound:s-1422_ピザを半分にカットしてください。.mp3]	(<b>半分</b>) ピザを半分にカットしてください。Please cut the pizza in half. <br>
正式	[sound:k-1423_正式.mp3]<br>せいしき <br> due form, official, formality
due form, official, formality	<b>正式<b> <br> せいしき <br>[sound:k-1423_正式.mp3]
[sound:k-1423_正式.mp3]	due form, official, formality<br> <b>正式</b> <br> (せいしき)
<b>前半</b> <br> 試合の前半は我々の優勢でした。	[sound:s-1423_試合の前半は我々の優勢でした。.mp3] <br> We dominated the first half of the game. <br>
[sound:s-1423_試合の前半は我々の優勢でした。.mp3]	(<b>前半</b>) 試合の前半は我々の優勢でした。We dominated the first half of the game. <br>
正常	[sound:k-1424_正常.mp3]<br>せいじょう <br> normalcy, normality, normal
normalcy, normality, normal	<b>正常<b> <br> せいじょう <br>[sound:k-1424_正常.mp3]
[sound:k-1424_正常.mp3]	normalcy, normality, normal<br> <b>正常</b> <br> (せいじょう)
<b>大半</b> <br> ほとんどの人がこの計画に賛成しています。	[sound:s-1424_ほとんどの人がこの計画に賛成しています。.mp3] <br> The majority of people support this plan. <br>
[sound:s-1424_ほとんどの人がこの計画に賛成しています。.mp3]	(<b>大半</b>) ほとんどの人がこの計画に賛成しています。The majority of people support this plan. <br>
是正	[sound:k-1425_是正.mp3]<br>ぜせい <br> correction, revision
correction, revision	<b>是正<b> <br> ぜせい <br>[sound:k-1425_是正.mp3]
[sound:k-1425_是正.mp3]	correction, revision<br> <b>是正</b> <br> (ぜせい)
<b>過半数</b> <br> 過半数の票を得ることが必要です。	[sound:s-1425_過半数の票を得ることが必要です。.mp3] <br> It is necessary to gain a majority of votes. <br>
[sound:s-1425_過半数の票を得ることが必要です。.mp3]	(<b>過半数</b>) 過半数の票を得ることが必要です。It is necessary to gain a majority of votes. <br>
正義	[sound:k-1426_正義.mp3]<br>せいぎ <br> justice, right, righteousness, correct meaning
justice, right, righteousness, correct meaning	<b>正義<b> <br> せいぎ <br>[sound:k-1426_正義.mp3]
[sound:k-1426_正義.mp3]	justice, right, righteousness, correct meaning<br> <b>正義</b> <br> (せいぎ)
<b>朝鮮半島</b> <br> 朝鮮半島には豊かな歴史があります。	[sound:s-1426_朝鮮半島には豊かな歴史があります。.mp3] <br> The Korean Peninsula has a rich history. <br>
[sound:s-1426_朝鮮半島には豊かな歴史があります。.mp3]	(<b>朝鮮半島</b>) 朝鮮半島には豊かな歴史があります。The Korean Peninsula has a rich history. <br>
正午	[sound:k-1427_正午.mp3]<br>しょうご <br> noon, mid-day
noon, mid-day	<b>正午<b> <br> しょうご <br>[sound:k-1427_正午.mp3]
[sound:k-1427_正午.mp3]	noon, mid-day<br> <b>正午</b> <br> (しょうご)
<b>半数</b> <br> 彼の案に半数の支持があります。	[sound:s-1427_彼の案に半数の支持があります。.mp3] <br> Half of the members support his proposal. <br>
[sound:s-1427_彼の案に半数の支持があります。.mp3]	(<b>半数</b>) 彼の案に半数の支持があります。Half of the members support his proposal. <br>
正面	[sound:k-1428_正面.mp3]<br>しょうめん <br> front, frontage, facade, main
front, frontage, facade, main	<b>正面<b> <br> しょうめん <br>[sound:k-1428_正面.mp3]
[sound:k-1428_正面.mp3]	front, frontage, facade, main<br> <b>正面</b> <br> (しょうめん)
<b>作品</b> <br> 彼女の最新の作品は高く評価されています。	[sound:s-1428_彼女の最新の作品は高く評価されています。.mp3] <br> Her latest work is highly praised. <br>
[sound:s-1428_彼女の最新の作品は高く評価されています。.mp3]	(<b>作品</b>) 彼女の最新の作品は高く評価されています。Her latest work is highly praised. <br>
不正	[sound:k-1429_不正.mp3]<br>ふせい <br> injustice, unfairness, iniquity, impropriety, irregularity, dishonesty, illegality, fraud
injustice, unfairness, iniquity, impropriety, irregularity, dishonesty, illegality, fraud	<b>不正<b> <br> ふせい <br>[sound:k-1429_不正.mp3]
[sound:k-1429_不正.mp3]	injustice, unfairness, iniquity, impropriety, irregularity, dishonesty, illegality, fraud<br> <b>不正</b> <br> (ふせい)
<b>商品</b> <br> その店は高品質の商品を扱っています。	[sound:s-1429_その店は高品質の商品を扱っています。.mp3] <br> The store deals in high-quality goods. <br>
[sound:s-1429_その店は高品質の商品を扱っています。.mp3]	(<b>商品</b>) その店は高品質の商品を扱っています。The store deals in high-quality goods. <br>
安全	[sound:k-1430_安全.mp3]<br>あんぜん <br> safety; security
safety; security	<b>安全<b> <br> あんぜん <br>[sound:k-1430_安全.mp3]
[sound:k-1430_安全.mp3]	safety; security<br> <b>安全</b> <br> (あんぜん)
<b>製品</b> <br> この製品は高性能です。	[sound:s-1430_この製品は高性能です。.mp3] <br> This product is high-performance. <br>
[sound:s-1430_この製品は高性能です。.mp3]	(<b>製品</b>) この製品は高性能です。This product is high-performance. <br>
安保	[sound:k-1431_安保.mp3]<br>あんぽ <br> US-Japan Security Treaty, safety, security
US-Japan Security Treaty, safety, security	<b>安保<b> <br> あんぽ <br>[sound:k-1431_安保.mp3]
[sound:k-1431_安保.mp3]	US-Japan Security Treaty, safety, security<br> <b>安保</b> <br> (あんぽ)
<b>食品</b> <br> 食品の安全性は重要です。	[sound:s-1431_食品の安全性は重要です。.mp3] <br> Food safety is important. <br>
[sound:s-1431_食品の安全性は重要です。.mp3]	(<b>食品</b>) 食品の安全性は重要です。Food safety is important. <br>
安全保障	[sound:k-1432_安全保障.mp3]<br>あんぜんほしょう <br> security guarantee (e.g. military security, network security, etc.)
security guarantee (e.g. military security, network security, etc.)	<b>安全保障<b> <br> あんぜんほしょう <br>[sound:k-1432_安全保障.mp3]
[sound:k-1432_安全保障.mp3]	security guarantee<br> <b>e.g. military security, network security, etc.) (安全保障</b> <br> (あんぜんほしょう)
<b>部品</b> <br> 車の部品を交換する必要があります。	[sound:s-1432_車の部品を交換する必要があります。.mp3] <br> It is necessary to replace the parts of the car. <br>
[sound:s-1432_車の部品を交換する必要があります。.mp3]	(<b>部品</b>) 車の部品を交換する必要があります。It is necessary to replace the parts of the car. <br>
安定	[sound:k-1433_安定.mp3]<br>あんてい <br> stability, equilibrium
stability, equilibrium	<b>安定<b> <br> あんてい <br>[sound:k-1433_安定.mp3]
[sound:k-1433_安定.mp3]	stability, equilibrium<br> <b>安定</b> <br> (あんてい)
<b>医薬品</b> <br> この医薬品は処方箋が必要です。	[sound:s-1433_この医薬品は処方箋が必要です。.mp3] <br> This medicine requires a prescription. <br>
[sound:s-1433_この医薬品は処方箋が必要です。.mp3]	(<b>医薬品</b>) この医薬品は処方箋が必要です。This medicine requires a prescription. <br>
不安	[sound:k-1434_不安.mp3]<br>ふあん <br> anxiety, uneasiness, insecurity, suspense
anxiety, uneasiness, insecurity, suspense	<b>不安<b> <br> ふあん <br>[sound:k-1434_不安.mp3]
[sound:k-1434_不安.mp3]	anxiety, uneasiness, insecurity, suspense<br> <b>不安</b> <br> (ふあん)
<b>品質</b> <br> 彼の仕事は常に高品質です。	[sound:s-1434_彼の仕事は常に高品質です。.mp3] <br> His work is always of high quality. <br>
[sound:s-1434_彼の仕事は常に高品質です。.mp3]	(<b>品質</b>) 彼の仕事は常に高品質です。His work is always of high quality. <br>
慰安	[sound:k-1435_慰安.mp3]<br>いあん <br> solace, relaxation
solace, relaxation	<b>慰安<b> <br> いあん <br>[sound:k-1435_慰安.mp3]
[sound:k-1435_慰安.mp3]	solace, relaxation<br> <b>慰安</b> <br> (いあん)
<b>用品</b> <br> 旅行のために必要な用品を用意しました。	[sound:s-1435_旅行のために必要な用品を用意しました。.mp3] <br> I prepared the necessary supplies for the trip. <br>
[sound:s-1435_旅行のために必要な用品を用意しました。.mp3]	(<b>用品</b>) 旅行のために必要な用品を用意しました。I prepared the necessary supplies for the trip. <br>
安打	[sound:k-1436_安打.mp3]<br>あんだ <br> safe hit (baseball)
safe hit (baseball)	<b>安打<b> <br> あんだ <br>[sound:k-1436_安打.mp3]
[sound:k-1436_安打.mp3]	safe hit<br> <b>baseball) (安打</b> <br> (あんだ)
<b>品種</b> <br> この農場では多くの異なる品種の野菜が栽培されています。	[sound:s-1436_この農場では多くの異なる品種の野菜が栽培されています。.mp3] <br> Many different varieties of vegetables are grown on this farm. <br>
[sound:s-1436_この農場では多くの異なる品種の野菜が栽培されています。.mp3]	(<b>品種</b>) この農場では多くの異なる品種の野菜が栽培されています。Many different varieties of vegetables are grown on this farm. <br>
治安	[sound:k-1437_治安.mp3]<br>ちあん <br> public order
public order	<b>治安<b> <br> ちあん <br>[sound:k-1437_治安.mp3]
[sound:k-1437_治安.mp3]	public order<br> <b>治安</b> <br> (ちあん)
<b>品目</b> <br> このリストにはさまざまな品目が含まれています。	[sound:s-1437_このリストにはさまざまな品目が含まれています。.mp3] <br> This list includes various items. <br>
[sound:s-1437_このリストにはさまざまな品目が含まれています。.mp3]	(<b>品目</b>) このリストにはさまざまな品目が含まれています。This list includes various items. <br>
安心	[sound:k-1438_安心.mp3]<br>あんしん <br> relief, peace of mind
relief, peace of mind	<b>安心<b> <br> あんしん <br>[sound:k-1438_安心.mp3]
[sound:k-1438_安心.mp3]	relief, peace of mind<br> <b>安心</b> <br> (あんしん)
<b>昨年</b> <br> 昨年は良い年でした。	[sound:s-1438_昨年は良い年でした。.mp3] <br> Last year was a good year. <br>
[sound:s-1438_昨年は良い年でした。.mp3]	(<b>昨年</b>) 昨年は良い年でした。Last year was a good year. <br>
不安定	[sound:k-1439_不安定.mp3]<br>ふあんてい <br> instability, insecurity, crankiness
instability, insecurity, crankiness	<b>不安定<b> <br> ふあんてい <br>[sound:k-1439_不安定.mp3]
[sound:k-1439_不安定.mp3]	instability, insecurity, crankiness<br> <b>不安定</b> <br> (ふあんてい)
<b>一昨年</b> <br> 一昨年に彼女と結婚しました。	[sound:s-1439_一昨年に彼女と結婚しました。.mp3] <br> I got married to her the year before last. <br>
[sound:s-1439_一昨年に彼女と結婚しました。.mp3]	(<b>一昨年</b>) 一昨年に彼女と結婚しました。I got married to her the year before last. <br>
建設	[sound:k-1440_建設.mp3]<br>けんせつ <br> construction, establishment
construction, establishment	<b>建設<b> <br> けんせつ <br>[sound:k-1440_建設.mp3]
[sound:k-1440_建設.mp3]	construction, establishment<br> <b>建設</b> <br> (けんせつ)
<b>昨秋</b> <br> 昨秋、私たちは美しい紅葉を楽しんだ。	"[sound:s-1440_昨秋、私たちは美しい紅葉を楽しんだ。.mp3] <br> ""Last autumn, we enjoyed beautiful autumn leaves.""" <br>
[sound:s-1440_昨秋、私たちは美しい紅葉を楽しんだ。.mp3]	(<b>昨秋</b>) 昨秋、私たちは美しい紅葉を楽しんだ。Last autumn, we enjoyed beautiful autumn leaves. <br>
施設	[sound:k-1441_施設.mp3]<br>しせつ <br> institution, establishment, facility; (army) engineer
institution, establishment, facility; (army) engineer	<b>施設<b> <br> しせつ <br>[sound:k-1441_施設.mp3]
[sound:k-1441_施設.mp3]	institution, establishment, facility;<br> <b>army) engineer (施設</b> <br> (しせつ)
<b>昨年度</b> <br> 昨年度の売り上げは前年よりも増加しました。	[sound:s-1441_昨年度の売り上げは前年よりも増加しました。.mp3] <br> Sales for last fiscal year increased compared to the previous year. <br>
[sound:s-1441_昨年度の売り上げは前年よりも増加しました。.mp3]	(<b>昨年度</b>) 昨年度の売り上げは前年よりも増加しました。Sales for last fiscal year increased compared to the previous year. <br>
設置	[sound:k-1442_設置.mp3]<br>せっち <br> establishment, institution
establishment, institution	<b>設置<b> <br> せっち <br>[sound:k-1442_設置.mp3]
[sound:k-1442_設置.mp3]	establishment, institution<br> <b>設置</b> <br> (せっち)
<b>昨春</b> <br> 昨春、私たちは日本を訪れました。	"[sound:s-1442_昨春、私たちは日本を訪れました。.mp3] <br> ""Last spring, we visited Japan.""" <br>
[sound:s-1442_昨春、私たちは日本を訪れました。.mp3]	(<b>昨春</b>) 昨春、私たちは日本を訪れました。Last spring, we visited Japan. <br>
設備	[sound:k-1443_設備.mp3]<br>せつび <br> equipment, device, facilities, installation
equipment, device, facilities, installation	<b>設備<b> <br> せつび <br>[sound:k-1443_設備.mp3]
[sound:k-1443_設備.mp3]	equipment, device, facilities, installation<br> <b>設備</b> <br> (せつび)
<b>昨日</b> <br> 昨日、彼に会いました。	[sound:s-1443_昨日、彼に会いました。.mp3] <br> I met him yesterday. <br>
[sound:s-1443_昨日、彼に会いました。.mp3]	(<b>昨日</b>) 昨日、彼に会いました。I met him yesterday. <br>
設計	[sound:k-1444_設計.mp3]<br>せっけい <br> plan, design, layout
plan, design, layout	<b>設計<b> <br> せっけい <br>[sound:k-1444_設計.mp3]
[sound:k-1444_設計.mp3]	plan, design, layout<br> <b>設計</b> <br> (せっけい)
<b>昨今</b> <br> 昨今の状況は非常に厳しいです。	[sound:s-1444_昨今の状況は非常に厳しいです。.mp3] <br> The current situation is very tough these days. <br>
[sound:s-1444_昨今の状況は非常に厳しいです。.mp3]	(<b>昨今</b>) 昨今の状況は非常に厳しいです。The current situation is very tough these days. <br>
設立	[sound:k-1445_設立.mp3]<br>せつりつ <br> establishment, foundation, incorporation (of a business)
establishment, foundation, incorporation (of a business)	<b>設立<b> <br> せつりつ <br>[sound:k-1445_設立.mp3]
[sound:k-1445_設立.mp3]	establishment, foundation, incorporation<br> <b>of a business) (設立</b> <br> (せつりつ)
<b>昨年来</b> <br> 昨年来、その地域では乾燥が続いています。	[sound:s-1445_昨年来、その地域では乾燥が続いています。.mp3] <br> It has been dry in that area since last year. <br>
[sound:s-1445_昨年来、その地域では乾燥が続いています。.mp3]	(<b>昨年来</b>) 昨年来、その地域では乾燥が続いています。It has been dry in that area since last year. <br>
設定	[sound:k-1446_設定.mp3]<br>せってい <br> establishment, creation; options or preference settings (in computer software), configuration, assignment, setup
establishment, creation; options or preference settings (in computer software), configuration, assignment, setup	<b>設定<b> <br> せってい <br>[sound:k-1446_設定.mp3]
[sound:k-1446_設定.mp3]	establishment, creation; options or preference settings<br> <b>in computer software), configuration, assignment, setup (設定</b> <br> (せってい)
<b>昨夜</b> <br> 昨夜、彼は遅くまで働いていました。	[sound:s-1446_昨夜、彼は遅くまで働いていました。.mp3] <br> He worked late last night. <br>
[sound:s-1446_昨夜、彼は遅くまで働いていました。.mp3]	(<b>昨夜</b>) 昨夜、彼は遅くまで働いていました。He worked late last night. <br>
創設	[sound:k-1447_創設.mp3]<br>そうせつ <br> establishment, founding, organization, organisation
establishment, founding, organization, organisation	<b>創設<b> <br> そうせつ <br>[sound:k-1447_創設.mp3]
[sound:k-1447_創設.mp3]	establishment, founding, organization, organisation<br> <b>創設</b> <br> (そうせつ)
<b>昨冬</b> <br> 昨冬、彼女はスキーに行きました。	[sound:s-1447_昨冬、彼女はスキーに行きました。.mp3] <br> She went skiing last winter. <br>
[sound:s-1447_昨冬、彼女はスキーに行きました。.mp3]	(<b>昨冬</b>) 昨冬、彼女はスキーに行きました。She went skiing last winter. <br>
建設省	[sound:k-1448_建設省.mp3]<br>けんせつしょう <br> Ministry of Construction
Ministry of Construction	<b>建設省<b> <br> けんせつしょう <br>[sound:k-1448_建設省.mp3]
[sound:k-1448_建設省.mp3]	Ministry of Construction<br> <b>建設省</b> <br> (けんせつしょう)
<b>論議</b> <br> その提案について論議が続いています。	[sound:s-1448_その提案について論議が続いています。.mp3] <br> There is ongoing discussion about the proposal. <br>
[sound:s-1448_その提案について論議が続いています。.mp3]	(<b>論議</b>) その提案について論議が続いています。There is ongoing discussion about the proposal. <br>
開設	[sound:k-1449_開設.mp3]<br>かいせつ <br> establishment, opening
establishment, opening	<b>開設<b> <br> かいせつ <br>[sound:k-1449_開設.mp3]
[sound:k-1449_開設.mp3]	establishment, opening<br> <b>開設</b> <br> (かいせつ)
<b>議論</b> <br> 彼らはその問題について激しい議論をした。	[sound:s-1449_彼らはその問題について激しい議論をした。.mp3] <br> They had a heated debate about the issue. <br>
[sound:s-1449_彼らはその問題について激しい議論をした。.mp3]	(<b>議論</b>) 彼らはその問題について激しい議論をした。They had a heated debate about the issue. <br>
保する	[sound:k-1450_保する.mp3]<br>ほする, ほうする <br> to guarantee
to guarantee	<b>保する<b> <br> ほする, ほうする <br>[sound:k-1450_保する.mp3]
[sound:k-1450_保する.mp3]	to guarantee<br> <b>保する</b> <br> (ほする, ほうする)
<b>結論</b> <br> 会議の結論はまだ出ていません。	[sound:s-1450_会議の結論はまだ出ていません。.mp3] <br> The conclusion of the meeting has not been reached yet. <br>
[sound:s-1450_会議の結論はまだ出ていません。.mp3]	(<b>結論</b>) 会議の結論はまだ出ていません。The conclusion of the meeting has not been reached yet. <br>
安保	[sound:k-1451_安保.mp3]<br>あんぽ <br> US-Japan Security Treaty, safety, security
US-Japan Security Treaty, safety, security	<b>安保<b> <br> あんぽ <br>[sound:k-1451_安保.mp3]
[sound:k-1451_安保.mp3]	US-Japan Security Treaty, safety, security<br> <b>安保</b> <br> (あんぽ)
<b>世論</b> <br> 世論はこの問題について分かれています。	[sound:s-1451_世論はこの問題について分かれています。.mp3] <br> Public opinion is divided on this issue. <br>
[sound:s-1451_世論はこの問題について分かれています。.mp3]	(<b>世論</b>) 世論はこの問題について分かれています。Public opinion is divided on this issue. <br>
保護	[sound:k-1452_保護.mp3]<br>ほご <br> care, protection, shelter, safeguard, guardianship, favor, favour, patronage
care, protection, shelter, safeguard, guardianship, favor, favour, patronage	<b>保護<b> <br> ほご <br>[sound:k-1452_保護.mp3]
[sound:k-1452_保護.mp3]	care, protection, shelter, safeguard, guardianship, favor, favour, patronage<br> <b>保護</b> <br> (ほご)
<b>評論家</b> <br> 彼は有名な映画評論家です。	[sound:s-1452_彼は有名な映画評論家です。.mp3] <br> He is a famous film critic. <br>
[sound:s-1452_彼は有名な映画評論家です。.mp3]	(<b>評論家</b>) 彼は有名な映画評論家です。He is a famous film critic. <br>
安全保障	[sound:k-1453_安全保障.mp3]<br>あんぜんほしょう <br> security guarantee (e.g. military security, network security, etc.)
security guarantee (e.g. military security, network security, etc.)	<b>安全保障<b> <br> あんぜんほしょう <br>[sound:k-1453_安全保障.mp3]
[sound:k-1453_安全保障.mp3]	security guarantee<br> <b>e.g. military security, network security, etc.) (安全保障</b> <br> (あんぜんほしょう)
<b>論文</b> <br> 彼の論文は国際的に高く評価されています。	[sound:s-1453_彼の論文は国際的に高く評価されています。.mp3] <br> His paper is highly regarded internationally. <br>
[sound:s-1453_彼の論文は国際的に高く評価されています。.mp3]	(<b>論文</b>) 彼の論文は国際的に高く評価されています。His paper is highly regarded internationally. <br>
確保	[sound:k-1454_確保.mp3]<br>かくほ <br> guarantee, maintain, ensure, insure, secure, reservation
guarantee, maintain, ensure, insure, secure, reservation	<b>確保<b> <br> かくほ <br>[sound:k-1454_確保.mp3]
[sound:k-1454_確保.mp3]	guarantee, maintain, ensure, insure, secure, reservation<br> <b>確保</b> <br> (かくほ)
<b>討論</b> <br> 彼らは激しい討論を行った。	[sound:s-1454_彼らは激しい討論を行った。.mp3] <br> They engaged in intense debate. <br>
[sound:s-1454_彼らは激しい討論を行った。.mp3]	(<b>討論</b>) 彼らは激しい討論を行った。They engaged in intense debate. <br>
保険	[sound:k-1455_保険.mp3]<br>ほけん <br> insurance, guarantee
insurance, guarantee	<b>保険<b> <br> ほけん <br>[sound:k-1455_保険.mp3]
[sound:k-1455_保険.mp3]	insurance, guarantee<br> <b>保険</b> <br> (ほけん)
<b>理論</b> <br> その理論は科学的な根拠に基づいています。	[sound:s-1455_その理論は科学的な根拠に基づいています。.mp3] <br> The theory is based on scientific evidence. <br>
[sound:s-1455_その理論は科学的な根拠に基づいています。.mp3]	(<b>理論</b>) その理論は科学的な根拠に基づいています。The theory is based on scientific evidence. <br>
保守	[sound:k-1456_保守.mp3]<br>ほしゅ <br> maintenance, conservation
maintenance, conservation	<b>保守<b> <br> ほしゅ <br>[sound:k-1456_保守.mp3]
[sound:k-1456_保守.mp3]	maintenance, conservation<br> <b>保守</b> <br> (ほしゅ)
<b>論争</b> <br> この問題について長い論争があります。	[sound:s-1456_この問題について長い論争があります。.mp3] <br> There has been a long-standing dispute over this issue. <br>
[sound:s-1456_この問題について長い論争があります。.mp3]	(<b>論争</b>) この問題について長い論争があります。There has been a long-standing dispute over this issue. <br>
保全	[sound:k-1457_保全.mp3]<br>ほぜん <br> preservation, integrity, conservation, maintenance
preservation, integrity, conservation, maintenance	<b>保全<b> <br> ほぜん <br>[sound:k-1457_保全.mp3]
[sound:k-1457_保全.mp3]	preservation, integrity, conservation, maintenance<br> <b>保全</b> <br> (ほぜん)
<b>論理</b> <br> 彼の議論は論理的に優れている。	[sound:s-1457_彼の議論は論理的に優れている。.mp3] <br> His argument is logically sound. <br>
[sound:s-1457_彼の議論は論理的に優れている。.mp3]	(<b>論理</b>) 彼の議論は論理的に優れている。His argument is logically sound. <br>
保証	[sound:k-1458_保証.mp3]<br>ほしょう <br> guarantee, security, assurance, pledge, warranty
guarantee, security, assurance, pledge, warranty	<b>保証<b> <br> ほしょう <br>[sound:k-1458_保証.mp3]
[sound:k-1458_保証.mp3]	guarantee, security, assurance, pledge, warranty<br> <b>保証</b> <br> (ほしょう)
<b>計</b> <br> その計画は長期的な視野で考えられています。	[sound:s-1458_その計画は長期的な視野で考えられています。.mp3] <br> The plan is being considered with a long-term perspective. <br>
[sound:s-1458_その計画は長期的な視野で考えられています。.mp3]	(<b>計</b>) その計画は長期的な視野で考えられています。The plan is being considered with a long-term perspective. <br>
担保	[sound:k-1459_担保.mp3]<br>たんぽ <br> security, collateral (e.g. mortgage)
security, collateral (e.g. mortgage)	<b>担保<b> <br> たんぽ <br>[sound:k-1459_担保.mp3]
[sound:k-1459_担保.mp3]	security, collateral<br> <b>e.g. mortgage) (担保</b> <br> (たんぽ)
<b>計画</b> <br> 彼は新しいプロジェクトの計画を立てています。	[sound:s-1459_彼は新しいプロジェクトの計画を立てています。.mp3] <br> He is making plans for a new project. <br>
[sound:s-1459_彼は新しいプロジェクトの計画を立てています。.mp3]	(<b>計画</b>) 彼は新しいプロジェクトの計画を立てています。He is making plans for a new project. <br>
改革	[sound:k-1460_改革.mp3]<br>かいかく <br> reform, reformation, innovation
reform, reformation, innovation	<b>改革<b> <br> かいかく <br>[sound:k-1460_改革.mp3]
[sound:k-1460_改革.mp3]	reform, reformation, innovation<br> <b>改革</b> <br> (かいかく)
<b>合計</b> <br> これらの数字の合計を計算してください。	[sound:s-1460_これらの数字の合計を計算してください。.mp3] <br> Please calculate the total of these numbers. <br>
[sound:s-1460_これらの数字の合計を計算してください。.mp3]	(<b>合計</b>) これらの数字の合計を計算してください。Please calculate the total of these numbers. <br>
改正	[sound:k-1461_改正.mp3]<br>かいせい <br> revision, amendment, alteration
revision, amendment, alteration	<b>改正<b> <br> かいせい <br>[sound:k-1461_改正.mp3]
[sound:k-1461_改正.mp3]	revision, amendment, alteration<br> <b>改正</b> <br> (かいせい)
<b>設計</b> <br> この建物の設計は革新的です。	[sound:s-1461_この建物の設計は革新的です。.mp3] <br> The design of this building is innovative. <br>
[sound:s-1461_この建物の設計は革新的です。.mp3]	(<b>設計</b>) この建物の設計は革新的です。The design of this building is innovative. <br>
改善	[sound:k-1462_改善.mp3]<br>かいぜん <br> betterment, improvement, incremental and continuous improvement
betterment, improvement, incremental and continuous improvement	<b>改善<b> <br> かいぜん <br>[sound:k-1462_改善.mp3]
[sound:k-1462_改善.mp3]	betterment, improvement, incremental and continuous improvement<br> <b>改善</b> <br> (かいぜん)
<b>計算</b> <br> 数学の問題を計算するのは得意ではありません。	[sound:s-1462_数学の問題を計算するのは得意ではありません。.mp3] <br> I'm not good at solving math problems. <br>
[sound:s-1462_数学の問題を計算するのは得意ではありません。.mp3]	(<b>計算</b>) 数学の問題を計算するのは得意ではありません。I'm not good at solving math problems. <br>
改造	[sound:k-1463_改造.mp3]<br>かいぞう <br> remodeling, remodelling, restructuring; modding
remodeling, remodelling, restructuring; modding	<b>改造<b> <br> かいぞう <br>[sound:k-1463_改造.mp3]
[sound:k-1463_改造.mp3]	remodeling, remodelling, restructuring; modding<br> <b>改造</b> <br> (かいぞう)
<b>統計</b> <br> このグラフは最新の統計データを示しています。	[sound:s-1463_このグラフは最新の統計データを示しています。.mp3] <br> This graph shows the latest statistical data. <br>
[sound:s-1463_このグラフは最新の統計データを示しています。.mp3]	(<b>統計</b>) このグラフは最新の統計データを示しています。This graph shows the latest statistical data. <br>
改める	[sound:k-1464_改める.mp3]<br>あらためる <br> to change, to alter, to revise, to replace; to reform, to correct, to mend, to improve; to examine, to check, to inspect; to do properly, to do formally
to change, to alter, to revise, to replace; to reform, to correct, to mend, to improve; to examine, to check, to inspect; to do properly, to do formally	<b>改める<b> <br> あらためる <br>[sound:k-1464_改める.mp3]
[sound:k-1464_改める.mp3]	to change, to alter, to revise, to replace; to reform, to correct, to mend, to improve; to examine, to check, to inspect; to do properly, to do formally<br> <b>改める</b> <br> (あらためる)
<b>会計</b> <br> その会社の会計士はとても優秀です。	[sound:s-1464_その会社の会計士はとても優秀です。.mp3] <br> The accountant of that company is very competent. <br>
[sound:s-1464_その会社の会計士はとても優秀です。.mp3]	(<b>会計</b>) その会社の会計士はとても優秀です。The accountant of that company is very competent. <br>
改定	[sound:k-1465_改定.mp3]<br>かいてい <br> reform
reform	<b>改定<b> <br> かいてい <br>[sound:k-1465_改定.mp3]
[sound:k-1465_改定.mp3]	reform<br> <b>改定</b> <br> (かいてい)
<b>時計</b> <br> この時計は正確に時間を示しています。	[sound:s-1465_この時計は正確に時間を示しています。.mp3] <br> This watch accurately shows the time. <br>
[sound:s-1465_この時計は正確に時間を示しています。.mp3]	(<b>時計</b>) この時計は正確に時間を示しています。This watch accurately shows the time. <br>
改憲	[sound:k-1466_改憲.mp3]<br>かいけん <br> constitutional change
constitutional change	<b>改憲<b> <br> かいけん <br>[sound:k-1466_改憲.mp3]
[sound:k-1466_改憲.mp3]	constitutional change<br> <b>改憲</b> <br> (かいけん)
<b>集計</b> <br> データを集計して、結果を報告してください。	[sound:s-1466_データを集計して、結果を報告してください。.mp3] <br> Please compile the data and report the results. <br>
[sound:s-1466_データを集計して、結果を報告してください。.mp3]	(<b>集計</b>) データを集計して、結果を報告してください。Please compile the data and report the results. <br>
改良	[sound:k-1467_改良.mp3]<br>かいりょう <br> improvement, reform
improvement, reform	<b>改良<b> <br> かいりょう <br>[sound:k-1467_改良.mp3]
[sound:k-1467_改良.mp3]	improvement, reform<br> <b>改良</b> <br> (かいりょう)
<b>家計</b> <br> 彼は家計を支えるために一生懸命働いています。	[sound:s-1467_彼は家計を支えるために一生懸命働いています。.mp3] <br> He works hard to support the household finances. <br>
[sound:s-1467_彼は家計を支えるために一生懸命働いています。.mp3]	(<b>家計</b>) 彼は家計を支えるために一生懸命働いています。He works hard to support the household finances. <br>
改選	[sound:k-1468_改選.mp3]<br>かいせん <br> re-election
re-election	<b>改選<b> <br> かいせん <br>[sound:k-1468_改選.mp3]
[sound:k-1468_改選.mp3]	re-election<br> <b>改選</b> <br> (かいせん)
<b>死</b> <br> 死は人生の一部です。	[sound:s-1468_死は人生の一部です。.mp3] <br> Death is a part of life. <br>
[sound:s-1468_死は人生の一部です。.mp3]	(<b>死</b>) 死は人生の一部です。Death is a part of life. <br>
改修	[sound:k-1469_改修.mp3]<br>かいしゅう <br> repair, improvement
repair, improvement	<b>改修<b> <br> かいしゅう <br>[sound:k-1469_改修.mp3]
[sound:k-1469_改修.mp3]	repair, improvement<br> <b>改修</b> <br> (かいしゅう)
<b>死者</b> <br> 地震で多くの死者が出ました。	[sound:s-1469_地震で多くの死者が出ました。.mp3] <br> Many people died in the earthquake. <br>
[sound:s-1469_地震で多くの死者が出ました。.mp3]	(<b>死者</b>) 地震で多くの死者が出ました。Many people died in the earthquake. <br>
数	[sound:k-1470_数.mp3]<br>かず <br> number, amount
number, amount	<b>数<b> <br> かず <br>[sound:k-1470_数.mp3]
[sound:k-1470_数.mp3]	number, amount<br> <b>数</b> <br> (かず)
<b>脳死</b> <br> 彼の脳死を宣告するしかなかった。	[sound:s-1470_彼の脳死を宣告するしかなかった。.mp3] <br> There was no choice but to declare him brain dead. <br>
[sound:s-1470_彼の脳死を宣告するしかなかった。.mp3]	(<b>脳死</b>) 彼の脳死を宣告するしかなかった。There was no choice but to declare him brain dead. <br>
数字	[sound:k-1471_数字.mp3]<br>すうじ <br> numeral, figure, digit, numeric character
numeral, figure, digit, numeric character	<b>数字<b> <br> すうじ <br>[sound:k-1471_数字.mp3]
[sound:k-1471_数字.mp3]	numeral, figure, digit, numeric character<br> <b>数字</b> <br> (すうじ)
<b>死亡</b> <br> その事故で多くの人が死亡しました。	[sound:s-1471_その事故で多くの人が死亡しました。.mp3] <br> Many people died in the accident. <br>
[sound:s-1471_その事故で多くの人が死亡しました。.mp3]	(<b>死亡</b>) その事故で多くの人が死亡しました。Many people died in the accident. <br>
多数	[sound:k-1472_多数.mp3]<br>たすう <br> great number; countless, majority
great number; countless, majority	<b>多数<b> <br> たすう <br>[sound:k-1472_多数.mp3]
[sound:k-1472_多数.mp3]	great number; countless, majority<br> <b>多数</b> <br> (たすう)
<b>二死</b> <br> 試合は二死で終わりました。	[sound:s-1472_試合は二死で終わりました。.mp3] <br> The game ended with two outs. <br>
[sound:s-1472_試合は二死で終わりました。.mp3]	(<b>二死</b>) 試合は二死で終わりました。The game ended with two outs. <br>
定数	[sound:k-1473_定数.mp3]<br>ていすう <br> constant; literal
constant; literal	<b>定数<b> <br> ていすう <br>[sound:k-1473_定数.mp3]
[sound:k-1473_定数.mp3]	constant; literal<br> <b>定数</b> <br> (ていすう)
<b>死去</b> <br> 彼の死去は多くの人に衝撃を与えました。	[sound:s-1473_彼の死去は多くの人に衝撃を与えました。.mp3] <br> His death shocked many people. <br>
[sound:s-1473_彼の死去は多くの人に衝撃を与えました。.mp3]	(<b>死去</b>) 彼の死去は多くの人に衝撃を与えました。His death shocked many people. <br>
少数	[sound:k-1474_少数.mp3]<br>しょうすう <br> minority, few
minority, few	<b>少数<b> <br> しょうすう <br>[sound:k-1474_少数.mp3]
[sound:k-1474_少数.mp3]	minority, few<br> <b>少数</b> <br> (しょうすう)
<b>死刑</b> <br> 彼は死刑を宣告されました。	[sound:s-1474_彼は死刑を宣告されました。.mp3] <br> He was sentenced to death. <br>
[sound:s-1474_彼は死刑を宣告されました。.mp3]	(<b>死刑</b>) 彼は死刑を宣告されました。He was sentenced to death. <br>
複数	[sound:k-1475_複数.mp3]<br>ふくすう <br> several, plural, plurality, multiple
several, plural, plurality, multiple	<b>複数<b> <br> ふくすう <br>[sound:k-1475_複数.mp3]
[sound:k-1475_複数.mp3]	several, plural, plurality, multiple<br> <b>複数</b> <br> (ふくすう)
<b>必死</b> <br> 彼は必死になって助けを求めた。	[sound:s-1475_彼は必死になって助けを求めた。.mp3] <br> He desperately sought help. <br>
[sound:s-1475_彼は必死になって助けを求めた。.mp3]	(<b>必死</b>) 彼は必死になって助けを求めた。He desperately sought help. <br>
過半数	[sound:k-1476_過半数.mp3]<br>かはんすう <br> majority
majority	<b>過半数<b> <br> かはんすう <br>[sound:k-1476_過半数.mp3]
[sound:k-1476_過半数.mp3]	majority<br> <b>過半数</b> <br> (かはんすう)
<b>死後</b> <br> 死後、彼の業績は評価されました。	"[sound:s-1476_死後、彼の業績は評価されました。.mp3] <br> ""After his death, his achievements were recognized.""" <br>
[sound:s-1476_死後、彼の業績は評価されました。.mp3]	(<b>死後</b>) 死後、彼の業績は評価されました。After his death, his achievements were recognized. <br>
半数	[sound:k-1477_半数.mp3]<br>はんすう <br> half the number; haploid
half the number; haploid	<b>半数<b> <br> はんすう <br>[sound:k-1477_半数.mp3]
[sound:k-1477_半数.mp3]	half the number; haploid<br> <b>半数</b> <br> (はんすう)
<b>死体</b> <br> 川で死体が発見された。	[sound:s-1477_川で死体が発見された。.mp3] <br> A dead body was found in the river. <br>
[sound:s-1477_川で死体が発見された。.mp3]	(<b>死体</b>) 川で死体が発見された。A dead body was found in the river. <br>
回数	[sound:k-1478_回数.mp3]<br>かいすう <br> number of times, frequency, count
number of times, frequency, count	<b>回数<b> <br> かいすう <br>[sound:k-1478_回数.mp3]
[sound:k-1478_回数.mp3]	number of times, frequency, count<br> <b>回数</b> <br> (かいすう)
<b>長官</b> <br> 外務長官が外交交渉を行った。	[sound:s-1478_外務長官が外交交渉を行った。.mp3] <br> The foreign minister conducted diplomatic negotiations. <br>
[sound:s-1478_外務長官が外交交渉を行った。.mp3]	(<b>長官</b>) 外務長官が外交交渉を行った。The foreign minister conducted diplomatic negotiations. <br>
指数	[sound:k-1479_指数.mp3]<br>しすう <br> index, index number, exponent (e.g. in floating-point representation), characteristic
index, index number, exponent (e.g. in floating-point representation), characteristic	<b>指数<b> <br> しすう <br>[sound:k-1479_指数.mp3]
[sound:k-1479_指数.mp3]	index, index number, exponent<br> <b>e.g. in floating-point representation), characteristic (指数</b> <br> (しすう)
<b>官邸</b> <br> 首相官邸には高いセキュリティが備わっている。	[sound:s-1479_首相官邸には高いセキュリティが備わっている。.mp3] <br> The prime minister's official residence has tight security. <br>
[sound:s-1479_首相官邸には高いセキュリティが備わっている。.mp3]	(<b>官邸</b>) 首相官邸には高いセキュリティが備わっている。The prime minister's official residence has tight security. <br>
記事	[sound:k-1480_記事.mp3]<br>きじ <br> article, news story, report, account
article, news story, report, account	<b>記事<b> <br> きじ <br>[sound:k-1480_記事.mp3]
[sound:k-1480_記事.mp3]	article, news story, report, account<br> <b>記事</b> <br> (きじ)
<b>官房長官</b> <br> 官房長官は記者会見で政府の方針を説明した。	[sound:s-1480_官房長官は記者会見で政府の方針を説明した。.mp3] <br> The Chief Cabinet Secretary explained the government's policy at a press conference. <br>
[sound:s-1480_官房長官は記者会見で政府の方針を説明した。.mp3]	(<b>官房長官</b>) 官房長官は記者会見で政府の方針を説明した。The Chief Cabinet Secretary explained the government's policy at a press conference. <br>
記者	[sound:k-1481_記者.mp3]<br>きしゃ <br> reporter
reporter	<b>記者<b> <br> きしゃ <br>[sound:k-1481_記者.mp3]
[sound:k-1481_記者.mp3]	reporter<br> <b>記者</b> <br> (きしゃ)
<b>官僚</b> <br> 官僚制度には改革が必要だと考えられています。	[sound:s-1481_官僚制度には改革が必要だと考えられています。.mp3] <br> Reform of the bureaucracy is considered necessary. <br>
[sound:s-1481_官僚制度には改革が必要だと考えられています。.mp3]	(<b>官僚</b>) 官僚制度には改革が必要だと考えられています。Reform of the bureaucracy is considered necessary. <br>
記録	[sound:k-1482_記録.mp3]<br>きろく <br> record, minutes, document; a record (e.g. in sports), results, score; to record, to document; to set a record (e.g. in sports), to show a result, to reach a value
record, minutes, document; a record (e.g. in sports), results, score; to record, to document; to set a record (e.g. in sports), to show a result, to reach a value	<b>記録<b> <br> きろく <br>[sound:k-1482_記録.mp3]
[sound:k-1482_記録.mp3]	record, minutes, document; a record<br> <b>e.g. in sports), results, score; to record, to document; to set a record (e.g. in sports), to show a result, to reach a value (記録</b> <br> (きろく)
<b>高官</b> <br> 彼は政府の高官としての地位を維持している。	[sound:s-1482_彼は政府の高官としての地位を維持している。.mp3] <br> He maintains his position as a high-ranking official in the government. <br>
[sound:s-1482_彼は政府の高官としての地位を維持している。.mp3]	(<b>高官</b>) 彼は政府の高官としての地位を維持している。He maintains his position as a high-ranking official in the government. <br>
書記	[sound:k-1483_書記.mp3]<br>しょき <br> clerk, secretary
clerk, secretary	<b>書記<b> <br> しょき <br>[sound:k-1483_書記.mp3]
[sound:k-1483_書記.mp3]	clerk, secretary<br> <b>書記</b> <br> (しょき)
<b>司令官</b> <br> 彼は軍の司令官として戦略を立てた。	[sound:s-1483_彼は軍の司令官として戦略を立てた。.mp3] <br> He devised strategies as the military commander. <br>
[sound:s-1483_彼は軍の司令官として戦略を立てた。.mp3]	(<b>司令官</b>) 彼は軍の司令官として戦略を立てた。He devised strategies as the military commander. <br>
記念	[sound:k-1484_記念.mp3]<br>きねん <br> commemoration, memory
commemoration, memory	<b>記念<b> <br> きねん <br>[sound:k-1484_記念.mp3]
[sound:k-1484_記念.mp3]	commemoration, memory<br> <b>記念</b> <br> (きねん)
<b>事務次官</b> <br> 事務次官は省庁の運営に責任を持っています。	[sound:s-1484_事務次官は省庁の運営に責任を持っています。.mp3] <br> The administrative vice-minister is responsible for the operation of the ministry. <br>
[sound:s-1484_事務次官は省庁の運営に責任を持っています。.mp3]	(<b>事務次官</b>) 事務次官は省庁の運営に責任を持っています。The administrative vice-minister is responsible for the operation of the ministry. <br>
記憶	[sound:k-1485_記憶.mp3]<br>きおく <br> memory, recollection, remembrance; storage
memory, recollection, remembrance; storage	<b>記憶<b> <br> きおく <br>[sound:k-1485_記憶.mp3]
[sound:k-1485_記憶.mp3]	memory, recollection, remembrance; storage<br> <b>記憶</b> <br> (きおく)
<b>官房</b> <br> 官房には政府の重要な書類が保管されている。	[sound:s-1485_官房には政府の重要な書類が保管されている。.mp3] <br> Important government documents are kept in the Cabinet Secretariat. <br>
[sound:s-1485_官房には政府の重要な書類が保管されている。.mp3]	(<b>官房</b>) 官房には政府の重要な書類が保管されている。Important government documents are kept in the Cabinet Secretariat. <br>
記す	[sound:k-1486_記す.mp3]<br>しるす, きす <br> to write down, to note; to remember
to write down, to note; to remember	<b>記す<b> <br> しるす, きす <br>[sound:k-1486_記す.mp3]
[sound:k-1486_記す.mp3]	to write down, to note; to remember<br> <b>記す</b> <br> (しるす, きす)
<b>国務長官</b> <br> 彼女は国務長官として外交政策を主導している。	[sound:s-1486_彼女は国務長官として外交政策を主導している。.mp3] <br> She leads foreign policy as the Secretary of State. <br>
[sound:s-1486_彼女は国務長官として外交政策を主導している。.mp3]	(<b>国務長官</b>) 彼女は国務長官として外交政策を主導している。She leads foreign policy as the Secretary of State. <br>
記述	[sound:k-1487_記述.mp3]<br>きじゅつ <br> description, descriptor
description, descriptor	<b>記述<b> <br> きじゅつ <br>[sound:k-1487_記述.mp3]
[sound:k-1487_記述.mp3]	description, descriptor<br> <b>記述</b> <br> (きじゅつ)
<b>増加</b> <br> 去年からこの地域の人口が増加しています。	[sound:s-1487_去年からこの地域の人口が増加しています。.mp3] <br> きょねんからこのちいきのじんこうがぞうかしています。 <br>The population in this area has been increasing since last year.
[sound:s-1487_去年からこの地域の人口が増加しています。.mp3]	<b>増加</b> <br> 去年からこの地域の人口が増加しています。<br> きょねんからこのちいきのじんこうがぞうかしています <br>The population in this area has been increasing since last year.
記念日	[sound:k-1488_記念日.mp3]<br>きねんび <br> holiday, anniversary, memorial day
holiday, anniversary, memorial day	<b>記念日<b> <br> きねんび <br>[sound:k-1488_記念日.mp3]
[sound:k-1488_記念日.mp3]	holiday, anniversary, memorial day<br> <b>記念日</b> <br> (きねんび)
<b>増税</b> <br> 来年、消費税が増税される予定です。	[sound:s-1488_来年、消費税が増税される予定です。.mp3] <br> らいねん、しょうひぜいがぞうぜいされるよていです。 <br>"Next year, there are plans to increase the consumption tax."
[sound:s-1488_来年、消費税が増税される予定です。.mp3]	<b>増税</b> <br> 来年、消費税が増税される予定です。<br> らいねん、しょうひぜいがぞうぜいされるよていです <br>Next year, there are plans to increase the consumption tax.
日記	[sound:k-1489_日記.mp3]<br>にっき <br> diary, journal
diary, journal	<b>日記<b> <br> にっき <br>[sound:k-1489_日記.mp3]
[sound:k-1489_日記.mp3]	diary, journal<br> <b>日記</b> <br> (にっき)
<b>増殖</b> <br> この水槽では、魚が増殖しています。	[sound:s-1489_この水槽では、魚が増殖しています。.mp3] <br> このすいそうでは、さかながぞうしょくしています。 <br>Fish are breeding in this aquarium.
[sound:s-1489_この水槽では、魚が増殖しています。.mp3]	<b>増殖</b> <br> この水槽では、魚が増殖しています。<br> このすいそうでは、さかながぞうしょくしています <br>Fish are breeding in this aquarium.
参院	[sound:k-1490_参院.mp3]<br>さんいん <br> House of Councillors
House of Councillors	<b>参院<b> <br> さんいん <br>[sound:k-1490_参院.mp3]
[sound:k-1490_参院.mp3]	House of Councillors<br> <b>参院</b> <br> (さんいん)
<b>急増</b> <br> 最近、感染者が急増しています。	[sound:s-1490_最近、感染者が急増しています。.mp3] <br> さいきん、かんせんしゃがきゅうぞうしています。 <br>"Recently, there has been a rapid increase in infected people."
[sound:s-1490_最近、感染者が急増しています。.mp3]	<b>急増</b> <br> 最近、感染者が急増しています。<br> さいきん、かんせんしゃがきゅうぞうしています <br>Recently, there has been a rapid increase in infected people.
衆院	[sound:k-1491_衆院.mp3]<br>しゅういん <br> lower house of the Diet
lower house of the Diet	<b>衆院<b> <br> しゅういん <br>[sound:k-1491_衆院.mp3]
[sound:k-1491_衆院.mp3]	lower house of the Diet<br> <b>衆院</b> <br> (しゅういん)
<b>増大</b> <br> その企業は急速に利益を増大させています。	[sound:s-1491_その企業は急速に利益を増大させています。.mp3] <br> そのきぎょうはきゅうそくにりえきをぞうだいさせています。 <br>The company is rapidly increasing its profits.
[sound:s-1491_その企業は急速に利益を増大させています。.mp3]	<b>増大</b> <br> その企業は急速に利益を増大させています。<br> そのきぎょうはきゅうそくにりえきをぞうだいさせています <br>The company is rapidly increasing its profits.
病院	[sound:k-1492_病院.mp3]<br>びょういん <br> hospital
hospital	<b>病院<b> <br> びょういん <br>[sound:k-1492_病院.mp3]
[sound:k-1492_病院.mp3]	hospital<br> <b>病院</b> <br> (びょういん)
<b>増強</b> <br> 国は自衛力を増強しています。	[sound:s-1492_国は自衛力を増強しています。.mp3] <br> くにはじえいりょくをぞうきょうしています。 <br>The country is strengthening its self-defense capabilities.
[sound:s-1492_国は自衛力を増強しています。.mp3]	<b>増強</b> <br> 国は自衛力を増強しています。<br> くにはじえいりょくをぞうきょうしています <br>The country is strengthening its self-defense capabilities.
下院	[sound:k-1493_下院.mp3]<br>かいん <br> lower house, lower (legislative) body
lower house, lower (legislative) body	<b>下院<b> <br> かいん <br>[sound:k-1493_下院.mp3]
[sound:k-1493_下院.mp3]	lower house, lower<br> <b>legislative) body (下院</b> <br> (かいん)
<b>増し</b> <br> 彼の指導はチームの士気を増しました。	[sound:s-1493_彼の指導はチームの士気を増しました。.mp3] <br> かれのしどうはちーむのしきをましました。 <br>His leadership boosted the team's morale.
[sound:s-1493_彼の指導はチームの士気を増しました。.mp3]	<b>増し</b> <br> 彼の指導はチームの士気を増しました。<br> かれのしどうはちーむのしきをましました <br>His leadership boosted the team's morale.
上院	[sound:k-1494_上院.mp3]<br>じょういん <br> Upper House, Senate, Lords
Upper House, Senate, Lords	<b>上院<b> <br> じょういん <br>[sound:k-1494_上院.mp3]
[sound:k-1494_上院.mp3]	Upper House, Senate, Lords<br> <b>上院</b> <br> (じょういん)
<b>増収</b> <br> 今年は売上が増収しています。	[sound:s-1494_今年は売上が増収しています。.mp3] <br> ことしはうりあげがぞうしゅうしています。 <br>Sales have increased this year.
[sound:s-1494_今年は売上が増収しています。.mp3]	<b>増収</b> <br> 今年は売上が増収しています。<br> ことしはうりあげがぞうしゅうしています <br>Sales have increased this year.
学院	[sound:k-1495_学院.mp3]<br>がくいん <br> institute, academy
institute, academy	<b>学院<b> <br> がくいん <br>[sound:k-1495_学院.mp3]
[sound:k-1495_学院.mp3]	institute, academy<br> <b>学院</b> <br> (がくいん)
<b>増益</b> <br> この会社は毎年増益しています。	[sound:s-1495_この会社は毎年増益しています。.mp3] <br> このかいしゃはまいとしぞうえきしています。 <br>This company has been increasing its profits every year.
[sound:s-1495_この会社は毎年増益しています。.mp3]	<b>増益</b> <br> この会社は毎年増益しています。<br> このかいしゃはまいとしぞうえきしています <br>This company has been increasing its profits every year.
大学院	[sound:k-1496_大学院.mp3]<br>だいがくいん <br> graduate school
graduate school	<b>大学院<b> <br> だいがくいん <br>[sound:k-1496_大学院.mp3]
[sound:k-1496_大学院.mp3]	graduate school<br> <b>大学院</b> <br> (だいがくいん)
<b>増額</b> <br> 予算が増額されたので、新しいプロジェクトが開始されます。	[sound:s-1496_予算が増額されたので、新しいプロジェクトが開始されます。.mp3] <br> よさんがぞうがくされたので、あたらしいぷろじぇくとがかいしされます。 <br>"Since the budget has been increased, a new project will be started."
[sound:s-1496_予算が増額されたので、新しいプロジェクトが開始されます。.mp3]	<b>増額</b> <br> 予算が増額されたので、新しいプロジェクトが開始されます。<br> よさんがぞうがくされたので、あたらしいぷろじぇくとがかいしされます <br>Since the budget has been increased, a new project will be started.
入院	[sound:k-1497_入院.mp3]<br>にゅういん <br> hospitalization, hospitalisation
hospitalization, hospitalisation	<b>入院<b> <br> にゅういん <br>[sound:k-1497_入院.mp3]
[sound:k-1497_入院.mp3]	hospitalization, hospitalisation<br> <b>入院</b> <br> (にゅういん)
<b>係</b> <br> この部署の係長はとても責任感が強いです。	[sound:s-1497_この部署の係長はとても責任感が強いです。.mp3] <br> このぶしょのかかりちょうはとてもせきにんかんがつよいです。 <br>The head of this department has a strong sense of responsibility.
[sound:s-1497_この部署の係長はとても責任感が強いです。.mp3]	<b>係</b> <br> この部署の係長はとても責任感が強いです。<br> このぶしょのかかりちょうはとてもせきにんかんがつよいです <br>The head of this department has a strong sense of responsibility.
両院	[sound:k-1498_両院.mp3]<br>りょういん <br> both Houses of Parliament
both Houses of Parliament	<b>両院<b> <br> りょういん <br>[sound:k-1498_両院.mp3]
[sound:k-1498_両院.mp3]	both Houses of Parliament<br> <b>両院</b> <br> (りょういん)
<b>関係</b> <br> 私たちの関係は長い間続いています。	[sound:s-1498_私たちの関係は長い間続いています。.mp3] <br> わたしたちのかんけいはながいあいだつづいています。 <br>Our relationship has been going on for a long time.
[sound:s-1498_私たちの関係は長い間続いています。.mp3]	<b>関係</b> <br> 私たちの関係は長い間続いています。<br> わたしたちのかんけいはながいあいだつづいています <br>Our relationship has been going on for a long time.
院長	[sound:k-1499_院長.mp3]<br>いんちょう <br> director
director	<b>院長<b> <br> いんちょう <br>[sound:k-1499_院長.mp3]
[sound:k-1499_院長.mp3]	director<br> <b>院長</b> <br> (いんちょう)
<b>関係者</b> <br> このプロジェクトには関係者全員が参加しています。	[sound:s-1499_このプロジェクトには関係者全員が参加しています。.mp3] <br> このぷろじぇくとにはかんけいしゃぜんいんがさんかしています。 <br>All relevant personnel are participating in this project.
[sound:s-1499_このプロジェクトには関係者全員が参加しています。.mp3]	<b>関係者</b> <br> このプロジェクトには関係者全員が参加しています。<br> このぷろじぇくとにはかんけいしゃぜんいんがさんかしています <br>All relevant personnel are participating in this project.
女	[sound:k-1500_女.mp3]<br>おんな <br> woman
woman	<b>女<b> <br> おんな <br>[sound:k-1500_女.mp3]
[sound:k-1500_女.mp3]	woman<br> <b>女</b> <br> (おんな)
<b>人間関係</b> <br> 職場で良好な人間関係を築くことは重要です。	[sound:s-1500_職場で良好な人間関係を築くことは重要です。.mp3] <br> しょくばでりょうこうなにんげんかんけいをきずくことはじゅうようです。 <br>Building good interpersonal relationships in the workplace is important.
[sound:s-1500_職場で良好な人間関係を築くことは重要です。.mp3]	<b>人間関係</b> <br> 職場で良好な人間関係を築くことは重要です。<br> しょくばでりょうこうなにんげんかんけいをきずくことはじゅうようです <br>Building good interpersonal relationships in the workplace is important.
女子	[sound:k-1501_女子.mp3]<br>じょし, おなご <br> woman, girl
woman, girl	<b>女子<b> <br> じょし, おなご <br>[sound:k-1501_女子.mp3]
[sound:k-1501_女子.mp3]	woman, girl<br> <b>女子</b> <br> (じょし, おなご)
<b>係長</b> <br> この部署の係長はリーダーシップがあります。	[sound:s-1501_この部署の係長はリーダーシップがあります。.mp3] <br> このぶしょのかかりちょうはりーだーしっぷがあります。 <br>The head of this department has leadership skills.
[sound:s-1501_この部署の係長はリーダーシップがあります。.mp3]	<b>係長</b> <br> この部署の係長はリーダーシップがあります。<br> このぶしょのかかりちょうはりーだーしっぷがあります <br>The head of this department has leadership skills.
女性	[sound:k-1502_女性.mp3]<br>じょせい <br> woman, female; feminine gender
woman, female; feminine gender	<b>女性<b> <br> じょせい <br>[sound:k-1502_女性.mp3]
[sound:k-1502_女性.mp3]	woman, female; feminine gender<br> <b>女性</b> <br> (じょせい)
<b>無関係</b> <br> 私はその問題とは無関係です。	[sound:s-1502_私はその問題とは無関係です。.mp3] <br> わたしはそのもんだいとはむかんけいです。 <br>I have nothing to do with that issue.
[sound:s-1502_私はその問題とは無関係です。.mp3]	<b>無関係</b> <br> 私はその問題とは無関係です。<br> わたしはそのもんだいとはむかんけいです <br>I have nothing to do with that issue.
男女	[sound:k-1503_男女.mp3]<br>だんじょ <br> man and woman, men and women
man and woman, men and women	<b>男女<b> <br> だんじょ <br>[sound:k-1503_男女.mp3]
[sound:k-1503_男女.mp3]	man and woman, men and women<br> <b>男女</b> <br> (だんじょ)
<b>係官</b> <br> この事務所の係官に連絡してください。	[sound:s-1503_この事務所の係官に連絡してください。.mp3] <br> このじむしょのかかりかんにれんらくしてください。 <br>Please contact the official in charge of this office.
[sound:s-1503_この事務所の係官に連絡してください。.mp3]	<b>係官</b> <br> この事務所の係官に連絡してください。<br> このじむしょのかかりかんにれんらくしてください <br>Please contact the official in charge of this office.
彼女	[sound:k-1504_彼女.mp3]<br>かのじょ <br> she, her; girl friend, girlfriend, sweetheart
she, her; girl friend, girlfriend, sweetheart	<b>彼女<b> <br> かのじょ <br>[sound:k-1504_彼女.mp3]
[sound:k-1504_彼女.mp3]	she, her; girl friend, girlfriend, sweetheart<br> <b>彼女</b> <br> (かのじょ)
<b>係員</b> <br> このプロジェクトには多くの係員が関わっています。	[sound:s-1504_このプロジェクトには多くの係員が関わっています。.mp3] <br> このぷろじぇくとにはおおくのかかりいんがかかわっています。 <br>Many staff members are involved in this project.
[sound:s-1504_このプロジェクトには多くの係員が関わっています。.mp3]	<b>係員</b> <br> このプロジェクトには多くの係員が関わっています。<br> このぷろじぇくとにはおおくのかかりいんがかかわっています <br>Many staff members are involved in this project.
女優	[sound:k-1505_女優.mp3]<br>じょゆう <br> actress
actress	<b>女優<b> <br> じょゆう <br>[sound:k-1505_女優.mp3]
[sound:k-1505_女優.mp3]	actress<br> <b>女優</b> <br> (じょゆう)
<b>係争</b> <br> この訴訟は長期間にわたる係争となりました。	[sound:s-1505_この訴訟は長期間にわたる係争となりました。.mp3] <br> このそしょうはちょうきかんにわたるかかりそうとなりました。 <br>This lawsuit has turned into a long-standing dispute.
[sound:s-1505_この訴訟は長期間にわたる係争となりました。.mp3]	<b>係争</b> <br> この訴訟は長期間にわたる係争となりました。<br> このそしょうはちょうきかんにわたるかかりそうとなりました <br>This lawsuit has turned into a long-standing dispute.
長女	[sound:k-1506_長女.mp3]<br>ちょうじょ <br> eldest daughter
eldest daughter	<b>長女<b> <br> ちょうじょ <br>[sound:k-1506_長女.mp3]
[sound:k-1506_長女.mp3]	eldest daughter<br> <b>長女</b> <br> (ちょうじょ)
<b>連係プレー</b> <br> チームメンバー間の連係プレーが素晴らしかった。	[sound:s-1506_チームメンバー間の連係プレーが素晴らしかった。.mp3] <br> ちーむめんばーかんのれんけいぷれーがすばらしかった。 <br>The teamwork between the team members was excellent.
[sound:s-1506_チームメンバー間の連係プレーが素晴らしかった。.mp3]	<b>連係プレー</b> <br> チームメンバー間の連係プレーが素晴らしかった。<br> ちーむめんばーかんのれんけいぷれーがすばらしかった <br>The teamwork between the team members was excellent.
少女	[sound:k-1507_少女.mp3]<br>しょうじょ, おとめ <br> young lady, little girl, virgin, maiden, daughter
young lady, little girl, virgin, maiden, daughter	<b>少女<b> <br> しょうじょ, おとめ <br>[sound:k-1507_少女.mp3]
[sound:k-1507_少女.mp3]	young lady, little girl, virgin, maiden, daughter<br> <b>少女</b> <br> (しょうじょ, おとめ)
<b>感じ</b> <br> 彼女の言葉から彼の気持ちを感じ取れる。	[sound:s-1507_彼女の言葉から彼の気持ちを感じ取れる。.mp3] <br> かのじょのことばからかれのきもちをかんじとれる。 <br>You can sense his feelings from her words.
[sound:s-1507_彼女の言葉から彼の気持ちを感じ取れる。.mp3]	<b>感じ</b> <br> 彼女の言葉から彼の気持ちを感じ取れる。<br> かのじょのことばからかれのきもちをかんじとれる <br>You can sense his feelings from her words.
女子大	[sound:k-1508_女子大.mp3]<br>じょしだい <br> women's college, women's university
women's college, women's university	<b>女子大<b> <br> じょしだい <br>[sound:k-1508_女子大.mp3]
[sound:k-1508_女子大.mp3]	women's college, women's university<br> <b>女子大</b> <br> (じょしだい)
<b>感覚</b> <br> 暗闇での感覚は鋭敏になる。	[sound:s-1508_暗闇での感覚は鋭敏になる。.mp3] <br> くらやみでのかんかくはえいびんになる。 <br>Your senses become more acute in the darkness.
[sound:s-1508_暗闇での感覚は鋭敏になる。.mp3]	<b>感覚</b> <br> 暗闇での感覚は鋭敏になる。<br> くらやみでのかんかくはえいびんになる <br>Your senses become more acute in the darkness.
女の子	[sound:k-1509_女の子.mp3]<br>おんなのこ, おんなのコ, おんにゃのこ <br> girl
girl	<b>女の子<b> <br> おんなのこ, おんなのコ, おんにゃのこ <br>[sound:k-1509_女の子.mp3]
[sound:k-1509_女の子.mp3]	girl<br> <b>女の子</b> <br> (おんなのこ, おんなのコ, おんにゃのこ)
<b>感染</b> <br> 新型ウイルスの感染が拡大しています。	[sound:s-1509_新型ウイルスの感染が拡大しています。.mp3] <br> しんがたういるすのかんせんがかくだいしています。 <br>The spread of the new virus infection is expanding.
[sound:s-1509_新型ウイルスの感染が拡大しています。.mp3]	<b>感染</b> <br> 新型ウイルスの感染が拡大しています。<br> しんがたういるすのかんせんがかくだいしています <br>The spread of the new virus infection is expanding.
初	[sound:k-1510_初.mp3]<br>はつ <br> first, new
first, new	<b>初<b> <br> はつ <br>[sound:k-1510_初.mp3]
[sound:k-1510_初.mp3]	first, new<br> <b>初</b> <br> (はつ)
<b>感じる</b> <br> 彼の言葉には深い愛情が感じられる。	[sound:s-1510_彼の言葉には深い愛情が感じられる。.mp3] <br> かれのことばにはふかいあいじょうがかんじられる。 <br>You can feel deep affection in his words.
[sound:s-1510_彼の言葉には深い愛情が感じられる。.mp3]	<b>感じる</b> <br> 彼の言葉には深い愛情が感じられる。<br> かれのことばにはふかいあいじょうがかんじられる <br>You can feel deep affection in his words.
最初	[sound:k-1511_最初.mp3]<br>さいしょ <br> beginning, outset, first, onset
beginning, outset, first, onset	<b>最初<b> <br> さいしょ <br>[sound:k-1511_最初.mp3]
[sound:k-1511_最初.mp3]	beginning, outset, first, onset<br> <b>最初</b> <br> (さいしょ)
<b>感情</b> <br> 彼女の顔には複雑な感情が浮かんでいる。	[sound:s-1511_彼女の顔には複雑な感情が浮かんでいる。.mp3] <br> かのじょのかおにはふくざつなかんじょうがうかんでいる。 <br>Complex emotions are evident on her face.
[sound:s-1511_彼女の顔には複雑な感情が浮かんでいる。.mp3]	<b>感情</b> <br> 彼女の顔には複雑な感情が浮かんでいる。<br> かのじょのかおにはふくざつなかんじょうがうかんでいる <br>Complex emotions are evident on her face.
当初	[sound:k-1512_当初.mp3]<br>とうしょ <br> at first
at first	<b>当初<b> <br> とうしょ <br>[sound:k-1512_当初.mp3]
[sound:k-1512_当初.mp3]	at first<br> <b>当初</b> <br> (とうしょ)
<b>感想</b> <br> 映画を見た後、彼は感想を述べた。	[sound:s-1512_映画を見た後、彼は感想を述べた。.mp3] <br> えいがをみたあと、かれはかんそうをのべた。 <br>"After watching the movie, he gave his impressions."
[sound:s-1512_映画を見た後、彼は感想を述べた。.mp3]	<b>感想</b> <br> 映画を見た後、彼は感想を述べた。<br> えいがをみたあと、かれはかんそうをのべた <br>After watching the movie, he gave his impressions.
初日	[sound:k-1513_初日.mp3]<br>しょにち <br> first or opening day
first or opening day	<b>初日<b> <br> しょにち <br>[sound:k-1513_初日.mp3]
[sound:k-1513_初日.mp3]	first or opening day<br> <b>初日</b> <br> (しょにち)
<b>感動</b> <br> 彼の演技に多くの観客が感動した。	[sound:s-1513_彼の演技に多くの観客が感動した。.mp3] <br> かれのえんぎにおおくのかんきゃくがかんどうした。 <br>Many spectators were moved by his performance.
[sound:s-1513_彼の演技に多くの観客が感動した。.mp3]	<b>感動</b> <br> 彼の演技に多くの観客が感動した。<br> かれのえんぎにおおくのかんきゃくがかんどうした <br>Many spectators were moved by his performance.
初期	[sound:k-1514_初期.mp3]<br>しょき <br> early (days), initial stage; initial
early (days), initial stage; initial	<b>初期<b> <br> しょき <br>[sound:k-1514_初期.mp3]
[sound:k-1514_初期.mp3]	early<br> <b>days), initial stage; initial (初期</b> <br> (しょき)
<b>感謝</b> <br> 彼女は友人に対して感謝の気持ちを伝えた。	[sound:s-1514_彼女は友人に対して感謝の気持ちを伝えた。.mp3] <br> かのじょはゆうじんにたいしてかんしゃのきもちをつたえた。 <br>She expressed her gratitude to her friend.
[sound:s-1514_彼女は友人に対して感謝の気持ちを伝えた。.mp3]	<b>感謝</b> <br> 彼女は友人に対して感謝の気持ちを伝えた。<br> かのじょはゆうじんにたいしてかんしゃのきもちをつたえた <br>She expressed her gratitude to her friend.
初代	[sound:k-1515_初代.mp3]<br>しょだい <br> first generation, founder
first generation, founder	<b>初代<b> <br> しょだい <br>[sound:k-1515_初代.mp3]
[sound:k-1515_初代.mp3]	first generation, founder<br> <b>初代</b> <br> (しょだい)
<b>感性</b> <br> 彼は芸術家として独特の感性を持っている。	[sound:s-1515_彼は芸術家として独特の感性を持っている。.mp3] <br> かれはげいじゅつかとしてどくとくのかんせいをもっている。 <br>He has a unique sensibility as an artist.
[sound:s-1515_彼は芸術家として独特の感性を持っている。.mp3]	<b>感性</b> <br> 彼は芸術家として独特の感性を持っている。<br> かれはげいじゅつかとしてどくとくのかんせいをもっている <br>He has a unique sensibility as an artist.
初戦	[sound:k-1516_初戦.mp3]<br>しょせん <br> first match (in a series)
first match (in a series)	<b>初戦<b> <br> しょせん <br>[sound:k-1516_初戦.mp3]
[sound:k-1516_初戦.mp3]	first match<br> <b>in a series) (初戦</b> <br> (しょせん)
<b>実感</b> <br> 長い間の努力の結果、ようやく実感が湧いてきた。	[sound:s-1516_長い間の努力の結果、ようやく実感が湧いてきた。.mp3] <br> ながいかんのどりょくのけっか、ようやくじっかんがわいてきた。 <br>"After long efforts, I finally feel a sense of accomplishment."
[sound:s-1516_長い間の努力の結果、ようやく実感が湧いてきた。.mp3]	<b>実感</b> <br> 長い間の努力の結果、ようやく実感が湧いてきた。<br> ながいかんのどりょくのけっか、ようやくじっかんがわいてきた <br>After long efforts, I finally feel a sense of accomplishment.
初演	[sound:k-1517_初演.mp3]<br>しょえん <br> first performance
first performance	<b>初演<b> <br> しょえん <br>[sound:k-1517_初演.mp3]
[sound:k-1517_初演.mp3]	first performance<br> <b>初演</b> <br> (しょえん)
<b>特に</b> <br> 彼は特にその問題に興味がある。	[sound:s-1517_彼は特にその問題に興味がある。.mp3] <br> かれはとくにそのもんだいにきょうみがある。 <br>He is particularly interested in that issue.
[sound:s-1517_彼は特にその問題に興味がある。.mp3]	<b>特に</b> <br> 彼は特にその問題に興味がある。<br> かれはとくにそのもんだいにきょうみがある <br>He is particularly interested in that issue.
初旬	[sound:k-1518_初旬.mp3]<br>しょじゅん <br> first 10 days of the month
first 10 days of the month	<b>初旬<b> <br> しょじゅん <br>[sound:k-1518_初旬.mp3]
[sound:k-1518_初旬.mp3]	first 10 days of the month<br> <b>初旬</b> <br> (しょじゅん)
<b>特別</b> <br> 彼女は特別な能力を持っています。	[sound:s-1518_彼女は特別な能力を持っています。.mp3] <br> かのじょはとくべつなのうりょくをもっています。 <br>She has special abilities.
[sound:s-1518_彼女は特別な能力を持っています。.mp3]	<b>特別</b> <br> 彼女は特別な能力を持っています。<br> かのじょはとくべつなのうりょくをもっています <br>She has special abilities.
初場所	[sound:k-1519_初場所.mp3]<br>はつばしょ <br> New Year's (January) sumo tournament, held in Tokyo
New Year's (January) sumo tournament, held in Tokyo	<b>初場所<b> <br> はつばしょ <br>[sound:k-1519_初場所.mp3]
[sound:k-1519_初場所.mp3]	New Year's<br> <b>January) sumo tournament, held in Tokyo (初場所</b> <br> (はつばしょ)
<b>特徴</b> <br> この機械の特徴を説明してください。	[sound:s-1519_この機械の特徴を説明してください。.mp3] <br> このきかいのとくちょうをせつめいしてください。 <br>Please explain the features of this machine.
[sound:s-1519_この機械の特徴を説明してください。.mp3]	<b>特徴</b> <br> この機械の特徴を説明してください。<br> このきかいのとくちょうをせつめいしてください <br>Please explain the features of this machine.
北	[sound:k-1520_北.mp3]<br>きた <br> north
north	<b>北<b> <br> きた <br>[sound:k-1520_北.mp3]
[sound:k-1520_北.mp3]	north<br> <b>北</b> <br> (きた)
<b>特定</b> <br> 犯人の特定には時間がかかるかもしれません。	[sound:s-1520_犯人の特定には時間がかかるかもしれません。.mp3] <br> はんにんのとくていにはじかんがかかるかもしれません。 <br>It may take time to identify the culprit.
[sound:s-1520_犯人の特定には時間がかかるかもしれません。.mp3]	<b>特定</b> <br> 犯人の特定には時間がかかるかもしれません。<br> はんにんのとくていにはじかんがかかるかもしれません <br>It may take time to identify the culprit.
北海道	[sound:k-1521_北海道.mp3]<br>ほっかいどう <br> Hokkaido (northernmost of the four main islands of Japan)
Hokkaido (northernmost of the four main islands of Japan)	<b>北海道<b> <br> ほっかいどう <br>[sound:k-1521_北海道.mp3]
[sound:k-1521_北海道.mp3]	Hokkaido<br> <b>northernmost of the four main islands of Japan) (北海道</b> <br> (ほっかいどう)
<b>特捜</b> <br> 特捜班が事件の捜査を行っている。	[sound:s-1521_特捜班が事件の捜査を行っている。.mp3] <br> とくそうはんがじけんのそうさをおこなっている。 <br>The special investigation team is conducting an inquiry into the case.
[sound:s-1521_特捜班が事件の捜査を行っている。.mp3]	<b>特捜</b> <br> 特捜班が事件の捜査を行っている。<br> とくそうはんがじけんのそうさをおこなっている <br>The special investigation team is conducting an inquiry into the case.
北京	[sound:k-1522_北京.mp3]<br>ぺきん <br> Beijing (China), Peking
Beijing (China), Peking	<b>北京<b> <br> ぺきん <br>[sound:k-1522_北京.mp3]
[sound:k-1522_北京.mp3]	Beijing<br> <b>China), Peking (北京</b> <br> (ぺきん)
<b>特殊</b> <br> その装置は特殊な材料で作られています。	[sound:s-1522_その装置は特殊な材料で作られています。.mp3] <br> そのそうちはとくしゅなざいりょうでつくられています。 <br>That device is made with special materials.
[sound:s-1522_その装置は特殊な材料で作られています。.mp3]	<b>特殊</b> <br> その装置は特殊な材料で作られています。<br> そのそうちはとくしゅなざいりょうでつくられています <br>That device is made with special materials.
北朝鮮	[sound:k-1523_北朝鮮.mp3]<br>きたちょうせん <br> North Korea
North Korea	<b>北朝鮮<b> <br> きたちょうせん <br>[sound:k-1523_北朝鮮.mp3]
[sound:k-1523_北朝鮮.mp3]	North Korea<br> <b>北朝鮮</b> <br> (きたちょうせん)
<b>特例</b> <br> この場合、特例が適用されます。	[sound:s-1523_この場合、特例が適用されます。.mp3] <br> このばあい、とくれいがてきようされます。 <br>"In this case, an exception will be made."
[sound:s-1523_この場合、特例が適用されます。.mp3]	<b>特例</b> <br> この場合、特例が適用されます。<br> このばあい、とくれいがてきようされます <br>In this case, an exception will be made.
東北	[sound:k-1524_東北.mp3]<br>とうほく, ひがしきた <br> north-east; Northern most six prefectures of Honshu
north-east; Northern most six prefectures of Honshu	<b>東北<b> <br> とうほく, ひがしきた <br>[sound:k-1524_東北.mp3]
[sound:k-1524_東北.mp3]	north-east; Northern most six prefectures of Honshu<br> <b>東北</b> <br> (とうほく, ひがしきた)
<b>独特</b> <br> その店は独特の雰囲気がある。	[sound:s-1524_その店は独特の雰囲気がある。.mp3] <br> そのみせはどくとくのふんいきがある。 <br>That store has a unique atmosphere.
[sound:s-1524_その店は独特の雰囲気がある。.mp3]	<b>独特</b> <br> その店は独特の雰囲気がある。<br> そのみせはどくとくのふんいきがある <br>That store has a unique atmosphere.
南北	[sound:k-1525_南北.mp3]<br>なんぼく <br> south and north
south and north	<b>南北<b> <br> なんぼく <br>[sound:k-1525_南北.mp3]
[sound:k-1525_南北.mp3]	south and north<br> <b>南北</b> <br> (なんぼく)
<b>特使</b> <br> 彼は特使として外交使節団に参加した。	[sound:s-1525_彼は特使として外交使節団に参加した。.mp3] <br> かれはとくしとしてがいこうしせつだんにさんかした。 <br>He participated in the diplomatic mission as a special envoy.
[sound:s-1525_彼は特使として外交使節団に参加した。.mp3]	<b>特使</b> <br> 彼は特使として外交使節団に参加した。<br> かれはとくしとしてがいこうしせつだんにさんかした <br>He participated in the diplomatic mission as a special envoy.
北方	[sound:k-1526_北方.mp3]<br>ほっぽう <br> northern (district), northward
northern (district), northward	<b>北方<b> <br> ほっぽう <br>[sound:k-1526_北方.mp3]
[sound:k-1526_北方.mp3]	northern<br> <b>district), northward (北方</b> <br> (ほっぽう)
<b>特集</b> <br> 今月の雑誌はペットに特集されています。	[sound:s-1526_今月の雑誌はペットに特集されています。.mp3] <br> こんげつのざっしはぺっとにとくしゅうされています。 <br>This month's magazine features pets.
[sound:s-1526_今月の雑誌はペットに特集されています。.mp3]	<b>特集</b> <br> 今月の雑誌はペットに特集されています。<br> こんげつのざっしはぺっとにとくしゅうされています <br>This month's magazine features pets.
北部	[sound:k-1527_北部.mp3]<br>ほくぶ <br> north, northern part
north, northern part	<b>北部<b> <br> ほくぶ <br>[sound:k-1527_北部.mp3]
[sound:k-1527_北部.mp3]	north, northern part<br> <b>北部</b> <br> (ほくぶ)
<b>情</b> <br> 彼の決断は常に情に基づいている。	[sound:s-1527_彼の決断は常に情に基づいている。.mp3] <br> かれのけつだんはつねにじょうにもとづいている。 <br>His decisions are always based on emotions.
[sound:s-1527_彼の決断は常に情に基づいている。.mp3]	<b>情</b> <br> 彼の決断は常に情に基づいている。<br> かれのけつだんはつねにじょうにもとづいている <br>His decisions are always based on emotions.
北東	[sound:k-1528_北東.mp3]<br>ほくとう, きたひがし <br> northeast
northeast	<b>北東<b> <br> ほくとう, きたひがし <br>[sound:k-1528_北東.mp3]
[sound:k-1528_北東.mp3]	northeast<br> <b>北東</b> <br> (ほくとう, きたひがし)
<b>事情</b> <br> 彼の家庭の事情を理解してください。	[sound:s-1528_彼の家庭の事情を理解してください。.mp3] <br> かれのかていのじじょうをりかいしてください。 <br>Please understand the circumstances of his family.
[sound:s-1528_彼の家庭の事情を理解してください。.mp3]	<b>事情</b> <br> 彼の家庭の事情を理解してください。<br> かれのかていのじじょうをりかいしてください <br>Please understand the circumstances of his family.
敗北	[sound:k-1529_敗北.mp3]<br>はいぼく <br> defeat; to be defeated
defeat; to be defeated	<b>敗北<b> <br> はいぼく <br>[sound:k-1529_敗北.mp3]
[sound:k-1529_敗北.mp3]	defeat; to be defeated<br> <b>敗北</b> <br> (はいぼく)
<b>情勢</b> <br> 国際情勢は不安定な状況です。	[sound:s-1529_国際情勢は不安定な状況です。.mp3] <br> こくさいじょうせいはふあんていなじょうきょうです。 <br>The international situation is unstable.
[sound:s-1529_国際情勢は不安定な状況です。.mp3]	<b>情勢</b> <br> 国際情勢は不安定な状況です。<br> こくさいじょうせいはふあんていなじょうきょうです <br>The international situation is unstable.
午後	[sound:k-1530_午後.mp3]<br>ごご <br> afternoon, p.m.
afternoon, p.m.	<b>午後<b> <br> ごご <br>[sound:k-1530_午後.mp3]
[sound:k-1530_午後.mp3]	afternoon, p.m.<br> <b>午後</b> <br> (ごご)
<b>情報</b> <br> このウェブサイトは最新の情報を提供しています。	[sound:s-1530_このウェブサイトは最新の情報を提供しています。.mp3] <br> このうぇぶさいとはさいしんのじょうほうをていきょうしています。 <br>This website provides the latest information.
[sound:s-1530_このウェブサイトは最新の情報を提供しています。.mp3]	<b>情報</b> <br> このウェブサイトは最新の情報を提供しています。<br> このうぇぶさいとはさいしんのじょうほうをていきょうしています <br>This website provides the latest information.
午前	[sound:k-1531_午前.mp3]<br>ごぜん <br> morning, a.m.
morning, a.m.	<b>午前<b> <br> ごぜん <br>[sound:k-1531_午前.mp3]
[sound:k-1531_午前.mp3]	morning, a.m.<br> <b>午前</b> <br> (ごぜん)
<b>表情</b> <br> 彼女の表情から彼女の気持ちが読み取れる。	[sound:s-1531_彼女の表情から彼女の気持ちが読み取れる。.mp3] <br> かのじょのひょうじょうからかのじょのきもちがよみとれる。 <br>You can read her feelings from her expression.
[sound:s-1531_彼女の表情から彼女の気持ちが読み取れる。.mp3]	<b>表情</b> <br> 彼女の表情から彼女の気持ちが読み取れる。<br> かのじょのひょうじょうからかのじょのきもちがよみとれる <br>You can read her feelings from her expression.
正午	[sound:k-1532_正午.mp3]<br>しょうご <br> noon, mid-day
noon, mid-day	<b>正午<b> <br> しょうご <br>[sound:k-1532_正午.mp3]
[sound:k-1532_正午.mp3]	noon, mid-day<br> <b>正午</b> <br> (しょうご)
<b>感情</b> <br> 彼の感情が高ぶっているのが見えた。	[sound:s-1532_彼の感情が高ぶっているのが見えた。.mp3] <br> かれのかんじょうがたかぶっているのがみえた。 <br>It was visible that his emotions were running high.
[sound:s-1532_彼の感情が高ぶっているのが見えた。.mp3]	<b>感情</b> <br> 彼の感情が高ぶっているのが見えた。<br> かれのかんじょうがたかぶっているのがみえた <br>It was visible that his emotions were running high.
午	[sound:k-1533_午.mp3]<br>うま <br> seventh sign of Chinese zodiac (The Horse, 11am-1pm, south, May)
seventh sign of Chinese zodiac (The Horse, 11am-1pm, south, May)	<b>午<b> <br> うま <br>[sound:k-1533_午.mp3]
[sound:k-1533_午.mp3]	seventh sign of Chinese zodiac<br> <b>The Horse, 11am-1pm, south, May) (午</b> <br> (うま)
<b>実情</b> <br> 彼の失業の実情を理解していなかった。	[sound:s-1533_彼の失業の実情を理解していなかった。.mp3] <br> かれのしつぎょうのじつじょうをりかいしていなかった。 <br>I didn't understand the true situation of his unemployment.
[sound:s-1533_彼の失業の実情を理解していなかった。.mp3]	<b>実情</b> <br> 彼の失業の実情を理解していなかった。<br> かれのしつぎょうのじつじょうをりかいしていなかった <br>I didn't understand the true situation of his unemployment.
午	[sound:k-1534_午.mp3]<br>ひる <br> noon, midday; daytime; lunch
noon, midday; daytime; lunch	<b>午<b> <br> ひる <br>[sound:k-1534_午.mp3]
[sound:k-1534_午.mp3]	noon, midday; daytime; lunch<br> <b>午</b> <br> (ひる)
<b>苦情</b> <br> 顧客からの苦情を真剣に受け止めるべきだ。	[sound:s-1534_顧客からの苦情を真剣に受け止めるべきだ。.mp3] <br> こきゃくからのくじょうをしんけんにうけとめるべきだ。 <br>We should take customer complaints seriously.
[sound:s-1534_顧客からの苦情を真剣に受け止めるべきだ。.mp3]	<b>苦情</b> <br> 顧客からの苦情を真剣に受け止めるべきだ。<br> こきゃくからのくじょうをしんけんにうけとめるべきだ <br>We should take customer complaints seriously.
子午線	[sound:k-1535_子午線.mp3]<br>しごせん <br> the meridian
the meridian	<b>子午線<b> <br> しごせん <br>[sound:k-1535_子午線.mp3]
[sound:k-1535_子午線.mp3]	the meridian<br> <b>子午線</b> <br> (しごせん)
<b>情熱</b> <br> 彼の仕事への情熱は誰にも負けない。	[sound:s-1535_彼の仕事への情熱は誰にも負けない。.mp3] <br> かれのしごとへのじょうねつはだれにもまけない。 <br>His passion for work is unmatched by anyone.
[sound:s-1535_彼の仕事への情熱は誰にも負けない。.mp3]	<b>情熱</b> <br> 彼の仕事への情熱は誰にも負けない。<br> かれのしごとへのじょうねつはだれにもまけない <br>His passion for work is unmatched by anyone.
端午	[sound:k-1536_端午.mp3]<br>たんご <br> Boy's Day celebration (May 5th)
Boy's Day celebration (May 5th)	<b>端午<b> <br> たんご <br>[sound:k-1536_端午.mp3]
[sound:k-1536_端午.mp3]	Boy's Day celebration<br> <b>May 5th) (端午</b> <br> (たんご)
<b>愛情</b> <br> 母は子供たちにたくさんの愛情を注いだ。	[sound:s-1536_母は子供たちにたくさんの愛情を注いだ。.mp3] <br> はははこどもたちにたくさんのあいじょうをそそいだ。 <br>The mother poured out much love to her children.
[sound:s-1536_母は子供たちにたくさんの愛情を注いだ。.mp3]	<b>愛情</b> <br> 母は子供たちにたくさんの愛情を注いだ。<br> はははこどもたちにたくさんのあいじょうをそそいだ <br>The mother poured out much love to her children.
午過ぎ	[sound:k-1537_午過ぎ.mp3]<br>ひるすぎ <br> after noon
after noon	<b>午過ぎ<b> <br> ひるすぎ <br>[sound:k-1537_午過ぎ.mp3]
[sound:k-1537_午過ぎ.mp3]	after noon<br> <b>午過ぎ</b> <br> (ひるすぎ)
<b>投資</b> <br> 彼は新しいビジネスに投資するつもりです。	[sound:s-1537_彼は新しいビジネスに投資するつもりです。.mp3] <br> かれはあたらしいびじねすにとうしするつもりです。 <br>He intends to invest in a new business.
[sound:s-1537_彼は新しいビジネスに投資するつもりです。.mp3]	<b>投資</b> <br> 彼は新しいビジネスに投資するつもりです。<br> かれはあたらしいびじねすにとうしするつもりです <br>He intends to invest in a new business.
午后	[sound:k-1538_午后.mp3]<br>ごご <br> afternoon, p.m.
afternoon, p.m.	<b>午后<b> <br> ごご <br>[sound:k-1538_午后.mp3]
[sound:k-1538_午后.mp3]	afternoon, p.m.<br> <b>午后</b> <br> (ごご)
<b>投手</b> <br> このチームの投手は非常に優れています。	[sound:s-1538_このチームの投手は非常に優れています。.mp3] <br> このちーむのとうしゅはひじょうにすぐれています。 <br>The pitcher of this team is very excellent.
[sound:s-1538_このチームの投手は非常に優れています。.mp3]	<b>投手</b> <br> このチームの投手は非常に優れています。<br> このちーむのとうしゅはひじょうにすぐれています <br>The pitcher of this team is very excellent.
午後中	[sound:k-1539_午後中.mp3]<br>ごごじゅう <br> throughout the afternoon
throughout the afternoon	<b>午後中<b> <br> ごごじゅう <br>[sound:k-1539_午後中.mp3]
[sound:k-1539_午後中.mp3]	throughout the afternoon<br> <b>午後中</b> <br> (ごごじゅう)
<b>投票</b> <br> 明日の選挙で投票する予定です。	[sound:s-1539_明日の選挙で投票する予定です。.mp3] <br> あしたのせんきょでとうひょうするよていです。 <br>I plan to vote in tomorrow's election.
[sound:s-1539_明日の選挙で投票する予定です。.mp3]	<b>投票</b> <br> 明日の選挙で投票する予定です。<br> あしたのせんきょでとうひょうするよていです <br>I plan to vote in tomorrow's election.
指	[sound:k-1540_指.mp3]<br>ゆび, および, おゆび <br> finger, toe, digit
finger, toe, digit	<b>指<b> <br> ゆび, および, おゆび <br>[sound:k-1540_指.mp3]
[sound:k-1540_指.mp3]	finger, toe, digit<br> <b>指</b> <br> (ゆび, および, おゆび)
<b>国民投票</b> <br> 政府は国民投票を実施することを決定した。	[sound:s-1540_政府は国民投票を実施することを決定した。.mp3] <br> せいふはこくみんとうひょうをじっしすることをけっていした。 <br>The government decided to hold a national referendum.
[sound:s-1540_政府は国民投票を実施することを決定した。.mp3]	<b>国民投票</b> <br> 政府は国民投票を実施することを決定した。<br> せいふはこくみんとうひょうをじっしすることをけっていした <br>The government decided to hold a national referendum.
指導	[sound:k-1541_指導.mp3]<br>しどう <br> leadership, guidance, coaching; shido (disciplinary action for a minor infringement of the rules of judo)
leadership, guidance, coaching; shido (disciplinary action for a minor infringement of the rules of judo)	<b>指導<b> <br> しどう <br>[sound:k-1541_指導.mp3]
[sound:k-1541_指導.mp3]	leadership, guidance, coaching; shido<br> <b>disciplinary action for a minor infringement of the rules of judo) (指導</b> <br> (しどう)
<b>投球</b> <br> 彼の投球は速く、正確です。	[sound:s-1541_彼の投球は速く、正確です。.mp3] <br> かれのとうきゅうははやく、せいかくです。 <br>His pitching is fast and accurate.
[sound:s-1541_彼の投球は速く、正確です。.mp3]	<b>投球</b> <br> 彼の投球は速く、正確です。<br> かれのとうきゅうははやく、せいかくです <br>His pitching is fast and accurate.
指揮	[sound:k-1542_指揮.mp3]<br>しき <br> command, direction
command, direction	<b>指揮<b> <br> しき <br>[sound:k-1542_指揮.mp3]
[sound:k-1542_指揮.mp3]	command, direction<br> <b>指揮</b> <br> (しき)
<b>完投</b> <br> 彼はこのシーズンで3回完投した。	[sound:s-1542_彼はこのシーズンで3回完投した。.mp3] <br> かれはこのしーずんで3かいかんとうした。 <br>He completed three games this season.
[sound:s-1542_彼はこのシーズンで3回完投した。.mp3]	<b>完投</b> <br> 彼はこのシーズンで3回完投した。<br> かれはこのしーずんで3かいかんとうした <br>He completed three games this season.
指定	[sound:k-1543_指定.mp3]<br>してい <br> designation, specification, assignment, appointment, pointing at
designation, specification, assignment, appointment, pointing at	<b>指定<b> <br> してい <br>[sound:k-1543_指定.mp3]
[sound:k-1543_指定.mp3]	designation, specification, assignment, appointment, pointing at<br> <b>指定</b> <br> (してい)
<b>継投</b> <br> 監督は継投を計画している。	[sound:s-1543_監督は継投を計画している。.mp3] <br> かんとくはけいとうをけいかくしている。 <br>The manager is planning to use relief pitchers.
[sound:s-1543_監督は継投を計画している。.mp3]	<b>継投</b> <br> 監督は継投を計画している。<br> かんとくはけいとうをけいかくしている <br>The manager is planning to use relief pitchers.
指名	[sound:k-1544_指名.mp3]<br>しめい <br> name, nominate, designate
name, nominate, designate	<b>指名<b> <br> しめい <br>[sound:k-1544_指名.mp3]
[sound:k-1544_指名.mp3]	name, nominate, designate<br> <b>指名</b> <br> (しめい)
<b>好投</b> <br> 今日の試合で彼は好投を見せた。	[sound:s-1544_今日の試合で彼は好投を見せた。.mp3] <br> きょうのしあいでかれはこうとうをみせた。 <br>He showed a great performance in today's game.
[sound:s-1544_今日の試合で彼は好投を見せた。.mp3]	<b>好投</b> <br> 今日の試合で彼は好投を見せた。<br> きょうのしあいでかれはこうとうをみせた <br>He showed a great performance in today's game.
指示	[sound:k-1545_指示.mp3]<br>しじ <br> indication, instruction, designation, directions
indication, instruction, designation, directions	<b>指示<b> <br> しじ <br>[sound:k-1545_指示.mp3]
[sound:k-1545_指示.mp3]	indication, instruction, designation, directions<br> <b>指示</b> <br> (しじ)
<b>投機</b> <br> 株式市場での投機はリスクが高い。	[sound:s-1545_株式市場での投機はリスクが高い。.mp3] <br> かぶしきしじょうでのとうきはりすくがたかい。 <br>Speculation in the stock market is high risk.
[sound:s-1545_株式市場での投機はリスクが高い。.mp3]	<b>投機</b> <br> 株式市場での投機はリスクが高い。<br> かぶしきしじょうでのとうきはりすくがたかい <br>Speculation in the stock market is high risk.
指摘	[sound:k-1546_指摘.mp3]<br>してき <br> pointing out, identification
pointing out, identification	<b>指摘<b> <br> してき <br>[sound:k-1546_指摘.mp3]
[sound:k-1546_指摘.mp3]	pointing out, identification<br> <b>指摘</b> <br> (してき)
<b>投棄</b> <br> ごみの適切な投棄は重要です。	[sound:s-1546_ごみの適切な投棄は重要です。.mp3] <br> ごみのてきせつなとうきはじゅうようです。 <br>Proper disposal of garbage is important.
[sound:s-1546_ごみの適切な投棄は重要です。.mp3]	<b>投棄</b> <br> ごみの適切な投棄は重要です。<br> ごみのてきせつなとうきはじゅうようです <br>Proper disposal of garbage is important.
指数	[sound:k-1547_指数.mp3]<br>しすう <br> index, index number, exponent (e.g. in floating-point representation), characteristic
index, index number, exponent (e.g. in floating-point representation), characteristic	<b>指数<b> <br> しすう <br>[sound:k-1547_指数.mp3]
[sound:k-1547_指数.mp3]	index, index number, exponent<br> <b>e.g. in floating-point representation), characteristic (指数</b> <br> (しすう)
<b>示す</b> <br> 彼は地図で道を示した。	[sound:s-1547_彼は地図で道を示した。.mp3] <br> かれはちずでみちをしめした。 <br>He showed the way on the map.
[sound:s-1547_彼は地図で道を示した。.mp3]	<b>示す</b> <br> 彼は地図で道を示した。<br> かれはちずでみちをしめした <br>He showed the way on the map.
指標	[sound:k-1548_指標.mp3]<br>しひょう <br> index, indices, indicator
index, indices, indicator	<b>指標<b> <br> しひょう <br>[sound:k-1548_指標.mp3]
[sound:k-1548_指標.mp3]	index, indices, indicator<br> <b>指標</b> <br> (しひょう)
<b>指示</b> <br> 上司から明確な指示が出た。	[sound:s-1548_上司から明確な指示が出た。.mp3] <br> じょうしけからめいかくなしじがでた。 <br>Clear instructions were given by the boss.
[sound:s-1548_上司から明確な指示が出た。.mp3]	<b>指示</b> <br> 上司から明確な指示が出た。<br> じょうしけからめいかくなしじがでた <br>Clear instructions were given by the boss.
指針	[sound:k-1549_指針.mp3]<br>ししん <br> compass needle (cursor), guideline, pointer
compass needle (cursor), guideline, pointer	<b>指針<b> <br> ししん <br>[sound:k-1549_指針.mp3]
[sound:k-1549_指針.mp3]	compass needle<br> <b>cursor), guideline, pointer (指針</b> <br> (ししん)
<b>表示</b> <br> 画面には時間が表示されています。	[sound:s-1549_画面には時間が表示されています。.mp3] <br> がめんにはじかんがひょうじされています。 <br>The time is displayed on the screen.
[sound:s-1549_画面には時間が表示されています。.mp3]	<b>表示</b> <br> 画面には時間が表示されています。<br> がめんにはじかんがひょうじされています <br>The time is displayed on the screen.
政権	[sound:k-1550_政権.mp3]<br>せいけん <br> (political) administration, political power
(political) administration, political power	<b>政権<b> <br> せいけん <br>[sound:k-1550_政権.mp3]
[sound:k-1550_政権.mp3]	(political) administration, political power<br> <b>政権</b> <br> (せいけん)
<b>展示</b> <br> 美術館で有名な絵画が展示されている。	[sound:s-1550_美術館で有名な絵画が展示されている。.mp3] <br> びじゅつかんでゆうめいなかいがてんじされている。 <br>Famous paintings are on display at the art museum.
[sound:s-1550_美術館で有名な絵画が展示されている。.mp3]	<b>展示</b> <br> 美術館で有名な絵画が展示されている。<br> びじゅつかんでゆうめいなかいがてんじされている <br>Famous paintings are on display at the art museum.
選手権	[sound:k-1551_選手権.mp3]<br>せんしゅけん <br> championship, title (of champion)
championship, title (of champion)	<b>選手権<b> <br> せんしゅけん <br>[sound:k-1551_選手権.mp3]
[sound:k-1551_選手権.mp3]	championship, title<br> <b>of champion) (選手権</b> <br> (せんしゅけん)
<b>開示</b> <br> 機密情報の開示は許可されていません。	[sound:s-1551_機密情報の開示は許可されていません。.mp3] <br> きみつじょうほうのかいじはきょかされていません。 <br>Disclosure of confidential information is not permitted.
[sound:s-1551_機密情報の開示は許可されていません。.mp3]	<b>開示</b> <br> 機密情報の開示は許可されていません。<br> きみつじょうほうのかいじはきょかされていません <br>Disclosure of confidential information is not permitted.
権利	[sound:k-1552_権利.mp3]<br>けんり <br> right, privilege
right, privilege	<b>権利<b> <br> けんり <br>[sound:k-1552_権利.mp3]
[sound:k-1552_権利.mp3]	right, privilege<br> <b>権利</b> <br> (けんり)
<b>告示</b> <br> イベントの告示がポスターで行われた。	[sound:s-1552_イベントの告示がポスターで行われた。.mp3] <br> いべんとのこくじがぽすたーでおこなわれた。 <br>The announcement of the event was made with posters.
[sound:s-1552_イベントの告示がポスターで行われた。.mp3]	<b>告示</b> <br> イベントの告示がポスターで行われた。<br> いべんとのこくじがぽすたーでおこなわれた <br>The announcement of the event was made with posters.
権力	[sound:k-1553_権力.mp3]<br>けんりょく <br> (political) power, authority, influence
(political) power, authority, influence	<b>権力<b> <br> けんりょく <br>[sound:k-1553_権力.mp3]
[sound:k-1553_権力.mp3]	(political) power, authority, influence<br> <b>権力</b> <br> (けんりょく)
<b>公示</b> <br> 政府からの公示が発表された。	[sound:s-1553_政府からの公示が発表された。.mp3] <br> せいふからのこうじがはっぴょうされた。 <br>The government's public announcement was made.
[sound:s-1553_政府からの公示が発表された。.mp3]	<b>公示</b> <br> 政府からの公示が発表された。<br> せいふからのこうじがはっぴょうされた <br>The government's public announcement was made.
人権	[sound:k-1554_人権.mp3]<br>じんけん <br> human rights, civil liberties
human rights, civil liberties	<b>人権<b> <br> じんけん <br>[sound:k-1554_人権.mp3]
[sound:k-1554_人権.mp3]	human rights, civil liberties<br> <b>人権</b> <br> (じんけん)
<b>示し</b> <br> 彼の行動は彼の本当の気持ちを示している。	[sound:s-1554_彼の行動は彼の本当の気持ちを示している。.mp3] <br> かれのこうどうはかれのほんとうのきもちをしめしている。 <br>His actions reveal his true feelings.
[sound:s-1554_彼の行動は彼の本当の気持ちを示している。.mp3]	<b>示し</b> <br> 彼の行動は彼の本当の気持ちを示している。<br> かれのこうどうはかれのほんとうのきもちをしめしている <br>His actions reveal his true feelings.
権限	[sound:k-1555_権限.mp3]<br>けんげん <br> power, authority, jurisdiction
power, authority, jurisdiction	<b>権限<b> <br> けんげん <br>[sound:k-1555_権限.mp3]
[sound:k-1555_権限.mp3]	power, authority, jurisdiction<br> <b>権限</b> <br> (けんげん)
<b>提示</b> <br> 彼はプレゼンテーションで提案を提示した。	[sound:s-1555_彼はプレゼンテーションで提案を提示した。.mp3] <br> かれはぷれぜんてーしょんでていあんをていじした。 <br>He presented his proposal in the presentation.
[sound:s-1555_彼はプレゼンテーションで提案を提示した。.mp3]	<b>提示</b> <br> 彼はプレゼンテーションで提案を提示した。<br> かれはぷれぜんてーしょんでていあんをていじした <br>He presented his proposal in the presentation.
債権	[sound:k-1556_債権.mp3]<br>さいけん <br> credit, claim
credit, claim	<b>債権<b> <br> さいけん <br>[sound:k-1556_債権.mp3]
[sound:k-1556_債権.mp3]	credit, claim<br> <b>債権</b> <br> (さいけん)
<b>意思表示</b> <br> 彼は交渉に参加する意思表示をした。	[sound:s-1556_彼は交渉に参加する意思表示をした。.mp3] <br> かれはこうしょうにさんかするいしひょうじをした。 <br>He indicated his intention to participate in the negotiation.
[sound:s-1556_彼は交渉に参加する意思表示をした。.mp3]	<b>意思表示</b> <br> 彼は交渉に参加する意思表示をした。<br> かれはこうしょうにさんかするいしひょうじをした <br>He indicated his intention to participate in the negotiation.
有権者	[sound:k-1557_有権者.mp3]<br>ゆうけんしゃ <br> voter, constituent, (electoral) franchise-holder, (the) electorate, eligible voters
voter, constituent, (electoral) franchise-holder, (the) electorate, eligible voters	<b>有権者<b> <br> ゆうけんしゃ <br>[sound:k-1557_有権者.mp3]
[sound:k-1557_有権者.mp3]	voter, constituent,<br> <b>electoral) franchise-holder, (the) electorate, eligible voters (有権者</b> <br> (ゆうけんしゃ)
<b>変わった</b> <br> 彼の服装はいつもと変わった。	[sound:s-1557_彼の服装はいつもと変わった。.mp3] <br> かれのふくそうはいつもとかわった。 <br>His attire was different from usual.
[sound:s-1557_彼の服装はいつもと変わった。.mp3]	<b>変わった</b> <br> 彼の服装はいつもと変わった。<br> かれのふくそうはいつもとかわった <br>His attire was different from usual.
主権	[sound:k-1558_主権.mp3]<br>しゅけん <br> sovereignty, supremacy, dominion
sovereignty, supremacy, dominion	<b>主権<b> <br> しゅけん <br>[sound:k-1558_主権.mp3]
[sound:k-1558_主権.mp3]	sovereignty, supremacy, dominion<br> <b>主権</b> <br> (しゅけん)
<b>変わらない</b> <br> 彼女の笑顔はいつも変わらない。	[sound:s-1558_彼女の笑顔はいつも変わらない。.mp3] <br> かのじょのえがおはいつもかわらない。 <br>Her smile never changes.
[sound:s-1558_彼女の笑顔はいつも変わらない。.mp3]	<b>変わらない</b> <br> 彼女の笑顔はいつも変わらない。<br> かのじょのえがおはいつもかわらない <br>Her smile never changes.
権	[sound:k-1559_権.mp3]<br>けん <br> authority, right (to do something)
authority, right (to do something)	<b>権<b> <br> けん <br>[sound:k-1559_権.mp3]
[sound:k-1559_権.mp3]	authority, right<br> <b>to do something) (権</b> <br> (けん)
<b>変わる</b> <br> この町は最近大きく変わった。	[sound:s-1559_この町は最近大きく変わった。.mp3] <br> このまちはさいきんおおきくかわった。 <br>This town has changed dramatically recently.
[sound:s-1559_この町は最近大きく変わった。.mp3]	<b>変わる</b> <br> この町は最近大きく変わった。<br> このまちはさいきんおおきくかわった <br>This town has changed dramatically recently.
関心	[sound:k-1560_関心.mp3]<br>かんしん <br> concern, interest
concern, interest	<b>関心<b> <br> かんしん <br>[sound:k-1560_関心.mp3]
[sound:k-1560_関心.mp3]	concern, interest<br> <b>関心</b> <br> (かんしん)
<b>変わり</b> <br> 天気の変わりが激しい。	[sound:s-1560_天気の変わりが激しい。.mp3] <br> てんきのかわりがはげしい。 <br>The weather changes drastically.
[sound:s-1560_天気の変わりが激しい。.mp3]	<b>変わり</b> <br> 天気の変わりが激しい。<br> てんきのかわりがはげしい <br>The weather changes drastically.
中心	[sound:k-1561_中心.mp3]<br>ちゅうしん <br> center, centre, middle, heart, core, focus, pivot, emphasis, balance
center, centre, middle, heart, core, focus, pivot, emphasis, balance	<b>中心<b> <br> ちゅうしん <br>[sound:k-1561_中心.mp3]
[sound:k-1561_中心.mp3]	center, centre, middle, heart, core, focus, pivot, emphasis, balance<br> <b>中心</b> <br> (ちゅうしん)
<b>変化</b> <br> 私の人生に大きな変化が起こった。	[sound:s-1561_私の人生に大きな変化が起こった。.mp3] <br> わたしのじんせいにおおきなへんかがおこった。 <br>There has been a significant change in my life.
[sound:s-1561_私の人生に大きな変化が起こった。.mp3]	<b>変化</b> <br> 私の人生に大きな変化が起こった。<br> わたしのじんせいにおおきなへんかがおこった <br>There has been a significant change in my life.
心不全	[sound:k-1562_心不全.mp3]<br>しんふぜん <br> heart failure
heart failure	<b>心不全<b> <br> しんふぜん <br>[sound:k-1562_心不全.mp3]
[sound:k-1562_心不全.mp3]	heart failure<br> <b>心不全</b> <br> (しんふぜん)
<b>大変</b> <br> 彼は大変忙しい仕事をしている。	[sound:s-1562_彼は大変忙しい仕事をしている。.mp3] <br> かれはたいへんいそがしいしごとをしている。 <br>He is very busy with work.
[sound:s-1562_彼は大変忙しい仕事をしている。.mp3]	<b>大変</b> <br> 彼は大変忙しい仕事をしている。<br> かれはたいへんいそがしいしごとをしている <br>He is very busy with work.
心から	[sound:k-1563_心から.mp3]<br>しんから, こころから <br> from the bottom of one's heart, heart and soul, by nature
from the bottom of one's heart, heart and soul, by nature	<b>心から<b> <br> しんから, こころから <br>[sound:k-1563_心から.mp3]
[sound:k-1563_心から.mp3]	from the bottom of one's heart, heart and soul, by nature<br> <b>心から</b> <br> (しんから, こころから)
<b>変更</b> <br> 予定が変更された。	[sound:s-1563_予定が変更された。.mp3] <br> よていがへんこうされた。 <br>The schedule has been changed.
[sound:s-1563_予定が変更された。.mp3]	<b>変更</b> <br> 予定が変更された。<br> よていがへんこうされた <br>The schedule has been changed.
心臓	[sound:k-1564_心臓.mp3]<br>しんぞう <br> heart
heart	<b>心臓<b> <br> しんぞう <br>[sound:k-1564_心臓.mp3]
[sound:k-1564_心臓.mp3]	heart<br> <b>心臓</b> <br> (しんぞう)
<b>変動</b> <br> 通貨市場は常に変動している。	[sound:s-1564_通貨市場は常に変動している。.mp3] <br> つうかしじょうはつねにへんどうしている。 <br>The currency market is constantly fluctuating.
[sound:s-1564_通貨市場は常に変動している。.mp3]	<b>変動</b> <br> 通貨市場は常に変動している。<br> つうかしじょうはつねにへんどうしている <br>The currency market is constantly fluctuating.
心配	[sound:k-1565_心配.mp3]<br>しんぱい <br> worry, concern, anxiety; care, help, aid, assistance
worry, concern, anxiety; care, help, aid, assistance	<b>心配<b> <br> しんぱい <br>[sound:k-1565_心配.mp3]
[sound:k-1565_心配.mp3]	worry, concern, anxiety; care, help, aid, assistance<br> <b>心配</b> <br> (しんぱい)
<b>変</b> <br> 彼の考え方は少し変だ。	[sound:s-1565_彼の考え方は少し変だ。.mp3] <br> かれのかんがえかたはすこしへんだ。 <br>His way of thinking is a bit strange.
[sound:s-1565_彼の考え方は少し変だ。.mp3]	<b>変</b> <br> 彼の考え方は少し変だ。<br> かれのかんがえかたはすこしへんだ <br>His way of thinking is a bit strange.
心理	[sound:k-1566_心理.mp3]<br>しんり <br> mentality
mentality	<b>心理<b> <br> しんり <br>[sound:k-1566_心理.mp3]
[sound:k-1566_心理.mp3]	mentality<br> <b>心理</b> <br> (しんり)
<b>変革</b> <br> 新しいリーダーシップによって変革が進められている。	[sound:s-1566_新しいリーダーシップによって変革が進められている。.mp3] <br> あたらしいりーだーしっぷによってへんかくがすすめられている。 <br>Transformation is being driven by new leadership.
[sound:s-1566_新しいリーダーシップによって変革が進められている。.mp3]	<b>変革</b> <br> 新しいリーダーシップによって変革が進められている。<br> あたらしいりーだーしっぷによってへんかくがすすめられている <br>Transformation is being driven by new leadership.
安心	[sound:k-1567_安心.mp3]<br>あんしん <br> relief, peace of mind
relief, peace of mind	<b>安心<b> <br> あんしん <br>[sound:k-1567_安心.mp3]
[sound:k-1567_安心.mp3]	relief, peace of mind<br> <b>安心</b> <br> (あんしん)
<b>打つ</b> <br> 彼はボールを強く打った。	[sound:s-1567_彼はボールを強く打った。.mp3] <br> かれはぼーるをつよくうった。 <br>He hit the ball hard.
[sound:s-1567_彼はボールを強く打った。.mp3]	<b>打つ</b> <br> 彼はボールを強く打った。<br> かれはぼーるをつよくうった <br>He hit the ball hard.
都心	[sound:k-1568_都心.mp3]<br>としん <br> city centre (center) (esp. capital city), urban centre, heart of city a metropolis
city centre (center) (esp. capital city), urban centre, heart of city a metropolis	<b>都心<b> <br> としん <br>[sound:k-1568_都心.mp3]
[sound:k-1568_都心.mp3]	city centre<br> <b>center) (esp. capital city), urban centre, heart of city a metropolis (都心</b> <br> (としん)
<b>本塁打</b> <br> 彼は今シーズンで多くの本塁打を打った。	[sound:s-1568_彼は今シーズンで多くの本塁打を打った。.mp3] <br> かれはこんしーずんでおおくのほんるいだをうった。 <br>He hit many home runs this season.
[sound:s-1568_彼は今シーズンで多くの本塁打を打った。.mp3]	<b>本塁打</b> <br> 彼は今シーズンで多くの本塁打を打った。<br> かれはこんしーずんでおおくのほんるいだをうった <br>He hit many home runs this season.
熱心	[sound:k-1569_熱心.mp3]<br>ねっしん <br> zeal, enthusiasm
zeal, enthusiasm	<b>熱心<b> <br> ねっしん <br>[sound:k-1569_熱心.mp3]
[sound:k-1569_熱心.mp3]	zeal, enthusiasm<br> <b>熱心</b> <br> (ねっしん)
<b>打撃</b> <br> 彼の打撃はチームに勇気を与えた。	[sound:s-1569_彼の打撃はチームに勇気を与えた。.mp3] <br> かれのだげきはちーむにゆうきをあたえた。 <br>His batting gave courage to the team.
[sound:s-1569_彼の打撃はチームに勇気を与えた。.mp3]	<b>打撃</b> <br> 彼の打撃はチームに勇気を与えた。<br> かれのだげきはちーむにゆうきをあたえた <br>His batting gave courage to the team.
業界	[sound:k-1570_業界.mp3]<br>ぎょうかい <br> industry, business
industry, business	<b>業界<b> <br> ぎょうかい <br>[sound:k-1570_業界.mp3]
[sound:k-1570_業界.mp3]	industry, business<br> <b>業界</b> <br> (ぎょうかい)
<b>打線</b> <br> このチームの打線はとても強力だ。	[sound:s-1570_このチームの打線はとても強力だ。.mp3] <br> このちーむのだせんはとてもきょうりょくだ。 <br>The batting lineup of this team is very powerful.
[sound:s-1570_このチームの打線はとても強力だ。.mp3]	<b>打線</b> <br> このチームの打線はとても強力だ。<br> このちーむのだせんはとてもきょうりょくだ <br>The batting lineup of this team is very powerful.
世界	[sound:k-1571_世界.mp3]<br>せかい <br> the world, society, the universe
the world, society, the universe	<b>世界<b> <br> せかい <br>[sound:k-1571_世界.mp3]
[sound:k-1571_世界.mp3]	the world, society, the universe<br> <b>世界</b> <br> (せかい)
<b>安打</b> <br> 彼はその試合で安打を記録した。	[sound:s-1571_彼はその試合で安打を記録した。.mp3] <br> かれはそのしあいであんだをきろくした。 <br>He recorded a base hit in that game.
[sound:s-1571_彼はその試合で安打を記録した。.mp3]	<b>安打</b> <br> 彼はその試合で安打を記録した。<br> かれはそのしあいであんだをきろくした <br>He recorded a base hit in that game.
政界	[sound:k-1572_政界.mp3]<br>せいかい <br> political world
political world	<b>政界<b> <br> せいかい <br>[sound:k-1572_政界.mp3]
[sound:k-1572_政界.mp3]	political world<br> <b>政界</b> <br> (せいかい)
<b>打者</b> <br> 彼は優れた打者です。	[sound:s-1572_彼は優れた打者です。.mp3] <br> かれはすぐれただしゃです。 <br>He is an excellent batter.
[sound:s-1572_彼は優れた打者です。.mp3]	<b>打者</b> <br> 彼は優れた打者です。<br> かれはすぐれただしゃです <br>He is an excellent batter.
財界	[sound:k-1573_財界.mp3]<br>ざいかい <br> financial world
financial world	<b>財界<b> <br> ざいかい <br>[sound:k-1573_財界.mp3]
[sound:k-1573_財界.mp3]	financial world<br> <b>財界</b> <br> (ざいかい)
<b>二塁打</b> <br> 彼はその試合で二塁打を打った。	[sound:s-1573_彼はその試合で二塁打を打った。.mp3] <br> かれはそのしあいでにるいだをうった。 <br>He hit a double in that game.
[sound:s-1573_彼はその試合で二塁打を打った。.mp3]	<b>二塁打</b> <br> 彼はその試合で二塁打を打った。<br> かれはそのしあいでにるいだをうった <br>He hit a double in that game.
限界	[sound:k-1574_限界.mp3]<br>げんかい <br> limit, bound
limit, bound	<b>限界<b> <br> げんかい <br>[sound:k-1574_限界.mp3]
[sound:k-1574_限界.mp3]	limit, bound<br> <b>限界</b> <br> (げんかい)
<b>打席</b> <br> 彼はその試合で多くの打席を得た。	[sound:s-1574_彼はその試合で多くの打席を得た。.mp3] <br> かれはそのしあいでおおくのだせきをえた。 <br>He had many at-bats in that game.
[sound:s-1574_彼はその試合で多くの打席を得た。.mp3]	<b>打席</b> <br> 彼はその試合で多くの打席を得た。<br> かれはそのしあいでおおくのだせきをえた <br>He had many at-bats in that game.
世界的	[sound:k-1575_世界的.mp3]<br>せかいてき <br> global, international, world-famous
global, international, world-famous	<b>世界的<b> <br> せかいてき <br>[sound:k-1575_世界的.mp3]
[sound:k-1575_世界的.mp3]	global, international, world-famous<br> <b>世界的</b> <br> (せかいてき)
<b>打ち上げ</b> <br> 大会後に選手たちは打ち上げを行った。	[sound:s-1575_大会後に選手たちは打ち上げを行った。.mp3] <br> たいかいごにせんしゅたちはうちあげをおこなった。 <br>The players held a celebration party after the tournament.
[sound:s-1575_大会後に選手たちは打ち上げを行った。.mp3]	<b>打ち上げ</b> <br> 大会後に選手たちは打ち上げを行った。<br> たいかいごにせんしゅたちはうちあげをおこなった <br>The players held a celebration party after the tournament.
経済界	[sound:k-1576_経済界.mp3]<br>けいざいかい <br> economic world, financial circles
economic world, financial circles	<b>経済界<b> <br> けいざいかい <br>[sound:k-1576_経済界.mp3]
[sound:k-1576_経済界.mp3]	economic world, financial circles<br> <b>経済界</b> <br> (けいざいかい)
<b>打開</b> <br> 彼は困難な状況から打開する方法を見つけた。	[sound:s-1576_彼は困難な状況から打開する方法を見つけた。.mp3] <br> かれはこんなんなじょうきょうからだかいするほうほうをみつけた。 <br>He found a way to break through the difficult situation.
[sound:s-1576_彼は困難な状況から打開する方法を見つけた。.mp3]	<b>打開</b> <br> 彼は困難な状況から打開する方法を見つけた。<br> かれはこんなんなじょうきょうからだかいするほうほうをみつけた <br>He found a way to break through the difficult situation.
産業界	[sound:k-1577_産業界.mp3]<br>さんぎょうかい <br> the industrial world
the industrial world	<b>産業界<b> <br> さんぎょうかい <br>[sound:k-1577_産業界.mp3]
[sound:k-1577_産業界.mp3]	the industrial world<br> <b>産業界</b> <br> (さんぎょうかい)
<b>男</b> <br> 彼は真の男のように振る舞った。	[sound:s-1577_彼は真の男のように振る舞った。.mp3] <br> かれはしんのおとこのようにふるまった。 <br>He behaved like a real man.
[sound:s-1577_彼は真の男のように振る舞った。.mp3]	<b>男</b> <br> 彼は真の男のように振る舞った。<br> かれはしんのおとこのようにふるまった <br>He behaved like a real man.
世界一	[sound:k-1578_世界一.mp3]<br>せかいいち <br> best in the world
best in the world	<b>世界一<b> <br> せかいいち <br>[sound:k-1578_世界一.mp3]
[sound:k-1578_世界一.mp3]	best in the world<br> <b>世界一</b> <br> (せかいいち)
<b>男子</b> <br> その学校には男子と女子が均等にいる。	[sound:s-1578_その学校には男子と女子が均等にいる。.mp3] <br> そのがっこうにはだんしとじょしはきんとうにいる。 <br>There are an equal number of boys and girls in that school.
[sound:s-1578_その学校には男子と女子が均等にいる。.mp3]	<b>男子</b> <br> その学校には男子と女子が均等にいる。<br> そのがっこうにはだんしとじょしはきんとうにいる <br>There are an equal number of boys and girls in that school.
境界	[sound:k-1579_境界.mp3]<br>きょうかい <br> boundary
boundary	<b>境界<b> <br> きょうかい <br>[sound:k-1579_境界.mp3]
[sound:k-1579_境界.mp3]	boundary<br> <b>境界</b> <br> (きょうかい)
<b>男性</b> <br> その職場は男性が多い。	[sound:s-1579_その職場は男性が多い。.mp3] <br> そのしょくばはだんせいがおおい。 <br>There are many men in that workplace.
[sound:s-1579_その職場は男性が多い。.mp3]	<b>男性</b> <br> その職場は男性が多い。<br> そのしょくばはだんせいがおおい <br>There are many men in that workplace.
支援	[sound:k-1580_支援.mp3]<br>しえん <br> support, backing, aid, assistance
support, backing, aid, assistance	<b>支援<b> <br> しえん <br>[sound:k-1580_支援.mp3]
[sound:k-1580_支援.mp3]	support, backing, aid, assistance<br> <b>支援</b> <br> (しえん)
<b>長男</b> <br> 彼は家族の長男です。	[sound:s-1580_彼は家族の長男です。.mp3] <br> かれはかぞくのちょうなんです。 <br>He is the eldest son in the family.
[sound:s-1580_彼は家族の長男です。.mp3]	<b>長男</b> <br> 彼は家族の長男です。<br> かれはかぞくのちょうなんです <br>He is the eldest son in the family.
支持	[sound:k-1581_支持.mp3]<br>しじ <br> support, maintenance
support, maintenance	<b>支持<b> <br> しじ <br>[sound:k-1581_支持.mp3]
[sound:k-1581_支持.mp3]	support, maintenance<br> <b>支持</b> <br> (しじ)
<b>男女</b> <br> 男女平等の社会を目指すべきだ。	[sound:s-1581_男女平等の社会を目指すべきだ。.mp3] <br> だんじょびょうどうのしゃかいをめざすべきだ。 <br>We should aim for gender equality in society.
[sound:s-1581_男女平等の社会を目指すべきだ。.mp3]	<b>男女</b> <br> 男女平等の社会を目指すべきだ。<br> だんじょびょうどうのしゃかいをめざすべきだ <br>We should aim for gender equality in society.
支局	[sound:k-1582_支局.mp3]<br>しきょく <br> branch office
branch office	<b>支局<b> <br> しきょく <br>[sound:k-1582_支局.mp3]
[sound:k-1582_支局.mp3]	branch office<br> <b>支局</b> <br> (しきょく)
<b>男の子</b> <br> 公園でたくさんの男の子が遊んでいる。	[sound:s-1582_公園でたくさんの男の子が遊んでいる。.mp3] <br> こうえんでたくさんのおとこのこがあそんでいる。 <br>Many boys are playing in the park.
[sound:s-1582_公園でたくさんの男の子が遊んでいる。.mp3]	<b>男の子</b> <br> 公園でたくさんの男の子が遊んでいる。<br> こうえんでたくさんのおとこのこがあそんでいる <br>Many boys are playing in the park.
支店	[sound:k-1583_支店.mp3]<br>してん <br> branch store (office)
branch store (office)	<b>支店<b> <br> してん <br>[sound:k-1583_支店.mp3]
[sound:k-1583_支店.mp3]	branch store<br> <b>office) (支店</b> <br> (してん)
<b>三男</b> <br> 彼の家族には三男がいます。	[sound:s-1583_彼の家族には三男がいます。.mp3] <br> かれのかぞくにはさんなんがいます。 <br>He has three sons in his family.
[sound:s-1583_彼の家族には三男がいます。.mp3]	<b>三男</b> <br> 彼の家族には三男がいます。<br> かれのかぞくにはさんなんがいます <br>He has three sons in his family.
支配	[sound:k-1584_支配.mp3]<br>しはい <br> rule, control, direction
rule, control, direction	<b>支配<b> <br> しはい <br>[sound:k-1584_支配.mp3]
[sound:k-1584_支配.mp3]	rule, control, direction<br> <b>支配</b> <br> (しはい)
<b>男児</b> <br> 子供たちは男児と女児が半々です。	[sound:s-1584_子供たちは男児と女児が半々です。.mp3] <br> こどもたちはだんじとじょじがはんはんです。 <br>The children consist of equal numbers of boys and girls.
[sound:s-1584_子供たちは男児と女児が半々です。.mp3]	<b>男児</b> <br> 子供たちは男児と女児が半々です。<br> こどもたちはだんじとじょじがはんはんです <br>The children consist of equal numbers of boys and girls.
支部	[sound:k-1585_支部.mp3]<br>しぶ <br> branch, subdivision
branch, subdivision	<b>支部<b> <br> しぶ <br>[sound:k-1585_支部.mp3]
[sound:k-1585_支部.mp3]	branch, subdivision<br> <b>支部</b> <br> (しぶ)
<b>一男</b> <br> 彼は家族の中で一男です。	[sound:s-1585_彼は家族の中で一男です。.mp3] <br> かれはかぞくのなかでいちなんです。 <br>He is the eldest son in the family.
[sound:s-1585_彼は家族の中で一男です。.mp3]	<b>一男</b> <br> 彼は家族の中で一男です。<br> かれはかぞくのなかでいちなんです <br>He is the eldest son in the family.
収支	[sound:k-1586_収支.mp3]<br>しゅうし <br> income and expenditure
income and expenditure	<b>収支<b> <br> しゅうし <br>[sound:k-1586_収支.mp3]
[sound:k-1586_収支.mp3]	income and expenditure<br> <b>収支</b> <br> (しゅうし)
<b>男優</b> <br> 彼は有名な俳優として活躍している。	[sound:s-1586_彼は有名な俳優として活躍している。.mp3] <br> かれはゆうめいなはいゆうとしてかつやくしている。 <br>He is active as a famous actor.
[sound:s-1586_彼は有名な俳優として活躍している。.mp3]	<b>男優</b> <br> 彼は有名な俳優として活躍している。<br> かれはゆうめいなはいゆうとしてかつやくしている <br>He is active as a famous actor.
支払い	[sound:k-1587_支払い.mp3]<br>しはらい <br> payment
payment	<b>支払い<b> <br> しはらい <br>[sound:k-1587_支払い.mp3]
[sound:k-1587_支払い.mp3]	payment<br> <b>支払い</b> <br> (しはらい)
<b>基本</b> <br> 数学の基本を学ぶことは重要です。	[sound:s-1587_数学の基本を学ぶことは重要です。.mp3] <br> すうがくのきほんをまなぶことはじゅうようです。 <br>Learning the basics of mathematics is important.
[sound:s-1587_数学の基本を学ぶことは重要です。.mp3]	<b>基本</b> <br> 数学の基本を学ぶことは重要です。<br> すうがくのきほんをまなぶことはじゅうようです <br>Learning the basics of mathematics is important.
支出	[sound:k-1588_支出.mp3]<br>ししゅつ <br> expenditure, expenses
expenditure, expenses	<b>支出<b> <br> ししゅつ <br>[sound:k-1588_支出.mp3]
[sound:k-1588_支出.mp3]	expenditure, expenses<br> <b>支出</b> <br> (ししゅつ)
<b>基準</b> <br> この製品は安全基準を満たしています。	[sound:s-1588_この製品は安全基準を満たしています。.mp3] <br> このせいひんはあんぜんきじゅんをみたしています。 <br>This product meets safety standards.
[sound:s-1588_この製品は安全基準を満たしています。.mp3]	<b>基準</b> <br> この製品は安全基準を満たしています。<br> このせいひんはあんぜんきじゅんをみたしています <br>This product meets safety standards.
支給	[sound:k-1589_支給.mp3]<br>しきゅう <br> provision, supply, payment, allowance, grant
provision, supply, payment, allowance, grant	<b>支給<b> <br> しきゅう <br>[sound:k-1589_支給.mp3]
[sound:k-1589_支給.mp3]	provision, supply, payment, allowance, grant<br> <b>支給</b> <br> (しきゅう)
<b>基金</b> <br> そのプロジェクトのための基金が集められました。	[sound:s-1589_そのプロジェクトのための基金が集められました。.mp3] <br> そのぷろじぇくとのためのききんがあつめられました。 <br>Funds have been raised for the project.
[sound:s-1589_そのプロジェクトのための基金が集められました。.mp3]	<b>基金</b> <br> そのプロジェクトのための基金が集められました。<br> そのぷろじぇくとのためのききんがあつめられました <br>Funds have been raised for the project.
次第に	[sound:k-1590_次第に.mp3]<br>しだいに <br> gradually (progress into a state); in sequence, in order, in turn
gradually (progress into a state); in sequence, in order, in turn	<b>次第に<b> <br> しだいに <br>[sound:k-1590_次第に.mp3]
[sound:k-1590_次第に.mp3]	gradually<br> <b>progress into a state); in sequence, in order, in turn (次第に</b> <br> (しだいに)
<b>基礎</b> <br> 科学の基礎を理解することは重要です。	[sound:s-1590_科学の基礎を理解することは重要です。.mp3] <br> かがくのきそをりかいすることはじゅうようです。 <br>Understanding the basics of science is important.
[sound:s-1590_科学の基礎を理解することは重要です。.mp3]	<b>基礎</b> <br> 科学の基礎を理解することは重要です。<br> かがくのきそをりかいすることはじゅうようです <br>Understanding the basics of science is important.
第一歩	[sound:k-1591_第一歩.mp3]<br>だいいっぽ <br> first step
first step	<b>第一歩<b> <br> だいいっぽ <br>[sound:k-1591_第一歩.mp3]
[sound:k-1591_第一歩.mp3]	first step<br> <b>第一歩</b> <br> (だいいっぽ)
<b>基地</b> <br> 軍事基地がその地域に建設された。	[sound:s-1591_軍事基地がその地域に建設された。.mp3] <br> ぐんじきちがそのちいきにけんせつされた。 <br>A military base was built in the area.
[sound:s-1591_軍事基地がその地域に建設された。.mp3]	<b>基地</b> <br> 軍事基地がその地域に建設された。<br> ぐんじきちがそのちいきにけんせつされた <br>A military base was built in the area.
第三者	[sound:k-1592_第三者.mp3]<br>だいさんしゃ <br> third person, outsider, disinterested person
third person, outsider, disinterested person	<b>第三者<b> <br> だいさんしゃ <br>[sound:k-1592_第三者.mp3]
[sound:k-1592_第三者.mp3]	third person, outsider, disinterested person<br> <b>第三者</b> <br> (だいさんしゃ)
<b>基盤</b> <br> 成功するためには強固な基盤が必要です。	[sound:s-1592_成功するためには強固な基盤が必要です。.mp3] <br> せいこうするためにはきょうこなきばんがひつようです。 <br>A solid foundation is necessary for success.
[sound:s-1592_成功するためには強固な基盤が必要です。.mp3]	<b>基盤</b> <br> 成功するためには強固な基盤が必要です。<br> せいこうするためにはきょうこなきばんがひつようです <br>A solid foundation is necessary for success.
第一人者	[sound:k-1593_第一人者.mp3]<br>だいいちにんしゃ <br> leading person
leading person	<b>第一人者<b> <br> だいいちにんしゃ <br>[sound:k-1593_第一人者.mp3]
[sound:k-1593_第一人者.mp3]	leading person<br> <b>第一人者</b> <br> (だいいちにんしゃ)
<b>基本的</b> <br> その問題の解決には基本的な知識が必要だ。	[sound:s-1593_その問題の解決には基本的な知識が必要だ。.mp3] <br> そのもんだいのかいけつにはきほんてきなちしきがひつようだ。 <br>Basic knowledge is required to solve the problem.
[sound:s-1593_その問題の解決には基本的な知識が必要だ。.mp3]	<b>基本的</b> <br> その問題の解決には基本的な知識が必要だ。<br> そのもんだいのかいけつにはきほんてきなちしきがひつようだ <br>Basic knowledge is required to solve the problem.
第二次世界大戦	[sound:k-1594_第二次世界大戦.mp3]<br>だいにじせかいたいせん <br> World War II
World War II	<b>第二次世界大戦<b> <br> だいにじせかいたいせん <br>[sound:k-1594_第二次世界大戦.mp3]
[sound:k-1594_第二次世界大戦.mp3]	World War II<br> <b>第二次世界大戦</b> <br> (だいにじせかいたいせん)
<b>基調</b> <br> この会議の基調は協力と共同です。	[sound:s-1594_この会議の基調は協力と共同です。.mp3] <br> このかいぎのきちょうはきょうりょくときょうどうです。 <br>The theme of this meeting is cooperation and collaboration.
[sound:s-1594_この会議の基調は協力と共同です。.mp3]	<b>基調</b> <br> この会議の基調は協力と共同です。<br> このかいぎのきちょうはきょうりょくときょうどうです <br>The theme of this meeting is cooperation and collaboration.
第一線	[sound:k-1595_第一線.mp3]<br>だいいっせん <br> the front (of a battlefield), forefront
the front (of a battlefield), forefront	<b>第一線<b> <br> だいいっせん <br>[sound:k-1595_第一線.mp3]
[sound:k-1595_第一線.mp3]	the front<br> <b>of a battlefield), forefront (第一線</b> <br> (だいいっせん)
<b>基幹</b> <br> この計画の成功は基幹となる技術に依存しています。	[sound:s-1595_この計画の成功は基幹となる技術に依存しています。.mp3] <br> このけいかくのせいこうはきかんとなるぎじゅつにいそんしています。 <br>The success of this plan depends on the core technology.
[sound:s-1595_この計画の成功は基幹となる技術に依存しています。.mp3]	<b>基幹</b> <br> この計画の成功は基幹となる技術に依存しています。<br> このけいかくのせいこうはきかんとなるぎじゅつにいそんしています <br>The success of this plan depends on the core technology.
第一声	[sound:k-1596_第一声.mp3]<br>だいいっせい <br> first tone, first speech
first tone, first speech	<b>第一声<b> <br> だいいっせい <br>[sound:k-1596_第一声.mp3]
[sound:k-1596_第一声.mp3]	first tone, first speech<br> <b>第一声</b> <br> (だいいっせい)
<b>基軸</b> <br> その計画の基軸は持続可能性です。	[sound:s-1596_その計画の基軸は持続可能性です。.mp3] <br> そのけいかくのきじくはじぞくかのうせいです。 <br>The cornerstone of the plan is sustainability.
[sound:s-1596_その計画の基軸は持続可能性です。.mp3]	<b>基軸</b> <br> その計画の基軸は持続可能性です。<br> そのけいかくのきじくはじぞくかのうせいです <br>The cornerstone of the plan is sustainability.
第三国	[sound:k-1597_第三国.mp3]<br>だいさんごく <br> a third country
a third country	<b>第三国<b> <br> だいさんごく <br>[sound:k-1597_第三国.mp3]
[sound:k-1597_第三国.mp3]	a third country<br> <b>第三国</b> <br> (だいさんごく)
<b>私</b> <br> 私は毎日散歩するのが好きです。	[sound:s-1597_私は毎日散歩するのが好きです。.mp3] <br> わたしはまいにちさんぽするのがすきです。 <br>I like to take a walk every day.
[sound:s-1597_私は毎日散歩するのが好きです。.mp3]	<b>私</b> <br> 私は毎日散歩するのが好きです。<br> わたしはまいにちさんぽするのがすきです <br>I like to take a walk every day.
次第	[sound:k-1598_次第.mp3]<br>しだい <br> dependent upon; as soon as, immediately (upon); circumstances; order, precedence, program, programme, agenda
dependent upon; as soon as, immediately (upon); circumstances; order, precedence, program, programme, agenda	<b>次第<b> <br> しだい <br>[sound:k-1598_次第.mp3]
[sound:k-1598_次第.mp3]	dependent upon; as soon as, immediately<br> <b>upon); circumstances; order, precedence, program, programme, agenda (次第</b> <br> (しだい)
<b>私立</b> <br> 彼の子供たちは私立学校に通っている。	[sound:s-1598_彼の子供たちは私立学校に通っている。.mp3] <br> かれのこどもたちはわたくしりつがっこうにかよっている。 <br>His children attend a private school.
[sound:s-1598_彼の子供たちは私立学校に通っている。.mp3]	<b>私立</b> <br> 彼の子供たちは私立学校に通っている。<br> かれのこどもたちはわたくしりつがっこうにかよっている <br>His children attend a private school.
第一義	[sound:k-1599_第一義.mp3]<br>だいいちぎ <br> first principle, original or greatest import
first principle, original or greatest import	<b>第一義<b> <br> だいいちぎ <br>[sound:k-1599_第一義.mp3]
[sound:k-1599_第一義.mp3]	first principle, original or greatest import<br> <b>第一義</b> <br> (だいいちぎ)
<b>私邸</b> <br> 彼の私邸は郊外にある。	[sound:s-1599_彼の私邸は郊外にある。.mp3] <br> かれのしていはこうがいにある。 <br>His private residence is in the suburbs.
[sound:s-1599_彼の私邸は郊外にある。.mp3]	<b>私邸</b> <br> 彼の私邸は郊外にある。<br> かれのしていはこうがいにある <br>His private residence is in the suburbs.
共産党	[sound:k-1600_共産党.mp3]<br>きょうさんとう <br> Communist Party
Communist Party	<b>共産党<b> <br> きょうさんとう <br>[sound:k-1600_共産党.mp3]
[sound:k-1600_共産党.mp3]	Communist Party<br> <b>共産党</b> <br> (きょうさんとう)
<b>私的</b> <br> 私的な問題を公にするのは避けたい。	[sound:s-1600_私的な問題を公にするのは避けたい。.mp3] <br> わたしてきなもんだいをおおやけにするのはさけたい。 <br>I want to avoid making private matters public.
[sound:s-1600_私的な問題を公にするのは避けたい。.mp3]	<b>私的</b> <br> 私的な問題を公にするのは避けたい。<br> わたしてきなもんだいをおおやけにするのはさけたい <br>I want to avoid making private matters public.
産業	[sound:k-1601_産業.mp3]<br>さんぎょう <br> industry
industry	<b>産業<b> <br> さんぎょう <br>[sound:k-1601_産業.mp3]
[sound:k-1601_産業.mp3]	industry<br> <b>産業</b> <br> (さんぎょう)
<b>私鉄</b> <br> その地域では私鉄が交通の中心です。	[sound:s-1601_その地域では私鉄が交通の中心です。.mp3] <br> そのちいきではしてつがこうつうのちゅうしんです。 <br>"In that area, private railways are the main mode of transportation."
[sound:s-1601_その地域では私鉄が交通の中心です。.mp3]	<b>私鉄</b> <br> その地域では私鉄が交通の中心です。<br> そのちいきではしてつがこうつうのちゅうしんです <br>In that area, private railways are the main mode of transportation.
生産	[sound:k-1602_生産.mp3]<br>せいさん <br> production, manufacture
production, manufacture	<b>生産<b> <br> せいさん <br>[sound:k-1602_生産.mp3]
[sound:k-1602_生産.mp3]	production, manufacture<br> <b>生産</b> <br> (せいさん)
<b>公私</b> <br> 仕事とプライベートのバランスを保つことは重要だ。	[sound:s-1602_仕事とプライベートのバランスを保つことは重要だ。.mp3] <br> しごととぷらいべーとのばらんすをたもつことはじゅうようだ。 <br>Maintaining a balance between work and personal life is important.
[sound:s-1602_仕事とプライベートのバランスを保つことは重要だ。.mp3]	<b>公私</b> <br> 仕事とプライベートのバランスを保つことは重要だ。<br> しごととぷらいべーとのばらんすをたもつことはじゅうようだ <br>Maintaining a balance between work and personal life is important.
資産	[sound:k-1603_資産.mp3]<br>しさん <br> property, fortune, means, assets
property, fortune, means, assets	<b>資産<b> <br> しさん <br>[sound:k-1603_資産.mp3]
[sound:k-1603_資産.mp3]	property, fortune, means, assets<br> <b>資産</b> <br> (しさん)
<b>私有</b> <br> その土地は彼の私有財産です。	[sound:s-1603_その土地は彼の私有財産です。.mp3] <br> そのとちはかれのしゆうざいさんです。 <br>The land is his private property.
[sound:s-1603_その土地は彼の私有財産です。.mp3]	<b>私有</b> <br> その土地は彼の私有財産です。<br> そのとちはかれのしゆうざいさんです <br>The land is his private property.
不動産	[sound:k-1604_不動産.mp3]<br>ふどうさん <br> real estate
real estate	<b>不動産<b> <br> ふどうさん <br>[sound:k-1604_不動産.mp3]
[sound:k-1604_不動産.mp3]	real estate<br> <b>不動産</b> <br> (ふどうさん)
<b>私学</b> <br> 彼女は私学で法律を学んでいます。	[sound:s-1604_彼女は私学で法律を学んでいます。.mp3] <br> かのじょはしがくでほうりつをまなんでいます。 <br>She is studying law at a private school.
[sound:s-1604_彼女は私学で法律を学んでいます。.mp3]	<b>私学</b> <br> 彼女は私学で法律を学んでいます。<br> かのじょはしがくでほうりつをまなんでいます <br>She is studying law at a private school.
通産省	[sound:k-1605_通産省.mp3]<br>つうさんしょう <br> (former) Ministry of International Trade and Industry (now Ministry of Economy, Trade and Industry), MITI
(former) Ministry of International Trade and Industry (now Ministry of Economy, Trade and Industry), MITI	<b>通産省<b> <br> つうさんしょう <br>[sound:k-1605_通産省.mp3]
[sound:k-1605_通産省.mp3]	(former) Ministry of International Trade and Industry<br> <b>now Ministry of Economy, Trade and Industry), MITI (通産省</b> <br> (つうさんしょう)
<b>私文書</b> <br> その手紙は私文書です。	[sound:s-1605_その手紙は私文書です。.mp3] <br> そのてがみはしぶんしょです。 <br>The letter is a private document.
[sound:s-1605_その手紙は私文書です。.mp3]	<b>私文書</b> <br> その手紙は私文書です。<br> そのてがみはしぶんしょです <br>The letter is a private document.
共産	[sound:k-1606_共産.mp3]<br>きょうさん <br> communism; Communist Party
communism; Communist Party	<b>共産<b> <br> きょうさん <br>[sound:k-1606_共産.mp3]
[sound:k-1606_共産.mp3]	communism; Communist Party<br> <b>共産</b> <br> (きょうさん)
<b>私設</b> <br> 彼は私設図書館を開設した。	[sound:s-1606_彼は私設図書館を開設した。.mp3] <br> かれはしせつとしょかんをかいせつした。 <br>He opened a private library.
[sound:s-1606_彼は私設図書館を開設した。.mp3]	<b>私設</b> <br> 彼は私設図書館を開設した。<br> かれはしせつとしょかんをかいせつした <br>He opened a private library.
財産	[sound:k-1607_財産.mp3]<br>ざいさん <br> property, fortune, assets
property, fortune, assets	<b>財産<b> <br> ざいさん <br>[sound:k-1607_財産.mp3]
[sound:k-1607_財産.mp3]	property, fortune, assets<br> <b>財産</b> <br> (ざいさん)
<b>各自</b> <br> この問題について、各自の意見を述べてください。	[sound:s-1607_この問題について、各自の意見を述べてください。.mp3] <br> このもんだいについて、かくじのいけんをのべてください。 <br>Please express your individual opinions on this issue.
[sound:s-1607_この問題について、各自の意見を述べてください。.mp3]	<b>各自</b> <br> この問題について、各自の意見を述べてください。<br> このもんだいについて、かくじのいけんをのべてください <br>Please express your individual opinions on this issue.
国産	[sound:k-1608_国産.mp3]<br>こくさん <br> domestic products
domestic products	<b>国産<b> <br> こくさん <br>[sound:k-1608_国産.mp3]
[sound:k-1608_国産.mp3]	domestic products<br> <b>国産</b> <br> (こくさん)
<b>各種学校</b> <br> この地域には各種学校が揃っています。	[sound:s-1608_この地域には各種学校が揃っています。.mp3] <br> このちいきにはかくしゅがっこうがそろっています。 <br>Various types of schools are available in this area.
[sound:s-1608_この地域には各種学校が揃っています。.mp3]	<b>各種学校</b> <br> この地域には各種学校が揃っています。<br> このちいきにはかくしゅがっこうがそろっています <br>Various types of schools are available in this area.
出産	[sound:k-1609_出産.mp3]<br>しゅっさん <br> (child)birth, delivery, production (of goods)
(child)birth, delivery, production (of goods)	<b>出産<b> <br> しゅっさん <br>[sound:k-1609_出産.mp3]
[sound:k-1609_出産.mp3]	(child)birth, delivery, production<br> <b>of goods) (出産</b> <br> (しゅっさん)
<b>各位</b> <br> 会議には役員各位が出席してください。	[sound:s-1609_会議には役員各位が出席してください。.mp3] <br> かいぎにはやくいんかくいがしゅっせきしてください。 <br>All board members are requested to attend the meeting.
[sound:s-1609_会議には役員各位が出席してください。.mp3]	<b>各位</b> <br> 会議には役員各位が出席してください。<br> かいぎにはやくいんかくいがしゅっせきしてください <br>All board members are requested to attend the meeting.
結果	[sound:k-1610_結果.mp3]<br>けっか <br> result, consequence
result, consequence	<b>結果<b> <br> けっか <br>[sound:k-1610_結果.mp3]
[sound:k-1610_結果.mp3]	result, consequence<br> <b>結果</b> <br> (けっか)
<b>各々</b> <br> その問題に対して、各々が自分の立場から意見を述べた。	[sound:s-1610_その問題に対して、各々が自分の立場から意見を述べた。.mp3] <br> そのもんだいにたいして、おのおのがじぶんのたちばからいけんをのべた。 <br>Each person expressed their opinion from their own standpoint on the issue.
[sound:s-1610_その問題に対して、各々が自分の立場から意見を述べた。.mp3]	<b>各々</b> <br> その問題に対して、各々が自分の立場から意見を述べた。<br> そのもんだいにたいして、おのおのがじぶんのたちばからいけんをのべた <br>Each person expressed their opinion from their own standpoint on the issue.
結局	[sound:k-1611_結局.mp3]<br>けっきょく <br> after all, eventually
after all, eventually	<b>結局<b> <br> けっきょく <br>[sound:k-1611_結局.mp3]
[sound:k-1611_結局.mp3]	after all, eventually<br> <b>結局</b> <br> (けっきょく)
<b>各面</b> <br> この計画は様々な面で評価されています。	[sound:s-1611_この計画は様々な面で評価されています。.mp3] <br> このけいかくはさまざまなめんでひょうかされています。 <br>This plan is being evaluated from various aspects.
[sound:s-1611_この計画は様々な面で評価されています。.mp3]	<b>各面</b> <br> この計画は様々な面で評価されています。<br> このけいかくはさまざまなめんでひょうかされています <br>This plan is being evaluated from various aspects.
結婚	[sound:k-1612_結婚.mp3]<br>けっこん <br> marriage
marriage	<b>結婚<b> <br> けっこん <br>[sound:k-1612_結婚.mp3]
[sound:k-1612_結婚.mp3]	marriage<br> <b>結婚</b> <br> (けっこん)
<b>各</b> <br> 今後、各案を検討していきます。	[sound:s-1612_今後、各案を検討していきます。.mp3] <br> こんご、かくあんをけんとうしていきます。 <br>"Going forward, we will consider each proposal."
[sound:s-1612_今後、各案を検討していきます。.mp3]	<b>各</b> <br> 今後、各案を検討していきます。<br> こんご、かくあんをけんとうしていきます <br>Going forward, we will consider each proposal.
結論	[sound:k-1613_結論.mp3]<br>けつろん <br> conclusion
conclusion	<b>結論<b> <br> けつろん <br>[sound:k-1613_結論.mp3]
[sound:k-1613_結論.mp3]	conclusion<br> <b>結論</b> <br> (けつろん)
<b>各</b> <br> 各駅停車でお進みください。	[sound:s-1613_各駅停車でお進みください。.mp3] <br> かくえきていしゃでおすすみください。 <br>Please proceed with caution on the local train.
[sound:s-1613_各駅停車でお進みください。.mp3]	<b>各</b> <br> 各駅停車でお進みください。<br> かくえきていしゃでおすすみください <br>Please proceed with caution on the local train.
結ぶ	[sound:k-1614_結ぶ.mp3]<br>むすぶ <br> to tie, to bind, to link; to bear (fruit)
to tie, to bind, to link; to bear (fruit)	<b>結ぶ<b> <br> むすぶ <br>[sound:k-1614_結ぶ.mp3]
[sound:k-1614_結ぶ.mp3]	to tie, to bind, to link; to bear<br> <b>fruit) (結ぶ</b> <br> (むすぶ)
<b>開始</b> <br> 新しいプロジェクトが開始されました。	[sound:s-1614_新しいプロジェクトが開始されました。.mp3] <br> あたらしいぷろじぇくとがかいしされました。 <br>The new project has begun.
[sound:s-1614_新しいプロジェクトが開始されました。.mp3]	<b>開始</b> <br> 新しいプロジェクトが開始されました。<br> あたらしいぷろじぇくとがかいしされました <br>The new project has begun.
結成	[sound:k-1615_結成.mp3]<br>けっせい <br> formation
formation	<b>結成<b> <br> けっせい <br>[sound:k-1615_結成.mp3]
[sound:k-1615_結成.mp3]	formation<br> <b>結成</b> <br> (けっせい)
<b>始まり</b> <br> その物語は古代の始まりから語られている。	[sound:s-1615_その物語は古代の始まりから語られている。.mp3] <br> そのものがたりはこだいのはじまりからかたられている。 <br>The story is told from the beginning of ancient times.
[sound:s-1615_その物語は古代の始まりから語られている。.mp3]	<b>始まり</b> <br> その物語は古代の始まりから語られている。<br> そのものがたりはこだいのはじまりからかたられている <br>The story is told from the beginning of ancient times.
終結	[sound:k-1616_終結.mp3]<br>しゅうけつ <br> end, close
end, close	<b>終結<b> <br> しゅうけつ <br>[sound:k-1616_終結.mp3]
[sound:k-1616_終結.mp3]	end, close<br> <b>終結</b> <br> (しゅうけつ)
<b>終始</b> <br> 彼女は終始笑顔でいられる人だ。	[sound:s-1616_彼女は終始笑顔でいられる人だ。.mp3] <br> かのじょはしゅうしはえがおでいられるひとだ。 <br>She is someone who can maintain a smile from start to finish.
[sound:s-1616_彼女は終始笑顔でいられる人だ。.mp3]	<b>終始</b> <br> 彼女は終始笑顔でいられる人だ。<br> かのじょはしゅうしはえがおでいられるひとだ <br>She is someone who can maintain a smile from start to finish.
凍結	[sound:k-1617_凍結.mp3]<br>とうけつ <br> freeze (e.g. program)
freeze (e.g. program)	<b>凍結<b> <br> とうけつ <br>[sound:k-1617_凍結.mp3]
[sound:k-1617_凍結.mp3]	freeze<br> <b>e.g. program) (凍結</b> <br> (とうけつ)
<b>始める</b> <br> 新年を迎えて新しい生活を始める。	[sound:s-1617_新年を迎えて新しい生活を始める。.mp3] <br> しんねんをむかえてあたらしいせいかつをはじめる。 <br>Start a new life as the new year begins.
[sound:s-1617_新年を迎えて新しい生活を始める。.mp3]	<b>始める</b> <br> 新年を迎えて新しい生活を始める。<br> しんねんをむかえてあたらしいせいかつをはじめる <br>Start a new life as the new year begins.
結び	[sound:k-1618_結び.mp3]<br>むすび <br> ending, conclusion, union
ending, conclusion, union	<b>結び<b> <br> むすび <br>[sound:k-1618_結び.mp3]
[sound:k-1618_結び.mp3]	ending, conclusion, union<br> <b>結び</b> <br> (むすび)
<b>始め</b> <br> キャンペーンの始めには大規模なイベントが行われた。	[sound:s-1618_キャンペーンの始めには大規模なイベントが行われた。.mp3] <br> きゃんぺーんのはじめにはだいきぼないべんとがおこなわれた。 <br>A large-scale event was held at the beginning of the campaign.
[sound:s-1618_キャンペーンの始めには大規模なイベントが行われた。.mp3]	<b>始め</b> <br> キャンペーンの始めには大規模なイベントが行われた。<br> きゃんぺーんのはじめにはだいきぼないべんとがおこなわれた <br>A large-scale event was held at the beginning of the campaign.
締結	[sound:k-1619_締結.mp3]<br>ていけつ <br> conclusion, execution (of a contract), entering (into treaty)
conclusion, execution (of a contract), entering (into treaty)	<b>締結<b> <br> ていけつ <br>[sound:k-1619_締結.mp3]
[sound:k-1619_締結.mp3]	conclusion, execution<br> <b>of a contract), entering (into treaty) (締結</b> <br> (ていけつ)
<b>年始</b> <br> 年始の挨拶をしてから仕事を始める。	[sound:s-1619_年始の挨拶をしてから仕事を始める。.mp3] <br> ねんしのあいさつをしてからしごとをはじめる。 <br>Start working after exchanging New Year's greetings.
[sound:s-1619_年始の挨拶をしてから仕事を始める。.mp3]	<b>年始</b> <br> 年始の挨拶をしてから仕事を始める。<br> ねんしのあいさつをしてからしごとをはじめる <br>Start working after exchanging New Year's greetings.
百	[sound:k-1620_百.mp3]<br>ひゃく, もも <br> 100, hundred
100, hundred	<b>百<b> <br> ひゃく, もも <br>[sound:k-1620_百.mp3]
[sound:k-1620_百.mp3]	100, hundred<br> <b>百</b> <br> (ひゃく, もも)
<b>始末</b> <br> 部屋の掃除を始末してから外出した。	[sound:s-1620_部屋の掃除を始末してから外出した。.mp3] <br> へやのそうじをしまつしてからがいしゅつした。 <br>I cleaned the room before going out.
[sound:s-1620_部屋の掃除を始末してから外出した。.mp3]	<b>始末</b> <br> 部屋の掃除を始末してから外出した。<br> へやのそうじをしまつしてからがいしゅつした <br>I cleaned the room before going out.
二百	[sound:k-1621_二百.mp3]<br>にひゃく <br> two hundred, 200
two hundred, 200	<b>二百<b> <br> にひゃく <br>[sound:k-1621_二百.mp3]
[sound:k-1621_二百.mp3]	two hundred, 200<br> <b>二百</b> <br> (にひゃく)
<b>原始</b> <br> この地域は原始的な生活様式を保っている。	[sound:s-1621_この地域は原始的な生活様式を保っている。.mp3] <br> このちいきはげんしてきなせいかつようしきをたもっている。 <br>This area maintains a primitive way of life.
[sound:s-1621_この地域は原始的な生活様式を保っている。.mp3]	<b>原始</b> <br> この地域は原始的な生活様式を保っている。<br> このちいきはげんしてきなせいかつようしきをたもっている <br>This area maintains a primitive way of life.
三百	[sound:k-1622_三百.mp3]<br>さんびゃく <br> 300, three hundred; 300 mon, trifling amount, two-bit item; shyster
300, three hundred; 300 mon, trifling amount, two-bit item; shyster	<b>三百<b> <br> さんびゃく <br>[sound:k-1622_三百.mp3]
[sound:k-1622_三百.mp3]	300, three hundred; 300 mon, trifling amount, two-bit item; shyster<br> <b>三百</b> <br> (さんびゃく)
<b>始発</b> <br> 早朝の始発列車に間に合った。	[sound:s-1622_早朝の始発列車に間に合った。.mp3] <br> そうちょうのしはつれっしゃにまにあった。 <br>I caught the first train in the early morning.
[sound:s-1622_早朝の始発列車に間に合った。.mp3]	<b>始発</b> <br> 早朝の始発列車に間に合った。<br> そうちょうのしはつれっしゃにまにあった <br>I caught the first train in the early morning.
百貨店	[sound:k-1623_百貨店.mp3]<br>ひゃっかてん <br> (department) store(s)
(department) store(s)	<b>百貨店<b> <br> ひゃっかてん <br>[sound:k-1623_百貨店.mp3]
[sound:k-1623_百貨店.mp3]	(department) store(s)<br> <b>百貨店</b> <br> (ひゃっかてん)
<b>手始め</b> <br> 新しいプロジェクトに取り組む手始めに、計画を立てた。	[sound:s-1623_新しいプロジェクトに取り組む手始めに、計画を立てた。.mp3] <br> あたらしいぷろじぇくとにとりくむてはじめに、けいかくをたてた。 <br>"As a start to working on the new project, we made a plan."
[sound:s-1623_新しいプロジェクトに取り組む手始めに、計画を立てた。.mp3]	<b>手始め</b> <br> 新しいプロジェクトに取り組む手始めに、計画を立てた。<br> あたらしいぷろじぇくとにとりくむてはじめに、けいかくをたてた <br>As a start to working on the new project, we made a plan.
百万	[sound:k-1624_百万.mp3]<br>ひゃくまん <br> 1,000,000, one million; many
1,000,000, one million; many	<b>百万<b> <br> ひゃくまん <br>[sound:k-1624_百万.mp3]
[sound:k-1624_百万.mp3]	1,000,000, one million; many<br> <b>百万</b> <br> (ひゃくまん)
<b>島</b> <br> 彼は南の島でのんびり過ごした。	[sound:s-1624_彼は南の島でのんびり過ごした。.mp3] <br> かれはみなみのしまでのんびりすごした。 <br>He spent a relaxing time on a southern island.
[sound:s-1624_彼は南の島でのんびり過ごした。.mp3]	<b>島</b> <br> 彼は南の島でのんびり過ごした。<br> かれはみなみのしまでのんびりすごした <br>He spent a relaxing time on a southern island.
四百	[sound:k-1625_四百.mp3]<br>よんひゃく <br> four hundred
four hundred	<b>四百<b> <br> よんひゃく <br>[sound:k-1625_四百.mp3]
[sound:k-1625_四百.mp3]	four hundred<br> <b>四百</b> <br> (よんひゃく)
<b>朝鮮半島</b> <br> 朝鮮半島は東アジアに位置している。	[sound:s-1625_朝鮮半島は東アジアに位置している。.mp3] <br> ちょうせんはんとうはひがしアジアにいちしている。 <br>The Korean Peninsula is located in East Asia.
[sound:s-1625_朝鮮半島は東アジアに位置している。.mp3]	<b>朝鮮半島</b> <br> 朝鮮半島は東アジアに位置している。<br> ちょうせんはんとうはひがしアジアにいちしている <br>The Korean Peninsula is located in East Asia.
百億	[sound:k-1626_百億.mp3]<br>ひゃくおく <br> 10,000,000,000, ten billion (American), (obs) ten milliard (British)
10,000,000,000, ten billion (American), (obs) ten milliard (British)	<b>百億<b> <br> ひゃくおく <br>[sound:k-1626_百億.mp3]
[sound:k-1626_百億.mp3]	10,000,000,000, ten billion<br> <b>American), (obs) ten milliard (British) (百億</b> <br> (ひゃくおく)
<b>中島</b> <br> その湖には小さな中島が浮かんでいる。	[sound:s-1626_その湖には小さな中島が浮かんでいる。.mp3] <br> そのみずうみにはちいさななかしまがうかんでいる。 <br>There is a small island floating in the lake.
[sound:s-1626_その湖には小さな中島が浮かんでいる。.mp3]	<b>中島</b> <br> その湖には小さな中島が浮かんでいる。<br> そのみずうみにはちいさななかしまがうかんでいる <br>There is a small island floating in the lake.
数百	[sound:k-1627_数百.mp3]<br>すうひゃく <br> several hundreds
several hundreds	<b>数百<b> <br> すうひゃく <br>[sound:k-1627_数百.mp3]
[sound:k-1627_数百.mp3]	several hundreds<br> <b>数百</b> <br> (すうひゃく)
<b>小島</b> <br> その小島は美しい砂浜と青い海に囲まれている。	[sound:s-1627_その小島は美しい砂浜と青い海に囲まれている。.mp3] <br> そのこじまはうつくしいすなはまとあおいうみにかこまれている。 <br>The small island is surrounded by beautiful sandy beaches and blue sea.
[sound:s-1627_その小島は美しい砂浜と青い海に囲まれている。.mp3]	<b>小島</b> <br> その小島は美しい砂浜と青い海に囲まれている。<br> そのこじまはうつくしいすなはまとあおいうみにかこまれている <br>The small island is surrounded by beautiful sandy beaches and blue sea.
百八十度	[sound:k-1628_百八十度.mp3]<br>ひゃくはちじゅうど <br> 180 degrees, complete change
180 degrees, complete change	<b>百八十度<b> <br> ひゃくはちじゅうど <br>[sound:k-1628_百八十度.mp3]
[sound:k-1628_百八十度.mp3]	180 degrees, complete change<br> <b>百八十度</b> <br> (ひゃくはちじゅうど)
<b>半島</b> <br> 韓国は半島の国である。	[sound:s-1628_韓国は半島の国である。.mp3] <br> かんこくははんとうのくにである。 <br>Korea is a peninsula nation.
[sound:s-1628_韓国は半島の国である。.mp3]	<b>半島</b> <br> 韓国は半島の国である。<br> かんこくははんとうのくにである <br>Korea is a peninsula nation.
百合	[sound:k-1629_百合.mp3]<br>ゆり, ユリ <br> lily, Lilium; comics and novels about female homosexuality
lily, Lilium; comics and novels about female homosexuality	<b>百合<b> <br> ゆり, ユリ <br>[sound:k-1629_百合.mp3]
[sound:k-1629_百合.mp3]	lily, Lilium; comics and novels about female homosexuality<br> <b>百合</b> <br> (ゆり, ユリ)
<b>列島</b> <br> 日本は火山性の列島である。	[sound:s-1629_日本は火山性の列島である。.mp3] <br> にほんはかざんせいのれっとうである。 <br>Japan is a volcanic archipelago.
[sound:s-1629_日本は火山性の列島である。.mp3]	<b>列島</b> <br> 日本は火山性の列島である。<br> にほんはかざんせいのれっとうである <br>Japan is a volcanic archipelago.
派遣	[sound:k-1630_派遣.mp3]<br>はけん <br> dispatch, despatch, send
dispatch, despatch, send	<b>派遣<b> <br> はけん <br>[sound:k-1630_派遣.mp3]
[sound:k-1630_派遣.mp3]	dispatch, despatch, send<br> <b>派遣</b> <br> (はけん)
<b>島根</b> <br> 島根県は日本の中国地方に位置している。	[sound:s-1630_島根県は日本の中国地方に位置している。.mp3] <br> しまねけんはにほんのちゅうごくちほうにいちしている。 <br>Shimane Prefecture is located in the Chugoku region of Japan.
[sound:s-1630_島根県は日本の中国地方に位置している。.mp3]	<b>島根</b> <br> 島根県は日本の中国地方に位置している。<br> しまねけんはにほんのちゅうごくちほうにいちしている <br>Shimane Prefecture is located in the Chugoku region of Japan.
派閥	[sound:k-1631_派閥.mp3]<br>はばつ <br> clique, faction
clique, faction	<b>派閥<b> <br> はばつ <br>[sound:k-1631_派閥.mp3]
[sound:k-1631_派閥.mp3]	clique, faction<br> <b>派閥</b> <br> (はばつ)
<b>千島</b> <br> 千島列島は北海道とロシアの間にある。	[sound:s-1631_千島列島は北海道とロシアの間にある。.mp3] <br> ちしまれっとうはほっかいどうとロシアのあいだにある。 <br>The Kuril Islands are located between Hokkaido and Russia.
[sound:s-1631_千島列島は北海道とロシアの間にある。.mp3]	<b>千島</b> <br> 千島列島は北海道とロシアの間にある。<br> ちしまれっとうはほっかいどうとロシアのあいだにある <br>The Kuril Islands are located between Hokkaido and Russia.
立派	[sound:k-1632_立派.mp3]<br>りっぱ <br> splendid, fine, handsome, elegant, imposing, prominent, legal, legitimate
splendid, fine, handsome, elegant, imposing, prominent, legal, legitimate	<b>立派<b> <br> りっぱ <br>[sound:k-1632_立派.mp3]
[sound:k-1632_立派.mp3]	splendid, fine, handsome, elegant, imposing, prominent, legal, legitimate<br> <b>立派</b> <br> (りっぱ)
<b>島国</b> <br> ニュージーランドは島国である。	[sound:s-1632_ニュージーランドは島国である。.mp3] <br> にゅーじーらんどはしまぐにである。 <br>New Zealand is an island nation.
[sound:s-1632_ニュージーランドは島国である。.mp3]	<b>島国</b> <br> ニュージーランドは島国である。<br> にゅーじーらんどはしまぐにである <br>New Zealand is an island nation.
右派	[sound:k-1633_右派.mp3]<br>うは <br> right wing
right wing	<b>右派<b> <br> うは <br>[sound:k-1633_右派.mp3]
[sound:k-1633_右派.mp3]	right wing<br> <b>右派</b> <br> (うは)
<b>離島</b> <br> この国の離島には美しいビーチが多い。	[sound:s-1633_この国の離島には美しいビーチが多い。.mp3] <br> このくにのりとうにはうつくしいびーちがおおい。 <br>There are many beautiful beaches on the outlying islands of this country.
[sound:s-1633_この国の離島には美しいビーチが多い。.mp3]	<b>離島</b> <br> この国の離島には美しいビーチが多い。<br> このくにのりとうにはうつくしいびーちがおおい <br>There are many beautiful beaches on the outlying islands of this country.
左派	[sound:k-1634_左派.mp3]<br>さは <br> left wing
left wing	<b>左派<b> <br> さは <br>[sound:k-1634_左派.mp3]
[sound:k-1634_左派.mp3]	left wing<br> <b>左派</b> <br> (さは)
<b>直</b> <br> 問題を直に解決することが重要だ。	[sound:s-1634_問題を直に解決することが重要だ。.mp3] <br> もんだいをじきにかいけつすることがじゅうようだ。 <br>It's important to solve problems directly.
[sound:s-1634_問題を直に解決することが重要だ。.mp3]	<b>直</b> <br> 問題を直に解決することが重要だ。<br> もんだいをじきにかいけつすることがじゅうようだ <br>It's important to solve problems directly.
特派員	[sound:k-1635_特派員.mp3]<br>とくはいん <br> correspondent
correspondent	<b>特派員<b> <br> とくはいん <br>[sound:k-1635_特派員.mp3]
[sound:k-1635_特派員.mp3]	correspondent<br> <b>特派員</b> <br> (とくはいん)
<b>直ちに</b> <br> 問題が発生したら直ちに対処する必要がある。	[sound:s-1635_問題が発生したら直ちに対処する必要がある。.mp3] <br> もんだいがはっせいしたらただちにたいしょするひつようがある。 <br>It's necessary to deal with problems immediately when they occur.
[sound:s-1635_問題が発生したら直ちに対処する必要がある。.mp3]	<b>直ちに</b> <br> 問題が発生したら直ちに対処する必要がある。<br> もんだいがはっせいしたらただちにたいしょするひつようがある <br>It's necessary to deal with problems immediately when they occur.
硬派	[sound:k-1636_硬派.mp3]<br>こうは <br> tough elements, hard-liners, stalwart(s)
tough elements, hard-liners, stalwart(s)	<b>硬派<b> <br> こうは <br>[sound:k-1636_硬派.mp3]
[sound:k-1636_硬派.mp3]	tough elements, hard-liners, stalwart(s)<br> <b>硬派</b> <br> (こうは)
<b>見直し</b> <br> プロジェクトの進捗状況を見直しました。	[sound:s-1636_プロジェクトの進捗状況を見直しました。.mp3] <br> ぷろじぇくとのしんちょくじょうきょうをみなおしました。 <br>We reviewed the progress of the project.
[sound:s-1636_プロジェクトの進捗状況を見直しました。.mp3]	<b>見直し</b> <br> プロジェクトの進捗状況を見直しました。<br> ぷろじぇくとのしんちょくじょうきょうをみなおしました <br>We reviewed the progress of the project.
党派	[sound:k-1637_党派.mp3]<br>とうは <br> faction
faction	<b>党派<b> <br> とうは <br>[sound:k-1637_党派.mp3]
[sound:k-1637_党派.mp3]	faction<br> <b>党派</b> <br> (とうは)
<b>直後</b> <br> 会議が終わった直後に報告書を送った。	[sound:s-1637_会議が終わった直後に報告書を送った。.mp3] <br> かいぎがおわったちょくごにほうこくしょをおくった。 <br>I sent the report immediately after the meeting ended.
[sound:s-1637_会議が終わった直後に報告書を送った。.mp3]	<b>直後</b> <br> 会議が終わった直後に報告書を送った。<br> かいぎがおわったちょくごにほうこくしょをおくった <br>I sent the report immediately after the meeting ended.
派手	[sound:k-1638_派手.mp3]<br>はで <br> showy, loud, gay, flashy, gaudy
showy, loud, gay, flashy, gaudy	<b>派手<b> <br> はで <br>[sound:k-1638_派手.mp3]
[sound:k-1638_派手.mp3]	showy, loud, gay, flashy, gaudy<br> <b>派手</b> <br> (はで)
<b>直接</b> <br> その問題について直接話し合いたい。	[sound:s-1638_その問題について直接話し合いたい。.mp3] <br> そのもんだいについてちょくせつはなしあいたい。 <br>I want to discuss the issue directly.
[sound:s-1638_その問題について直接話し合いたい。.mp3]	<b>直接</b> <br> その問題について直接話し合いたい。<br> そのもんだいについてちょくせつはなしあいたい <br>I want to discuss the issue directly.
派兵	[sound:k-1639_派兵.mp3]<br>はへい <br> dispatch of troops, despatch of troops
dispatch of troops, despatch of troops	<b>派兵<b> <br> はへい <br>[sound:k-1639_派兵.mp3]
[sound:k-1639_派兵.mp3]	dispatch of troops, despatch of troops<br> <b>派兵</b> <br> (はへい)
<b>直前</b> <br> 出発直前に電車が遅れた。	[sound:s-1639_出発直前に電車が遅れた。.mp3] <br> しゅっぱつちょくぜんにでんしゃがおくれた。 <br>The train was delayed just before departure.
[sound:s-1639_出発直前に電車が遅れた。.mp3]	<b>直前</b> <br> 出発直前に電車が遅れた。<br> しゅっぱつちょくぜんにでんしゃがおくれた <br>The train was delayed just before departure.
点	[sound:k-1640_点.mp3]<br>てん <br> spot, mark; point, dot; mark (e.g. in exam), score, points; counter for goods or items
spot, mark; point, dot; mark (e.g. in exam), score, points; counter for goods or items	<b>点<b> <br> てん <br>[sound:k-1640_点.mp3]
[sound:k-1640_点.mp3]	spot, mark; point, dot; mark<br> <b>e.g. in exam), score, points; counter for goods or items (点</b> <br> (てん)
<b>直面</b> <br> 困難に直面しても決して逃げてはいけない。	[sound:s-1640_困難に直面しても決して逃げてはいけない。.mp3] <br> こんなんにちょくめんしてもけっしてにげてはいけない。 <br>You must never run away even when faced with difficulties.
[sound:s-1640_困難に直面しても決して逃げてはいけない。.mp3]	<b>直面</b> <br> 困難に直面しても決して逃げてはいけない。<br> こんなんにちょくめんしてもけっしてにげてはいけない <br>You must never run away even when faced with difficulties.
焦点	[sound:k-1641_焦点.mp3]<br>しょうてん <br> focus (e.g. photographic), focal point
focus (e.g. photographic), focal point	<b>焦点<b> <br> しょうてん <br>[sound:k-1641_焦点.mp3]
[sound:k-1641_焦点.mp3]	focus<br> <b>e.g. photographic), focal point (焦点</b> <br> (しょうてん)
<b>率直</b> <br> 彼は率直な意見を言った。	[sound:s-1641_彼は率直な意見を言った。.mp3] <br> かれはそっちょくないけんをいった。 <br>He expressed his honest opinion.
[sound:s-1641_彼は率直な意見を言った。.mp3]	<b>率直</b> <br> 彼は率直な意見を言った。<br> かれはそっちょくないけんをいった <br>He expressed his honest opinion.
拠点	[sound:k-1642_拠点.mp3]<br>きょてん <br> position, location, base, point
position, location, base, point	<b>拠点<b> <br> きょてん <br>[sound:k-1642_拠点.mp3]
[sound:k-1642_拠点.mp3]	position, location, base, point<br> <b>拠点</b> <br> (きょてん)
<b>正直</b> <br> 彼は正直な人柄で信頼されている。	[sound:s-1642_彼は正直な人柄で信頼されている。.mp3] <br> かれはしょうじきなひとがらでしんらいされている。 <br>He is trusted for his honesty and sincerity.
[sound:s-1642_彼は正直な人柄で信頼されている。.mp3]	<b>正直</b> <br> 彼は正直な人柄で信頼されている。<br> かれはしょうじきなひとがらでしんらいされている <br>He is trusted for his honesty and sincerity.
時点	[sound:k-1643_時点.mp3]<br>じてん <br> point in time, occasion
point in time, occasion	<b>時点<b> <br> じてん <br>[sound:k-1643_時点.mp3]
[sound:k-1643_時点.mp3]	point in time, occasion<br> <b>時点</b> <br> (じてん)
<b>素直</b> <br> 彼女は素直な性格で人々に愛されている。	[sound:s-1643_彼女は素直な性格で人々に愛されている。.mp3] <br> かのじょはすなおなせいかくでひとびとにあいされている。 <br>She is loved by people for her straightforward personality.
[sound:s-1643_彼女は素直な性格で人々に愛されている。.mp3]	<b>素直</b> <br> 彼女は素直な性格で人々に愛されている。<br> かのじょはすなおなせいかくでひとびとにあいされている <br>She is loved by people for her straightforward personality.
得点	[sound:k-1644_得点.mp3]<br>とくてん <br> score, points made, marks obtained, runs
score, points made, marks obtained, runs	<b>得点<b> <br> とくてん <br>[sound:k-1644_得点.mp3]
[sound:k-1644_得点.mp3]	score, points made, marks obtained, runs<br> <b>得点</b> <br> (とくてん)
<b>両国</b> <br> 両国の首脳会談が成功裏に終了した。	[sound:s-1644_両国の首脳会談が成功裏に終了した。.mp3] <br> りょうこくのしゅのうかいだんがせいこうりにしゅうりょうした。 <br>The summit meeting between the two countries ended successfully.
[sound:s-1644_両国の首脳会談が成功裏に終了した。.mp3]	<b>両国</b> <br> 両国の首脳会談が成功裏に終了した。<br> りょうこくのしゅのうかいだんがせいこうりにしゅうりょうした <br>The summit meeting between the two countries ended successfully.
視点	[sound:k-1645_視点.mp3]<br>してん <br> opinion, point of view, visual point
opinion, point of view, visual point	<b>視点<b> <br> してん <br>[sound:k-1645_視点.mp3]
[sound:k-1645_視点.mp3]	opinion, point of view, visual point<br> <b>視点</b> <br> (してん)
<b>両党</b> <br> 両党は対立を乗り越えて協力することになった。	[sound:s-1645_両党は対立を乗り越えて協力することになった。.mp3] <br> りょうとうはたいりつをのりこえてきょうりょくすることになった。 <br>Both parties agreed to cooperate by overcoming their differences.
[sound:s-1645_両党は対立を乗り越えて協力することになった。.mp3]	<b>両党</b> <br> 両党は対立を乗り越えて協力することになった。<br> りょうとうはたいりつをのりこえてきょうりょくすることになった <br>Both parties agreed to cooperate by overcoming their differences.
失点	[sound:k-1646_失点.mp3]<br>しってん <br> run charged to the pitcher
run charged to the pitcher	<b>失点<b> <br> しってん <br>[sound:k-1646_失点.mp3]
[sound:k-1646_失点.mp3]	run charged to the pitcher<br> <b>失点</b> <br> (しってん)
<b>両親</b> <br> 私の両親は共に長生きしてほしい。	[sound:s-1646_私の両親は共に長生きしてほしい。.mp3] <br> わたしのりょうしんはともにながいきしてほしい。 <br>I want both of my parents to live long lives.
[sound:s-1646_私の両親は共に長生きしてほしい。.mp3]	<b>両親</b> <br> 私の両親は共に長生きしてほしい。<br> わたしのりょうしんはともにながいきしてほしい <br>I want both of my parents to live long lives.
重点	[sound:k-1647_重点.mp3]<br>じゅうてん <br> important point, lay stress on, colon, emphasis
important point, lay stress on, colon, emphasis	<b>重点<b> <br> じゅうてん <br>[sound:k-1647_重点.mp3]
[sound:k-1647_重点.mp3]	important point, lay stress on, colon, emphasis<br> <b>重点</b> <br> (じゅうてん)
<b>車両</b> <br> 駅で車両の乗り換えをする。	[sound:s-1647_駅で車両の乗り換えをする。.mp3] <br> えきでしゃりょうののりかえをする。 <br>Transfer to another train at the station.
[sound:s-1647_駅で車両の乗り換えをする。.mp3]	<b>車両</b> <br> 駅で車両の乗り換えをする。<br> えきでしゃりょうののりかえをする <br>Transfer to another train at the station.
同点	[sound:k-1648_同点.mp3]<br>どうてん <br> deadlock, tie, draw
deadlock, tie, draw	<b>同点<b> <br> どうてん <br>[sound:k-1648_同点.mp3]
[sound:k-1648_同点.mp3]	deadlock, tie, draw<br> <b>同点</b> <br> (どうてん)
<b>両院</b> <br> 法案は両院で可決された。	[sound:s-1648_法案は両院で可決された。.mp3] <br> ほうあんはりょういんでかけつされた。 <br>The bill was passed by both houses of the legislature.
[sound:s-1648_法案は両院で可決された。.mp3]	<b>両院</b> <br> 法案は両院で可決された。<br> ほうあんはりょういんでかけつされた <br>The bill was passed by both houses of the legislature.
問題点	[sound:k-1649_問題点.mp3]<br>もんだいてん <br> the point at issue
the point at issue	<b>問題点<b> <br> もんだいてん <br>[sound:k-1649_問題点.mp3]
[sound:k-1649_問題点.mp3]	the point at issue<br> <b>問題点</b> <br> (もんだいてん)
<b>両氏</b> <br> 両氏の間には確執がある。	[sound:s-1649_両氏の間には確執がある。.mp3] <br> りょうしのあいだにはかくしつがある。 <br>There is a conflict between the two parties.
[sound:s-1649_両氏の間には確執がある。.mp3]	<b>両氏</b> <br> 両氏の間には確執がある。<br> りょうしのあいだにはかくしつがある <br>There is a conflict between the two parties.
教育	[sound:k-1650_教育.mp3]<br>きょういく <br> training, education
training, education	<b>教育<b> <br> きょういく <br>[sound:k-1650_教育.mp3]
[sound:k-1650_教育.mp3]	training, education<br> <b>教育</b> <br> (きょういく)
<b>両日</b> <br> 両日とも快晴だった。	[sound:s-1650_両日とも快晴だった。.mp3] <br> りょうじつともかいせいだった。 <br>Both days were sunny.
[sound:s-1650_両日とも快晴だった。.mp3]	<b>両日</b> <br> 両日とも快晴だった。<br> りょうじつともかいせいだった <br>Both days were sunny.
教授	[sound:k-1651_教授.mp3]<br>きょうじゅ <br> professor; teaching, instruction
professor; teaching, instruction	<b>教授<b> <br> きょうじゅ <br>[sound:k-1651_教授.mp3]
[sound:k-1651_教授.mp3]	professor; teaching, instruction<br> <b>教授</b> <br> (きょうじゅ)
<b>両者</b> <br> 両者の意見が相いれない。	[sound:s-1651_両者の意見が相いれない。.mp3] <br> りょうしゃのいけんがあいあわない。 <br>The opinions of the two parties do not match.
[sound:s-1651_両者の意見が相いれない。.mp3]	<b>両者</b> <br> 両者の意見が相いれない。<br> りょうしゃのいけんがあいあわない <br>The opinions of the two parties do not match.
教師	[sound:k-1652_教師.mp3]<br>きょうし <br> teacher (classroom)
teacher (classroom)	<b>教師<b> <br> きょうし <br>[sound:k-1652_教師.mp3]
[sound:k-1652_教師.mp3]	teacher<br> <b>classroom) (教師</b> <br> (きょうし)
<b>両方</b> <br> 両方の選択肢を検討した。	[sound:s-1652_両方の選択肢を検討した。.mp3] <br> りょうほうのせんたくしをけんとうした。 <br>Both options were considered.
[sound:s-1652_両方の選択肢を検討した。.mp3]	<b>両方</b> <br> 両方の選択肢を検討した。<br> りょうほうのせんたくしをけんとうした <br>Both options were considered.
宗教	[sound:k-1653_宗教.mp3]<br>しゅうきょう <br> religion
religion	<b>宗教<b> <br> しゅうきょう <br>[sound:k-1653_宗教.mp3]
[sound:k-1653_宗教.mp3]	religion<br> <b>宗教</b> <br> (しゅうきょう)
<b>両面</b> <br> 彼の提案は両面から議論されるべきだ。	[sound:s-1653_彼の提案は両面から議論されるべきだ。.mp3] <br> かれのていあんはりょうめんからぎろんされるべきだ。 <br>His proposal should be discussed from both perspectives.
[sound:s-1653_彼の提案は両面から議論されるべきだ。.mp3]	<b>両面</b> <br> 彼の提案は両面から議論されるべきだ。<br> かれのていあんはりょうめんからぎろんされるべきだ <br>His proposal should be discussed from both perspectives.
教室	[sound:k-1654_教室.mp3]<br>きょうしつ <br> classroom
classroom	<b>教室<b> <br> きょうしつ <br>[sound:k-1654_教室.mp3]
[sound:k-1654_教室.mp3]	classroom<br> <b>教室</b> <br> (きょうしつ)
<b>朝</b> <br> 朝早く起きてジョギングをする。	[sound:s-1654_朝早く起きてジョギングをする。.mp3] <br> あさはやくおきてじょぎんぐをする。 <br>Get up early in the morning and go jogging.
[sound:s-1654_朝早く起きてジョギングをする。.mp3]	<b>朝</b> <br> 朝早く起きてジョギングをする。<br> あさはやくおきてじょぎんぐをする <br>Get up early in the morning and go jogging.
教徒	[sound:k-1655_教徒.mp3]<br>きょうと <br> believer, adherent
believer, adherent	<b>教徒<b> <br> きょうと <br>[sound:k-1655_教徒.mp3]
[sound:k-1655_教徒.mp3]	believer, adherent<br> <b>教徒</b> <br> (きょうと)
<b>北朝鮮</b> <br> 北朝鮮の核実験が国際社会から非難された。	[sound:s-1655_北朝鮮の核実験が国際社会から非難された。.mp3] <br> きたちょうせんのかくじっけんがこくさいしゃかいからひなんされた。 <br>North Korea's nuclear test was condemned by the international community.
[sound:s-1655_北朝鮮の核実験が国際社会から非難された。.mp3]	<b>北朝鮮</b> <br> 北朝鮮の核実験が国際社会から非難された。<br> きたちょうせんのかくじっけんがこくさいしゃかいからひなんされた <br>North Korea's nuclear test was condemned by the international community.
教科書	[sound:k-1656_教科書.mp3]<br>きょうかしょ <br> textbook, text book
textbook, text book	<b>教科書<b> <br> きょうかしょ <br>[sound:k-1656_教科書.mp3]
[sound:k-1656_教科書.mp3]	textbook, text book<br> <b>教科書</b> <br> (きょうかしょ)
<b>朝鮮</b> <br> 朝鮮半島は韓国と北朝鮮からなる。	[sound:s-1656_朝鮮半島は韓国と北朝鮮からなる。.mp3] <br> ちょうせんはんとうはかんこくときたちょうせんからなる。 <br>The Korean Peninsula consists of South Korea and North Korea.
[sound:s-1656_朝鮮半島は韓国と北朝鮮からなる。.mp3]	<b>朝鮮</b> <br> 朝鮮半島は韓国と北朝鮮からなる。<br> ちょうせんはんとうはかんこくときたちょうせんからなる <br>The Korean Peninsula consists of South Korea and North Korea.
教諭	[sound:k-1657_教諭.mp3]<br>きょうゆ <br> teacher
teacher	<b>教諭<b> <br> きょうゆ <br>[sound:k-1657_教諭.mp3]
[sound:k-1657_教諭.mp3]	teacher<br> <b>教諭</b> <br> (きょうゆ)
<b>朝鮮民主主義人民共和国</b> <br> 朝鮮民主主義人民共和国の首都は平壌です。	[sound:s-1657_朝鮮民主主義人民共和国の首都は平壌です。.mp3] <br> ちょうせんみんしゅしゅぎじんみんきょうわこくのしゅとはへいじょうです。 <br>The capital of the Democratic People's Republic of Korea is Pyongyang.
[sound:s-1657_朝鮮民主主義人民共和国の首都は平壌です。.mp3]	<b>朝鮮民主主義人民共和国</b> <br> 朝鮮民主主義人民共和国の首都は平壌です。<br> ちょうせんみんしゅしゅぎじんみんきょうわこくのしゅとはへいじょうです <br>The capital of the Democratic People's Republic of Korea is Pyongyang.
助教授	[sound:k-1658_助教授.mp3]<br>じょきょうじゅ <br> assistant professor
assistant professor	<b>助教授<b> <br> じょきょうじゅ <br>[sound:k-1658_助教授.mp3]
[sound:k-1658_助教授.mp3]	assistant professor<br> <b>助教授</b> <br> (じょきょうじゅ)
<b>朝鮮半島</b> <br> 朝鮮半島は東アジアに位置している。	[sound:s-1658_朝鮮半島は東アジアに位置している。.mp3] <br> ちょうせんはんとうはひがしアジアにいちしている。 <br>The Korean Peninsula is located in East Asia.
[sound:s-1658_朝鮮半島は東アジアに位置している。.mp3]	<b>朝鮮半島</b> <br> 朝鮮半島は東アジアに位置している。<br> ちょうせんはんとうはひがしアジアにいちしている <br>The Korean Peninsula is located in East Asia.
教会	[sound:k-1659_教会.mp3]<br>きょうかい <br> church
church	<b>教会<b> <br> きょうかい <br>[sound:k-1659_教会.mp3]
[sound:k-1659_教会.mp3]	church<br> <b>教会</b> <br> (きょうかい)
<b>早朝</b> <br> 早朝の散歩は気持ちがいい。	[sound:s-1659_早朝の散歩は気持ちがいい。.mp3] <br> そうちょうのさんぽはきもちがいい。 <br>Early morning walks are refreshing.
[sound:s-1659_早朝の散歩は気持ちがいい。.mp3]	<b>早朝</b> <br> 早朝の散歩は気持ちがいい。<br> そうちょうのさんぽはきもちがいい <br>Early morning walks are refreshing.
情報	[sound:k-1660_情報.mp3]<br>じょうほう <br> news, gossip, (military) intelligence; information (data contained in characters, signals, code, etc.)
news, gossip, (military) intelligence; information (data contained in characters, signals, code, etc.)	<b>情報<b> <br> じょうほう <br>[sound:k-1660_情報.mp3]
[sound:k-1660_情報.mp3]	news, gossip,<br> <b>military) intelligence; information (data contained in characters, signals, code, etc.) (情報</b> <br> (じょうほう)
<b>朝日</b> <br> 山々が朝日に照らされて美しい景色が広がっていた。	[sound:s-1660_山々が朝日に照らされて美しい景色が広がっていた。.mp3] <br> やまがたちがあさひにてらされてうつくしいけしきがひろがっていた。 <br>"The mountains were bathed in the morning sun, creating a beautiful landscape."
[sound:s-1660_山々が朝日に照らされて美しい景色が広がっていた。.mp3]	<b>朝日</b> <br> 山々が朝日に照らされて美しい景色が広がっていた。<br> やまがたちがあさひにてらされてうつくしいけしきがひろがっていた <br>The mountains were bathed in the morning sun, creating a beautiful landscape.
報告	[sound:k-1661_報告.mp3]<br>ほうこく <br> report, information
report, information	<b>報告<b> <br> ほうこく <br>[sound:k-1661_報告.mp3]
[sound:k-1661_報告.mp3]	report, information<br> <b>報告</b> <br> (ほうこく)
<b>朝刊</b> <br> 朝刊を読んでから仕事に出かけた。	[sound:s-1661_朝刊を読んでから仕事に出かけた。.mp3] <br> ちょうかんをよんでからしごとにでかけた。 <br>I went to work after reading the morning paper.
[sound:s-1661_朝刊を読んでから仕事に出かけた。.mp3]	<b>朝刊</b> <br> 朝刊を読んでから仕事に出かけた。<br> ちょうかんをよんでからしごとにでかけた <br>I went to work after reading the morning paper.
報道	[sound:k-1662_報道.mp3]<br>ほうどう <br> information, report, journalism
information, report, journalism	<b>報道<b> <br> ほうどう <br>[sound:k-1662_報道.mp3]
[sound:k-1662_報道.mp3]	information, report, journalism<br> <b>報道</b> <br> (ほうどう)
<b>朝食</b> <br> 朝食は一日の始まりだ。	[sound:s-1662_朝食は一日の始まりだ。.mp3] <br> ちょうしょくはいちにちのはじまりだ。 <br>Breakfast is the beginning of the day.
[sound:s-1662_朝食は一日の始まりだ。.mp3]	<b>朝食</b> <br> 朝食は一日の始まりだ。<br> ちょうしょくはいちにちのはじまりだ <br>Breakfast is the beginning of the day.
報告書	[sound:k-1663_報告書.mp3]<br>ほうこくしょ <br> (written) report
(written) report	<b>報告書<b> <br> ほうこくしょ <br>[sound:k-1663_報告書.mp3]
[sound:k-1663_報告書.mp3]	(written) report<br> <b>報告書</b> <br> (ほうこくしょ)
<b>毎朝</b> <br> 毎朝、ジョギングをする習慣がある。	[sound:s-1663_毎朝、ジョギングをする習慣がある。.mp3] <br> まいあさ、じょぎんぐをするしゅうかんがある。 <br>I have a habit of jogging every morning.
[sound:s-1663_毎朝、ジョギングをする習慣がある。.mp3]	<b>毎朝</b> <br> 毎朝、ジョギングをする習慣がある。<br> まいあさ、じょぎんぐをするしゅうかんがある <br>I have a habit of jogging every morning.
広報	[sound:k-1664_広報.mp3]<br>こうほう <br> PR, public relations, publicity, information
PR, public relations, publicity, information	<b>広報<b> <br> こうほう <br>[sound:k-1664_広報.mp3]
[sound:k-1664_広報.mp3]	PR, public relations, publicity, information<br> <b>広報</b> <br> (こうほう)
<b>革</b> <br> 革製品の製造工程には多くの手間がかかる。	[sound:s-1664_革製品の製造工程には多くの手間がかかる。.mp3] <br> かわせいひんのせいぞうこうていにはおおくのてまがかかる。 <br>The production process of leather goods requires a lot of effort.
[sound:s-1664_革製品の製造工程には多くの手間がかかる。.mp3]	<b>革</b> <br> 革製品の製造工程には多くの手間がかかる。<br> かわせいひんのせいぞうこうていにはおおくのてまがかかる <br>The production process of leather goods requires a lot of effort.
報酬	[sound:k-1665_報酬.mp3]<br>ほうしゅう <br> remuneration, recompense, reward, toll
remuneration, recompense, reward, toll	<b>報酬<b> <br> ほうしゅう <br>[sound:k-1665_報酬.mp3]
[sound:k-1665_報酬.mp3]	remuneration, recompense, reward, toll<br> <b>報酬</b> <br> (ほうしゅう)
<b>改革</b> <br> 新しい政府は国の改革を約束した。	[sound:s-1665_新しい政府は国の改革を約束した。.mp3] <br> あたらしいせいふはくにのかいかくをやくそくした。 <br>The new government promised reforms for the country.
[sound:s-1665_新しい政府は国の改革を約束した。.mp3]	<b>改革</b> <br> 新しい政府は国の改革を約束した。<br> あたらしいせいふはくにのかいかくをやくそくした <br>The new government promised reforms for the country.
報道陣	[sound:k-1666_報道陣.mp3]<br>ほうどうじん <br> press corps
press corps	<b>報道陣<b> <br> ほうどうじん <br>[sound:k-1666_報道陣.mp3]
[sound:k-1666_報道陣.mp3]	press corps<br> <b>報道陣</b> <br> (ほうどうじん)
<b>革命</b> <br> その国では社会革命が起きた。	[sound:s-1666_その国では社会革命が起きた。.mp3] <br> そのくにではしゃかいかくめいがおきた。 <br>A social revolution occurred in that country.
[sound:s-1666_その国では社会革命が起きた。.mp3]	<b>革命</b> <br> その国では社会革命が起きた。<br> そのくにではしゃかいかくめいがおきた <br>A social revolution occurred in that country.
速報	[sound:k-1667_速報.mp3]<br>そくほう <br> prompt report, quick announcement
prompt report, quick announcement	<b>速報<b> <br> そくほう <br>[sound:k-1667_速報.mp3]
[sound:k-1667_速報.mp3]	prompt report, quick announcement<br> <b>速報</b> <br> (そくほう)
<b>革新</b> <br> 技術の革新が産業の発展に貢献している。	[sound:s-1667_技術の革新が産業の発展に貢献している。.mp3] <br> ぎじゅつのかくしんがさんぎょうのはってんにこうけんしている。 <br>Technological innovation is contributing to the development of industries.
[sound:s-1667_技術の革新が産業の発展に貢献している。.mp3]	<b>革新</b> <br> 技術の革新が産業の発展に貢献している。<br> ぎじゅつのかくしんがさんぎょうのはってんにこうけんしている <br>Technological innovation is contributing to the development of industries.
日報	[sound:k-1668_日報.mp3]<br>にっぽう <br> daily report
daily report	<b>日報<b> <br> にっぽう <br>[sound:k-1668_日報.mp3]
[sound:k-1668_日報.mp3]	daily report<br> <b>日報</b> <br> (にっぽう)
<b>変革</b> <br> 新しいリーダーシップの下で変革が進められている。	[sound:s-1668_新しいリーダーシップの下で変革が進められている。.mp3] <br> あたらしいりーだーしっぷのしたでへんかくがすすめられている。 <br>Change is being pursued under new leadership.
[sound:s-1668_新しいリーダーシップの下で変革が進められている。.mp3]	<b>変革</b> <br> 新しいリーダーシップの下で変革が進められている。<br> あたらしいりーだーしっぷのしたでへんかくがすすめられている <br>Change is being pursued under new leadership.
報復	[sound:k-1669_報復.mp3]<br>ほうふく <br> retribution
retribution	<b>報復<b> <br> ほうふく <br>[sound:k-1669_報復.mp3]
[sound:k-1669_報復.mp3]	retribution<br> <b>報復</b> <br> (ほうふく)
<b>行革</b> <br> 行政改革が国の競争力を高める。	[sound:s-1669_行政改革が国の競争力を高める。.mp3] <br> ぎょうせいかいかくがくにのきょうそうりょくをたかめる。 <br>Administrative reform enhances the country's competitiveness.
[sound:s-1669_行政改革が国の競争力を高める。.mp3]	<b>行革</b> <br> 行政改革が国の競争力を高める。<br> ぎょうせいかいかくがくにのきょうそうりょくをたかめる <br>Administrative reform enhances the country's competitiveness.
経済	[sound:k-1670_経済.mp3]<br>けいざい <br> economics, business, finance, economy
economics, business, finance, economy	<b>経済<b> <br> けいざい <br>[sound:k-1670_経済.mp3]
[sound:k-1670_経済.mp3]	economics, business, finance, economy<br> <b>経済</b> <br> (けいざい)
<b>保革</b> <br> その政党は保守派と革新派から成り立っている。	[sound:s-1670_その政党は保守派と革新派から成り立っている。.mp3] <br> そのせいとうはほしゅはとかくしんはからなりたっている。 <br>The party consists of both conservatives and progressives.
[sound:s-1670_その政党は保守派と革新派から成り立っている。.mp3]	<b>保革</b> <br> その政党は保守派と革新派から成り立っている。<br> そのせいとうはほしゅはとかくしんはからなりたっている <br>The party consists of both conservatives and progressives.
救済	[sound:k-1671_救済.mp3]<br>きゅうさい <br> relief, aid, rescue, salvation, help
relief, aid, rescue, salvation, help	<b>救済<b> <br> きゅうさい <br>[sound:k-1671_救済.mp3]
[sound:k-1671_救済.mp3]	relief, aid, rescue, salvation, help<br> <b>救済</b> <br> (きゅうさい)
<b>皮革</b> <br> この店では高品質の皮革製品を取り扱っている。	[sound:s-1671_この店では高品質の皮革製品を取り扱っている。.mp3] <br> このみせではこうひんしつのひかくせいひんをとりあつかっている。 <br>This store deals with high-quality leather products.
[sound:s-1671_この店では高品質の皮革製品を取り扱っている。.mp3]	<b>皮革</b> <br> この店では高品質の皮革製品を取り扱っている。<br> このみせではこうひんしつのひかくせいひんをとりあつかっている <br>This store deals with high-quality leather products.
返済	[sound:k-1672_返済.mp3]<br>へんさい <br> repayment, reimbursement, refund, redemption
repayment, reimbursement, refund, redemption	<b>返済<b> <br> へんさい <br>[sound:k-1672_返済.mp3]
[sound:k-1672_返済.mp3]	repayment, reimbursement, refund, redemption<br> <b>返済</b> <br> (へんさい)
<b>農地改革</b> <br> 農地改革は農民の生活を改善するために行われた。	[sound:s-1672_農地改革は農民の生活を改善するために行われた。.mp3] <br> のうちかいかくはのうみんのせいかつをかいぜんするためにおこなわれた。 <br>Agrarian reform was carried out to improve the lives of farmers.
[sound:s-1672_農地改革は農民の生活を改善するために行われた。.mp3]	<b>農地改革</b> <br> 農地改革は農民の生活を改善するために行われた。<br> のうちかいかくはのうみんのせいかつをかいぜんするためにおこなわれた <br>Agrarian reform was carried out to improve the lives of farmers.
経済的	[sound:k-1673_経済的.mp3]<br>けいざいてき <br> economic, economical
economic, economical	<b>経済的<b> <br> けいざいてき <br>[sound:k-1673_経済的.mp3]
[sound:k-1673_経済的.mp3]	economic, economical<br> <b>経済的</b> <br> (けいざいてき)
<b>革靴</b> <br> 彼は毎日革靴を履いて仕事に出かける。	[sound:s-1673_彼は毎日革靴を履いて仕事に出かける。.mp3] <br> かれはまいにちかわぐつをはいてしごとにでかける。 <br>He wears leather shoes every day when going to work.
[sound:s-1673_彼は毎日革靴を履いて仕事に出かける。.mp3]	<b>革靴</b> <br> 彼は毎日革靴を履いて仕事に出かける。<br> かれはまいにちかわぐつをはいてしごとにでかける <br>He wears leather shoes every day when going to work.
経済界	[sound:k-1674_経済界.mp3]<br>けいざいかい <br> economic world, financial circles
economic world, financial circles	<b>経済界<b> <br> けいざいかい <br>[sound:k-1674_経済界.mp3]
[sound:k-1674_経済界.mp3]	economic world, financial circles<br> <b>経済界</b> <br> (けいざいかい)
<b>価格</b> <br> 商品の価格は需要と供給によって決まる。	[sound:s-1674_商品の価格は需要と供給によって決まる。.mp3] <br> しょうひんのかかくはじゅようときょうきゅうによってきまる。 <br>The price of goods is determined by demand and supply.
[sound:s-1674_商品の価格は需要と供給によって決まる。.mp3]	<b>価格</b> <br> 商品の価格は需要と供給によって決まる。<br> しょうひんのかかくはじゅようときょうきゅうによってきまる <br>The price of goods is determined by demand and supply.
経済企画庁	[sound:k-1675_経済企画庁.mp3]<br>けいざいきかくちょう <br> Economic Planning Agency
Economic Planning Agency	<b>経済企画庁<b> <br> けいざいきかくちょう <br>[sound:k-1675_経済企画庁.mp3]
[sound:k-1675_経済企画庁.mp3]	Economic Planning Agency<br> <b>経済企画庁</b> <br> (けいざいきかくちょう)
<b>株価</b> <br> この企業の株価は昨日急上昇した。	[sound:s-1675_この企業の株価は昨日急上昇した。.mp3] <br> このきぎょうのかぶかはきのうきゅうじょうしょうした。 <br>The stock price of this company surged yesterday.
[sound:s-1675_この企業の株価は昨日急上昇した。.mp3]	<b>株価</b> <br> この企業の株価は昨日急上昇した。<br> このきぎょうのかぶかはきのうきゅうじょうしょうした <br>The stock price of this company surged yesterday.
共済	[sound:k-1676_共済.mp3]<br>きょうさい <br> mutual aid
mutual aid	<b>共済<b> <br> きょうさい <br>[sound:k-1676_共済.mp3]
[sound:k-1676_共済.mp3]	mutual aid<br> <b>共済</b> <br> (きょうさい)
<b>評価</b> <br> 彼の功績が高く評価された。	[sound:s-1676_彼の功績が高く評価された。.mp3] <br> かれのこうせきがたかくひょうかされた。 <br>His achievements were highly praised.
[sound:s-1676_彼の功績が高く評価された。.mp3]	<b>評価</b> <br> 彼の功績が高く評価された。<br> かれのこうせきがたかくひょうかされた <br>His achievements were highly praised.
決済	[sound:k-1677_決済.mp3]<br>けっさい <br> settlement, payment of account
settlement, payment of account	<b>決済<b> <br> けっさい <br>[sound:k-1677_決済.mp3]
[sound:k-1677_決済.mp3]	settlement, payment of account<br> <b>決済</b> <br> (けっさい)
<b>価値</b> <br> 人生における真の幸福の価値を考える。	[sound:s-1677_人生における真の幸福の価値を考える。.mp3] <br> じんせいにおけるしんのこうふくのかちをかんがえる。 <br>Consider the true value of happiness in life.
[sound:s-1677_人生における真の幸福の価値を考える。.mp3]	<b>価値</b> <br> 人生における真の幸福の価値を考える。<br> じんせいにおけるしんのこうふくのかちをかんがえる <br>Consider the true value of happiness in life.
使用済み	[sound:k-1678_使用済み.mp3]<br>しようずみ <br> already finished being used, second-hand, no longer used
already finished being used, second-hand, no longer used	<b>使用済み<b> <br> しようずみ <br>[sound:k-1678_使用済み.mp3]
[sound:k-1678_使用済み.mp3]	already finished being used, second-hand, no longer used<br> <b>使用済み</b> <br> (しようずみ)
<b>地価</b> <br> この地域の地価は高騰している。	[sound:s-1678_この地域の地価は高騰している。.mp3] <br> このちいきのちかはこうとうしている。 <br>The land prices in this area are soaring.
[sound:s-1678_この地域の地価は高騰している。.mp3]	<b>地価</b> <br> この地域の地価は高騰している。<br> このちいきのちかはこうとうしている <br>The land prices in this area are soaring.
経済研究所	[sound:k-1679_経済研究所.mp3]<br>けいざいけんきゅうしょ <br> economics research centre, economics research center
economics research centre, economics research center	<b>経済研究所<b> <br> けいざいけんきゅうしょ <br>[sound:k-1679_経済研究所.mp3]
[sound:k-1679_経済研究所.mp3]	economics research centre, economics research center<br> <b>経済研究所</b> <br> (けいざいけんきゅうしょ)
<b>物価</b> <br> 物価上昇が家計に大きな影響を与える。	[sound:s-1679_物価上昇が家計に大きな影響を与える。.mp3] <br> ぶっかじょうしょうがかけいにおおきなえいきょうをあたえる。 <br>Rising prices have a significant impact on household budgets.
[sound:s-1679_物価上昇が家計に大きな影響を与える。.mp3]	<b>物価</b> <br> 物価上昇が家計に大きな影響を与える。<br> ぶっかじょうしょうがかけいにおおきなえいきょうをあたえる <br>Rising prices have a significant impact on household budgets.
書記	[sound:k-1680_書記.mp3]<br>しょき <br> clerk, secretary
clerk, secretary	<b>書記<b> <br> しょき <br>[sound:k-1680_書記.mp3]
[sound:k-1680_書記.mp3]	clerk, secretary<br> <b>書記</b> <br> (しょき)
<b>価値観</b> <br> 彼は異なる価値観を持つ人々と理解し合うことができる。	[sound:s-1680_彼は異なる価値観を持つ人々と理解し合うことができる。.mp3] <br> かれはことなるかちかんをもつひとびととりかいしゃうことができる。 <br>He can understand and empathize with people who hold different values.
[sound:s-1680_彼は異なる価値観を持つ人々と理解し合うことができる。.mp3]	<b>価値観</b> <br> 彼は異なる価値観を持つ人々と理解し合うことができる。<br> かれはことなるかちかんをもつひとびととりかいしゃうことができる <br>He can understand and empathize with people who hold different values.
秘書	[sound:k-1681_秘書.mp3]<br>ひしょ <br> (private) secretary
(private) secretary	<b>秘書<b> <br> ひしょ <br>[sound:k-1681_秘書.mp3]
[sound:k-1681_秘書.mp3]	(private) secretary<br> <b>秘書</b> <br> (ひしょ)
<b>有価証券</b> <br> 株式は代表的な有価証券の一つだ。	[sound:s-1681_株式は代表的な有価証券の一つだ。.mp3] <br> かぶしきはだいひょうてきなゆうかしょうけんのひとつだ。 <br>Stocks are one of the representative securities.
[sound:s-1681_株式は代表的な有価証券の一つだ。.mp3]	<b>有価証券</b> <br> 株式は代表的な有価証券の一つだ。<br> かぶしきはだいひょうてきなゆうかしょうけんのひとつだ <br>Stocks are one of the representative securities.
報告書	[sound:k-1682_報告書.mp3]<br>ほうこくしょ <br> (written) report
(written) report	<b>報告書<b> <br> ほうこくしょ <br>[sound:k-1682_報告書.mp3]
[sound:k-1682_報告書.mp3]	(written) report<br> <b>報告書</b> <br> (ほうこくしょ)
<b>米価</b> <br> 米価の上昇が農家にとって好ましくない影響を与える。	[sound:s-1682_米価の上昇が農家にとって好ましくない影響を与える。.mp3] <br> べいかのじょうしょうがのうかにとってこのましくないえいきょうをあたえる。 <br>The rise in rice prices has undesirable effects on farmers.
[sound:s-1682_米価の上昇が農家にとって好ましくない影響を与える。.mp3]	<b>米価</b> <br> 米価の上昇が農家にとって好ましくない影響を与える。<br> べいかのじょうしょうがのうかにとってこのましくないえいきょうをあたえる <br>The rise in rice prices has undesirable effects on farmers.
文書	[sound:k-1683_文書.mp3]<br>ぶんしょ, もんじょ <br> document, writing, letter, paperwork, note, records, archives
document, writing, letter, paperwork, note, records, archives	<b>文書<b> <br> ぶんしょ, もんじょ <br>[sound:k-1683_文書.mp3]
[sound:k-1683_文書.mp3]	document, writing, letter, paperwork, note, records, archives<br> <b>文書</b> <br> (ぶんしょ, もんじょ)
<b>時価</b> <br> 不動産の時価は市況に左右される。	[sound:s-1683_不動産の時価は市況に左右される。.mp3] <br> ふどうさんのじかはしきょうにさゆうされる。 <br>The market value of real estate is influenced by market conditions.
[sound:s-1683_不動産の時価は市況に左右される。.mp3]	<b>時価</b> <br> 不動産の時価は市況に左右される。<br> ふどうさんのじかはしきょうにさゆうされる <br>The market value of real estate is influenced by market conditions.
教科書	[sound:k-1684_教科書.mp3]<br>きょうかしょ <br> textbook, text book
textbook, text book	<b>教科書<b> <br> きょうかしょ <br>[sound:k-1684_教科書.mp3]
[sound:k-1684_教科書.mp3]	textbook, text book<br> <b>教科書</b> <br> (きょうかしょ)
<b>評価</b> <br> 彼の才能は高く評価されている。	[sound:s-1684_彼の才能は高く評価されている。.mp3] <br> かれのさいのうはたかくひょうかされている。 <br>His talent is highly appreciated.
[sound:s-1684_彼の才能は高く評価されている。.mp3]	<b>評価</b> <br> 彼の才能は高く評価されている。<br> かれのさいのうはたかくひょうかされている <br>His talent is highly appreciated.
書店	[sound:k-1685_書店.mp3]<br>しょてん <br> bookshop, bookstore
bookshop, bookstore	<b>書店<b> <br> しょてん <br>[sound:k-1685_書店.mp3]
[sound:k-1685_書店.mp3]	bookshop, bookstore<br> <b>書店</b> <br> (しょてん)
<b>株式</b> <br> 彼は株式投資で成功した。	[sound:s-1685_彼は株式投資で成功した。.mp3] <br> かれはかぶしきとうしみでせいこうした。 <br>He succeeded in stock investment.
[sound:s-1685_彼は株式投資で成功した。.mp3]	<b>株式</b> <br> 彼は株式投資で成功した。<br> かれはかぶしきとうしみでせいこうした <br>He succeeded in stock investment.
著書	[sound:k-1686_著書.mp3]<br>ちょしょ <br> literary work, book
literary work, book	<b>著書<b> <br> ちょしょ <br>[sound:k-1686_著書.mp3]
[sound:k-1686_著書.mp3]	literary work, book<br> <b>著書</b> <br> (ちょしょ)
<b>公式</b> <br> この手紙は公式の文書です。	[sound:s-1686_この手紙は公式の文書です。.mp3] <br> このてがみはこうしきのぶんしょです。 <br>This letter is an official document.
[sound:s-1686_この手紙は公式の文書です。.mp3]	<b>公式</b> <br> この手紙は公式の文書です。<br> このてがみはこうしきのぶんしょです <br>This letter is an official document.
白書	[sound:k-1687_白書.mp3]<br>はくしょ <br> white paper
white paper	<b>白書<b> <br> はくしょ <br>[sound:k-1687_白書.mp3]
[sound:k-1687_白書.mp3]	white paper<br> <b>白書</b> <br> (はくしょ)
<b>正式</b> <br> 正式な手続きを踏む必要があります。	[sound:s-1687_正式な手続きを踏む必要があります。.mp3] <br> せいしきなてつづきをふむひつようがあります。 <br>Formal procedures need to be followed.
[sound:s-1687_正式な手続きを踏む必要があります。.mp3]	<b>正式</b> <br> 正式な手続きを踏む必要があります。<br> せいしきなてつづきをふむひつようがあります <br>Formal procedures need to be followed.
書類	[sound:k-1688_書類.mp3]<br>しょるい <br> documents, official papers
documents, official papers	<b>書類<b> <br> しょるい <br>[sound:k-1688_書類.mp3]
[sound:k-1688_書類.mp3]	documents, official papers<br> <b>書類</b> <br> (しょるい)
<b>方式</b> <br> 新しい料理の作り方を学ぶ。	[sound:s-1688_新しい料理の作り方を学ぶ。.mp3] <br> あたらしいりょうりのつくりかたをまなぶ。 <br>Learn how to cook a new dish.
[sound:s-1688_新しい料理の作り方を学ぶ。.mp3]	<b>方式</b> <br> 新しい料理の作り方を学ぶ。<br> あたらしいりょうりのつくりかたをまなぶ <br>Learn how to cook a new dish.
図書館	[sound:k-1689_図書館.mp3]<br>としょかん, ずしょかん <br> library
library	<b>図書館<b> <br> としょかん, ずしょかん <br>[sound:k-1689_図書館.mp3]
[sound:k-1689_図書館.mp3]	library<br> <b>図書館</b> <br> (としょかん, ずしょかん)
<b>形式</b> <br> 会議は形式を守って行われた。	[sound:s-1689_会議は形式を守って行われた。.mp3] <br> かいぎはけいしきをまもっておこなわれた。 <br>The meeting was conducted following the formalities.
[sound:s-1689_会議は形式を守って行われた。.mp3]	<b>形式</b> <br> 会議は形式を守って行われた。<br> かいぎはけいしきをまもっておこなわれた <br>The meeting was conducted following the formalities.
政府	[sound:k-1690_政府.mp3]<br>せいふ <br> government, administration
government, administration	<b>政府<b> <br> せいふ <br>[sound:k-1690_政府.mp3]
[sound:k-1690_政府.mp3]	government, administration<br> <b>政府</b> <br> (せいふ)
<b>非公式</b> <br> 非公式の情報が流れている。	[sound:s-1690_非公式の情報が流れている。.mp3] <br> ひこうしきのじょうほうがながれている。 <br>Unofficial information is circulating.
