有罪	[sound:k-2818_有罪.mp3]<br>ゆうざい <br> guilt, culpability
guilt, culpability	<b>有罪<b> <br> ゆうざい <br>[sound:k-2818_有罪.mp3]
[sound:k-2818_有罪.mp3]	guilt, culpability<br> <b>有罪</b> <br> (ゆうざい)
(<b>警察</b>) 警察は犯罪を捜査しています。	[sound:s-2818_警察は犯罪を捜査しています。.mp3] <br> けいさつははんざいをそうさしています。 <br> The police are investigating the crime.
[sound:s-2808_その企業は独自の技術を持っています。.mp3]	(<b>独自</b>) その企業は独自の技術を持っています。<br> そのきぎょうはどくじのぎじゅつをもっています。 <br>The company has its own unique technology.	
有価証券	[sound:k-2819_有価証券.mp3]<br>ゆうかしょうけん <br> marketable securities, stocks and bonds
marketable securities, stocks and bonds	<b>有価証券<b> <br> ゆうかしょうけん <br>[sound:k-2819_有価証券.mp3]
[sound:k-2819_有価証券.mp3]	marketable securities, stocks and bonds<br> <b>有価証券</b> <br> (ゆうかしょうけん)
(<b>警視庁</b>) 東京都の警視庁は広範囲な治安活動を行っています。	[sound:s-2819_東京都の警視庁は広範囲な治安活動を行っています。.mp3] <br> とうきょうとのけいしちょうはこうはんいなちあんかつどうをおこなっています。 <br> The Tokyo Metropolitan Police Department is conducting extensive security operations.
[sound:s-2809_彼女は独立心が強い人です。.mp3]	(<b>独立</b>) 彼女は独立心が強い人です。<br> かのじょはどくりつしんがつよいひとです。 <br>She is a person with a strong sense of independence.	
疑い	[sound:k-2820_疑い.mp3]<br>うたがい <br> doubt, question, uncertainty, skepticism, scepticism, suspicion, distrust
doubt, question, uncertainty, skepticism, scepticism, suspicion, distrust	<b>疑い<b> <br> うたがい <br>[sound:k-2820_疑い.mp3]
[sound:k-2820_疑い.mp3]	doubt, question, uncertainty, skepticism, scepticism, suspicion, distrust<br> <b>疑い</b> <br> (うたがい)
(<b>県警</b>) 県警は交通事故の防止に力を入れています。	[sound:s-2820_県警は交通事故の防止に力を入れています。.mp3] <br> けんけいはこうつうじこのぼうしにちからをいれています。 <br> The prefectural police are focusing on preventing traffic accidents.
[sound:s-2810_彼は単独でそのプロジェクトを完成させました。.mp3]	(<b>単独</b>) 彼は単独でそのプロジェクトを完成させました。<br> かれはたんどくでそのぷろじぇくとをかんせいさせました。 <br>He completed the project alone.	
容疑者	[sound:k-2821_容疑者.mp3]<br>ようぎしゃ <br> suspect (person)
suspect (person)	<b>容疑者<b> <br> ようぎしゃ <br>[sound:k-2821_容疑者.mp3]
[sound:k-2821_容疑者.mp3]	suspect<br> <b>person) (容疑者</b> <br> (ようぎしゃ)
(<b>警戒</b>) 警察は市民にテロリストの脅威に対する警戒を呼びかけています。	[sound:s-2821_警察は市民にテロリストの脅威に対する警戒を呼びかけています。.mp3] <br> けいさつはしみんにてろりすとのきょういにたいするけいかいをよびかけています。 <br> The police are urging citizens to be vigilant against the threat of terrorists.
[sound:s-2811_この料理には独特の風味があります。.mp3]	(<b>独特</b>) この料理には独特の風味があります。<br> このりょうりにはどくとくのふうみがあります。 <br>This dish has a unique flavor.	
疑問	[sound:k-2822_疑問.mp3]<br>ぎもん <br> question, problem, doubt, guess
question, problem, doubt, guess	<b>疑問<b> <br> ぎもん <br>[sound:k-2822_疑問.mp3]
[sound:k-2822_疑問.mp3]	question, problem, doubt, guess<br> <b>疑問</b> <br> (ぎもん)
(<b>警察庁</b>) 警察庁は全国の警察活動を統括しています。	[sound:s-2822_警察庁は全国の警察活動を統括しています。.mp3] <br> けいさつちょうはぜんこくのけいさつかつどうをとうかつしています。 <br> The National Police Agency oversees police activities nationwide.
[sound:s-2812_彼らは独立国としての地位を宣言しました。.mp3]	(<b>独立国</b>) 彼らは独立国としての地位を宣言しました。<br> かれらはどくりつこくとしてのちいをせんげんしました。 <br>They declared their status as an independent country.	
疑惑	[sound:k-2823_疑惑.mp3]<br>ぎわく <br> doubt, misgivings, distrust, suspicion
doubt, misgivings, distrust, suspicion	<b>疑惑<b> <br> ぎわく <br>[sound:k-2823_疑惑.mp3]
[sound:k-2823_疑惑.mp3]	doubt, misgivings, distrust, suspicion<br> <b>疑惑</b> <br> (ぎわく)
(<b>警備</b>) 会議の警備が厳重に行われています。	[sound:s-2823_会議の警備が厳重に行われています。.mp3] <br> かいぎのけいびがげんじゅうにおこなわれています。 <br> Security for the meeting is being conducted rigorously.
[sound:s-2813_東ドイツは西ドイツとは別の国でした。.mp3]	(<b>東独</b>) 東ドイツは西ドイツとは別の国でした。<br> ひがしドイツはにしドイツとはべつのくにでした。 <br>East Germany was a separate country from West Germany.	
容疑	[sound:k-2824_容疑.mp3]<br>ようぎ <br> suspect, charge
suspect, charge	<b>容疑<b> <br> ようぎ <br>[sound:k-2824_容疑.mp3]
[sound:k-2824_容疑.mp3]	suspect, charge<br> <b>容疑</b> <br> (ようぎ)
(<b>警官</b>) 交通警官が交差点の交通整理をしています。	[sound:s-2824_交通警官が交差点の交通整理をしています。.mp3] <br> こうつうけいかんがこうさてんのこうつうせいりをしています。 <br> Traffic police officers are directing traffic at the intersection.
[sound:s-2814_この国では独裁政治が行われています。.mp3]	(<b>独裁</b>) この国では独裁政治が行われています。<br> このくにではどくさいせいじがおこなわれています。 <br>This country is under a dictatorship.	
質疑	[sound:k-2825_質疑.mp3]<br>しつぎ <br> question; interpellation
question; interpellation	<b>質疑<b> <br> しつぎ <br>[sound:k-2825_質疑.mp3]
[sound:k-2825_質疑.mp3]	question; interpellation<br> <b>質疑</b> <br> (しつぎ)
(<b>警告</b>) 警告なしに作業場に入ることは禁止されています。	[sound:s-2825_警告なしに作業場に入ることは禁止されています。.mp3] <br> けいこくなしにさぎょうばにはいることはきんしされています。 <br> Entering the workshop without warning is prohibited.
[sound:s-2815_その企業は市場で独占的な地位を占めています。.mp3]	(<b>独占</b>) その企業は市場で独占的な地位を占めています。<br> そのきぎょうはしじょうでどくせんてきなちいをしめています。 <br>The company holds a monopolistic position in the market.	
疑う	[sound:k-2826_疑う.mp3]<br>うたがう <br> to doubt, to distrust, to be suspicious of, to suspect
to doubt, to distrust, to be suspicious of, to suspect	<b>疑う<b> <br> うたがう <br>[sound:k-2826_疑う.mp3]
[sound:k-2826_疑う.mp3]	to doubt, to distrust, to be suspicious of, to suspect<br> <b>疑う</b> <br> (うたがう)
(<b>府警</b>) 府警は地域の治安維持に尽力しています。	[sound:s-2826_府警は地域の治安維持に尽力しています。.mp3] <br> ふけいはちいきのちあんいじにじんりょくしています。 <br> The prefectural police are making every effort to maintain public order in the region.
[sound:s-2816_独禁法は市場における競争を規制します。.mp3]	(<b>独禁法</b>) 独禁法は市場における競争を規制します。<br> どっきんほうはしじょうにおけるきょうそうをきせいします。 <br>Antitrust laws regulate competition in the market.	
疑念	[sound:k-2827_疑念.mp3]<br>ぎねん <br> doubt, suspicion, misgivings, scruples
doubt, suspicion, misgivings, scruples	<b>疑念<b> <br> ぎねん <br>[sound:k-2827_疑念.mp3]
[sound:k-2827_疑念.mp3]	doubt, suspicion, misgivings, scruples<br> <b>疑念</b> <br> (ぎねん)
(<b>警報</b>) 大雨の警報が発令されました。	[sound:s-2827_大雨の警報が発令されました。.mp3] <br> おおあめのけいほうがはつりょうされました。 <br> A heavy rain warning has been issued.
[sound:s-2817_彼はまだ独身です。.mp3]	(<b>独身</b>) 彼はまだ独身です。<br> かれはまだどくしんです。 <br>He is still single.	
懐疑	[sound:k-2828_懐疑.mp3]<br>かいぎ <br> doubt, skepticism, scepticism, disbelief
doubt, skepticism, scepticism, disbelief	<b>懐疑<b> <br> かいぎ <br>[sound:k-2828_懐疑.mp3]
[sound:k-2828_懐疑.mp3]	doubt, skepticism, scepticism, disbelief<br> <b>懐疑</b> <br> (かいぎ)
(<b>宮城</b>) 宮城県は東北地方の一部です。	[sound:s-2828_宮城県は東北地方の一部です。.mp3] <br> みやぎけんはとうほくちほうのいちぶです。 <br> Miyagi Prefecture is part of the Tohoku region.
[sound:s-2818_警察は犯罪を捜査しています。.mp3]	(<b>警察</b>) 警察は犯罪を捜査しています。<br> けいさつははんざいをそうさしています。 <br>The police are investigating the crime.	
疑わしい	[sound:k-2829_疑わしい.mp3]<br>うたがわしい <br> doubtful, questionable, uncertain, disputable, suspicious
doubtful, questionable, uncertain, disputable, suspicious	<b>疑わしい<b> <br> うたがわしい <br>[sound:k-2829_疑わしい.mp3]
[sound:k-2829_疑わしい.mp3]	doubtful, questionable, uncertain, disputable, suspicious<br> <b>疑わしい</b> <br> (うたがわしい)
(<b>宮内庁</b>) 宮内庁は皇室の事務を担当しています。	[sound:s-2829_宮内庁は皇室の事務を担当しています。.mp3] <br> くないちょうはこうしつのじむをたんとうしています。 <br> The Imperial Household Agency is in charge of the affairs of the Imperial Family.
[sound:s-2819_東京都の警視庁は広範囲な治安活動を行っています。.mp3]	(<b>警視庁</b>) 東京都の警視庁は広範囲な治安活動を行っています。<br> とうきょうとのけいしちょうはこうはんいなちあんかつどうをおこなっています。 <br>The Tokyo Metropolitan Police Department is conducting extensive security operations.	
口	[sound:k-2830_口.mp3]<br>くち <br> mouth; opening, hole, gap, orifice; mouth (of a bottle), spout, nozzle, mouthpiece; gate, door, entrance, exit; speaking, speech, talk (i.e. gossip); taste, palate; mouth (to feed); opening (i.e. vacancy), available position; invitation, summons; kind, sort, type; opening (i.e. beginning); counter for mouthfuls, shares (of money), and swords
mouth; opening, hole, gap, orifice; mouth (of a bottle), spout, nozzle, mouthpiece; gate, door, entrance, exit; speaking, speech, talk (i.e. gossip); taste, palate; mouth (to feed); opening (i.e. vacancy), available position; invitation, summons; kind, sort, type; opening (i.e. beginning); counter for mouthfuls, shares (of money), and swords	<b>口<b> <br> くち <br>[sound:k-2830_口.mp3]
[sound:k-2830_口.mp3]	mouth; opening, hole, gap, orifice; mouth<br> <b>of a bottle), spout, nozzle, mouthpiece; gate, door, entrance, exit; speaking, speech, talk (i.e. gossip); taste, palate; mouth (to feed); opening (i.e. vacancy), available position; invitation, summons; kind, sort, type; opening (i.e. beginning); counter for mouthfuls, shares (of money), and swords (口</b> <br> (くち)
(<b>神宮</b>) 神宮の境内は静かで美しいです。	[sound:s-2830_神宮の境内は静かで美しいです。.mp3] <br> じんぐうのけいだいはしずかでうつくしいです。 <br> The grounds of the shrine are quiet and beautiful.
[sound:s-2820_県警は交通事故の防止に力を入れています。.mp3]	(<b>県警</b>) 県警は交通事故の防止に力を入れています。<br> けんけいはこうつうじこのぼうしにちからをいれています。 <br>The prefectural police are focusing on preventing traffic accidents.	
人口	[sound:k-2831_人口.mp3]<br>じんこう <br> population; common talk
population; common talk	<b>人口<b> <br> じんこう <br>[sound:k-2831_人口.mp3]
[sound:k-2831_人口.mp3]	population; common talk<br> <b>人口</b> <br> (じんこう)
(<b>宮殿</b>) 王宮の宮殿は壮麗な建物です。	[sound:s-2831_王宮の宮殿は壮麗な建物です。.mp3] <br> おうきゅうのきゅうでんはそうれいなたてものです。 <br> The palace of the royal palace is a magnificent building.
[sound:s-2821_警察は市民にテロリストの脅威に対する警戒を呼びかけています。.mp3]	(<b>警戒</b>) 警察は市民にテロリストの脅威に対する警戒を呼びかけています。<br> けいさつはしみんにてろりすとのきょういにたいするけいかいをよびかけています。 <br>The police are urging citizens to be vigilant against the threat of terrorists.	
窓口	[sound:k-2832_窓口.mp3]<br>まどぐち <br> ticket window, teller window, counter; contact person, point of contact
ticket window, teller window, counter; contact person, point of contact	<b>窓口<b> <br> まどぐち <br>[sound:k-2832_窓口.mp3]
[sound:k-2832_窓口.mp3]	ticket window, teller window, counter; contact person, point of contact<br> <b>窓口</b> <br> (まどぐち)
(<b>子宮</b>) 子宮の病気は女性にとって深刻な問題です。	[sound:s-2832_子宮の病気は女性にとって深刻な問題です。.mp3] <br> しきゅうのびょうきはじょせいにとってしんこくなもんだいです。 <br> Diseases of the uterus are serious problems for women.
[sound:s-2822_警察庁は全国の警察活動を統括しています。.mp3]	(<b>警察庁</b>) 警察庁は全国の警察活動を統括しています。<br> けいさつちょうはぜんこくのけいさつかつどうをとうかつしています。 <br>The National Police Agency oversees police activities nationwide.	
口座	[sound:k-2833_口座.mp3]<br>こうざ <br> account (e.g. bank)
account (e.g. bank)	<b>口座<b> <br> こうざ <br>[sound:k-2833_口座.mp3]
[sound:k-2833_口座.mp3]	account<br> <b>e.g. bank) (口座</b> <br> (こうざ)
(<b>宮中</b>) 宮中での儀式は厳粛な雰囲気です。	[sound:s-2833_宮中での儀式は厳粛な雰囲気です。.mp3] <br> きゅうちゅうでのぎしきはげんしゅくなふんいきです。 <br> Ceremonies at the imperial court are solemn affairs.
[sound:s-2823_会議の警備が厳重に行われています。.mp3]	(<b>警備</b>) 会議の警備が厳重に行われています。<br> かいぎのけいびがげんじゅうにおこなわれています。 <br>Security for the meeting is being conducted rigorously.	
入り口	[sound:k-2834_入り口.mp3]<br>いりぐち, いりくち, はいりぐち, はいりくち <br> entrance, entry, gate, approach, mouth
entrance, entry, gate, approach, mouth	<b>入り口<b> <br> いりぐち, いりくち, はいりぐち, はいりくち <br>[sound:k-2834_入り口.mp3]
[sound:k-2834_入り口.mp3]	entrance, entry, gate, approach, mouth<br> <b>入り口</b> <br> (いりぐち, いりくち, はいりぐち, はいりくち)
(<b>東宮</b>) 東宮は皇太子のお住まいです。	[sound:s-2834_東宮は皇太子のお住まいです。.mp3] <br> とうぐうはこうたいしのおすまいです。 <br> The Crown Prince resides in the Crown Prince's Palace.
[sound:s-2824_交通警官が交差点の交通整理をしています。.mp3]	(<b>警官</b>) 交通警官が交差点の交通整理をしています。<br> こうつうけいかんがこうさてんのこうつうせいりをしています。 <br>Traffic police officers are directing traffic at the intersection.	
大口	[sound:k-2835_大口.mp3]<br>おおぐち <br> large amount, big mouth, tall talk
large amount, big mouth, tall talk	<b>大口<b> <br> おおぐち <br>[sound:k-2835_大口.mp3]
[sound:k-2835_大口.mp3]	large amount, big mouth, tall talk<br> <b>大口</b> <br> (おおぐち)
(<b>王宮</b>) 王宮の庭園は広大で美しいです。	[sound:s-2835_王宮の庭園は広大で美しいです。.mp3] <br> おうきゅうのていえんはこうだいでうつくしいです。 <br> The palace gardens are vast and beautiful.
[sound:s-2825_警告なしに作業場に入ることは禁止されています。.mp3]	(<b>警告</b>) 警告なしに作業場に入ることは禁止されています。<br> けいこくなしにさぎょうばにはいることはきんしされています。 <br>Entering the workshop without warning is prohibited.	
口調	[sound:k-2836_口調.mp3]<br>くちょう <br> tone (e.g. of voice, etc.), (verbal) expression
tone (e.g. of voice, etc.), (verbal) expression	<b>口調<b> <br> くちょう <br>[sound:k-2836_口調.mp3]
[sound:k-2836_口調.mp3]	tone<br> <b>e.g. of voice, etc.), (verbal) expression (口調</b> <br> (くちょう)
(<b>宮廷</b>) 宮廷の宴会は華やかな雰囲気です。	[sound:s-2836_宮廷の宴会は華やかな雰囲気です。.mp3] <br> きゅうていのえんかいははなやかなふんいきです。 <br> The court banquets are glamorous affairs.
[sound:s-2826_府警は地域の治安維持に尽力しています。.mp3]	(<b>府警</b>) 府警は地域の治安維持に尽力しています。<br> ふけいはちいきのちあんいじにじんりょくしています。 <br>The prefectural police are making every effort to maintain public order in the region.	
出口	[sound:k-2837_出口.mp3]<br>でぐち <br> exit, gateway, way out, outlet, leak, vent
exit, gateway, way out, outlet, leak, vent	<b>出口<b> <br> でぐち <br>[sound:k-2837_出口.mp3]
[sound:k-2837_出口.mp3]	exit, gateway, way out, outlet, leak, vent<br> <b>出口</b> <br> (でぐち)
(<b>二宮</b>) 二宮和也さんは人気のある俳優です。	[sound:s-2837_二宮和也さんは人気のある俳優です。.mp3] <br> にのみやかずやさんはにんきのあるはいゆうです。 <br> Kazuya Ninomiya is a popular actor.
[sound:s-2827_大雨の警報が発令されました。.mp3]	(<b>警報</b>) 大雨の警報が発令されました。<br> おおあめのけいほうがはつりょうされました。 <br>A heavy rain warning has been issued.	
川口	[sound:k-2838_川口.mp3]<br>かわぐち, かこう <br> mouth of river, estuary
mouth of river, estuary	<b>川口<b> <br> かわぐち, かこう <br>[sound:k-2838_川口.mp3]
[sound:k-2838_川口.mp3]	mouth of river, estuary<br> <b>川口</b> <br> (かわぐち, かこう)
(<b>研究</b>) 科学者たちは新しい発見のために研究しています。	[sound:s-2838_科学者たちは新しい発見のために研究しています。.mp3] <br> かがくしゃたちはあたらしいはっけんのためにけんきゅうしています。 <br> Scientists are researching for new discoveries.
[sound:s-2828_宮城県は東北地方の一部です。.mp3]	(<b>宮城</b>) 宮城県は東北地方の一部です。<br> みやぎけんはとうほくちほうのいちぶです。 <br>Miyagi Prefecture is part of the Tohoku region.	
手口	[sound:k-2839_手口.mp3]<br>てぐち <br> modus operandi, criminal technique, trick
modus operandi, criminal technique, trick	<b>手口<b> <br> てぐち <br>[sound:k-2839_手口.mp3]
[sound:k-2839_手口.mp3]	modus operandi, criminal technique, trick<br> <b>手口</b> <br> (てぐち)
(<b>研究所</b>) この研究所では最新の技術が開発されています。	[sound:s-2839_この研究所では最新の技術が開発されています。.mp3] <br> このけんきゅうしょではさいしんのぎじゅつがかいはつされています。 <br> The research institute is developing the latest technology.
[sound:s-2829_宮内庁は皇室の事務を担当しています。.mp3]	(<b>宮内庁</b>) 宮内庁は皇室の事務を担当しています。<br> くないちょうはこうしつのじむをたんとうしています。 <br>The Imperial Household Agency is in charge of the affairs of the Imperial Family.	
過ぎ	[sound:k-2840_過ぎ.mp3]<br>すぎ <br> past, after; too (much), over (e.g. eating)
past, after; too (much), over (e.g. eating)	<b>過ぎ<b> <br> すぎ <br>[sound:k-2840_過ぎ.mp3]
[sound:k-2840_過ぎ.mp3]	past, after; too<br> <b>much), over (e.g. eating) (過ぎ</b> <br> (すぎ)
(<b>研究者</b>) 彼は有名な研究者です。	[sound:s-2840_彼は有名な研究者です。.mp3] <br> かれはゆうめいなけんきゅうしゃです。 <br> He is a famous researcher.
[sound:s-2830_神宮の境内は静かで美しいです。.mp3]	(<b>神宮</b>) 神宮の境内は静かで美しいです。<br> じんぐうのけいだいはしずかでうつくしいです。 <br>The grounds of the shrine are quiet and beautiful.	
過去	[sound:k-2841_過去.mp3]<br>かこ <br> the past, bygone days, the previous
the past, bygone days, the previous	<b>過去<b> <br> かこ <br>[sound:k-2841_過去.mp3]
[sound:k-2841_過去.mp3]	the past, bygone days, the previous<br> <b>過去</b> <br> (かこ)
(<b>究明</b>) 事件の真相を究明するために捜査が行われています。	[sound:s-2841_事件の真相を究明するために捜査が行われています。.mp3] <br> じけんのしんそうをきゅうめいするためにそうさがおこなわれています。 <br> Investigation is being conducted to uncover the truth behind the incident.
[sound:s-2831_王宮の宮殿は壮麗な建物です。.mp3]	(<b>宮殿</b>) 王宮の宮殿は壮麗な建物です。<br> おうきゅうのきゅうでんはそうれいなたてものです。 <br>The palace of the royal palace is a magnificent building.	
過程	[sound:k-2842_過程.mp3]<br>かてい <br> process
process	<b>過程<b> <br> かてい <br>[sound:k-2842_過程.mp3]
[sound:k-2842_過程.mp3]	process<br> <b>過程</b> <br> (かてい)
(<b>研究員</b>) この研究所には優秀な研究員が多く在籍しています。	[sound:s-2842_この研究所には優秀な研究員が多く在籍しています。.mp3] <br> このけんきゅうしょにはゆうしゅうなけんきゅういんがおおくざいせきしています。 <br> This research institute has many excellent researchers on staff.
[sound:s-2832_子宮の病気は女性にとって深刻な問題です。.mp3]	(<b>子宮</b>) 子宮の病気は女性にとって深刻な問題です。<br> しきゅうのびょうきはじょせいにとってしんこくなもんだいです。 <br>Diseases of the uterus are serious problems for women.	
過半数	[sound:k-2843_過半数.mp3]<br>かはんすう <br> majority
majority	<b>過半数<b> <br> かはんすう <br>[sound:k-2843_過半数.mp3]
[sound:k-2843_過半数.mp3]	majority<br> <b>過半数</b> <br> (かはんすう)
(<b>研究室</b>) 彼は研究室で実験を行っています。	[sound:s-2843_彼は研究室で実験を行っています。.mp3] <br> かれはけんきゅうしつでじっけんをおこなっています。 <br> He is conducting experiments in the laboratory.
[sound:s-2833_宮中での儀式は厳粛な雰囲気です。.mp3]	(<b>宮中</b>) 宮中での儀式は厳粛な雰囲気です。<br> きゅうちゅうでのぎしきはげんしゅくなふんいきです。 <br>Ceremonies at the imperial court are solemn affairs.	
過激	[sound:k-2844_過激.mp3]<br>かげき <br> extreme, radical
extreme, radical	<b>過激<b> <br> かげき <br>[sound:k-2844_過激.mp3]
[sound:k-2844_過激.mp3]	extreme, radical<br> <b>過激</b> <br> (かげき)
(<b>研究家</b>) 彼は医学の研究家です。	[sound:s-2844_彼は医学の研究家です。.mp3] <br> かれはいがくのけんきゅうかです。 <br> He is a scholar in the field of medicine.
[sound:s-2834_東宮は皇太子のお住まいです。.mp3]	(<b>東宮</b>) 東宮は皇太子のお住まいです。<br> とうぐうはこうたいしのおすまいです。 <br>The Crown Prince resides in the Crown Prince's Palace.	
経過	[sound:k-2845_経過.mp3]<br>けいか <br> passage, expiration, progress
passage, expiration, progress	<b>経過<b> <br> けいか <br>[sound:k-2845_経過.mp3]
[sound:k-2845_経過.mp3]	passage, expiration, progress<br> <b>経過</b> <br> (けいか)
(<b>経済研究所</b>) 経済研究所は景気の動向を分析しています。	[sound:s-2845_経済研究所は景気の動向を分析しています。.mp3] <br> けいざいけんきゅうしょはけいきのどうこうをぶんせきしています。 <br> The economic research institute is analyzing economic trends.
[sound:s-2835_王宮の庭園は広大で美しいです。.mp3]	(<b>王宮</b>) 王宮の庭園は広大で美しいです。<br> おうきゅうのていえんはこうだいでうつくしいです。 <br>The palace gardens are vast and beautiful.	
通過	[sound:k-2846_通過.mp3]<br>つうか <br> passage through, transit, passing
passage through, transit, passing	<b>通過<b> <br> つうか <br>[sound:k-2846_通過.mp3]
[sound:k-2846_通過.mp3]	passage through, transit, passing<br> <b>通過</b> <br> (つうか)
(<b>究極</b>) 人間の究極の目標は幸福です。	[sound:s-2846_人間の究極の目標は幸福です。.mp3] <br> にんげんのきゅうきょくのもくひょうはこうふくです。 <br> The ultimate goal of humans is happiness.
[sound:s-2836_宮廷の宴会は華やかな雰囲気です。.mp3]	(<b>宮廷</b>) 宮廷の宴会は華やかな雰囲気です。<br> きゅうていのえんかいははなやかなふんいきです。 <br>The court banquets are glamorous affairs.	
過失	[sound:k-2847_過失.mp3]<br>かしつ <br> error, blunder, accident; fault, defect
error, blunder, accident; fault, defect	<b>過失<b> <br> かしつ <br>[sound:k-2847_過失.mp3]
[sound:k-2847_過失.mp3]	error, blunder, accident; fault, defect<br> <b>過失</b> <br> (かしつ)
(<b>研究官</b>) その政府機関には研究官が専門知識を提供しています。	[sound:s-2847_その政府機関には研究官が専門知識を提供しています。.mp3] <br> そのせいふきかんにはけんきゅうかんがせんもんちしきをていきょうしています。 <br> The government agency has researchers providing specialized knowledge.
[sound:s-2837_二宮和也さんは人気のある俳優です。.mp3]	(<b>二宮</b>) 二宮和也さんは人気のある俳優です。<br> にのみやかずやさんはにんきのあるはいゆうです。 <br>Kazuya Ninomiya is a popular actor.	
過剰	[sound:k-2848_過剰.mp3]<br>かじょう <br> excess, over-
excess, over-	<b>過剰<b> <br> かじょう <br>[sound:k-2848_過剰.mp3]
[sound:k-2848_過剰.mp3]	excess, over-<br> <b>過剰</b> <br> (かじょう)
(<b>教育</b>) 教育は社会の発展に不可欠です。	[sound:s-2848_教育は社会の発展に不可欠です。.mp3] <br> きょういくはしゃかいのはってんにふかけつです。 <br> Education is essential for the development of society.
[sound:s-2838_科学者たちは新しい発見のために研究しています。.mp3]	(<b>研究</b>) 科学者たちは新しい発見のために研究しています。<br> かがくしゃたちはあたらしいはっけんのためにけんきゅうしています。 <br>Scientists are researching for new discoveries.	
過ち	[sound:k-2849_過ち.mp3]<br>あやまち <br> fault, error, indiscretion, faux pas
fault, error, indiscretion, faux pas	<b>過ち<b> <br> あやまち <br>[sound:k-2849_過ち.mp3]
[sound:k-2849_過ち.mp3]	fault, error, indiscretion, faux pas<br> <b>過ち</b> <br> (あやまち)
(<b>体育</b>) 学校では体育の授業が毎日行われています。	[sound:s-2849_学校では体育の授業が毎日行われています。.mp3] <br> がっこうではたいいくのじゅぎょうがまいにちおこなわれています。 <br> Physical education classes are held every day at school.
[sound:s-2839_この研究所では最新の技術が開発されています。.mp3]	(<b>研究所</b>) この研究所では最新の技術が開発されています。<br> このけんきゅうしょではさいしんのぎじゅつがかいはつされています。 <br>The research institute is developing the latest technology.	
局	[sound:k-2850_局.mp3]<br>きょく <br> channel (i.e. TV or radio), station, department; affair, situation
channel (i.e. TV or radio), station, department; affair, situation	<b>局<b> <br> きょく <br>[sound:k-2850_局.mp3]
[sound:k-2850_局.mp3]	channel<br> <b>i.e. TV or radio), station, department; affair, situation (局</b> <br> (きょく)
(<b>育児</b>) 彼女は育児に専念しています。	[sound:s-2850_彼女は育児に専念しています。.mp3] <br> かのじょはいくじにせんねんしています。 <br> She is dedicated to childcare.
[sound:s-2840_彼は有名な研究者です。.mp3]	(<b>研究者</b>) 彼は有名な研究者です。<br> かれはゆうめいなけんきゅうしゃです。 <br>He is a famous researcher.	
事務局	[sound:k-2851_事務局.mp3]<br>じむきょく <br> secretariat, executive office
secretariat, executive office	<b>事務局<b> <br> じむきょく <br>[sound:k-2851_事務局.mp3]
[sound:k-2851_事務局.mp3]	secretariat, executive office<br> <b>事務局</b> <br> (じむきょく)
(<b>保育</b>) 保育園では子供たちの世話をしています。	[sound:s-2851_保育園では子供たちの世話をしています。.mp3] <br> ほいくえんではこどもたちのせわをしています。 <br> Nursery schools take care of children.
[sound:s-2841_事件の真相を究明するために捜査が行われています。.mp3]	(<b>究明</b>) 事件の真相を究明するために捜査が行われています。<br> じけんのしんそうをきゅうめいするためにそうさがおこなわれています。 <br>Investigation is being conducted to uncover the truth behind the incident.	
当局	[sound:k-2852_当局.mp3]<br>とうきょく <br> authorities; this office
authorities; this office	<b>当局<b> <br> とうきょく <br>[sound:k-2852_当局.mp3]
[sound:k-2852_当局.mp3]	authorities; this office<br> <b>当局</b> <br> (とうきょく)
(<b>育成</b>) そのプログラムは若者のリーダーシップを育成することを目的としています。	[sound:s-2852_そのプログラムは若者のリーダーシップを育成することを目的としています。.mp3] <br> そのぷろぐらむはわかもののりーだーしっぷをいくせいすることをもくてきとしています。 <br> The program aims to foster leadership in young people.
[sound:s-2842_この研究所には優秀な研究員が多く在籍しています。.mp3]	(<b>研究員</b>) この研究所には優秀な研究員が多く在籍しています。<br> このけんきゅうしょにはゆうしゅうなけんきゅういんがおおくざいせきしています。 <br>This research institute has many excellent researchers on staff.	
局長	[sound:k-2853_局長.mp3]<br>きょくちょう <br> bureau director, office chief
bureau director, office chief	<b>局長<b> <br> きょくちょう <br>[sound:k-2853_局長.mp3]
[sound:k-2853_局長.mp3]	bureau director, office chief<br> <b>局長</b> <br> (きょくちょう)
(<b>育ち</b>) 彼は自然豊かな環境で育ちました。	[sound:s-2853_彼は自然豊かな環境で育ちました。.mp3] <br> かれはしぜんゆたかなかんきょうでそだちました。 <br> He grew up in a rich natural environment.
[sound:s-2843_彼は研究室で実験を行っています。.mp3]	(<b>研究室</b>) 彼は研究室で実験を行っています。<br> かれはけんきゅうしつでじっけんをおこなっています。 <br>He is conducting experiments in the laboratory.	
結局	[sound:k-2854_結局.mp3]<br>けっきょく <br> after all, eventually
after all, eventually	<b>結局<b> <br> けっきょく <br>[sound:k-2854_結局.mp3]
[sound:k-2854_結局.mp3]	after all, eventually<br> <b>結局</b> <br> (けっきょく)
(<b>飼育</b>) その動物園ではさまざまな動物を飼育しています。	[sound:s-2854_その動物園ではさまざまな動物を飼育しています。.mp3] <br> そのどうぶつえんではさまざまなどうぶつをしいくしています。 <br> The zoo keeps various animals.
[sound:s-2844_彼は医学の研究家です。.mp3]	(<b>研究家</b>) 彼は医学の研究家です。<br> かれはいがくのけんきゅうかです。 <br>He is a scholar in the field of medicine.	
支局	[sound:k-2855_支局.mp3]<br>しきょく <br> branch office
branch office	<b>支局<b> <br> しきょく <br>[sound:k-2855_支局.mp3]
[sound:k-2855_支局.mp3]	branch office<br> <b>支局</b> <br> (しきょく)
(<b>育英</b>) 彼女は孤児の育英に尽力しています。	[sound:s-2855_彼女は孤児の育英に尽力しています。.mp3] <br> かのじょはこじのいくえいにじんりょくしています。 <br> She is dedicated to the upbringing of orphans.
[sound:s-2845_経済研究所は景気の動向を分析しています。.mp3]	(<b>経済研究所</b>) 経済研究所は景気の動向を分析しています。<br> けいざいけんきゅうしょはけいきのどうこうをぶんせきしています。 <br>The economic research institute is analyzing economic trends.	
政局	[sound:k-2856_政局.mp3]<br>せいきょく <br> political situation
political situation	<b>政局<b> <br> せいきょく <br>[sound:k-2856_政局.mp3]
[sound:k-2856_政局.mp3]	political situation<br> <b>政局</b> <br> (せいきょく)
(<b>教育委員会</b>) 教育委員会は学校教育の方針を決定します。	[sound:s-2856_教育委員会は学校教育の方針を決定します。.mp3] <br> きょういくいいんかいはがっこうきょういくのほうしんをけっていします。 <br> The board of education determines the educational policies of schools.
[sound:s-2846_人間の究極の目標は幸福です。.mp3]	(<b>究極</b>) 人間の究極の目標は幸福です。<br> にんげんのきゅうきょくのもくひょうはこうふくです。 <br>The ultimate goal of humans is happiness.	
局面	[sound:k-2857_局面.mp3]<br>きょくめん <br> checkerboard, aspect, situation
checkerboard, aspect, situation	<b>局面<b> <br> きょくめん <br>[sound:k-2857_局面.mp3]
[sound:k-2857_局面.mp3]	checkerboard, aspect, situation<br> <b>局面</b> <br> (きょくめん)
(<b>保育所</b>) 保育所では幼い子供たちが保育されます。	[sound:s-2857_保育所では幼い子供たちが保育されます。.mp3] <br> ほいくしょではおさないこどもたちがほいくされます。 <br> Nursery schools take care of young children.
[sound:s-2847_その政府機関には研究官が専門知識を提供しています。.mp3]	(<b>研究官</b>) その政府機関には研究官が専門知識を提供しています。<br> そのせいふきかんにはけんきゅうかんがせんもんちしきをていきょうしています。 <br>The government agency has researchers providing specialized knowledge.	
郵便局	[sound:k-2858_郵便局.mp3]<br>ゆうびんきょく <br> post office
post office	<b>郵便局<b> <br> ゆうびんきょく <br>[sound:k-2858_郵便局.mp3]
[sound:k-2858_郵便局.mp3]	post office<br> <b>郵便局</b> <br> (ゆうびんきょく)
(<b>席</b>) 会議の席は準備されていますか？	[sound:s-2858_会議の席は準備されていますか？.mp3] <br> かいぎのせきはじゅんびされていますか？	Is the seat for the meeting prepared?
[sound:s-2848_教育は社会の発展に不可欠です。.mp3]	(<b>教育</b>) 教育は社会の発展に不可欠です。<br> きょういくはしゃかいのはってんにふかけつです。 <br>Education is essential for the development of society.	
対局	[sound:k-2859_対局.mp3]<br>たいきょく <br> (playing) a game of go, shogi or chess, etc.
(playing) a game of go, shogi or chess, etc.	<b>対局<b> <br> たいきょく <br>[sound:k-2859_対局.mp3]
[sound:k-2859_対局.mp3]	(playing) a game of go, shogi or chess, etc.<br> <b>対局</b> <br> (たいきょく)
(<b>議席</b>) 彼は国会の議席を勝ち取りました。	[sound:s-2859_彼は国会の議席を勝ち取りました。.mp3] <br> かれはこっかいのぎせきをかちとりました。 <br> He won a seat in the parliament.
[sound:s-2849_学校では体育の授業が毎日行われています。.mp3]	(<b>体育</b>) 学校では体育の授業が毎日行われています。<br> がっこうではたいいくのじゅぎょうがまいにちおこなわれています。 <br>Physical education classes are held every day at school.	
少し	[sound:k-2860_少し.mp3]<br>すこし <br> small quantity, little, few, something; little while; short distance
small quantity, little, few, something; little while; short distance	<b>少し<b> <br> すこし <br>[sound:k-2860_少し.mp3]
[sound:k-2860_少し.mp3]	small quantity, little, few, something; little while; short distance<br> <b>少し</b> <br> (すこし)
(<b>主席</b>) 彼は会社の主席に昇進しました。	[sound:s-2860_彼は会社の主席に昇進しました。.mp3] <br> かれはかいしゃのしゅせきにしょうしんしました。 <br> He was promoted to the position of CEO in the company.
[sound:s-2850_彼女は育児に専念しています。.mp3]	(<b>育児</b>) 彼女は育児に専念しています。<br> かのじょはいくじにせんねんしています。 <br>She is dedicated to childcare.	
少なくとも	[sound:k-2861_少なくとも.mp3]<br>すくなくとも <br> at least
at least	<b>少なくとも<b> <br> すくなくとも <br>[sound:k-2861_少なくとも.mp3]
[sound:k-2861_少なくとも.mp3]	at least<br> <b>少なくとも</b> <br> (すくなくとも)
(<b>出席</b>) 明日の会議に出席する予定です。	[sound:s-2861_明日の会議に出席する予定です。.mp3] <br> あしたのかいぎにしゅっせきするよていです。 <br> I plan to attend the meeting tomorrow.
[sound:s-2851_保育園では子供たちの世話をしています。.mp3]	(<b>保育</b>) 保育園では子供たちの世話をしています。<br> ほいくえんではこどもたちのせわをしています。 <br>Nursery schools take care of children.	
少年	[sound:k-2862_少年.mp3]<br>しょうねん <br> boys, juveniles
boys, juveniles	<b>少年<b> <br> しょうねん <br>[sound:k-2862_少年.mp3]
[sound:k-2862_少年.mp3]	boys, juveniles<br> <b>少年</b> <br> (しょうねん)
(<b>打席</b>) 野球の試合で彼は良い打席を迎えました。	[sound:s-2862_野球の試合で彼は良い打席を迎えました。.mp3] <br> やきゅうのしあいでかれはよいだせきをむかえました。 <br> He had a good turn at bat in the baseball game.
[sound:s-2852_そのプログラムは若者のリーダーシップを育成することを目的としています。.mp3]	(<b>育成</b>) そのプログラムは若者のリーダーシップを育成することを目的としています。<br> そのぷろぐらむはわかもののりーだーしっぷをいくせいすることをもくてきとしています。 <br>The program aims to foster leadership in young people.	
減少	[sound:k-2863_減少.mp3]<br>げんしょう <br> decrease, reduction, decline
decrease, reduction, decline	<b>減少<b> <br> げんしょう <br>[sound:k-2863_減少.mp3]
[sound:k-2863_減少.mp3]	decrease, reduction, decline<br> <b>減少</b> <br> (げんしょう)
(<b>席上</b>) 会議の席上で彼は重要な提案を行いました。	[sound:s-2863_会議の席上で彼は重要な提案を行いました。.mp3] <br> かいぎのせきじょうでかれはじゅうようなていあんをおこないました。 <br> He made an important proposal during the meeting.
[sound:s-2853_彼は自然豊かな環境で育ちました。.mp3]	(<b>育ち</b>) 彼は自然豊かな環境で育ちました。<br> かれはしぜんゆたかなかんきょうでそだちました。 <br>He grew up in a rich natural environment.	
少数	[sound:k-2864_少数.mp3]<br>しょうすう <br> minority, few
minority, few	<b>少数<b> <br> しょうすう <br>[sound:k-2864_少数.mp3]
[sound:k-2864_少数.mp3]	minority, few<br> <b>少数</b> <br> (しょうすう)
(<b>同席</b>) 彼と同席するのはいつも楽しいです。	[sound:s-2864_彼と同席するのはいつも楽しいです。.mp3] <br> かれとどうせきするのはいつもたのしいです。 <br> It's always enjoyable to sit with him.
[sound:s-2854_その動物園ではさまざまな動物を飼育しています。.mp3]	(<b>飼育</b>) その動物園ではさまざまな動物を飼育しています。<br> そのどうぶつえんではさまざまなどうぶつをしいくしています。 <br>The zoo keeps various animals.	
少女	[sound:k-2865_少女.mp3]<br>しょうじょ, おとめ <br> young lady, little girl, virgin, maiden, daughter
young lady, little girl, virgin, maiden, daughter	<b>少女<b> <br> しょうじょ, おとめ <br>[sound:k-2865_少女.mp3]
[sound:k-2865_少女.mp3]	young lady, little girl, virgin, maiden, daughter<br> <b>少女</b> <br> (しょうじょ, おとめ)
(<b>座席</b>) 映画館の座席はすぐに売り切れました。	[sound:s-2865_映画館の座席はすぐに売り切れました。.mp3] <br> えいがかんのざせきはすぐにうりきれました。 <br> The seats in the movie theater sold out quickly.
[sound:s-2855_彼女は孤児の育英に尽力しています。.mp3]	(<b>育英</b>) 彼女は孤児の育英に尽力しています。<br> かのじょはこじのいくえいにじんりょくしています。 <br>She is dedicated to the upbringing of orphans.	
青少年	[sound:k-2866_青少年.mp3]<br>せいしょうねん <br> youth, young person
youth, young person	<b>青少年<b> <br> せいしょうねん <br>[sound:k-2866_青少年.mp3]
[sound:k-2866_青少年.mp3]	youth, young person<br> <b>青少年</b> <br> (せいしょうねん)
(<b>首席</b>) 彼女はクラスで常に首席を取っています。	[sound:s-2866_彼女はクラスで常に首席を取っています。.mp3] <br> かのじょはくらすでつねにしゅせきをとっています。 <br> She always takes the top spot in the class.
[sound:s-2856_教育委員会は学校教育の方針を決定します。.mp3]	(<b>教育委員会</b>) 教育委員会は学校教育の方針を決定します。<br> きょういくいいんかいはがっこうきょういくのほうしんをけっていします。 <br>The board of education determines the educational policies of schools.	
多少	[sound:k-2867_多少.mp3]<br>たしょう <br> more or less, somewhat, a little, some
more or less, somewhat, a little, some	<b>多少<b> <br> たしょう <br>[sound:k-2867_多少.mp3]
[sound:k-2867_多少.mp3]	more or less, somewhat, a little, some<br> <b>多少</b> <br> (たしょう)
(<b>出席者</b>) 会議の出席者が欠席することは許可されています。	[sound:s-2867_会議の出席者が欠席することは許可されています。.mp3] <br> かいぎのしゅっせきしゃがけっせきすることはきょかされています。 <br> Absence of meeting attendees is allowed.
[sound:s-2857_保育所では幼い子供たちが保育されます。.mp3]	(<b>保育所</b>) 保育所では幼い子供たちが保育されます。<br> ほいくしょではおさないこどもたちがほいくされます。 <br>Nursery schools take care of young children.	
少ない	[sound:k-2868_少ない.mp3]<br>すくない <br> few, a little, scarce, insufficient, seldom
few, a little, scarce, insufficient, seldom	<b>少ない<b> <br> すくない <br>[sound:k-2868_少ない.mp3]
[sound:k-2868_少ない.mp3]	few, a little, scarce, insufficient, seldom<br> <b>少ない</b> <br> (すくない)
(<b>欠席</b>) 明日の授業に欠席することを先生に連絡しなければなりません。	[sound:s-2868_明日の授業に欠席することを先生に連絡しなければなりません。.mp3] <br> あしたのじゅぎょうにけっせきすることをせんせいにれんらくしなければなりません。 <br> I have to inform the teacher if I'm absent from class tomorrow.
[sound:s-2858_会議の席は準備されていますか？.mp3]	(<b>席</b>) 会議の席は準備されていますか？	かいぎのせきはじゅんびされていますか？ <br>Is the seat for the meeting prepared?
少なからず	[sound:k-2869_少なからず.mp3]<br>すくなからず <br> considerably, not a little, in no small numbers
considerably, not a little, in no small numbers	<b>少なからず<b> <br> すくなからず <br>[sound:k-2869_少なからず.mp3]
[sound:k-2869_少なからず.mp3]	considerably, not a little, in no small numbers<br> <b>少なからず</b> <br> (すくなからず)
(<b>輸出</b>) 彼は輸出業者です。	[sound:s-2869_彼は輸出業者です。.mp3] <br> かれはゆしゅつぎょうしゃです。 <br>  He is an exporter.
[sound:s-2859_彼は国会の議席を勝ち取りました。.mp3]	(<b>議席</b>) 彼は国会の議席を勝ち取りました。<br> かれはこっかいのぎせきをかちとりました。 <br>He won a seat in the parliament.	
放る	[sound:k-2870_放る.mp3]<br>ほうる, ほる <br> to let go, to abandon, to leave undone; to throw, to toss, to fling
to let go, to abandon, to leave undone; to throw, to toss, to fling	<b>放る<b> <br> ほうる, ほる <br>[sound:k-2870_放る.mp3]
[sound:k-2870_放る.mp3]	to let go, to abandon, to leave undone; to throw, to toss, to fling<br> <b>放る</b> <br> (ほうる, ほる)
(<b>輸入</b>) その商品は輸入されました。	[sound:s-2870_その商品は輸入されました。.mp3] <br> そのしょうひんはゆにゅうされました。 <br>  That product was imported.
[sound:s-2860_彼は会社の主席に昇進しました。.mp3]	(<b>主席</b>) 彼は会社の主席に昇進しました。<br> かれはかいしゃのしゅせきにしょうしんしました。 <br>He was promoted to the position of CEO in the company.	
放送	[sound:k-2871_放送.mp3]<br>ほうそう <br> broadcast, broadcasting
broadcast, broadcasting	<b>放送<b> <br> ほうそう <br>[sound:k-2871_放送.mp3]
[sound:k-2871_放送.mp3]	broadcast, broadcasting<br> <b>放送</b> <br> (ほうそう)
(<b>輸送</b>) 輸送業は大切です。	[sound:s-2871_輸送業は大切です。.mp3] <br> ゆそうぎょうはたいせつです。 <br>  Transportation is important.
[sound:s-2861_明日の会議に出席する予定です。.mp3]	(<b>出席</b>) 明日の会議に出席する予定です。<br> あしたのかいぎにしゅっせきするよていです。 <br>I plan to attend the meeting tomorrow.	
開放	[sound:k-2872_開放.mp3]<br>かいほう <br> open, throw open, liberalization, liberalisation
open, throw open, liberalization, liberalisation	<b>開放<b> <br> かいほう <br>[sound:k-2872_開放.mp3]
[sound:k-2872_開放.mp3]	open, throw open, liberalization, liberalisation<br> <b>開放</b> <br> (かいほう)
(<b>運輸</b>) 運輸業界は発展しています。	[sound:s-2872_運輸業界は発展しています。.mp3] <br> うんゆぎょうかいははってんしています。 <br>  The transportation industry is developing.
[sound:s-2862_野球の試合で彼は良い打席を迎えました。.mp3]	(<b>打席</b>) 野球の試合で彼は良い打席を迎えました。<br> やきゅうのしあいでかれはよいだせきをむかえました。 <br>He had a good turn at bat in the baseball game.	
解放	[sound:k-2873_解放.mp3]<br>かいほう <br> release, unleashing, liberation, emancipation, setting free; deallocation (of computer memory)
release, unleashing, liberation, emancipation, setting free; deallocation (of computer memory)	<b>解放<b> <br> かいほう <br>[sound:k-2873_解放.mp3]
[sound:k-2873_解放.mp3]	release, unleashing, liberation, emancipation, setting free; deallocation<br> <b>of computer memory) (解放</b> <br> (かいほう)
(<b>運輸省</b>) 運輸省は交通政策を策定しています。	[sound:s-2873_運輸省は交通政策を策定しています。.mp3] <br> うんゆしょうはこうつうせいさくをさくていしています。 <br>  The Ministry of Transport is formulating transportation policies.
[sound:s-2863_会議の席上で彼は重要な提案を行いました。.mp3]	(<b>席上</b>) 会議の席上で彼は重要な提案を行いました。<br> かいぎのせきじょうでかれはじゅうようなていあんをおこないました。 <br>He made an important proposal during the meeting.	
民放	[sound:k-2874_民放.mp3]<br>みんぽう <br> commercial broadcast
commercial broadcast	<b>民放<b> <br> みんぽう <br>[sound:k-2874_民放.mp3]
[sound:k-2874_民放.mp3]	commercial broadcast<br> <b>民放</b> <br> (みんぽう)
(<b>禁輸</b>) その国には禁輸措置が課されました。	[sound:s-2874_その国には禁輸措置が課されました。.mp3] <br> そのくににはきんゆそちがかされました。 <br>  Trade sanctions were imposed on that country.
[sound:s-2864_彼と同席するのはいつも楽しいです。.mp3]	(<b>同席</b>) 彼と同席するのはいつも楽しいです。<br> かれとどうせきするのはいつもたのしいです。 <br>It's always enjoyable to sit with him.	
追放	[sound:k-2875_追放.mp3]<br>ついほう <br> exile, banishment
exile, banishment	<b>追放<b> <br> ついほう <br>[sound:k-2875_追放.mp3]
[sound:k-2875_追放.mp3]	exile, banishment<br> <b>追放</b> <br> (ついほう)
(<b>密輸</b>) 密輸品が見つかりました。	[sound:s-2875_密輸品が見つかりました。.mp3] <br> みつゆひんがみつかりました。 <br>  Smuggled goods were found.
[sound:s-2865_映画館の座席はすぐに売り切れました。.mp3]	(<b>座席</b>) 映画館の座席はすぐに売り切れました。<br> えいがかんのざせきはすぐにうりきれました。 <br>The seats in the movie theater sold out quickly.	
放射性	[sound:k-2876_放射性.mp3]<br>ほうしゃせい <br> radioactive
radioactive	<b>放射性<b> <br> ほうしゃせい <br>[sound:k-2876_放射性.mp3]
[sound:k-2876_放射性.mp3]	radioactive<br> <b>放射性</b> <br> (ほうしゃせい)
(<b>輸出入</b>) この港は輸出入の拠点です。	[sound:s-2876_この港は輸出入の拠点です。.mp3] <br> このみなとはゆしゅつにゅうのきょてんです。 <br>  This port is a hub for imports and exports.
[sound:s-2866_彼女はクラスで常に首席を取っています。.mp3]	(<b>首席</b>) 彼女はクラスで常に首席を取っています。<br> かのじょはくらすでつねにしゅせきをとっています。 <br>She always takes the top spot in the class.	
放射線	[sound:k-2877_放射線.mp3]<br>ほうしゃせん <br> radiation
radiation	<b>放射線<b> <br> ほうしゃせん <br>[sound:k-2877_放射線.mp3]
[sound:k-2877_放射線.mp3]	radiation<br> <b>放射線</b> <br> (ほうしゃせん)
(<b>輸血</b>) 負傷者に緊急輸血が必要です。	[sound:s-2877_負傷者に緊急輸血が必要です。.mp3] <br> ふしょうしゃにきんきゅうゆけつがひつようです。 <br>  Emergency blood transfusion is needed for the injured.
[sound:s-2867_会議の出席者が欠席することは許可されています。.mp3]	(<b>出席者</b>) 会議の出席者が欠席することは許可されています。<br> かいぎのしゅっせきしゃがけっせきすることはきょかされています。 <br>Absence of meeting attendees is allowed.	
放射能	[sound:k-2878_放射能.mp3]<br>ほうしゃのう <br> radioactivity
radioactivity	<b>放射能<b> <br> ほうしゃのう <br>[sound:k-2878_放射能.mp3]
[sound:k-2878_放射能.mp3]	radioactivity<br> <b>放射能</b> <br> (ほうしゃのう)
(<b>空輸</b>) 緊急物資が空輸されました。	[sound:s-2878_緊急物資が空輸されました。.mp3] <br> きんきゅうぶっしはくうゆされました。 <br>  Emergency supplies were airlifted.
[sound:s-2868_明日の授業に欠席することを先生に連絡しなければなりません。.mp3]	(<b>欠席</b>) 明日の授業に欠席することを先生に連絡しなければなりません。<br> あしたのじゅぎょうにけっせきすることをせんせいにれんらくしなければなりません。 <br>I have to inform the teacher if I'm absent from class tomorrow.	
放映	[sound:k-2879_放映.mp3]<br>ほうえい <br> televising
televising	<b>放映<b> <br> ほうえい <br>[sound:k-2879_放映.mp3]
[sound:k-2879_放映.mp3]	televising<br> <b>放映</b> <br> (ほうえい)
(<b>訪ねる</b>) 彼は母校を訪ねました。	[sound:s-2879_彼は母校を訪ねました。.mp3] <br> かれはぼこうをたずねました。 <br>  He visited his alma mater.
[sound:s-2869_彼は輸出業者です。.mp3]	(<b>輸出</b>) 彼は輸出業者です。<br> かれはゆしゅつぎょうしゃです。 <br> He is an exporter.	
関税	[sound:k-2880_関税.mp3]<br>かんぜい <br> customs, duty, tariff
customs, duty, tariff	<b>関税<b> <br> かんぜい <br>[sound:k-2880_関税.mp3]
[sound:k-2880_関税.mp3]	customs, duty, tariff<br> <b>関税</b> <br> (かんぜい)
(<b>訪問</b>) 外国元首が訪問しました。	[sound:s-2880_外国元首が訪問しました。.mp3] <br> がいこくげんしゅがほうもんしました。 <br>  Foreign heads of state visited.
[sound:s-2870_その商品は輸入されました。.mp3]	(<b>輸入</b>) その商品は輸入されました。<br> そのしょうひんはゆにゅうされました。 <br> That product was imported.	
減税	[sound:k-2881_減税.mp3]<br>げんぜい <br> tax reduction
tax reduction	<b>減税<b> <br> げんぜい <br>[sound:k-2881_減税.mp3]
[sound:k-2881_減税.mp3]	tax reduction<br> <b>減税</b> <br> (げんぜい)
(<b>訪日</b>) 外国人観光客が訪日しました。	[sound:s-2881_外国人観光客が訪日しました。.mp3] <br> がいこくじんかんこうきゃくがほうにちしました。 <br>  Foreign tourists visited Japan.
[sound:s-2871_輸送業は大切です。.mp3]	(<b>輸送</b>) 輸送業は大切です。<br> ゆそうぎょうはたいせつです。 <br> Transportation is important.	
消費税	[sound:k-2882_消費税.mp3]<br>しょうひぜい <br> consumption tax (incl. sales tax, VAT, excise duty, etc.)
consumption tax (incl. sales tax, VAT, excise duty, etc.)	<b>消費税<b> <br> しょうひぜい <br>[sound:k-2882_消費税.mp3]
[sound:k-2882_消費税.mp3]	consumption tax<br> <b>incl. sales tax, VAT, excise duty, etc.) (消費税</b> <br> (しょうひぜい)
(<b>訪中</b>) 政府代表団が訪中しました。	[sound:s-2882_政府代表団が訪中しました。.mp3] <br> せいふだいひょうだんがほうちゅうしました。 <br>  Government delegations visited China.
[sound:s-2872_運輸業界は発展しています。.mp3]	(<b>運輸</b>) 運輸業界は発展しています。<br> うんゆぎょうかいははってんしています。 <br> The transportation industry is developing.	
税制	[sound:k-2883_税制.mp3]<br>ぜいせい <br> tax system
tax system	<b>税制<b> <br> ぜいせい <br>[sound:k-2883_税制.mp3]
[sound:k-2883_税制.mp3]	tax system<br> <b>税制</b> <br> (ぜいせい)
(<b>訪米</b>) その大統領は訪米しました。	[sound:s-2883_その大統領は訪米しました。.mp3] <br> そのだいとうりょうはほうべいしました。 <br>  The president visited the United States.
[sound:s-2873_運輸省は交通政策を策定しています。.mp3]	(<b>運輸省</b>) 運輸省は交通政策を策定しています。<br> うんゆしょうはこうつうせいさくをさくていしています。 <br> The Ministry of Transport is formulating transportation policies.	
課税	[sound:k-2884_課税.mp3]<br>かぜい <br> taxation
taxation	<b>課税<b> <br> かぜい <br>[sound:k-2884_課税.mp3]
[sound:k-2884_課税.mp3]	taxation<br> <b>課税</b> <br> (かぜい)
(<b>歴訪</b>) 彼は歴訪した国々で多くの経験を積んだ。	[sound:s-2884_彼は歴訪した国々で多くの経験を積んだ。.mp3] <br> かれはれきほうしたくにでおおくのけいけんをつんだ。 <br>  He gained a lot of experience in the countries he visited.
[sound:s-2874_その国には禁輸措置が課されました。.mp3]	(<b>禁輸</b>) その国には禁輸措置が課されました。<br> そのくににはきんゆそちがかされました。 <br> Trade sanctions were imposed on that country.	
所得税	[sound:k-2885_所得税.mp3]<br>しょとくぜい <br> income tax
income tax	<b>所得税<b> <br> しょとくぜい <br>[sound:k-2885_所得税.mp3]
[sound:k-2885_所得税.mp3]	income tax<br> <b>所得税</b> <br> (しょとくぜい)
(<b>訪れ</b>) 幸せが訪れることを願っています。	[sound:s-2885_幸せが訪れることを願っています。.mp3] <br> しあわせがおとずれることをねがっています。 <br>  I hope happiness comes.
[sound:s-2875_密輸品が見つかりました。.mp3]	(<b>密輸</b>) 密輸品が見つかりました。<br> みつゆひんがみつかりました。 <br> Smuggled goods were found.	
税率	[sound:k-2886_税率.mp3]<br>ぜいりつ <br> tariff; tax rate
tariff; tax rate	<b>税率<b> <br> ぜいりつ <br>[sound:k-2886_税率.mp3]
[sound:k-2886_税率.mp3]	tariff; tax rate<br> <b>税率</b> <br> (ぜいりつ)
(<b>戸別訪問</b>) 政治家は戸別訪問を行って有権者と接触する。	[sound:s-2886_政治家は戸別訪問を行って有権者と接触する。.mp3] <br> せいじかはこべつほうもんをおこなってゆうけんしゃとせっしょくする。 <br>  Politicians conduct door-to-door visits to contact voters.
[sound:s-2876_この港は輸出入の拠点です。.mp3]	(<b>輸出入</b>) この港は輸出入の拠点です。<br> このみなとはゆしゅつにゅうのきょてんです。 <br> This port is a hub for imports and exports.	
増税	[sound:k-2887_増税.mp3]<br>ぞうぜい <br> tax increase
tax increase	<b>増税<b> <br> ぞうぜい <br>[sound:k-2887_増税.mp3]
[sound:k-2887_増税.mp3]	tax increase<br> <b>増税</b> <br> (ぞうぜい)
(<b>訪欧</b>) その団体は訪欧旅行を計画しています。	[sound:s-2887_その団体は訪欧旅行を計画しています。.mp3] <br> そのだんたいはほうおうりょこうをけいかくしています。 <br>  The organization is planning a trip to Europe.
[sound:s-2877_負傷者に緊急輸血が必要です。.mp3]	(<b>輸血</b>) 負傷者に緊急輸血が必要です。<br> ふしょうしゃにきんきゅうゆけつがひつようです。 <br> Emergency blood transfusion is needed for the injured.	
税金	[sound:k-2888_税金.mp3]<br>ぜいきん <br> tax, duty
tax, duty	<b>税金<b> <br> ぜいきん <br>[sound:k-2888_税金.mp3]
[sound:k-2888_税金.mp3]	tax, duty<br> <b>税金</b> <br> (ぜいきん)
(<b>来訪</b>) 友人が来訪してくれた。	[sound:s-2888_友人が来訪してくれた。.mp3] <br> ゆうじんがらいほうしてくれた。 <br>  My friend came to visit.
[sound:s-2878_緊急物資が空輸されました。.mp3]	(<b>空輸</b>) 緊急物資が空輸されました。<br> きんきゅうぶっしはくうゆされました。 <br> Emergency supplies were airlifted.	
税収	[sound:k-2889_税収.mp3]<br>ぜいしゅう <br> tax yields, revenue
tax yields, revenue	<b>税収<b> <br> ぜいしゅう <br>[sound:k-2889_税収.mp3]
[sound:k-2889_税収.mp3]	tax yields, revenue<br> <b>税収</b> <br> (ぜいしゅう)
(<b>楽しみ</b>) 旅行は私の楽しみです。	[sound:s-2889_旅行は私の楽しみです。.mp3] <br> りょこうはわたしのたのしみです。 <br>  Traveling is my pleasure.
[sound:s-2879_彼は母校を訪ねました。.mp3]	(<b>訪ねる</b>) 彼は母校を訪ねました。<br> かれはぼこうをたずねました。 <br> He visited his alma mater.	
検査	[sound:k-2890_検査.mp3]<br>けんさ <br> inspection (e.g. customs, factory), examination
inspection (e.g. customs, factory), examination	<b>検査<b> <br> けんさ <br>[sound:k-2890_検査.mp3]
[sound:k-2890_検査.mp3]	inspection<br> <b>e.g. customs, factory), examination (検査</b> <br> (けんさ)
(<b>音楽</b>) 彼は音楽を勉強しています。	[sound:s-2890_彼は音楽を勉強しています。.mp3] <br> かれはおんがくをべんきょうしています。 <br>  He is studying music.
[sound:s-2880_外国元首が訪問しました。.mp3]	(<b>訪問</b>) 外国元首が訪問しました。<br> がいこくげんしゅがほうもんしました。 <br> Foreign heads of state visited.	
検察	[sound:k-2891_検察.mp3]<br>けんさつ <br> examination, prosecutor
examination, prosecutor	<b>検察<b> <br> けんさつ <br>[sound:k-2891_検察.mp3]
[sound:k-2891_検察.mp3]	examination, prosecutor<br> <b>検察</b> <br> (けんさつ)
(<b>楽</b>) 彼女は毎日楽しく生活しています。	[sound:s-2891_彼女は毎日楽しく生活しています。.mp3] <br> かのじょはまいにちたのしくせいかつしています。 <br>  She lives happily every day.
[sound:s-2881_外国人観光客が訪日しました。.mp3]	(<b>訪日</b>) 外国人観光客が訪日しました。<br> がいこくじんかんこうきゃくがほうにちしました。 <br> Foreign tourists visited Japan.	
検討	[sound:k-2892_検討.mp3]<br>けんとう <br> consideration, examination, investigation, study, scrutiny, discussion
consideration, examination, investigation, study, scrutiny, discussion	<b>検討<b> <br> けんとう <br>[sound:k-2892_検討.mp3]
[sound:k-2892_検討.mp3]	consideration, examination, investigation, study, scrutiny, discussion<br> <b>検討</b> <br> (けんとう)
(<b>楽器</b>) 子供たちは楽器を演奏します。	[sound:s-2892_子供たちは楽器を演奏します。.mp3] <br> こどもたちはがっきをえんそうします。 <br>  The children play musical instruments.
[sound:s-2882_政府代表団が訪中しました。.mp3]	(<b>訪中</b>) 政府代表団が訪中しました。<br> せいふだいひょうだんがほうちゅうしました。 <br> Government delegations visited China.	
地検	[sound:k-2893_地検.mp3]<br>ちけん <br> District Public Prosecutor's Office
District Public Prosecutor's Office	<b>地検<b> <br> ちけん <br>[sound:k-2893_地検.mp3]
[sound:k-2893_地検.mp3]	District Public Prosecutor's Office<br> <b>地検</b> <br> (ちけん)
(<b>倶楽部</b>) 彼はクラブで倶楽部の活動に参加しています。	[sound:s-2893_彼はクラブで倶楽部の活動に参加しています。.mp3] <br> かれはくらぶでくらぶのかつどうにさんかしています。 <br>  He participates in club activities at the club.
[sound:s-2883_その大統領は訪米しました。.mp3]	(<b>訪米</b>) その大統領は訪米しました。<br> そのだいとうりょうはほうべいしました。 <br> The president visited the United States.	
検事	[sound:k-2894_検事.mp3]<br>けんじ <br> public prosecutor
public prosecutor	<b>検事<b> <br> けんじ <br>[sound:k-2894_検事.mp3]
[sound:k-2894_検事.mp3]	public prosecutor<br> <b>検事</b> <br> (けんじ)
(<b>娯楽</b>) 週末には娯楽施設に行きます。	[sound:s-2894_週末には娯楽施設に行きます。.mp3] <br> しゅうまつにはごらくしせつにいきます。 <br>  We go to entertainment facilities on weekends.
[sound:s-2884_彼は歴訪した国々で多くの経験を積んだ。.mp3]	(<b>歴訪</b>) 彼は歴訪した国々で多くの経験を積んだ。<br> かれはれきほうしたくにでおおくのけいけんをつんだ。 <br> He gained a lot of experience in the countries he visited.	
検定	[sound:k-2895_検定.mp3]<br>けんてい <br> official certification, approval, inspection
official certification, approval, inspection	<b>検定<b> <br> けんてい <br>[sound:k-2895_検定.mp3]
[sound:k-2895_検定.mp3]	official certification, approval, inspection<br> <b>検定</b> <br> (けんてい)
(<b>能楽</b>) 能楽の公演が素晴らしかったです。	[sound:s-2895_能楽の公演が素晴らしかったです。.mp3] <br> のうがくのこうえんがすばらしかったです。 <br>  The Noh performance was wonderful.
[sound:s-2885_幸せが訪れることを願っています。.mp3]	(<b>訪れ</b>) 幸せが訪れることを願っています。<br> しあわせがおとずれることをねがっています。 <br> I hope happiness comes.	
点検	[sound:k-2896_点検.mp3]<br>てんけん <br> inspection, examination, checking
inspection, examination, checking	<b>点検<b> <br> てんけん <br>[sound:k-2896_点検.mp3]
[sound:k-2896_点検.mp3]	inspection, examination, checking<br> <b>点検</b> <br> (てんけん)
(<b>楽観</b>) 彼は常に楽観的な見方をしています。	[sound:s-2896_彼は常に楽観的な見方をしています。.mp3] <br> かれはつねにらっかんてきなみかたをしています。 <br>  He always has an optimistic view.
[sound:s-2886_政治家は戸別訪問を行って有権者と接触する。.mp3]	(<b>戸別訪問</b>) 政治家は戸別訪問を行って有権者と接触する。<br> せいじかはこべつほうもんをおこなってゆうけんしゃとせっしょくする。 <br> Politicians conduct door-to-door visits to contact voters.	
検証	[sound:k-2897_検証.mp3]<br>けんしょう <br> verification, inspection
verification, inspection	<b>検証<b> <br> けんしょう <br>[sound:k-2897_検証.mp3]
[sound:k-2897_検証.mp3]	verification, inspection<br> <b>検証</b> <br> (けんしょう)
(<b>楽しい</b>) パーティーはとても楽しいです。	[sound:s-2897_パーティーはとても楽しいです。.mp3] <br> ぱーてぃーはとてもたのしいです。 <br>  The party is very fun.
[sound:s-2887_その団体は訪欧旅行を計画しています。.mp3]	(<b>訪欧</b>) その団体は訪欧旅行を計画しています。<br> そのだんたいはほうおうりょこうをけいかくしています。 <br> The organization is planning a trip to Europe.	
検診	[sound:k-2898_検診.mp3]<br>けんしん <br> medical examination
medical examination	<b>検診<b> <br> けんしん <br>[sound:k-2898_検診.mp3]
[sound:k-2898_検診.mp3]	medical examination<br> <b>検診</b> <br> (けんしん)
(<b>楽しむ</b>) 旅行で自然を楽しんでください。	[sound:s-2898_旅行で自然を楽しんでください。.mp3] <br> りょこうでしぜんをたのしんでください。 <br>  Please enjoy nature on your trip.
[sound:s-2888_友人が来訪してくれた。.mp3]	(<b>来訪</b>) 友人が来訪してくれた。<br> ゆうじんがらいほうしてくれた。 <br> My friend came to visit.	
検問	[sound:k-2899_検問.mp3]<br>けんもん <br> inspection, examination
inspection, examination	<b>検問<b> <br> けんもん <br>[sound:k-2899_検問.mp3]
[sound:k-2899_検問.mp3]	inspection, examination<br> <b>検問</b> <br> (けんもん)
(<b>起訴</b>) 彼は殺人罪で起訴されました。	[sound:s-2899_彼は殺人罪で起訴されました。.mp3] <br> かれはさつじんざいできそされました。 <br>  He was charged with murder.
[sound:s-2889_旅行は私の楽しみです。.mp3]	(<b>楽しみ</b>) 旅行は私の楽しみです。<br> りょこうはわたしのたのしみです。 <br> Traveling is my pleasure.	
藤	[sound:k-2900_藤.mp3]<br>ふじ <br> wisteria, Wisteria floribunda
wisteria, Wisteria floribunda	<b>藤<b> <br> ふじ <br>[sound:k-2900_藤.mp3]
[sound:k-2900_藤.mp3]	wisteria, Wisteria floribunda<br> <b>藤</b> <br> (ふじ)
(<b>起こす</b>) 事件は大きな騒ぎを起こしました。	[sound:s-2900_事件は大きな騒ぎを起こしました。.mp3] <br> じけんはおおきなさわぎをおこしました。 <br>  The incident caused a big fuss.
[sound:s-2890_彼は音楽を勉強しています。.mp3]	(<b>音楽</b>) 彼は音楽を勉強しています。<br> かれはおんがくをべんきょうしています。 <br> He is studying music.	
葛藤	[sound:k-2901_葛藤.mp3]<br>かっとう <br> conflict, complication, troubles, discord
conflict, complication, troubles, discord	<b>葛藤<b> <br> かっとう <br>[sound:k-2901_葛藤.mp3]
[sound:k-2901_葛藤.mp3]	conflict, complication, troubles, discord<br> <b>葛藤</b> <br> (かっとう)
(<b>起用</b>) 彼女は新しいポジションに起用されました。	[sound:s-2901_彼女は新しいポジションに起用されました。.mp3] <br> かのじょはあたらしいぽじしょんにきようされました。 <br>  She was appointed to a new position.
[sound:s-2891_彼女は毎日楽しく生活しています。.mp3]	(<b>楽</b>) 彼女は毎日楽しく生活しています。<br> かのじょはまいにちたのしくせいかつしています。 <br> She lives happily every day.	
藤色	[sound:k-2902_藤色.mp3]<br>ふじいろ <br> light purple
light purple	<b>藤色<b> <br> ふじいろ <br>[sound:k-2902_藤色.mp3]
[sound:k-2902_藤色.mp3]	light purple<br> <b>藤色</b> <br> (ふじいろ)
(<b>起こる</b>) 事故は突然に起こりました。	[sound:s-2902_事故は突然に起こりました。.mp3] <br> じこはとつぜんにおこりました。 <br>  The accident happened suddenly.
[sound:s-2892_子供たちは楽器を演奏します。.mp3]	(<b>楽器</b>) 子供たちは楽器を演奏します。<br> こどもたちはがっきをえんそうします。 <br> The children play musical instruments.	
藤棚	[sound:k-2903_藤棚.mp3]<br>ふじだな <br> wisteria trellis (arbor, arbour)
wisteria trellis (arbor, arbour)	<b>藤棚<b> <br> ふじだな <br>[sound:k-2903_藤棚.mp3]
[sound:k-2903_藤棚.mp3]	wisteria trellis<br> <b>arbor, arbour) (藤棚</b> <br> (ふじだな)
(<b>提起</b>) 彼の提起に対して多くの人が反対しました。	[sound:s-2903_彼の提起に対して多くの人が反対しました。.mp3] <br> かれのていきにたいしておおくのひとがはんたいしました。 <br>  Many people opposed his proposal.
[sound:s-2893_彼はクラブで倶楽部の活動に参加しています。.mp3]	(<b>倶楽部</b>) 彼はクラブで倶楽部の活動に参加しています。<br> かれはくらぶでくらぶのかつどうにさんかしています。 <br> He participates in club activities at the club.	
藤蔓	[sound:k-2904_藤蔓.mp3]<br>ふじづる <br> wisteria vine
wisteria vine	<b>藤蔓<b> <br> ふじづる <br>[sound:k-2904_藤蔓.mp3]
[sound:k-2904_藤蔓.mp3]	wisteria vine<br> <b>藤蔓</b> <br> (ふじづる)
(<b>躍起</b>) 彼は成功のために躍起になっている。	[sound:s-2904_彼は成功のために躍起になっている。.mp3] <br> かれはせいこうのためにやっきになっている。 <br>  He is determined to succeed.
[sound:s-2894_週末には娯楽施設に行きます。.mp3]	(<b>娯楽</b>) 週末には娯楽施設に行きます。<br> しゅうまつにはごらくしせつにいきます。 <br> We go to entertainment facilities on weekends.	
藤氏	[sound:k-2905_藤氏.mp3]<br>とうし <br> Fujiwara family
Fujiwara family	<b>藤氏<b> <br> とうし <br>[sound:k-2905_藤氏.mp3]
[sound:k-2905_藤氏.mp3]	Fujiwara family<br> <b>藤氏</b> <br> (とうし)
(<b>決起</b>) 国民は団結して決起しました。	[sound:s-2905_国民は団結して決起しました。.mp3] <br> こくみんはだんけつしてけっきしました。 <br>  The people united and rose up.
[sound:s-2895_能楽の公演が素晴らしかったです。.mp3]	(<b>能楽</b>) 能楽の公演が素晴らしかったです。<br> のうがくのこうえんがすばらしかったです。 <br> The Noh performance was wonderful.	
藤本	[sound:k-2906_藤本.mp3]<br>とうほん <br> climbing trees, liana
climbing trees, liana	<b>藤本<b> <br> とうほん <br>[sound:k-2906_藤本.mp3]
[sound:k-2906_藤本.mp3]	climbing trees, liana<br> <b>藤本</b> <br> (とうほん)
(<b>発起人</b>) この運動の発起人は彼女です。	[sound:s-2906_この運動の発起人は彼女です。.mp3] <br> このうんどうのはっきにんはかのじょです。 <br>  She is the initiator of this movement.
[sound:s-2896_彼は常に楽観的な見方をしています。.mp3]	(<b>楽観</b>) 彼は常に楽観的な見方をしています。<br> かれはつねにらっかんてきなみかたをしています。 <br> He always has an optimistic view.	
上り藤	[sound:k-2907_上り藤.mp3]<br>のぼりふじ <br> lupine
lupine	<b>上り藤<b> <br> のぼりふじ <br>[sound:k-2907_上り藤.mp3]
[sound:k-2907_上り藤.mp3]	lupine<br> <b>上り藤</b> <br> (のぼりふじ)
(<b>起草</b>) その法案の起草に多くの時間がかかった。	[sound:s-2907_その法案の起草に多くの時間がかかった。.mp3] <br> そのほうあんのきそうにおおくのじかんがかかった。 <br>  Drafting the bill took a lot of time.
[sound:s-2897_パーティーはとても楽しいです。.mp3]	(<b>楽しい</b>) パーティーはとても楽しいです。<br> ぱーてぃーはとてもたのしいです。 <br> The party is very fun.	
藤原氏の出	[sound:k-2908_藤原氏の出.mp3]<br>ふじわらしのしゅつ <br> of Fujiwara descent
of Fujiwara descent	<b>藤原氏の出<b> <br> ふじわらしのしゅつ <br>[sound:k-2908_藤原氏の出.mp3]
[sound:k-2908_藤原氏の出.mp3]	of Fujiwara descent<br> <b>藤原氏の出</b> <br> (ふじわらしのしゅつ)
(<b>不起訴</b>) 彼は容疑が晴れて不起訴となりました。	[sound:s-2908_彼は容疑が晴れて不起訴となりました。.mp3] <br> かれはようぎがはれてふきそとなりました。 <br>  He was cleared of suspicion and not prosecuted.
[sound:s-2898_旅行で自然を楽しんでください。.mp3]	(<b>楽しむ</b>) 旅行で自然を楽しんでください。<br> りょこうでしぜんをたのしんでください。 <br> Please enjoy nature on your trip.	
藤袴	[sound:k-2909_藤袴.mp3]<br>ふじばかま, フジバカマ <br> thoroughwort, Eupatorium fortunei (species of boneset), Eupatorium japonicum
thoroughwort, Eupatorium fortunei (species of boneset), Eupatorium japonicum	<b>藤袴<b> <br> ふじばかま, フジバカマ <br>[sound:k-2909_藤袴.mp3]
[sound:k-2909_藤袴.mp3]	thoroughwort, Eupatorium fortunei<br> <b>species of boneset), Eupatorium japonicum (藤袴</b> <br> (ふじばかま, フジバカマ)
(<b>十万</b>) 車を買うために十万円を貯めました。	[sound:s-2909_車を買うために十万円を貯めました。.mp3] <br> くるまをかうためにじゅうまんえんをためました。 <br> I saved 100,000 yen to buy a car.
[sound:s-2899_彼は殺人罪で起訴されました。.mp3]	(<b>起訴</b>) 彼は殺人罪で起訴されました。<br> かれはさつじんざいできそされました。 <br> He was charged with murder.	
町	[sound:k-2910_町.mp3]<br>まち, ちょう <br> town, block, neighbourhood, neighborhood; street, road; 109.09 m; 0.99 hectares
town, block, neighbourhood, neighborhood; street, road; 109.09 m; 0.99 hectares	<b>町<b> <br> まち, ちょう <br>[sound:k-2910_町.mp3]
[sound:k-2910_町.mp3]	town, block, neighbourhood, neighborhood; street, road; 109.09 m; 0.99 hectares<br> <b>町</b> <br> (まち, ちょう)
(<b>百万</b>) 彼の貯金は百万円に達した。	[sound:s-2910_彼の貯金は百万円に達した。.mp3] <br> かれのちょきんはひゃくまんえんにたっした。 <br>  His savings reached one million yen.
[sound:s-2900_事件は大きな騒ぎを起こしました。.mp3]	(<b>起こす</b>) 事件は大きな騒ぎを起こしました。<br> じけんはおおきなさわぎをおこしました。 <br> The incident caused a big fuss.	
市町村	[sound:k-2911_市町村.mp3]<br>しちょうそん <br> cities, towns and villages, municipalities
cities, towns and villages, municipalities	<b>市町村<b> <br> しちょうそん <br>[sound:k-2911_市町村.mp3]
[sound:k-2911_市町村.mp3]	cities, towns and villages, municipalities<br> <b>市町村</b> <br> (しちょうそん)
(<b>万全</b>) 彼は準備万全で会議に臨みました。	[sound:s-2911_彼は準備万全で会議に臨みました。.mp3] <br> かれはじゅんびばんぜんでかいぎにのぞみました。 <br>  He went to the meeting fully prepared.
[sound:s-2901_彼女は新しいポジションに起用されました。.mp3]	(<b>起用</b>) 彼女は新しいポジションに起用されました。<br> かのじょはあたらしいぽじしょんにきようされました。 <br> She was appointed to a new position.	
同町	[sound:k-2912_同町.mp3]<br>どうちょう <br> the same town, that town
the same town, that town	<b>同町<b> <br> どうちょう <br>[sound:k-2912_同町.mp3]
[sound:k-2912_同町.mp3]	the same town, that town<br> <b>同町</b> <br> (どうちょう)
(<b>数万</b>) 数万人がそのイベントに参加しました。	[sound:s-2912_数万人がそのイベントに参加しました。.mp3] <br> すうまんにんがそのイベントにさんかしました。 <br>  Tens of thousands of people attended the event.
[sound:s-2902_事故は突然に起こりました。.mp3]	(<b>起こる</b>) 事故は突然に起こりました。<br> じこはとつぜんにおこりました。 <br> The accident happened suddenly.	
町長	[sound:k-2913_町長.mp3]<br>ちょうちょう <br> town headman, town mayor
town headman, town mayor	<b>町長<b> <br> ちょうちょう <br>[sound:k-2913_町長.mp3]
[sound:k-2913_町長.mp3]	town headman, town mayor<br> <b>町長</b> <br> (ちょうちょう)
(<b>万里</b>) 古代の船は万里を航海しました。	[sound:s-2913_古代の船は万里を航海しました。.mp3] <br> こだいのふねはまんりをこうかいしました。 <br>  Ancient ships sailed thousands of miles.
[sound:s-2903_彼の提起に対して多くの人が反対しました。.mp3]	(<b>提起</b>) 彼の提起に対して多くの人が反対しました。<br> かれのていきにたいしておおくのひとがはんたいしました。 <br> Many people opposed his proposal.	
町内	[sound:k-2914_町内.mp3]<br>ちょうない <br> neighborhood, neighbourhood, street, block, town
neighborhood, neighbourhood, street, block, town	<b>町内<b> <br> ちょうない <br>[sound:k-2914_町内.mp3]
[sound:k-2914_町内.mp3]	neighborhood, neighbourhood, street, block, town<br> <b>町内</b> <br> (ちょうない)
(<b>万能</b>) 彼は万能な才能を持っています。	[sound:s-2914_彼は万能な才能を持っています。.mp3] <br> かれはばんのうなさいのうをもっています。 <br>  He has versatile talent.
[sound:s-2904_彼は成功のために躍起になっている。.mp3]	(<b>躍起</b>) 彼は成功のために躍起になっている。<br> かれはせいこうのためにやっきになっている。 <br> He is determined to succeed.	
下町	[sound:k-2915_下町.mp3]<br>したまち <br> Shitamachi, lower parts of town
Shitamachi, lower parts of town	<b>下町<b> <br> したまち <br>[sound:k-2915_下町.mp3]
[sound:k-2915_下町.mp3]	Shitamachi, lower parts of town<br> <b>下町</b> <br> (したまち)
(<b>万一</b>) 万一の場合に備えて準備しておきましょう。	[sound:s-2915_万一の場合に備えて準備しておきましょう。.mp3] <br> まんいちのばあいにそなえてじゅんびしておきましょう。 <br>  Let's prepare for the worst-case scenario.
[sound:s-2905_国民は団結して決起しました。.mp3]	(<b>決起</b>) 国民は団結して決起しました。<br> こくみんはだんけつしてけっきしました。 <br> The people united and rose up.	
町村	[sound:k-2916_町村.mp3]<br>ちょうそん <br> towns and villages
towns and villages	<b>町村<b> <br> ちょうそん <br>[sound:k-2916_町村.mp3]
[sound:k-2916_町村.mp3]	towns and villages<br> <b>町村</b> <br> (ちょうそん)
(<b>万国</b>) 万国博覧会は多くの国々が参加しました。	[sound:s-2916_万国博覧会は多くの国々が参加しました。.mp3] <br> ばんこくはくらんかいはおおくのくにがさんかしました。 <br>  Many countries participated in the World Exposition.
[sound:s-2906_この運動の発起人は彼女です。.mp3]	(<b>発起人</b>) この運動の発起人は彼女です。<br> このうんどうのはっきにんはかのじょです。 <br> She is the initiator of this movement.	
町民	[sound:k-2917_町民.mp3]<br>ちょうみん <br> townspeople
townspeople	<b>町民<b> <br> ちょうみん <br>[sound:k-2917_町民.mp3]
[sound:k-2917_町民.mp3]	townspeople<br> <b>町民</b> <br> (ちょうみん)
(<b>万人</b>) そのイベントは万人以上の人々が集まりました。	[sound:s-2917_そのイベントは万人以上の人々が集まりました。.mp3] <br> そのイベントはまんにんいじょうのひとびとがあつまりました。 <br>  The event attracted over ten thousand people.
[sound:s-2907_その法案の起草に多くの時間がかかった。.mp3]	(<b>起草</b>) その法案の起草に多くの時間がかかった。<br> そのほうあんのきそうにおおくのじかんがかかった。 <br> Drafting the bill took a lot of time.	
町並み	[sound:k-2918_町並み.mp3]<br>まちなみ <br> street (of stores and houses), townscape, (look of) stores and houses on street
street (of stores and houses), townscape, (look of) stores and houses on street	<b>町並み<b> <br> まちなみ <br>[sound:k-2918_町並み.mp3]
[sound:k-2918_町並み.mp3]	street<br> <b>of stores and houses), townscape, (look of) stores and houses on street (町並み</b> <br> (まちなみ)
(<b>万歳</b>) 万歳の声が会場に響き渡った。	[sound:s-2918_万歳の声が会場に響き渡った。.mp3] <br> ばんざいのこえがかいじょうにひびきわたった。 <br>  Cheers echoed throughout the venue.
[sound:s-2908_彼は容疑が晴れて不起訴となりました。.mp3]	(<b>不起訴</b>) 彼は容疑が晴れて不起訴となりました。<br> かれはようぎがはれてふきそとなりました。 <br> He was cleared of suspicion and not prosecuted.	
室町	[sound:k-2919_室町.mp3]<br>むろまち <br> Muromachi (era 1392-1573, or 1333-1573, or 1336-1573)
Muromachi (era 1392-1573, or 1333-1573, or 1336-1573)	<b>室町<b> <br> むろまち <br>[sound:k-2919_室町.mp3]
[sound:k-2919_室町.mp3]	Muromachi<br> <b>era 1392-1573, or 1333-1573, or 1336-1573) (室町</b> <br> (むろまち)
(<b>決着</b>) 争いはついに決着がついた。	[sound:s-2919_争いはついに決着がついた。.mp3] <br> あらそいはついにけっちゃくがついた。 <br>  The dispute finally came to an end.
[sound:s-2909_車を買うために十万円を貯めました。.mp3]	(<b>十万</b>) 車を買うために十万円を貯めました。<br> くるまをかうためにじゅうまんえんをためました。 <br>I saved 100,000 yen to buy a car.	
常	[sound:k-2920_常.mp3]<br>とこ <br> ever, endless
ever, endless	<b>常<b> <br> とこ <br>[sound:k-2920_常.mp3]
[sound:k-2920_常.mp3]	ever, endless<br> <b>常</b> <br> (とこ)
(<b>着実</b>) 彼は着実な進歩を遂げています。	[sound:s-2920_彼は着実な進歩を遂げています。.mp3] <br> かれはちゃくじつなしんぽをとげています。 <br>  He is making steady progress.
[sound:s-2910_彼の貯金は百万円に達した。.mp3]	(<b>百万</b>) 彼の貯金は百万円に達した。<br> かれのちょきんはひゃくまんえんにたっした。 <br> His savings reached one million yen.	
常に	[sound:k-2921_常に.mp3]<br>つねに <br> always, constantly
always, constantly	<b>常に<b> <br> つねに <br>[sound:k-2921_常に.mp3]
[sound:k-2921_常に.mp3]	always, constantly<br> <b>常に</b> <br> (つねに)
(<b>落ち着いた</b>) 彼はいつも落ち着いた態度を保っている。	[sound:s-2921_彼はいつも落ち着いた態度を保っている。.mp3] <br> かれはいつもおちついたたいどをたもっている。 <br>  He always maintains a calm attitude.
[sound:s-2911_彼は準備万全で会議に臨みました。.mp3]	(<b>万全</b>) 彼は準備万全で会議に臨みました。<br> かれはじゅんびばんぜんでかいぎにのぞみました。 <br> He went to the meeting fully prepared.	
常務	[sound:k-2922_常務.mp3]<br>じょうむ <br> managing director, executive director; routine business, regular business
managing director, executive director; routine business, regular business	<b>常務<b> <br> じょうむ <br>[sound:k-2922_常務.mp3]
[sound:k-2922_常務.mp3]	managing director, executive director; routine business, regular business<br> <b>常務</b> <br> (じょうむ)
(<b>癒着</b>) その組織は汚職と癒着が蔓延している。	[sound:s-2922_その組織は汚職と癒着が蔓延している。.mp3] <br> そのそしきはおしょくとゆちゃくがまんえんしている。 <br>  Corruption and collusion are rampant in that organization.
[sound:s-2912_数万人がそのイベントに参加しました。.mp3]	(<b>数万</b>) 数万人がそのイベントに参加しました。<br> すうまんにんがそのイベントにさんかしました。 <br> Tens of thousands of people attended the event.	
正常	[sound:k-2923_正常.mp3]<br>せいじょう <br> normalcy, normality, normal
normalcy, normality, normal	<b>正常<b> <br> せいじょう <br>[sound:k-2923_正常.mp3]
[sound:k-2923_正常.mp3]	normalcy, normality, normal<br> <b>正常</b> <br> (せいじょう)
(<b>着る</b>) 彼はスーツを着て会議に出席しました。	[sound:s-2923_彼はスーツを着て会議に出席しました。.mp3] <br> かれはすーつをきてかいぎにしゅっせきしました。 <br>  He wore a suit to the meeting.
[sound:s-2913_古代の船は万里を航海しました。.mp3]	(<b>万里</b>) 古代の船は万里を航海しました。<br> こだいのふねはまんりをこうかいしました。 <br> Ancient ships sailed thousands of miles.	
通常	[sound:k-2924_通常.mp3]<br>つうじょう <br> common, general, normal, usual
common, general, normal, usual	<b>通常<b> <br> つうじょう <br>[sound:k-2924_通常.mp3]
[sound:k-2924_通常.mp3]	common, general, normal, usual<br> <b>通常</b> <br> (つうじょう)
(<b>着工</b>) 工事は着工されました。	[sound:s-2924_工事は着工されました。.mp3] <br> こうじはちゃっこうされました。 <br>  Construction has commenced.
[sound:s-2914_彼は万能な才能を持っています。.mp3]	(<b>万能</b>) 彼は万能な才能を持っています。<br> かれはばんのうなさいのうをもっています。 <br> He has versatile talent.	
非常	[sound:k-2925_非常.mp3]<br>ひじょう <br> emergency, extraordinary, unusual
emergency, extraordinary, unusual	<b>非常<b> <br> ひじょう <br>[sound:k-2925_非常.mp3]
[sound:k-2925_非常.mp3]	emergency, extraordinary, unusual<br> <b>非常</b> <br> (ひじょう)
(<b>着陸</b>) 飛行機は無事に着陸しました。	[sound:s-2925_飛行機は無事に着陸しました。.mp3] <br> ひこうきはぶじにちゃくりくしました。 <br>  The plane landed safely.
[sound:s-2915_万一の場合に備えて準備しておきましょう。.mp3]	(<b>万一</b>) 万一の場合に備えて準備しておきましょう。<br> まんいちのばあいにそなえてじゅんびしておきましょう。 <br> Let's prepare for the worst-case scenario.	
常任	[sound:k-2926_常任.mp3]<br>じょうにん <br> standing, regular, permanent
standing, regular, permanent	<b>常任<b> <br> じょうにん <br>[sound:k-2926_常任.mp3]
[sound:k-2926_常任.mp3]	standing, regular, permanent<br> <b>常任</b> <br> (じょうにん)
(<b>到着</b>) 船が予定より早く到着しました。	[sound:s-2926_船が予定より早く到着しました。.mp3] <br> ふねがよていよりはやくとうちゃくしました。 <br>  The ship arrived earlier than scheduled.
[sound:s-2916_万国博覧会は多くの国々が参加しました。.mp3]	(<b>万国</b>) 万国博覧会は多くの国々が参加しました。<br> ばんこくはくらんかいはおおくのくにがさんかしました。 <br> Many countries participated in the World Exposition.	
日常	[sound:k-2927_日常.mp3]<br>にちじょう <br> ordinary, regular, everyday, usual
ordinary, regular, everyday, usual	<b>日常<b> <br> にちじょう <br>[sound:k-2927_日常.mp3]
[sound:k-2927_日常.mp3]	ordinary, regular, everyday, usual<br> <b>日常</b> <br> (にちじょう)
(<b>着物</b>) お正月に着物を着ます。	[sound:s-2927_お正月に着物を着ます。.mp3] <br> おしょうがつにきものをきます。 <br>  I wear a kimono for New Year's.
[sound:s-2917_そのイベントは万人以上の人々が集まりました。.mp3]	(<b>万人</b>) そのイベントは万人以上の人々が集まりました。<br> そのイベントはまんにんいじょうのひとびとがあつまりました。 <br> The event attracted over ten thousand people.	
経常	[sound:k-2928_経常.mp3]<br>けいじょう <br> ordinary
ordinary	<b>経常<b> <br> けいじょう <br>[sound:k-2928_経常.mp3]
[sound:k-2928_経常.mp3]	ordinary<br> <b>経常</b> <br> (けいじょう)
(<b>下着</b>) この店は高品質な下着を扱っています。	[sound:s-2928_この店は高品質な下着を扱っています。.mp3] <br> このみせはこうひんしつなしたぎをあつかっています。 <br>  This store sells high-quality underwear.
[sound:s-2918_万歳の声が会場に響き渡った。.mp3]	(<b>万歳</b>) 万歳の声が会場に響き渡った。<br> ばんざいのこえがかいじょうにひびきわたった。 <br> Cheers echoed throughout the venue.	
異常	[sound:k-2929_異常.mp3]<br>いじょう <br> strangeness, abnormality, disorder
strangeness, abnormality, disorder	<b>異常<b> <br> いじょう <br>[sound:k-2929_異常.mp3]
[sound:k-2929_異常.mp3]	strangeness, abnormality, disorder<br> <b>異常</b> <br> (いじょう)
(<b>乗り</b>) 彼は新しいビジネスに乗り出した。	[sound:s-2929_彼は新しいビジネスに乗り出した。.mp3] <br> かれはあたらしいびじねすにのりだした。 <br>  He embarked on a new business venture.
[sound:s-2919_争いはついに決着がついた。.mp3]	(<b>決着</b>) 争いはついに決着がついた。<br> あらそいはついにけっちゃくがついた。 <br> The dispute finally came to an end.	
学校	[sound:k-2930_学校.mp3]<br>がっこう <br> school
school	<b>学校<b> <br> がっこう <br>[sound:k-2930_学校.mp3]
[sound:k-2930_学校.mp3]	school<br> <b>学校</b> <br> (がっこう)
(<b>乗用車</b>) 乗用車の需要が増えています。	[sound:s-2930_乗用車の需要が増えています。.mp3] <br> じょうようしゃのじゅようがふえています。 <br>  The demand for passenger cars is increasing.
[sound:s-2920_彼は着実な進歩を遂げています。.mp3]	(<b>着実</b>) 彼は着実な進歩を遂げています。<br> かれはちゃくじつなしんぽをとげています。 <br> He is making steady progress.	
高校	[sound:k-2931_高校.mp3]<br>こうこう <br> senior high school
senior high school	<b>高校<b> <br> こうこう <br>[sound:k-2931_高校.mp3]
[sound:k-2931_高校.mp3]	senior high school<br> <b>高校</b> <br> (こうこう)
(<b>乗客</b>) 列車には乗客がたくさんいます。	[sound:s-2931_列車には乗客がたくさんいます。.mp3] <br> れっしゃにはじょうきゃくがたくさんいます。 <br>  There are many passengers on the train.
[sound:s-2921_彼はいつも落ち着いた態度を保っている。.mp3]	(<b>落ち着いた</b>) 彼はいつも落ち着いた態度を保っている。<br> かれはいつもおちついたたいどをたもっている。 <br> He always maintains a calm attitude.	
校長	[sound:k-2932_校長.mp3]<br>こうちょう <br> principal, headmaster
principal, headmaster	<b>校長<b> <br> こうちょう <br>[sound:k-2932_校長.mp3]
[sound:k-2932_校長.mp3]	principal, headmaster<br> <b>校長</b> <br> (こうちょう)
(<b>乗せる</b>) 彼は子供を自転車に乗せた。	[sound:s-2932_彼は子供を自転車に乗せた。.mp3] <br> かれはこどもをじてんしゃにのせた。 <br>  He put his child on the bicycle.
[sound:s-2922_その組織は汚職と癒着が蔓延している。.mp3]	(<b>癒着</b>) その組織は汚職と癒着が蔓延している。<br> そのそしきはおしょくとゆちゃくがまんえんしている。 <br> Corruption and collusion are rampant in that organization.	
高校生	[sound:k-2933_高校生.mp3]<br>こうこうせい <br> senior high school student
senior high school student	<b>高校生<b> <br> こうこうせい <br>[sound:k-2933_高校生.mp3]
[sound:k-2933_高校生.mp3]	senior high school student<br> <b>高校生</b> <br> (こうこうせい)
(<b>乗員</b>) 船には乗員が何人かいます。	[sound:s-2933_船には乗員が何人かいます。.mp3] <br> ふねにはじょういんがなんにんかいます。 <br>  There are several crew members on the ship.
[sound:s-2923_彼はスーツを着て会議に出席しました。.mp3]	(<b>着る</b>) 彼はスーツを着て会議に出席しました。<br> かれはすーつをきてかいぎにしゅっせきしました。 <br> He wore a suit to the meeting.	
小学校	[sound:k-2934_小学校.mp3]<br>しょうがっこう <br> primary school, elementary school, grade school
primary school, elementary school, grade school	<b>小学校<b> <br> しょうがっこう <br>[sound:k-2934_小学校.mp3]
[sound:k-2934_小学校.mp3]	primary school, elementary school, grade school<br> <b>小学校</b> <br> (しょうがっこう)
(<b>乗組員</b>) 乗組員は船の運行に貢献しています。	[sound:s-2934_乗組員は船の運行に貢献しています。.mp3] <br> じょうそしがんはふねのうんこうにこうけんしています。 <br>  Crew members contribute to the operation of the ship.
[sound:s-2924_工事は着工されました。.mp3]	(<b>着工</b>) 工事は着工されました。<br> こうじはちゃっこうされました。 <br> Construction has commenced.	
中学校	[sound:k-2935_中学校.mp3]<br>ちゅうがっこう <br> junior high school, middle school, lower secondary school
junior high school, middle school, lower secondary school	<b>中学校<b> <br> ちゅうがっこう <br>[sound:k-2935_中学校.mp3]
[sound:k-2935_中学校.mp3]	junior high school, middle school, lower secondary school<br> <b>中学校</b> <br> (ちゅうがっこう)
(<b>相乗り</b>) 彼らはタクシーで相乗りした。	[sound:s-2935_彼らはタクシーで相乗りした。.mp3] <br> かれらはたくしーであいのりした。 <br>  They shared a taxi.
[sound:s-2925_飛行機は無事に着陸しました。.mp3]	(<b>着陸</b>) 飛行機は無事に着陸しました。<br> ひこうきはぶじにちゃくりくしました。 <br> The plane landed safely.	
登校	[sound:k-2936_登校.mp3]<br>とうこう <br> attendance (at school), going to school
attendance (at school), going to school	<b>登校<b> <br> とうこう <br>[sound:k-2936_登校.mp3]
[sound:k-2936_登校.mp3]	attendance<br> <b>at school), going to school (登校</b> <br> (とうこう)
(<b>名乗り</b>) 彼はその名乗りを拒否した。	[sound:s-2936_彼はその名乗りを拒否した。.mp3] <br> かれはそのなのりをきょひした。 <br>  He refused to give his name.
[sound:s-2926_船が予定より早く到着しました。.mp3]	(<b>到着</b>) 船が予定より早く到着しました。<br> ふねがよていよりはやくとうちゃくしました。 <br> The ship arrived earlier than scheduled.	
校舎	[sound:k-2937_校舎.mp3]<br>こうしゃ <br> school building
school building	<b>校舎<b> <br> こうしゃ <br>[sound:k-2937_校舎.mp3]
[sound:k-2937_校舎.mp3]	school building<br> <b>校舎</b> <br> (こうしゃ)
(<b>搭乗</b>) 搭乗口はどこですか？	[sound:s-2937_搭乗口はどこですか？.mp3] <br> とうじょうぐちはどこですか？	 Where is the boarding gate?
[sound:s-2927_お正月に着物を着ます。.mp3]	(<b>着物</b>) お正月に着物を着ます。<br> おしょうがつにきものをきます。 <br> I wear a kimono for New Year's.	
同校	[sound:k-2938_同校.mp3]<br>どうこう <br> same school
same school	<b>同校<b> <br> どうこう <br>[sound:k-2938_同校.mp3]
[sound:k-2938_同校.mp3]	same school<br> <b>同校</b> <br> (どうこう)
(<b>乗車</b>) 電車に乗車する前に切符を買ってください。	[sound:s-2938_電車に乗車する前に切符を買ってください。.mp3] <br> でんしゃにじょうしゃするまえにきっぷをかってください。 <br>  Please buy a ticket before boarding the train.
[sound:s-2928_この店は高品質な下着を扱っています。.mp3]	(<b>下着</b>) この店は高品質な下着を扱っています。<br> このみせはこうひんしつなしたぎをあつかっています。 <br> This store sells high-quality underwear.	
専門学校	[sound:k-2939_専門学校.mp3]<br>せんもんがっこう, せんもんガッコウ, せんもんガッコ <br> vocational school, technical school
vocational school, technical school	<b>専門学校<b> <br> せんもんがっこう, せんもんガッコウ, せんもんガッコ <br>[sound:k-2939_専門学校.mp3]
[sound:k-2939_専門学校.mp3]	vocational school, technical school<br> <b>専門学校</b> <br> (せんもんがっこう, せんもんガッコウ, せんもんガッコ)
(<b>支店</b>) その企業は全国に支店を展開しています。	[sound:s-2939_その企業は全国に支店を展開しています。.mp3] <br> そのきぎょうはぜんこくにしてんをてんかいしています。 <br>  The company has branches nationwide.
[sound:s-2929_彼は新しいビジネスに乗り出した。.mp3]	(<b>乗り</b>) 彼は新しいビジネスに乗り出した。<br> かれはあたらしいびじねすにのりだした。 <br> He embarked on a new business venture.	
資料	[sound:k-2940_資料.mp3]<br>しりょう <br> materials, data, document
materials, data, document	<b>資料<b> <br> しりょう <br>[sound:k-2940_資料.mp3]
[sound:k-2940_資料.mp3]	materials, data, document<br> <b>資料</b> <br> (しりょう)
(<b>百貨店</b>) 彼女は百貨店で買い物を楽しんでいます。	[sound:s-2940_彼女は百貨店で買い物を楽しんでいます。.mp3] <br> かのじょはひゃっかてんでかいものをたのしんでいます。 <br>  She enjoys shopping at department stores.
[sound:s-2930_乗用車の需要が増えています。.mp3]	(<b>乗用車</b>) 乗用車の需要が増えています。<br> じょうようしゃのじゅようがふえています。 <br> The demand for passenger cars is increasing.	
無料	[sound:k-2941_無料.mp3]<br>むりょう <br> free, no charge
free, no charge	<b>無料<b> <br> むりょう <br>[sound:k-2941_無料.mp3]
[sound:k-2941_無料.mp3]	free, no charge<br> <b>無料</b> <br> (むりょう)
(<b>書店</b>) 私は書店で新しい小説を買った。	[sound:s-2941_私は書店で新しい小説を買った。.mp3] <br> わたしはしょてんであたらしいしょうせつをかった。 <br>  I bought a new novel at the bookstore.
[sound:s-2931_列車には乗客がたくさんいます。.mp3]	(<b>乗客</b>) 列車には乗客がたくさんいます。<br> れっしゃにはじょうきゃくがたくさんいます。 <br> There are many passengers on the train.	
料金	[sound:k-2942_料金.mp3]<br>りょうきん <br> fee, charge, fare
fee, charge, fare	<b>料金<b> <br> りょうきん <br>[sound:k-2942_料金.mp3]
[sound:k-2942_料金.mp3]	fee, charge, fare<br> <b>料金</b> <br> (りょうきん)
(<b>店舗</b>) この商業施設には多くの店舗が入っています。	[sound:s-2942_この商業施設には多くの店舗が入っています。.mp3] <br> このしょうぎょうしせつにはおおくのてんぽがはいっています。 <br>  Many stores are located in this commercial facility.
[sound:s-2932_彼は子供を自転車に乗せた。.mp3]	(<b>乗せる</b>) 彼は子供を自転車に乗せた。<br> かれはこどもをじてんしゃにのせた。 <br> He put his child on the bicycle.	
料理	[sound:k-2943_料理.mp3]<br>りょうり <br> cooking, cookery, cuisine; dealing with something, handling, administration, management
cooking, cookery, cuisine; dealing with something, handling, administration, management	<b>料理<b> <br> りょうり <br>[sound:k-2943_料理.mp3]
[sound:k-2943_料理.mp3]	cooking, cookery, cuisine; dealing with something, handling, administration, management<br> <b>料理</b> <br> (りょうり)
(<b>商店</b>) 町には古風な商店が残っている。	[sound:s-2943_町には古風な商店が残っている。.mp3] <br> まちにはこふうなしょうてんがのこっている。 <br>  There are old-fashioned shops remaining in the town.
[sound:s-2933_船には乗員が何人かいます。.mp3]	(<b>乗員</b>) 船には乗員が何人かいます。<br> ふねにはじょういんがなんにんかいます。 <br> There are several crew members on the ship.	
材料	[sound:k-2944_材料.mp3]<br>ざいりょう <br> ingredients, material
ingredients, material	<b>材料<b> <br> ざいりょう <br>[sound:k-2944_材料.mp3]
[sound:k-2944_材料.mp3]	ingredients, material<br> <b>材料</b> <br> (ざいりょう)
(<b>店頭</b>) 店頭にはセール品が並んでいました。	[sound:s-2944_店頭にはセール品が並んでいました。.mp3] <br> てんとうにはせーるひんがならんでいました。 <br>  Sale items were displayed at the storefront.
[sound:s-2934_乗組員は船の運行に貢献しています。.mp3]	(<b>乗組員</b>) 乗組員は船の運行に貢献しています。<br> じょうそしがんはふねのうんこうにこうけんしています。 <br> Crew members contribute to the operation of the ship.	
燃料	[sound:k-2945_燃料.mp3]<br>ねんりょう <br> fuel
fuel	<b>燃料<b> <br> ねんりょう <br>[sound:k-2945_燃料.mp3]
[sound:k-2945_燃料.mp3]	fuel<br> <b>燃料</b> <br> (ねんりょう)
(<b>本店</b>) この店は本店とは別に支店も持っています。	[sound:s-2945_この店は本店とは別に支店も持っています。.mp3] <br> このみせはほんてんとはべつにしてんももっています。 <br>  This store has branches in addition to the main store.
[sound:s-2935_彼らはタクシーで相乗りした。.mp3]	(<b>相乗り</b>) 彼らはタクシーで相乗りした。<br> かれらはたくしーであいのりした。 <br> They shared a taxi.	
食料	[sound:k-2946_食料.mp3]<br>しょくりょう <br> food
food	<b>食料<b> <br> しょくりょう <br>[sound:k-2946_食料.mp3]
[sound:k-2946_食料.mp3]	food<br> <b>食料</b> <br> (しょくりょう)
(<b>支店長</b>) 彼はその支店の新しい支店長です。	[sound:s-2946_彼はその支店の新しい支店長です。.mp3] <br> かれはそのしてんのあたらしいしてんちょうです。 <br>  He is the new branch manager of that branch.
[sound:s-2936_彼はその名乗りを拒否した。.mp3]	(<b>名乗り</b>) 彼はその名乗りを拒否した。<br> かれはそのなのりをきょひした。 <br> He refused to give his name.	
手数料	[sound:k-2947_手数料.mp3]<br>てすうりょう <br> handling charge, commission
handling charge, commission	<b>手数料<b> <br> てすうりょう <br>[sound:k-2947_手数料.mp3]
[sound:k-2947_手数料.mp3]	handling charge, commission<br> <b>手数料</b> <br> (てすうりょう)
(<b>代理店</b>) この商品は代理店を通じて販売されます。	[sound:s-2947_この商品は代理店を通じて販売されます。.mp3] <br> このしょうひんはだいりてんをつうじてはんばいされます。 <br>  This product is sold through an agency.
[sound:s-2937_搭乗口はどこですか？.mp3]	(<b>搭乗</b>) 搭乗口はどこですか？	とうじょうぐちはどこですか？ <br> Where is the boarding gate?
給料	[sound:k-2948_給料.mp3]<br>きゅうりょう <br> salary, wages
salary, wages	<b>給料<b> <br> きゅうりょう <br>[sound:k-2948_給料.mp3]
[sound:k-2948_給料.mp3]	salary, wages<br> <b>給料</b> <br> (きゅうりょう)
(<b>店員</b>) その店員はとても親切でした。	[sound:s-2948_その店員はとても親切でした。.mp3] <br> そのてんいんはとてもしんせつでした。 <br>  The shop assistant was very kind.
[sound:s-2938_電車に乗車する前に切符を買ってください。.mp3]	(<b>乗車</b>) 電車に乗車する前に切符を買ってください。<br> でんしゃにじょうしゃするまえにきっぷをかってください。 <br> Please buy a ticket before boarding the train.	
飲料	[sound:k-2949_飲料.mp3]<br>いんりょう <br> (a) drink
(a) drink	<b>飲料<b> <br> いんりょう <br>[sound:k-2949_飲料.mp3]
[sound:k-2949_飲料.mp3]	(a) drink<br> <b>飲料</b> <br> (いんりょう)
(<b>支店</b>) その企業は全国に支店を展開しています。	[sound:s-2949_その企業は全国に支店を展開しています。.mp3] <br> そのきぎょうはぜんこくにしてんをてんかいしています。 <br>  The company has branches nationwide.
[sound:s-2939_その企業は全国に支店を展開しています。.mp3]	(<b>支店</b>) その企業は全国に支店を展開しています。<br> そのきぎょうはぜんこくにしてんをてんかいしています。 <br> The company has branches nationwide.	
沢	[sound:k-2950_沢.mp3]<br>さわ <br> swamp, marsh; mountain stream, valley, dale
swamp, marsh; mountain stream, valley, dale	<b>沢<b> <br> さわ <br>[sound:k-2950_沢.mp3]
[sound:k-2950_沢.mp3]	swamp, marsh; mountain stream, valley, dale<br> <b>沢</b> <br> (さわ)
(<b>百貨店</b>) 彼女は百貨店で買い物を楽しんでいます。	[sound:s-2950_彼女は百貨店で買い物を楽しんでいます。.mp3] <br> かのじょはひゃっかてんでかいものをたのしんでいます。 <br>  She enjoys shopping at department stores.
[sound:s-2940_彼女は百貨店で買い物を楽しんでいます。.mp3]	(<b>百貨店</b>) 彼女は百貨店で買い物を楽しんでいます。<br> かのじょはひゃっかてんでかいものをたのしんでいます。 <br> She enjoys shopping at department stores.	
光沢	[sound:k-2951_光沢.mp3]<br>こうたく <br> brilliance, polish, lustre, luster, glossy finish (of photographs)
brilliance, polish, lustre, luster, glossy finish (of photographs)	<b>光沢<b> <br> こうたく <br>[sound:k-2951_光沢.mp3]
[sound:k-2951_光沢.mp3]	brilliance, polish, lustre, luster, glossy finish<br> <b>of photographs) (光沢</b> <br> (こうたく)
(<b>書店</b>) 私は書店で新しい小説を買った。	[sound:s-2951_私は書店で新しい小説を買った。.mp3] <br> わたしはしょてんであたらしいしょうせつをかった。 <br>  I bought a new novel at the bookstore.
[sound:s-2941_私は書店で新しい小説を買った。.mp3]	(<b>書店</b>) 私は書店で新しい小説を買った。<br> わたしはしょてんであたらしいしょうせつをかった。 <br> I bought a new novel at the bookstore.	
沢辺	[sound:k-2952_沢辺.mp3]<br>さわべ <br> edge of a swamp
edge of a swamp	<b>沢辺<b> <br> さわべ <br>[sound:k-2952_沢辺.mp3]
[sound:k-2952_沢辺.mp3]	edge of a swamp<br> <b>沢辺</b> <br> (さわべ)
(<b>店舗</b>) この商業施設には多くの店舗が入っています。	[sound:s-2952_この商業施設には多くの店舗が入っています。.mp3] <br> このしょうぎょうしせつにはおおくのてんぽがはいっています。 <br>  Many stores are located in this commercial facility.
[sound:s-2942_この商業施設には多くの店舗が入っています。.mp3]	(<b>店舗</b>) この商業施設には多くの店舗が入っています。<br> このしょうぎょうしせつにはおおくのてんぽがはいっています。 <br> Many stores are located in this commercial facility.	
潤沢	[sound:k-2953_潤沢.mp3]<br>じゅんたく <br> luster, lustre, favor, favour, abundance, plenty
luster, lustre, favor, favour, abundance, plenty	<b>潤沢<b> <br> じゅんたく <br>[sound:k-2953_潤沢.mp3]
[sound:k-2953_潤沢.mp3]	luster, lustre, favor, favour, abundance, plenty<br> <b>潤沢</b> <br> (じゅんたく)
(<b>商店</b>) 町には古風な商店が残っている。	[sound:s-2953_町には古風な商店が残っている。.mp3] <br> まちにはこふうなしょうてんがのこっている。 <br>  There are old-fashioned shops remaining in the town.
[sound:s-2943_町には古風な商店が残っている。.mp3]	(<b>商店</b>) 町には古風な商店が残っている。<br> まちにはこふうなしょうてんがのこっている。 <br> There are old-fashioned shops remaining in the town.	
沢地	[sound:k-2954_沢地.mp3]<br>さわち <br> marshy land
marshy land	<b>沢地<b> <br> さわち <br>[sound:k-2954_沢地.mp3]
[sound:k-2954_沢地.mp3]	marshy land<br> <b>沢地</b> <br> (さわち)
(<b>店頭</b>) 店頭にはセール品が並んでいました。	[sound:s-2954_店頭にはセール品が並んでいました。.mp3] <br> てんとうにはせーるひんがならんでいました。 <br>  Sale items were displayed at the storefront.
[sound:s-2944_店頭にはセール品が並んでいました。.mp3]	(<b>店頭</b>) 店頭にはセール品が並んでいました。<br> てんとうにはせーるひんがならんでいました。 <br> Sale items were displayed at the storefront.	
沢庵	[sound:k-2955_沢庵.mp3]<br>たくあん <br> pickled daikon radish
pickled daikon radish	<b>沢庵<b> <br> たくあん <br>[sound:k-2955_沢庵.mp3]
[sound:k-2955_沢庵.mp3]	pickled daikon radish<br> <b>沢庵</b> <br> (たくあん)
(<b>本店</b>) この店は本店とは別に支店も持っています。	[sound:s-2955_この店は本店とは別に支店も持っています。.mp3] <br> このみせはほんてんとはべつにしてんももっています。 <br>  This store has branches in addition to the main store.
[sound:s-2945_この店は本店とは別に支店も持っています。.mp3]	(<b>本店</b>) この店は本店とは別に支店も持っています。<br> このみせはほんてんとはべつにしてんももっています。 <br> This store has branches in addition to the main store.	
沢山	c	たくさん <br> many, a lot, much
many, a lot, much	<b>沢山<b> <br> たくさん <br>[sound:k-2956_沢山.mp3]
c	たくさん	many, a lot, much (沢山)
(<b>支店長</b>) 彼はその支店の新しい支店長です。	[sound:s-2956_彼はその支店の新しい支店長です。.mp3] <br> かれはそのしてんのあたらしいしてんちょうです。 <br>  He is the new branch manager of that branch.
[sound:s-2946_彼はその支店の新しい支店長です。.mp3]	(<b>支店長</b>) 彼はその支店の新しい支店長です。<br> かれはそのしてんのあたらしいしてんちょうです。 <br> He is the new branch manager of that branch.	
贅沢	[sound:k-2957_贅沢.mp3]<br>ぜいたく <br> luxury, extravagance; to live in luxury
luxury, extravagance; to live in luxury	<b>贅沢<b> <br> ぜいたく <br>[sound:k-2957_贅沢.mp3]
[sound:k-2957_贅沢.mp3]	luxury, extravagance; to live in luxury<br> <b>贅沢</b> <br> (ぜいたく)
(<b>代理店</b>) この商品は代理店を通じて販売されます。	[sound:s-2957_この商品は代理店を通じて販売されます。.mp3] <br> このしょうひんはだいりてんをつうじてはんばいされます。 <br>  This product is sold through an agency.
[sound:s-2947_この商品は代理店を通じて販売されます。.mp3]	(<b>代理店</b>) この商品は代理店を通じて販売されます。<br> このしょうひんはだいりてんをつうじてはんばいされます。 <br> This product is sold through an agency.	
沼沢	[sound:k-2958_沼沢.mp3]<br>しょうたく <br> marsh, swamp
marsh, swamp	<b>沼沢<b> <br> しょうたく <br>[sound:k-2958_沼沢.mp3]
[sound:k-2958_沼沢.mp3]	marsh, swamp<br> <b>沼沢</b> <br> (しょうたく)
(<b>店員</b>) その店員はとても親切でした。	[sound:s-2958_その店員はとても親切でした。.mp3] <br> そのてんいんはとてもしんせつでした。 <br>  The shop assistant was very kind.
[sound:s-2948_その店員はとても親切でした。.mp3]	(<b>店員</b>) その店員はとても親切でした。<br> そのてんいんはとてもしんせつでした。 <br> The shop assistant was very kind.	
恩沢	[sound:k-2959_恩沢.mp3]<br>おんたく, おんだく <br> favour, favor, benefit
favour, favor, benefit	<b>恩沢<b> <br> おんたく, おんだく <br>[sound:k-2959_恩沢.mp3]
[sound:k-2959_恩沢.mp3]	favour, favor, benefit<br> <b>恩沢</b> <br> (おんたく, おんだく)
(<b>残り</b>) チームの残りのメンバーはどこですか？	[sound:s-2959_チームの残りのメンバーはどこですか？.mp3] <br> チームののこりのメンバーはどこですか？	 Where are the rest of the team members?
[sound:s-2949_その企業は全国に支店を展開しています。.mp3]	(<b>支店</b>) その企業は全国に支店を展開しています。<br> そのきぎょうはぜんこくにしてんをてんかいしています。 <br> The company has branches nationwide.	
裁判	[sound:k-2960_裁判.mp3]<br>さいばん <br> trial, judgement, judgment
trial, judgement, judgment	<b>裁判<b> <br> さいばん <br>[sound:k-2960_裁判.mp3]
[sound:k-2960_裁判.mp3]	trial, judgement, judgment<br> <b>裁判</b> <br> (さいばん)
(<b>残す</b>) 彼は仕事を残して早く帰宅した。	[sound:s-2960_彼は仕事を残して早く帰宅した。.mp3] <br> かれはしごとをのこしてはやくきたくした。 <br>  He left work unfinished and went home early.
[sound:s-2950_彼女は百貨店で買い物を楽しんでいます。.mp3]	(<b>百貨店</b>) 彼女は百貨店で買い物を楽しんでいます。<br> かのじょはひゃっかてんでかいものをたのしんでいます。 <br> She enjoys shopping at department stores.	
総裁	[sound:k-2961_総裁.mp3]<br>そうさい <br> president
president	<b>総裁<b> <br> そうさい <br>[sound:k-2961_総裁.mp3]
[sound:k-2961_総裁.mp3]	president<br> <b>総裁</b> <br> (そうさい)
(<b>残った分</b>) 食事の残った分は明日の朝食に使いましょう。	[sound:s-2961_食事の残った分は明日の朝食に使いましょう。.mp3] <br> しょくじののこったぶんはあすのちょうしょくにつかいましょう。 <br>  Let's use the leftover food for breakfast tomorrow.
[sound:s-2951_私は書店で新しい小説を買った。.mp3]	(<b>書店</b>) 私は書店で新しい小説を買った。<br> わたしはしょてんであたらしいしょうせつをかった。 <br> I bought a new novel at the bookstore.	
制裁	[sound:k-2962_制裁.mp3]<br>せいさい <br> restraint, sanctions, punishment
restraint, sanctions, punishment	<b>制裁<b> <br> せいさい <br>[sound:k-2962_制裁.mp3]
[sound:k-2962_制裁.mp3]	restraint, sanctions, punishment<br> <b>制裁</b> <br> (せいさい)
(<b>残念</b>) 残念ながら、彼はパーティーに参加できませんでした。	[sound:s-2962_残念ながら、彼はパーティーに参加できませんでした。.mp3] <br> ざんねんながら、かれはパーティーにさんかできませんでした。 <br>  Unfortunately, he couldn't attend the party.
[sound:s-2952_この商業施設には多くの店舗が入っています。.mp3]	(<b>店舗</b>) この商業施設には多くの店舗が入っています。<br> このしょうぎょうしせつにはおおくのてんぽがはいっています。 <br> Many stores are located in this commercial facility.	
地裁	[sound:k-2963_地裁.mp3]<br>ちさい <br> district court
district court	<b>地裁<b> <br> ちさい <br>[sound:k-2963_地裁.mp3]
[sound:k-2963_地裁.mp3]	district court<br> <b>地裁</b> <br> (ちさい)
(<b>残留</b>) 残留物が水質を汚染しています。	[sound:s-2963_残留物が水質を汚染しています。.mp3] <br> ざんりゅうぶつがすいしつをおせんしています。 <br>  Residual substances are contaminating the water quality.
[sound:s-2953_町には古風な商店が残っている。.mp3]	(<b>商店</b>) 町には古風な商店が残っている。<br> まちにはこふうなしょうてんがのこっている。 <br> There are old-fashioned shops remaining in the town.	
最高裁	[sound:k-2964_最高裁.mp3]<br>さいこうさい <br> Supreme Court
Supreme Court	<b>最高裁<b> <br> さいこうさい <br>[sound:k-2964_最高裁.mp3]
[sound:k-2964_最高裁.mp3]	Supreme Court<br> <b>最高裁</b> <br> (さいこうさい)
(<b>残高</b>) 銀行口座の残高を確認してください。	[sound:s-2964_銀行口座の残高を確認してください。.mp3] <br> ぎんこうこうざのざんだかをかくにんしてください。 <br>  Please check the balance of your bank account.
[sound:s-2954_店頭にはセール品が並んでいました。.mp3]	(<b>店頭</b>) 店頭にはセール品が並んでいました。<br> てんとうにはせーるひんがならんでいました。 <br> Sale items were displayed at the storefront.	
裁判所	[sound:k-2965_裁判所.mp3]<br>さいばんしょ <br> court, courthouse
court, courthouse	<b>裁判所<b> <br> さいばんしょ <br>[sound:k-2965_裁判所.mp3]
[sound:k-2965_裁判所.mp3]	court, courthouse<br> <b>裁判所</b> <br> (さいばんしょ)
(<b>残業</b>) 最近、彼は毎日残業しています。	[sound:s-2965_最近、彼は毎日残業しています。.mp3] <br> さいきん、かれはまいにちざんぎょうしています。 <br>  Lately, he has been working overtime every day.
[sound:s-2955_この店は本店とは別に支店も持っています。.mp3]	(<b>本店</b>) この店は本店とは別に支店も持っています。<br> このみせはほんてんとはべつにしてんももっています。 <br> This store has branches in addition to the main store.	
高裁	[sound:k-2966_高裁.mp3]<br>こうさい <br> High Court
High Court	<b>高裁<b> <br> こうさい <br>[sound:k-2966_高裁.mp3]
[sound:k-2966_高裁.mp3]	High Court<br> <b>高裁</b> <br> (こうさい)
(<b>生き残り</b>) その遭難者たちは山中で一晩生き残りました。	[sound:s-2966_その遭難者たちは山中で一晩生き残りました。.mp3] <br> そのそうなんしゃたちはさんちゅうでひとばんいきのこりました。 <br>  The survivors managed to survive a night in the mountains.
[sound:s-2956_彼はその支店の新しい支店長です。.mp3]	(<b>支店長</b>) 彼はその支店の新しい支店長です。<br> かれはそのしてんのあたらしいしてんちょうです。 <br> He is the new branch manager of that branch.	
独裁	[sound:k-2967_独裁.mp3]<br>どくさい <br> dictatorship, despotism
dictatorship, despotism	<b>独裁<b> <br> どくさい <br>[sound:k-2967_独裁.mp3]
[sound:k-2967_独裁.mp3]	dictatorship, despotism<br> <b>独裁</b> <br> (どくさい)
(<b>残る</b>) 残った時間を有効に使いましょう。	[sound:s-2967_残った時間を有効に使いましょう。.mp3] <br> のこったじかんをゆうこうにつかいましょう。 <br>  Let's make good use of the remaining time.
[sound:s-2957_この商品は代理店を通じて販売されます。.mp3]	(<b>代理店</b>) この商品は代理店を通じて販売されます。<br> このしょうひんはだいりてんをつうじてはんばいされます。 <br> This product is sold through an agency.	
裁判官	[sound:k-2968_裁判官.mp3]<br>さいばんかん <br> judge
judge	<b>裁判官<b> <br> さいばんかん <br>[sound:k-2968_裁判官.mp3]
[sound:k-2968_裁判官.mp3]	judge<br> <b>裁判官</b> <br> (さいばんかん)
(<b>取り残す</b>) バスが彼女を停留所で取り残しました。	[sound:s-2968_バスが彼女を停留所で取り残しました。.mp3] <br> バスがかのじょをていりゅうじょでとりのこしました。 <br>  The bus left her behind at the bus stop.
[sound:s-2958_その店員はとても親切でした。.mp3]	(<b>店員</b>) その店員はとても親切でした。<br> そのてんいんはとてもしんせつでした。 <br> The shop assistant was very kind.	
裁量	[sound:k-2969_裁量.mp3]<br>さいりょう <br> admeasure, discretion
admeasure, discretion	<b>裁量<b> <br> さいりょう <br>[sound:k-2969_裁量.mp3]
[sound:k-2969_裁量.mp3]	admeasure, discretion<br> <b>裁量</b> <br> (さいりょう)
(<b>構想</b>) 彼は新しいプロジェクトの構想を練っている。	[sound:s-2969_彼は新しいプロジェクトの構想を練っている。.mp3] <br> かれはあたらしいぷろじぇくとのこうそうをねっている。 <br>  He is developing ideas for a new project.
[sound:s-2959_チームの残りのメンバーはどこですか？.mp3]	(<b>残り</b>) チームの残りのメンバーはどこですか？	チームののこりのメンバーはどこですか？ <br> Where are the rest of the team members?
状況	[sound:k-2970_状況.mp3]<br>じょうきょう <br> state of affairs (around you), situation, circumstances
state of affairs (around you), situation, circumstances	<b>状況<b> <br> じょうきょう <br>[sound:k-2970_状況.mp3]
[sound:k-2970_状況.mp3]	state of affairs<br> <b>around you), situation, circumstances (状況</b> <br> (じょうきょう)
(<b>予想</b>) 明日の天気予報は雨が予想されている。	[sound:s-2970_明日の天気予報は雨が予想されている。.mp3] <br> あしたのてんきよほうはあめがよそうされている。 <br>  Rain is expected in tomorrow's weather forecast.
[sound:s-2960_彼は仕事を残して早く帰宅した。.mp3]	(<b>残す</b>) 彼は仕事を残して早く帰宅した。<br> かれはしごとをのこしてはやくきたくした。 <br> He left work unfinished and went home early.	
状態	[sound:k-2971_状態.mp3]<br>じょうたい <br> current status, condition, situation, circumstances, state
current status, condition, situation, circumstances, state	<b>状態<b> <br> じょうたい <br>[sound:k-2971_状態.mp3]
[sound:k-2971_状態.mp3]	current status, condition, situation, circumstances, state<br> <b>状態</b> <br> (じょうたい)
(<b>思想</b>) 彼の政治思想は進歩的です。	[sound:s-2971_彼の政治思想は進歩的です。.mp3] <br> かれのせいじしそうはしんぽてきです。 <br>  His political ideology is progressive.
[sound:s-2961_食事の残った分は明日の朝食に使いましょう。.mp3]	(<b>残った分</b>) 食事の残った分は明日の朝食に使いましょう。<br> しょくじののこったぶんはあすのちょうしょくにつかいましょう。 <br> Let's use the leftover food for breakfast tomorrow.	
現状	[sound:k-2972_現状.mp3]<br>げんじょう <br> present condition, existing state, status quo
present condition, existing state, status quo	<b>現状<b> <br> げんじょう <br>[sound:k-2972_現状.mp3]
[sound:k-2972_現状.mp3]	present condition, existing state, status quo<br> <b>現状</b> <br> (げんじょう)
(<b>感想</b>) 映画を見て、彼は感想を述べました。	[sound:s-2972_映画を見て、彼は感想を述べました。.mp3] <br> えいがをみて、かれはかんそうをのべました。 <br>  After watching the movie, he expressed his impressions.
[sound:s-2962_残念ながら、彼はパーティーに参加できませんでした。.mp3]	(<b>残念</b>) 残念ながら、彼はパーティーに参加できませんでした。<br> ざんねんながら、かれはパーティーにさんかできませんでした。 <br> Unfortunately, he couldn't attend the party.	
症状	[sound:k-2973_症状.mp3]<br>しょうじょう <br> symptoms, condition
symptoms, condition	<b>症状<b> <br> しょうじょう <br>[sound:k-2973_症状.mp3]
[sound:k-2973_症状.mp3]	symptoms, condition<br> <b>症状</b> <br> (しょうじょう)
(<b>発想</b>) 彼の発想は常に斬新です。	[sound:s-2973_彼の発想は常に斬新です。.mp3] <br> かれのはっそうはつねにざんしんです。 <br>  His ideas are always innovative.
[sound:s-2963_残留物が水質を汚染しています。.mp3]	(<b>残留</b>) 残留物が水質を汚染しています。<br> ざんりゅうぶつがすいしつをおせんしています。 <br> Residual substances are contaminating the water quality.	
賞状	[sound:k-2974_賞状.mp3]<br>しょうじょう <br> honorable certificate, honourable certificate
honorable certificate, honourable certificate	<b>賞状<b> <br> しょうじょう <br>[sound:k-2974_賞状.mp3]
[sound:k-2974_賞状.mp3]	honorable certificate, honourable certificate<br> <b>賞状</b> <br> (しょうじょう)
(<b>理想</b>) 彼は社会の理想を追求しています。	[sound:s-2974_彼は社会の理想を追求しています。.mp3] <br> かれはしゃかいのりそうをついきゅうしています。 <br>  He is pursuing the ideal of society.
[sound:s-2964_銀行口座の残高を確認してください。.mp3]	(<b>残高</b>) 銀行口座の残高を確認してください。<br> ぎんこうこうざのざんだかをかくにんしてください。 <br> Please check the balance of your bank account.	
訴状	[sound:k-2975_訴状.mp3]<br>そじょう <br> petition, complaint, (legal) brief
petition, complaint, (legal) brief	<b>訴状<b> <br> そじょう <br>[sound:k-2975_訴状.mp3]
[sound:k-2975_訴状.mp3]	petition, complaint,<br> <b>legal) brief (訴状</b> <br> (そじょう)
(<b>想像</b>) 私たちは未来を想像することができます。	[sound:s-2975_私たちは未来を想像することができます。.mp3] <br> わたしたちはみらいをそうぞうすることができます。 <br>  We can imagine the future.
[sound:s-2965_最近、彼は毎日残業しています。.mp3]	(<b>残業</b>) 最近、彼は毎日残業しています。<br> さいきん、かれはまいにちざんぎょうしています。 <br> Lately, he has been working overtime every day.	
病状	[sound:k-2976_病状.mp3]<br>びょうじょう <br> condition of a disease (patient)
condition of a disease (patient)	<b>病状<b> <br> びょうじょう <br>[sound:k-2976_病状.mp3]
[sound:k-2976_病状.mp3]	condition of a disease<br> <b>patient) (病状</b> <br> (びょうじょう)
(<b>幻想</b>) 彼は幻想の世界に夢中になっている。	[sound:s-2976_彼は幻想の世界に夢中になっている。.mp3] <br> かれはげんそうのせかいにむちゅうになっている。 <br>  He is fascinated by the world of fantasy.
[sound:s-2966_その遭難者たちは山中で一晩生き残りました。.mp3]	(<b>生き残り</b>) その遭難者たちは山中で一晩生き残りました。<br> そのそうなんしゃたちはさんちゅうでひとばんいきのこりました。 <br> The survivors managed to survive a night in the mountains.	
年賀状	[sound:k-2977_年賀状.mp3]<br>ねんがじょう <br> New Year's card
New Year's card	<b>年賀状<b> <br> ねんがじょう <br>[sound:k-2977_年賀状.mp3]
[sound:k-2977_年賀状.mp3]	New Year's card<br> <b>年賀状</b> <br> (ねんがじょう)
(<b>予想外</b>) 事故は予想外の所で起こりました。	[sound:s-2977_事故は予想外の所で起こりました。.mp3] <br> じこはよそうがいのところでおこりました。 <br>  The accident happened unexpectedly.
[sound:s-2967_残った時間を有効に使いましょう。.mp3]	(<b>残る</b>) 残った時間を有効に使いましょう。<br> のこったじかんをゆうこうにつかいましょう。 <br> Let's make good use of the remaining time.	
形状	[sound:k-2978_形状.mp3]<br>けいじょう <br> shape, form
shape, form	<b>形状<b> <br> けいじょう <br>[sound:k-2978_形状.mp3]
[sound:k-2978_形状.mp3]	shape, form<br> <b>形状</b> <br> (けいじょう)
(<b>想定</b>) この計画には様々なリスクが想定されています。	[sound:s-2978_この計画には様々なリスクが想定されています。.mp3] <br> このけいかくにはさまざまなりすくがそうていされています。 <br>  Various risks are anticipated in this plan.
[sound:s-2968_バスが彼女を停留所で取り残しました。.mp3]	(<b>取り残す</b>) バスが彼女を停留所で取り残しました。<br> バスがかのじょをていりゅうじょでとりのこしました。 <br> The bus left her behind at the bus stop.	
窮状	[sound:k-2979_窮状.mp3]<br>きゅうじょう <br> distress, wretched condition
distress, wretched condition	<b>窮状<b> <br> きゅうじょう <br>[sound:k-2979_窮状.mp3]
[sound:k-2979_窮状.mp3]	distress, wretched condition<br> <b>窮状</b> <br> (きゅうじょう)
(<b>線</b>) 地図に線でルートを示してください。	[sound:s-2979_地図に線でルートを示してください。.mp3] <br> ちずにせんでルートをしめしてください。 <br>  Please indicate the route on the map with a line.
[sound:s-2969_彼は新しいプロジェクトの構想を練っている。.mp3]	(<b>構想</b>) 彼は新しいプロジェクトの構想を練っている。<br> かれはあたらしいぷろじぇくとのこうそうをねっている。 <br> He is developing ideas for a new project.	
工場	[sound:k-2980_工場.mp3]<br>こうじょう, こうば <br> factory, plant, mill, workshop
factory, plant, mill, workshop	<b>工場<b> <br> こうじょう, こうば <br>[sound:k-2980_工場.mp3]
[sound:k-2980_工場.mp3]	factory, plant, mill, workshop<br> <b>工場</b> <br> (こうじょう, こうば)
(<b>路線</b>) その都市には多くの交通路線があります。	[sound:s-2980_その都市には多くの交通路線があります。.mp3] <br> そのとしにはおおくのこうつうろせんがあります。 <br>  The city has many transportation routes.
[sound:s-2970_明日の天気予報は雨が予想されている。.mp3]	(<b>予想</b>) 明日の天気予報は雨が予想されている。<br> あしたのてんきよほうはあめがよそうされている。 <br> Rain is expected in tomorrow's weather forecast.	
工業	[sound:k-2981_工業.mp3]<br>こうぎょう <br> (manufacturing) industry
(manufacturing) industry	<b>工業<b> <br> こうぎょう <br>[sound:k-2981_工業.mp3]
[sound:k-2981_工業.mp3]	(manufacturing) industry<br> <b>工業</b> <br> (こうぎょう)
(<b>新幹線</b>) 日本の新幹線は非常に速いです。	[sound:s-2981_日本の新幹線は非常に速いです。.mp3] <br> にほんのしんかんせんはひじょうにはやいです。 <br>  Japan's Shinkansen is very fast.
[sound:s-2971_彼の政治思想は進歩的です。.mp3]	(<b>思想</b>) 彼の政治思想は進歩的です。<br> かれのせいじしそうはしんぽてきです。 <br> His political ideology is progressive.	
工事	[sound:k-2982_工事.mp3]<br>こうじ <br> construction work
construction work	<b>工事<b> <br> こうじ <br>[sound:k-2982_工事.mp3]
[sound:k-2982_工事.mp3]	construction work<br> <b>工事</b> <br> (こうじ)
(<b>打線</b>) その野球チームの打線は強力です。	[sound:s-2982_その野球チームの打線は強力です。.mp3] <br> そのやきゅうちーむのだせんはきょうりょくです。 <br>  The baseball team's batting lineup is powerful.
[sound:s-2972_映画を見て、彼は感想を述べました。.mp3]	(<b>感想</b>) 映画を見て、彼は感想を述べました。<br> えいがをみて、かれはかんそうをのべました。 <br> After watching the movie, he expressed his impressions.	
工作	[sound:k-2983_工作.mp3]<br>こうさく <br> work, construction, handicraft, maneuvering, manoeuvering
work, construction, handicraft, maneuvering, manoeuvering	<b>工作<b> <br> こうさく <br>[sound:k-2983_工作.mp3]
[sound:k-2983_工作.mp3]	work, construction, handicraft, maneuvering, manoeuvering<br> <b>工作</b> <br> (こうさく)
(<b>戦線</b>) 戦線は日々拡大している。	[sound:s-2983_戦線は日々拡大している。.mp3] <br> せんせんはひびかくだいしている。 <br>  The front line is expanding day by day.
[sound:s-2973_彼の発想は常に斬新です。.mp3]	(<b>発想</b>) 彼の発想は常に斬新です。<br> かれのはっそうはつねにざんしんです。 <br> His ideas are always innovative.	
加工	[sound:k-2984_加工.mp3]<br>かこう <br> manufacturing, processing, treatment, machining
manufacturing, processing, treatment, machining	<b>加工<b> <br> かこう <br>[sound:k-2984_加工.mp3]
[sound:k-2984_加工.mp3]	manufacturing, processing, treatment, machining<br> <b>加工</b> <br> (かこう)
(<b>三十八度線</b>) 三十八度線は朝鮮半島を分割している。	[sound:s-2984_三十八度線は朝鮮半島を分割している。.mp3] <br> さんじゅうはちどせんはちょうせんはんとうをぶんかつしている。 <br> The 38th parallel divides the Korean Peninsula.
[sound:s-2974_彼は社会の理想を追求しています。.mp3]	(<b>理想</b>) 彼は社会の理想を追求しています。<br> かれはしゃかいのりそうをついきゅうしています。 <br> He is pursuing the ideal of society.	
工夫	[sound:k-2985_工夫.mp3]<br>くふう <br> scheme, device, scheming, devising, figuring out, coming up with, solving ingeniously; dedication to spiritual improvement (esp. through Zen meditation)
scheme, device, scheming, devising, figuring out, coming up with, solving ingeniously; dedication to spiritual improvement (esp. through Zen meditation)	<b>工夫<b> <br> くふう <br>[sound:k-2985_工夫.mp3]
[sound:k-2985_工夫.mp3]	scheme, device, scheming, devising, figuring out, coming up with, solving ingeniously; dedication to spiritual improvement<br> <b>esp. through Zen meditation) (工夫</b> <br> (くふう)
(<b>無線</b>) 無線通信がこの地域で利用できますか？	[sound:s-2985_無線通信がこの地域で利用できますか？.mp3] <br> むせんつうしんがこのちいきでりようできますか？	 Is wireless communication available in this area?
[sound:s-2975_私たちは未来を想像することができます。.mp3]	(<b>想像</b>) 私たちは未来を想像することができます。<br> わたしたちはみらいをそうぞうすることができます。 <br> We can imagine the future.	
人工	[sound:k-2986_人工.mp3]<br>じんこう <br> artificial, manmade, human work, human skill, artificiality
artificial, manmade, human work, human skill, artificiality	<b>人工<b> <br> じんこう <br>[sound:k-2986_人工.mp3]
[sound:k-2986_人工.mp3]	artificial, manmade, human work, human skill, artificiality<br> <b>人工</b> <br> (じんこう)
(<b>一線</b>) 彼はビジネスの一線に立っています。	[sound:s-2986_彼はビジネスの一線に立っています。.mp3] <br> かれはびじねすのいっせんにたっています。 <br>  He is at the forefront of the business.
[sound:s-2976_彼は幻想の世界に夢中になっている。.mp3]	(<b>幻想</b>) 彼は幻想の世界に夢中になっている。<br> かれはげんそうのせかいにむちゅうになっている。 <br> He is fascinated by the world of fantasy.	
工学	[sound:k-2987_工学.mp3]<br>こうがく <br> engineering
engineering	<b>工学<b> <br> こうがく <br>[sound:k-2987_工学.mp3]
[sound:k-2987_工学.mp3]	engineering<br> <b>工学</b> <br> (こうがく)
(<b>回線</b>) インターネット回線が不安定です。	[sound:s-2987_インターネット回線が不安定です。.mp3] <br> いんたーねっとかいせんがふあんていです。 <br>  The internet connection is unstable.
[sound:s-2977_事故は予想外の所で起こりました。.mp3]	(<b>予想外</b>) 事故は予想外の所で起こりました。<br> じこはよそうがいのところでおこりました。 <br> The accident happened unexpectedly.	
商工	[sound:k-2988_商工.mp3]<br>しょうこう <br> commerce and industry
commerce and industry	<b>商工<b> <br> しょうこう <br>[sound:k-2988_商工.mp3]
[sound:k-2988_商工.mp3]	commerce and industry<br> <b>商工</b> <br> (しょうこう)
(<b>視線</b>) 彼の視線が私に向けられた。	[sound:s-2988_彼の視線が私に向けられた。.mp3] <br> かれのしせんがわたしにむけられた。 <br>  His gaze was directed towards me.
[sound:s-2978_この計画には様々なリスクが想定されています。.mp3]	(<b>想定</b>) この計画には様々なリスクが想定されています。<br> このけいかくにはさまざまなりすくがそうていされています。 <br> Various risks are anticipated in this plan.	
大工	[sound:k-2989_大工.mp3]<br>だいく <br> carpenter
carpenter	<b>大工<b> <br> だいく <br>[sound:k-2989_大工.mp3]
[sound:k-2989_大工.mp3]	carpenter<br> <b>大工</b> <br> (だいく)
(<b>比率</b>) この地域の失業率は他の地域と比べて高いです。	[sound:s-2989_この地域の失業率は他の地域と比べて高いです。.mp3] <br> このちいきのしつぎょうりつはほかのちいきとくらべてたかいです。 <br>  The unemployment rate in this area is higher compared to other areas.
[sound:s-2979_地図に線でルートを示してください。.mp3]	(<b>線</b>) 地図に線でルートを示してください。<br> ちずにせんでルートをしめしてください。 <br> Please indicate the route on the map with a line.	
建設	[sound:k-2990_建設.mp3]<br>けんせつ <br> construction, establishment
construction, establishment	<b>建設<b> <br> けんせつ <br>[sound:k-2990_建設.mp3]
[sound:k-2990_建設.mp3]	construction, establishment<br> <b>建設</b> <br> (けんせつ)
(<b>効率</b>) 新しい機械は生産効率を大幅に改善しました。	[sound:s-2990_新しい機械は生産効率を大幅に改善しました。.mp3] <br> あたらしいきかいはせいさんこうりつをおおはばにかいぜんしました。 <br>  The new machine greatly improved production efficiency.
[sound:s-2980_その都市には多くの交通路線があります。.mp3]	(<b>路線</b>) その都市には多くの交通路線があります。<br> そのとしにはおおくのこうつうろせんがあります。 <br> The city has many transportation routes.	
建築	[sound:k-2991_建築.mp3]<br>けんちく <br> construction, architecture
construction, architecture	<b>建築<b> <br> けんちく <br>[sound:k-2991_建築.mp3]
[sound:k-2991_建築.mp3]	construction, architecture<br> <b>建築</b> <br> (けんちく)
(<b>税率</b>) 政府は所得税率を引き上げる計画を立てています。	[sound:s-2991_政府は所得税率を引き上げる計画を立てています。.mp3] <br> せいふはしょとくぜいりつをひきあげるけいかくをたてています。 <br>  The government is planning to raise income tax rates.
[sound:s-2981_日本の新幹線は非常に速いです。.mp3]	(<b>新幹線</b>) 日本の新幹線は非常に速いです。<br> にほんのしんかんせんはひじょうにはやいです。 <br> Japan's Shinkansen is very fast.	
建物	[sound:k-2992_建物.mp3]<br>たてもの <br> building
building	<b>建物<b> <br> たてもの <br>[sound:k-2992_建物.mp3]
[sound:k-2992_建物.mp3]	building<br> <b>建物</b> <br> (たてもの)
(<b>視聴率</b>) この番組の視聴率は高くない。	[sound:s-2992_この番組の視聴率は高くない。.mp3] <br> このばんぐみのしちょうりつはたかくない。 <br>  The viewership rating of this program is not high.
[sound:s-2982_その野球チームの打線は強力です。.mp3]	(<b>打線</b>) その野球チームの打線は強力です。<br> そのやきゅうちーむのだせんはきょうりょくです。 <br> The baseball team's batting lineup is powerful.	
再建	[sound:k-2993_再建.mp3]<br>さいけん <br> rebuilding, reconstruction, rehabilitation
rebuilding, reconstruction, rehabilitation	<b>再建<b> <br> さいけん <br>[sound:k-2993_再建.mp3]
[sound:k-2993_再建.mp3]	rebuilding, reconstruction, rehabilitation<br> <b>再建</b> <br> (さいけん)
(<b>伸び率</b>) 今年の売上は昨年より10％伸びました。	[sound:s-2993_今年の売上は昨年より10％伸びました。.mp3] <br> ことしのうりあげはさくねんより10%のびました。 <br> Sales this year increased by 10% compared to last year.
[sound:s-2983_戦線は日々拡大している。.mp3]	(<b>戦線</b>) 戦線は日々拡大している。<br> せんせんはひびかくだいしている。 <br> The front line is expanding day by day.	
建設省	[sound:k-2994_建設省.mp3]<br>けんせつしょう <br> Ministry of Construction
Ministry of Construction	<b>建設省<b> <br> けんせつしょう <br>[sound:k-2994_建設省.mp3]
[sound:k-2994_建設省.mp3]	Ministry of Construction<br> <b>建設省</b> <br> (けんせつしょう)
(<b>率直</b>) 彼は率直な意見を述べた。	[sound:s-2994_彼は率直な意見を述べた。.mp3] <br> かれはそっちょくないけんをのべた。 <br>  He expressed his honest opinion.
[sound:s-2984_三十八度線は朝鮮半島を分割している。.mp3]	(<b>三十八度線</b>) 三十八度線は朝鮮半島を分割している。<br> さんじゅうはちどせんはちょうせんはんとうをぶんかつしている。 <br>The 38th parallel divides the Korean Peninsula.	
二階建て	[sound:k-2995_二階建て.mp3]<br>にかいだて <br> two-storied building
two-storied building	<b>二階建て<b> <br> にかいだて <br>[sound:k-2995_二階建て.mp3]
[sound:k-2995_二階建て.mp3]	two-storied building<br> <b>二階建て</b> <br> (にかいだて)
(<b>打率</b>) その野球選手は打率が高い。	[sound:s-2995_その野球選手は打率が高い。.mp3] <br> そのやきゅうせんしゅはだりつがたかい。 <br>  That baseball player has a high batting average.
[sound:s-2985_無線通信がこの地域で利用できますか？.mp3]	(<b>無線</b>) 無線通信がこの地域で利用できますか？	むせんつうしんがこのちいきでりようできますか？ <br> Is wireless communication available in this area?
建前	[sound:k-2996_建前.mp3]<br>たてまえ, てまえ <br> face, official stance, public position or attitude (as opposed to private thoughts); ceremony for the erection of the framework of a house; tea ceremony procedures, tea ceremony etiquette
face, official stance, public position or attitude (as opposed to private thoughts); ceremony for the erection of the framework of a house; tea ceremony procedures, tea ceremony etiquette	<b>建前<b> <br> たてまえ, てまえ <br>[sound:k-2996_建前.mp3]
[sound:k-2996_建前.mp3]	face, official stance, public position or attitude<br> <b>as opposed to private thoughts); ceremony for the erection of the framework of a house; tea ceremony procedures, tea ceremony etiquette (建前</b> <br> (たてまえ, てまえ)
(<b>確率</b>) その事故が発生する確率は低いです。	[sound:s-2996_その事故が発生する確率は低いです。.mp3] <br> そのじこがはっせいするかくりつはひくいです。 <br>  The probability of the accident occurring is low.
[sound:s-2986_彼はビジネスの一線に立っています。.mp3]	(<b>一線</b>) 彼はビジネスの一線に立っています。<br> かれはびじねすのいっせんにたっています。 <br> He is at the forefront of the business.	
建国	[sound:k-2997_建国.mp3]<br>けんこく <br> founding of a nation
founding of a nation	<b>建国<b> <br> けんこく <br>[sound:k-2997_建国.mp3]
[sound:k-2997_建国.mp3]	founding of a nation<br> <b>建国</b> <br> (けんこく)
(<b>倍率</b>) この顕微鏡の倍率を調整できますか？	[sound:s-2997_この顕微鏡の倍率を調整できますか？.mp3] <br> このけんびきょうのばいりつをちょうせいできますか？	 Can you adjust the magnification of this microscope?
[sound:s-2987_インターネット回線が不安定です。.mp3]	(<b>回線</b>) インターネット回線が不安定です。<br> いんたーねっとかいせんがふあんていです。 <br> The internet connection is unstable.	
建造物	[sound:k-2998_建造物.mp3]<br>けんぞうぶつ <br> structure
structure	<b>建造物<b> <br> けんぞうぶつ <br>[sound:k-2998_建造物.mp3]
[sound:k-2998_建造物.mp3]	structure<br> <b>建造物</b> <br> (けんぞうぶつ)
(<b>利率</b>) 銀行の利率が上がりました。	[sound:s-2998_銀行の利率が上がりました。.mp3] <br> ぎんこうのりりつがあがりました。 <br>  The bank interest rates have increased.
[sound:s-2988_彼の視線が私に向けられた。.mp3]	(<b>視線</b>) 彼の視線が私に向けられた。<br> かれのしせんがわたしにむけられた。 <br> His gaze was directed towards me.	
建つ	[sound:k-2999_建つ.mp3]<br>たつ <br> to be erected, to be built
to be erected, to be built	<b>建つ<b> <br> たつ <br>[sound:k-2999_建つ.mp3]
[sound:k-2999_建つ.mp3]	to be erected, to be built<br> <b>建つ</b> <br> (たつ)
(<b>病院</b>) 彼は病院で医師の診察を受けた。	[sound:s-2999_彼は病院で医師の診察を受けた。.mp3] <br> かれはびょういんでいしのしんさつをうけた。 <br>  He received a medical examination at the hospital.
[sound:s-2989_この地域の失業率は他の地域と比べて高いです。.mp3]	(<b>比率</b>) この地域の失業率は他の地域と比べて高いです。<br> このちいきのしつぎょうりつはほかのちいきとくらべてたかいです。 <br> The unemployment rate in this area is higher compared to other areas.	
英語	[sound:k-3000_英語.mp3]<br>えいご <br> English (language)
English (language)	<b>英語<b> <br> えいご <br>[sound:k-3000_英語.mp3]
[sound:k-3000_英語.mp3]	English<br> <b>language) (英語</b> <br> (えいご)
(<b>病気</b>) 彼女は風邪で病気になっています。	[sound:s-3000_彼女は風邪で病気になっています。.mp3] <br> かのじょはかぜでびょうきになっています。 <br>  She is sick with a cold.
[sound:s-2990_新しい機械は生産効率を大幅に改善しました。.mp3]	(<b>効率</b>) 新しい機械は生産効率を大幅に改善しました。<br> あたらしいきかいはせいさんこうりつをおおはばにかいぜんしました。 <br> The new machine greatly improved production efficiency.	
日本語	[sound:k-3001_日本語.mp3]<br>にほんご, にっぽんご <br> Japanese (language)
Japanese (language)	<b>日本語<b> <br> にほんご, にっぽんご <br>[sound:k-3001_日本語.mp3]
[sound:k-3001_日本語.mp3]	Japanese<br> <b>language) (日本語</b> <br> (にほんご, にっぽんご)
(<b>水俣病</b>) 水俣病は水銀中毒の一形態です。	[sound:s-3001_水俣病は水銀中毒の一形態です。.mp3] <br> みなまたびょうはすいぎんちゅうどくのいちけいたいです。 <br>  Minamata disease is a form of mercury poisoning.
[sound:s-2991_政府は所得税率を引き上げる計画を立てています。.mp3]	(<b>税率</b>) 政府は所得税率を引き上げる計画を立てています。<br> せいふはしょとくぜいりつをひきあげるけいかくをたてています。 <br> The government is planning to raise income tax rates.	
物語	[sound:k-3002_物語.mp3]<br>ものがたり <br> tale, story, legend
tale, story, legend	<b>物語<b> <br> ものがたり <br>[sound:k-3002_物語.mp3]
[sound:k-3002_物語.mp3]	tale, story, legend<br> <b>物語</b> <br> (ものがたり)
(<b>糖尿病</b>) 糖尿病の治療法について相談したいです。	[sound:s-3002_糖尿病の治療法について相談したいです。.mp3] <br> とうにょうびょうのちりょうほうについてそうだんしたいです。 <br>  I want to discuss treatment options for diabetes.
[sound:s-2992_この番組の視聴率は高くない。.mp3]	(<b>視聴率</b>) この番組の視聴率は高くない。<br> このばんぐみのしちょうりつはたかくない。 <br> The viewership rating of this program is not high.	
語らう	[sound:k-3003_語らう.mp3]<br>かたらう <br> to talk, to tell, to recite, to pledge, to conspire with
to talk, to tell, to recite, to pledge, to conspire with	<b>語らう<b> <br> かたらう <br>[sound:k-3003_語らう.mp3]
[sound:k-3003_語らう.mp3]	to talk, to tell, to recite, to pledge, to conspire with<br> <b>語らう</b> <br> (かたらう)
(<b>白血病</b>) 白血病の患者数は増加しています。	[sound:s-3003_白血病の患者数は増加しています。.mp3] <br> はっけつびょうのかんじゃすうはぞうかしています。 <br>  The number of leukemia patients is increasing.
[sound:s-2993_今年の売上は昨年より10％伸びました。.mp3]	(<b>伸び率</b>) 今年の売上は昨年より10％伸びました。<br> ことしのうりあげはさくねんより10%のびました。 <br>Sales this year increased by 10% compared to last year.	
語る	[sound:k-3004_語る.mp3]<br>かたる <br> to talk, to tell, to recite
to talk, to tell, to recite	<b>語る<b> <br> かたる <br>[sound:k-3004_語る.mp3]
[sound:k-3004_語る.mp3]	to talk, to tell, to recite<br> <b>語る</b> <br> (かたる)
(<b>病状</b>) 医師は彼の病状を調べました。	[sound:s-3004_医師は彼の病状を調べました。.mp3] <br> いしはかれのびょうじょうをしらべました。 <br>  The doctor examined his medical condition.
[sound:s-2994_彼は率直な意見を述べた。.mp3]	(<b>率直</b>) 彼は率直な意見を述べた。<br> かれはそっちょくないけんをのべた。 <br> He expressed his honest opinion.	
言語	[sound:k-3005_言語.mp3]<br>げんご, ごんご <br> language
language	<b>言語<b> <br> げんご, ごんご <br>[sound:k-3005_言語.mp3]
[sound:k-3005_言語.mp3]	language<br> <b>言語</b> <br> (げんご, ごんご)
(<b>病棟</b>) 病院の新しい病棟が完成しました。	[sound:s-3005_病院の新しい病棟が完成しました。.mp3] <br> びょういんのあたらしいびょうとうがかんせいしました。 <br>  The new ward of the hospital has been completed.
[sound:s-2995_その野球選手は打率が高い。.mp3]	(<b>打率</b>) その野球選手は打率が高い。<br> そのやきゅうせんしゅはだりつがたかい。 <br> That baseball player has a high batting average.	
語り	[sound:k-3006_語り.mp3]<br>かたり <br> talking
talking	<b>語り<b> <br> かたり <br>[sound:k-3006_語り.mp3]
[sound:k-3006_語り.mp3]	talking<br> <b>語り</b> <br> (かたり)
(<b>難病</b>) その疾患は難病として知られています。	[sound:s-3006_その疾患は難病として知られています。.mp3] <br> そのしっかんはなんびょうとしてしられています。 <br>  The disease is known as a rare disease.
[sound:s-2996_その事故が発生する確率は低いです。.mp3]	(<b>確率</b>) その事故が発生する確率は低いです。<br> そのじこがはっせいするかくりつはひくいです。 <br> The probability of the accident occurring is low.	
用語	[sound:k-3007_用語.mp3]<br>ようご <br> term, terminology
term, terminology	<b>用語<b> <br> ようご <br>[sound:k-3007_用語.mp3]
[sound:k-3007_用語.mp3]	term, terminology<br> <b>用語</b> <br> (ようご)
(<b>成人病</b>) 成人病の予防には健康的な生活が重要です。	[sound:s-3007_成人病の予防には健康的な生活が重要です。.mp3] <br> せいじんびょうのよぼうにはけんこうてきなせいかつがじゅうようです。 <br>  A healthy lifestyle is important for preventing lifestyle-related diseases.
[sound:s-2997_この顕微鏡の倍率を調整できますか？.mp3]	(<b>倍率</b>) この顕微鏡の倍率を調整できますか？	このけんびきょうのばいりつをちょうせいできますか？ <br> Can you adjust the magnification of this microscope?
国語	[sound:k-3008_国語.mp3]<br>こくご <br> Japanese (language); national language; native Japanese words (as opposed to loanwords)
Japanese (language); national language; native Japanese words (as opposed to loanwords)	<b>国語<b> <br> こくご <br>[sound:k-3008_国語.mp3]
[sound:k-3008_国語.mp3]	Japanese<br> <b>language); national language; native Japanese words (as opposed to loanwords) (国語</b> <br> (こくご)
(<b>心臓病</b>) 父は心臓病で入院しています。	[sound:s-3008_父は心臓病で入院しています。.mp3] <br> ちちはしんぞうびょうでにゅういんしています。 <br>  My father is hospitalized with heart disease.
[sound:s-2998_銀行の利率が上がりました。.mp3]	(<b>利率</b>) 銀行の利率が上がりました。<br> ぎんこうのりりつがあがりました。 <br> The bank interest rates have increased.	
外国語	[sound:k-3009_外国語.mp3]<br>がいこくご <br> foreign language
foreign language	<b>外国語<b> <br> がいこくご <br>[sound:k-3009_外国語.mp3]
[sound:k-3009_外国語.mp3]	foreign language<br> <b>外国語</b> <br> (がいこくご)
(<b>農</b>) 農業はその地域の主要な産業です。	[sound:s-3009_農業はその地域の主要な産業です。.mp3] <br> のうぎょうはそのちいきのしゅようなさんぎょうです。 <br>  Agriculture is the main industry in that region.
[sound:s-2999_彼は病院で医師の診察を受けた。.mp3]	(<b>病院</b>) 彼は病院で医師の診察を受けた。<br> かれはびょういんでいしのしんさつをうけた。 <br> He received a medical examination at the hospital.	
球	[sound:k-3010_球.mp3]<br>きゅう, たま <br> globe, sphere, ball
globe, sphere, ball	<b>球<b> <br> きゅう, たま <br>[sound:k-3010_球.mp3]
[sound:k-3010_球.mp3]	globe, sphere, ball<br> <b>球</b> <br> (きゅう, たま)
(<b>農業</b>) 彼は農業を通じて地域社会に貢献しています。	[sound:s-3010_彼は農業を通じて地域社会に貢献しています。.mp3] <br> かれはのうぎょうをつうじてちいきしゃかいにこうけんしています。 <br>  He contributes to the local community through agriculture.
[sound:s-3000_彼女は風邪で病気になっています。.mp3]	(<b>病気</b>) 彼女は風邪で病気になっています。<br> かのじょはかぜでびょうきになっています。 <br> She is sick with a cold.	
地球	[sound:k-3011_地球.mp3]<br>ちきゅう <br> the earth
the earth	<b>地球<b> <br> ちきゅう <br>[sound:k-3011_地球.mp3]
[sound:k-3011_地球.mp3]	the earth<br> <b>地球</b> <br> (ちきゅう)
(<b>農家</b>) その農家は美しい田園風景を所有しています。	[sound:s-3011_その農家は美しい田園風景を所有しています。.mp3] <br> そののうかはうつくしいでんえんふうけいをしょゆうしています。 <br>  The farmer owns beautiful rural scenery.
[sound:s-3001_水俣病は水銀中毒の一形態です。.mp3]	(<b>水俣病</b>) 水俣病は水銀中毒の一形態です。<br> みなまたびょうはすいぎんちゅうどくのいちけいたいです。 <br> Minamata disease is a form of mercury poisoning.	
野球	[sound:k-3012_野球.mp3]<br>やきゅう <br> baseball
baseball	<b>野球<b> <br> やきゅう <br>[sound:k-3012_野球.mp3]
[sound:k-3012_野球.mp3]	baseball<br> <b>野球</b> <br> (やきゅう)
(<b>農協</b>) 農協は地域の農民を支援しています。	[sound:s-3012_農協は地域の農民を支援しています。.mp3] <br> のうきょうはちいきののうみんをしえんしています。 <br>  The agricultural cooperative supports local farmers.
[sound:s-3002_糖尿病の治療法について相談したいです。.mp3]	(<b>糖尿病</b>) 糖尿病の治療法について相談したいです。<br> とうにょうびょうのちりょうほうについてそうだんしたいです。 <br> I want to discuss treatment options for diabetes.	
球場	[sound:k-3013_球場.mp3]<br>きゅうじょう <br> baseball stadium
baseball stadium	<b>球場<b> <br> きゅうじょう <br>[sound:k-3013_球場.mp3]
[sound:k-3013_球場.mp3]	baseball stadium<br> <b>球場</b> <br> (きゅうじょう)
(<b>農村</b>) その国では農村地域の開発が進んでいます。	[sound:s-3013_その国では農村地域の開発が進んでいます。.mp3] <br> そのくにではのうそんちいきのかいはつがすすんでいます。 <br>  Rural development is progressing in that country.
[sound:s-3003_白血病の患者数は増加しています。.mp3]	(<b>白血病</b>) 白血病の患者数は増加しています。<br> はっけつびょうのかんじゃすうはぞうかしています。 <br> The number of leukemia patients is increasing.	
球団	[sound:k-3014_球団.mp3]<br>きゅうだん <br> baseball team
baseball team	<b>球団<b> <br> きゅうだん <br>[sound:k-3014_球団.mp3]
[sound:k-3014_球団.mp3]	baseball team<br> <b>球団</b> <br> (きゅうだん)
(<b>農民</b>) 農民たちは収穫祭を楽しみにしています。	[sound:s-3014_農民たちは収穫祭を楽しみにしています。.mp3] <br> のうみんたちはしゅうかくさいをたのしみにしています。 <br>  Farmers are looking forward to the harvest festival.
[sound:s-3004_医師は彼の病状を調べました。.mp3]	(<b>病状</b>) 医師は彼の病状を調べました。<br> いしはかれのびょうじょうをしらべました。 <br> The doctor examined his medical condition.	
四球	[sound:k-3015_四球.mp3]<br>しきゅう <br> four balls, base on balls (baseball), a walk
four balls, base on balls (baseball), a walk	<b>四球<b> <br> しきゅう <br>[sound:k-3015_四球.mp3]
[sound:k-3015_四球.mp3]	four balls, base on balls<br> <b>baseball), a walk (四球</b> <br> (しきゅう)
(<b>農薬</b>) 農薬の使用量を減らす方法を模索しています。	[sound:s-3015_農薬の使用量を減らす方法を模索しています。.mp3] <br> のうやくのしようりょうをへらすほうほうをもさくしています。 <br>  We are exploring ways to reduce the use of pesticides.
[sound:s-3005_病院の新しい病棟が完成しました。.mp3]	(<b>病棟</b>) 病院の新しい病棟が完成しました。<br> びょういんのあたらしいびょうとうがかんせいしました。 <br> The new ward of the hospital has been completed.	
投球	[sound:k-3016_投球.mp3]<br>とうきゅう <br> pitching, throwing a ball, bowling (in cricket), pitched ball
pitching, throwing a ball, bowling (in cricket), pitched ball	<b>投球<b> <br> とうきゅう <br>[sound:k-3016_投球.mp3]
[sound:k-3016_投球.mp3]	pitching, throwing a ball, bowling<br> <b>in cricket), pitched ball (投球</b> <br> (とうきゅう)
(<b>農産物</b>) その地域は新鮮な農産物で知られています。	[sound:s-3016_その地域は新鮮な農産物で知られています。.mp3] <br> そのちいきはしんせんなのうさんぶつでしられています。 <br>  The region is known for its fresh agricultural products.
[sound:s-3006_その疾患は難病として知られています。.mp3]	(<b>難病</b>) その疾患は難病として知られています。<br> そのしっかんはなんびょうとしてしられています。 <br> The disease is known as a rare disease.	
速球	[sound:k-3017_速球.mp3]<br>そっきゅう <br> fastball
fastball	<b>速球<b> <br> そっきゅう <br>[sound:k-3017_速球.mp3]
[sound:k-3017_速球.mp3]	fastball<br> <b>速球</b> <br> (そっきゅう)
(<b>農地</b>) 農地の不毛化が地球温暖化の問題の一つです。	[sound:s-3017_農地の不毛化が地球温暖化の問題の一つです。.mp3] <br> のうちのふもうかがちきゅうおんだんかのもんだいのひとつです。 <br>  Desertification of farmland is one of the issues of global warming.
[sound:s-3007_成人病の予防には健康的な生活が重要です。.mp3]	(<b>成人病</b>) 成人病の予防には健康的な生活が重要です。<br> せいじんびょうのよぼうにはけんこうてきなせいかつがじゅうようです。 <br> A healthy lifestyle is important for preventing lifestyle-related diseases.	
制球	[sound:k-3018_制球.mp3]<br>せいきゅう <br> (pitcher's) control (baseball)
(pitcher's) control (baseball)	<b>制球<b> <br> せいきゅう <br>[sound:k-3018_制球.mp3]
[sound:k-3018_制球.mp3]	(pitcher's) control<br> <b>baseball) (制球</b> <br> (せいきゅう)
(<b>農林</b>) 農林業は地球環境の保護に重要な役割を果たしています。	[sound:s-3018_農林業は地球環境の保護に重要な役割を果たしています。.mp3] <br> のうりんぎょうはちきゅうかんきょうのほごにじゅうようなやくわりをはたしています。 <br>  Agriculture and forestry play an important role in protecting the global environment.
[sound:s-3008_父は心臓病で入院しています。.mp3]	(<b>心臓病</b>) 父は心臓病で入院しています。<br> ちちはしんぞうびょうでにゅういんしています。 <br> My father is hospitalized with heart disease.	
直球	[sound:k-3019_直球.mp3]<br>ちょくきゅう, ちょっきゅう <br> straight ball (pitch); straight, frank
straight ball (pitch); straight, frank	<b>直球<b> <br> ちょくきゅう, ちょっきゅう <br>[sound:k-3019_直球.mp3]
[sound:k-3019_直球.mp3]	straight ball<br> <b>pitch); straight, frank (直球</b> <br> (ちょくきゅう, ちょっきゅう)
(<b>州</b>) アメリカ合衆国には50の州があります。	[sound:s-3019_アメリカ合衆国には50の州があります。.mp3] <br> アメリカがっしゅうこくには50のしゅうがあります。 <br> There are 50 states in the United States of America.
[sound:s-3009_農業はその地域の主要な産業です。.mp3]	(<b>農</b>) 農業はその地域の主要な産業です。<br> のうぎょうはそのちいきのしゅようなさんぎょうです。 <br> Agriculture is the main industry in that region.	
経営	[sound:k-3020_経営.mp3]<br>けいえい <br> management, administration
management, administration	<b>経営<b> <br> けいえい <br>[sound:k-3020_経営.mp3]
[sound:k-3020_経営.mp3]	management, administration<br> <b>経営</b> <br> (けいえい)
(<b>欧州</b>) 欧州連合はヨーロッパの統合を図っています。	[sound:s-3020_欧州連合はヨーロッパの統合を図っています。.mp3] <br> おうしゅうれんごうはヨーロッパのとうごうをはかっています。 <br>  The European Union aims for integration in Europe.
[sound:s-3010_彼は農業を通じて地域社会に貢献しています。.mp3]	(<b>農業</b>) 彼は農業を通じて地域社会に貢献しています。<br> かれはのうぎょうをつうじてちいきしゃかいにこうけんしています。 <br> He contributes to the local community through agriculture.	
運営	[sound:k-3021_運営.mp3]<br>うんえい <br> management, administration, operation
management, administration, operation	<b>運営<b> <br> うんえい <br>[sound:k-3021_運営.mp3]
[sound:k-3021_運営.mp3]	management, administration, operation<br> <b>運営</b> <br> (うんえい)
(<b>九州</b>) 日本の九州には多くの観光地があります。	[sound:s-3021_日本の九州には多くの観光地があります。.mp3] <br> にほんのきゅうしゅうにはおおくのかんこうちがあります。 <br>  Kyushu, Japan, has many tourist attractions.
[sound:s-3011_その農家は美しい田園風景を所有しています。.mp3]	(<b>農家</b>) その農家は美しい田園風景を所有しています。<br> そののうかはうつくしいでんえんふうけいをしょゆうしています。 <br> The farmer owns beautiful rural scenery.	
営業	[sound:k-3022_営業.mp3]<br>えいぎょう <br> business, trade, sales, operations
business, trade, sales, operations	<b>営業<b> <br> えいぎょう <br>[sound:k-3022_営業.mp3]
[sound:k-3022_営業.mp3]	business, trade, sales, operations<br> <b>営業</b> <br> (えいぎょう)
(<b>州都</b>) カリフォルニア州の州都はサクラメントです。	[sound:s-3022_カリフォルニア州の州都はサクラメントです。.mp3] <br> カリフォルニアしゅうのしゅうとはサクラメントです。 <br>  The capital of California state is Sacramento.
[sound:s-3012_農協は地域の農民を支援しています。.mp3]	(<b>農協</b>) 農協は地域の農民を支援しています。<br> のうきょうはちいきののうみんをしえんしています。 <br> The agricultural cooperative supports local farmers.	
経営者	[sound:k-3023_経営者.mp3]<br>けいえいしゃ <br> manager, proprietor
manager, proprietor	<b>経営者<b> <br> けいえいしゃ <br>[sound:k-3023_経営者.mp3]
[sound:k-3023_経営者.mp3]	manager, proprietor<br> <b>経営者</b> <br> (けいえいしゃ)
(<b>州政府</b>) 州政府は地方自治の拠点です。	[sound:s-3023_州政府は地方自治の拠点です。.mp3] <br> しゅうせいふはちほうじちのきょてんです。 <br>  State governments are the foundation of local autonomy.
[sound:s-3013_その国では農村地域の開発が進んでいます。.mp3]	(<b>農村</b>) その国では農村地域の開発が進んでいます。<br> そのくにではのうそんちいきのかいはつがすすんでいます。 <br> Rural development is progressing in that country.	
国営	[sound:k-3024_国営.mp3]<br>こくえい <br> state management
state management	<b>国営<b> <br> こくえい <br>[sound:k-3024_国営.mp3]
[sound:k-3024_国営.mp3]	state management<br> <b>国営</b> <br> (こくえい)
(<b>広州</b>) 広州は中国南部の主要都市の一つです。	[sound:s-3024_広州は中国南部の主要都市の一つです。.mp3] <br> こうしゅうはちゅうごくなんぶのしゅようとしのひとつです。 <br>  Guangzhou is one of the major cities in southern China.
[sound:s-3014_農民たちは収穫祭を楽しみにしています。.mp3]	(<b>農民</b>) 農民たちは収穫祭を楽しみにしています。<br> のうみんたちはしゅうかくさいをたのしみにしています。 <br> Farmers are looking forward to the harvest festival.	
陣営	[sound:k-3025_陣営.mp3]<br>じんえい <br> camp (group of same ideological beliefs)
camp (group of same ideological beliefs)	<b>陣営<b> <br> じんえい <br>[sound:k-3025_陣営.mp3]
[sound:k-3025_陣営.mp3]	camp<br> <b>group of same ideological beliefs) (陣営</b> <br> (じんえい)
(<b>沿海州</b>) その国の沿海州は海洋資源に富んでいます。	[sound:s-3025_その国の沿海州は海洋資源に富んでいます。.mp3] <br> そのくにのえんかいしゅうはかいようしげんにとむんでいます。 <br>  The coastal provinces of that country are rich in marine resources.
[sound:s-3015_農薬の使用量を減らす方法を模索しています。.mp3]	(<b>農薬</b>) 農薬の使用量を減らす方法を模索しています。<br> のうやくのしようりょうをへらすほうほうをもさくしています。 <br> We are exploring ways to reduce the use of pesticides.	
民営	[sound:k-3026_民営.mp3]<br>みんえい <br> private management
private management	<b>民営<b> <br> みんえい <br>[sound:k-3026_民営.mp3]
[sound:k-3026_民営.mp3]	private management<br> <b>民営</b> <br> (みんえい)
(<b>州</b>) 州議会は新しい法律を承認しました。	[sound:s-3026_州議会は新しい法律を承認しました。.mp3] <br> しゅうぎかいはあたらしいほうりつをしょうにんしました。 <br>  The state legislature approved the new law.
[sound:s-3016_その地域は新鮮な農産物で知られています。.mp3]	(<b>農産物</b>) その地域は新鮮な農産物で知られています。<br> そのちいきはしんせんなのうさんぶつでしられています。 <br> The region is known for its fresh agricultural products.	
営業所	[sound:k-3027_営業所.mp3]<br>えいぎょうしょ <br> business office, place of business
business office, place of business	<b>営業所<b> <br> えいぎょうしょ <br>[sound:k-3027_営業所.mp3]
[sound:k-3027_営業所.mp3]	business office, place of business<br> <b>営業所</b> <br> (えいぎょうしょ)
(<b>大洋州</b>) オーストラリアは大洋州に位置しています。	[sound:s-3027_オーストラリアは大洋州に位置しています。.mp3] <br> オーストラリアはたいようしゅうにいちしています。 <br>  Australia is located in Oceania.
[sound:s-3017_農地の不毛化が地球温暖化の問題の一つです。.mp3]	(<b>農地</b>) 農地の不毛化が地球温暖化の問題の一つです。<br> のうちのふもうかがちきゅうおんだんかのもんだいのひとつです。 <br> Desertification of farmland is one of the issues of global warming.	
公営	[sound:k-3028_公営.mp3]<br>こうえい <br> public management
public management	<b>公営<b> <br> こうえい <br>[sound:k-3028_公営.mp3]
[sound:k-3028_公営.mp3]	public management<br> <b>公営</b> <br> (こうえい)
(<b>加州</b>) 加州はアメリカ西海岸に位置しています。	[sound:s-3028_加州はアメリカ西海岸に位置しています。.mp3] <br> カしゅうはアメリカせいかいがんにいちしています。 <br>  California is located on the west coast of the United States.
[sound:s-3018_農林業は地球環境の保護に重要な役割を果たしています。.mp3]	(<b>農林</b>) 農林業は地球環境の保護に重要な役割を果たしています。<br> のうりんぎょうはちきゅうかんきょうのほごにじゅうようなやくわりをはたしています。 <br> Agriculture and forestry play an important role in protecting the global environment.	
市営	[sound:k-3029_市営.mp3]<br>しえい <br> municipal management
municipal management	<b>市営<b> <br> しえい <br>[sound:k-3029_市営.mp3]
[sound:k-3029_市営.mp3]	municipal management<br> <b>市営</b> <br> (しえい)
(<b>武器</b>) 戦争で使用される武器は非常に危険です。	[sound:s-3029_戦争で使用される武器は非常に危険です。.mp3] <br> せんそうでしようされるぶきはひじょうにきけんです。 <br>  Weapons used in war are extremely dangerous.
[sound:s-3019_アメリカ合衆国には50の州があります。.mp3]	(<b>州</b>) アメリカ合衆国には50の州があります。<br> アメリカがっしゅうこくには50のしゅうがあります。 <br>There are 50 states in the United States of America.	
空	[sound:k-3030_空.mp3]<br>から <br> emptiness, vacuum, blank
emptiness, vacuum, blank	<b>空<b> <br> から <br>[sound:k-3030_空.mp3]
[sound:k-3030_空.mp3]	emptiness, vacuum, blank<br> <b>空</b> <br> (から)
(<b>武装</b>) 彼らは武装して国境を守っています。	[sound:s-3030_彼らは武装して国境を守っています。.mp3] <br> かれらはぶそうしてこっきょうをまもっています。 <br>  They are armed and guarding the border.
[sound:s-3020_欧州連合はヨーロッパの統合を図っています。.mp3]	(<b>欧州</b>) 欧州連合はヨーロッパの統合を図っています。<br> おうしゅうれんごうはヨーロッパのとうごうをはかっています。 <br> The European Union aims for integration in Europe.	
空港	[sound:k-3031_空港.mp3]<br>くうこう <br> airport
airport	<b>空港<b> <br> くうこう <br>[sound:k-3031_空港.mp3]
[sound:k-3031_空港.mp3]	airport<br> <b>空港</b> <br> (くうこう)
(<b>武力</b>) 武力行使は最終手段とされます。	[sound:s-3031_武力行使は最終手段とされます。.mp3] <br> ぶりょくこうしはさいしゅうしゅだんとされます。 <br>  The use of force is considered a last resort.
[sound:s-3021_日本の九州には多くの観光地があります。.mp3]	(<b>九州</b>) 日本の九州には多くの観光地があります。<br> にほんのきゅうしゅうにはおおくのかんこうちがあります。 <br> Kyushu, Japan, has many tourist attractions.	
航空	[sound:k-3032_航空.mp3]<br>こうくう <br> aviation, flying
aviation, flying	<b>航空<b> <br> こうくう <br>[sound:k-3032_航空.mp3]
[sound:k-3032_航空.mp3]	aviation, flying<br> <b>航空</b> <br> (こうくう)
(<b>武道</b>) 彼は若い頃に柔道を習いました。	[sound:s-3032_彼は若い頃に柔道を習いました。.mp3] <br> かれはわかいころにじゅうどうをならいました。 <br>  He learned judo when he was young.
[sound:s-3022_カリフォルニア州の州都はサクラメントです。.mp3]	(<b>州都</b>) カリフォルニア州の州都はサクラメントです。<br> カリフォルニアしゅうのしゅうとはサクラメントです。 <br> The capital of California state is Sacramento.	
空気	[sound:k-3033_空気.mp3]<br>くうき <br> air, atmosphere
air, atmosphere	<b>空気<b> <br> くうき <br>[sound:k-3033_空気.mp3]
[sound:k-3033_空気.mp3]	air, atmosphere<br> <b>空気</b> <br> (くうき)
(<b>武士</b>) 平和な時代に武士は軍事技術を磨いた。	[sound:s-3033_平和な時代に武士は軍事技術を磨いた。.mp3] <br> へいわなじだいにぶしはぐんじぎじゅつをみがいた。 <br>  During peaceful times, samurai honed their military skills.
[sound:s-3023_州政府は地方自治の拠点です。.mp3]	(<b>州政府</b>) 州政府は地方自治の拠点です。<br> しゅうせいふはちほうじちのきょてんです。 <br> State governments are the foundation of local autonomy.	
航空機	[sound:k-3034_航空機.mp3]<br>こうくうき <br> aircraft, aeroplane, airplane
aircraft, aeroplane, airplane	<b>航空機<b> <br> こうくうき <br>[sound:k-3034_航空機.mp3]
[sound:k-3034_航空機.mp3]	aircraft, aeroplane, airplane<br> <b>航空機</b> <br> (こうくうき)
(<b>核武装</b>) 核武装国家との平和交渉が続いています。	[sound:s-3034_核武装国家との平和交渉が続いています。.mp3] <br> かくぶそうこっかとのへいわこうしょうがつづいています。 <br>  Peace negotiations with nuclear-armed states continue.
[sound:s-3024_広州は中国南部の主要都市の一つです。.mp3]	(<b>広州</b>) 広州は中国南部の主要都市の一つです。<br> こうしゅうはちゅうごくなんぶのしゅようとしのひとつです。 <br> Guangzhou is one of the major cities in southern China.	
空間	[sound:k-3035_空間.mp3]<br>くうかん <br> space, room, airspace
space, room, airspace	<b>空間<b> <br> くうかん <br>[sound:k-3035_空間.mp3]
[sound:k-3035_空間.mp3]	space, room, airspace<br> <b>空間</b> <br> (くうかん)
(<b>武者</b>) その映画は武者の物語を描いています。	[sound:s-3035_その映画は武者の物語を描いています。.mp3] <br> そのえいがはむしゃのものがたりをえがいています。 <br>  The movie depicts the story of a warrior.
[sound:s-3025_その国の沿海州は海洋資源に富んでいます。.mp3]	(<b>沿海州</b>) その国の沿海州は海洋資源に富んでいます。<br> そのくにのえんかいしゅうはかいようしげんにとむんでいます。 <br> The coastal provinces of that country are rich in marine resources.	
空爆	[sound:k-3036_空爆.mp3]<br>くうばく <br> aerial bombing
aerial bombing	<b>空爆<b> <br> くうばく <br>[sound:k-3036_空爆.mp3]
[sound:k-3036_空爆.mp3]	aerial bombing<br> <b>空爆</b> <br> (くうばく)
(<b>武将</b>) 戦国時代に多くの有名な武将が活躍しました。	[sound:s-3036_戦国時代に多くの有名な武将が活躍しました。.mp3] <br> せんごくじだいにおおくのゆうめいなぶしょうがかつやくしました。 <br>  Many famous military commanders played active roles during the Warring States period.
[sound:s-3026_州議会は新しい法律を承認しました。.mp3]	(<b>州</b>) 州議会は新しい法律を承認しました。<br> しゅうぎかいはあたらしいほうりつをしょうにんしました。 <br> The state legislature approved the new law.	
空軍	[sound:k-3037_空軍.mp3]<br>くうぐん <br> Air Force
Air Force	<b>空軍<b> <br> くうぐん <br>[sound:k-3037_空軍.mp3]
[sound:k-3037_空軍.mp3]	Air Force<br> <b>空軍</b> <br> (くうぐん)
(<b>武家</b>) 平安時代に武家の勢力が台頭しました。	[sound:s-3037_平安時代に武家の勢力が台頭しました。.mp3] <br> へいあんじだいにぶけのせいりょくがたいとうしました。 <br>  The military power of the samurai rose to prominence during the Heian period.
[sound:s-3027_オーストラリアは大洋州に位置しています。.mp3]	(<b>大洋州</b>) オーストラリアは大洋州に位置しています。<br> オーストラリアはたいようしゅうにいちしています。 <br> Australia is located in Oceania.	
上空	[sound:k-3038_上空.mp3]<br>じょうくう <br> sky, the skies, high-altitude sky, upper air
sky, the skies, high-altitude sky, upper air	<b>上空<b> <br> じょうくう <br>[sound:k-3038_上空.mp3]
[sound:k-3038_上空.mp3]	sky, the skies, high-altitude sky, upper air<br> <b>上空</b> <br> (じょうくう)
(<b>文武</b>) 彼は文武両道の人物です。	[sound:s-3038_彼は文武両道の人物です。.mp3] <br> かれはぶんぶりょうどうのじんぶつです。 <br>  He is proficient in both literary and military arts.
[sound:s-3028_加州はアメリカ西海岸に位置しています。.mp3]	(<b>加州</b>) 加州はアメリカ西海岸に位置しています。<br> カしゅうはアメリカせいかいがんにいちしています。 <br> California is located on the west coast of the United States.	
架空	[sound:k-3039_架空.mp3]<br>かくう <br> aerial, overhead, fiction, fanciful
aerial, overhead, fiction, fanciful	<b>架空<b> <br> かくう <br>[sound:k-3039_架空.mp3]
[sound:k-3039_架空.mp3]	aerial, overhead, fiction, fanciful<br> <b>架空</b> <br> (かくう)
(<b>声</b>) 彼の声は部屋中に響き渡った。	[sound:s-3039_彼の声は部屋中に響き渡った。.mp3] <br> かれのこえはへやじゅうにひびきわたった。 <br>  His voice echoed throughout the room.
[sound:s-3029_戦争で使用される武器は非常に危険です。.mp3]	(<b>武器</b>) 戦争で使用される武器は非常に危険です。<br> せんそうでしようされるぶきはひじょうにきけんです。 <br> Weapons used in war are extremely dangerous.	
職	[sound:k-3040_職.mp3]<br>しょく <br> employment
employment	<b>職<b> <br> しょく <br>[sound:k-3040_職.mp3]
[sound:k-3040_職.mp3]	employment<br> <b>職</b> <br> (しょく)
(<b>声明</b>) 会社からの公式な声明が発表された。	[sound:s-3040_会社からの公式な声明が発表された。.mp3] <br> かいしゃからのこうしきなせいめいがはっぴょうされた。 <br>  An official statement from the company was released.
[sound:s-3030_彼らは武装して国境を守っています。.mp3]	(<b>武装</b>) 彼らは武装して国境を守っています。<br> かれらはぶそうしてこっきょうをまもっています。 <br> They are armed and guarding the border.	
職員	[sound:k-3041_職員.mp3]<br>しょくいん <br> staff member, personnel
staff member, personnel	<b>職員<b> <br> しょくいん <br>[sound:k-3041_職員.mp3]
[sound:k-3041_職員.mp3]	staff member, personnel<br> <b>職員</b> <br> (しょくいん)
(<b>音声</b>) このビデオには日本語の音声が付いています。	[sound:s-3041_このビデオには日本語の音声が付いています。.mp3] <br> このビデオにはにほんごのおんせいがついています。 <br>  This video comes with Japanese audio.
[sound:s-3031_武力行使は最終手段とされます。.mp3]	(<b>武力</b>) 武力行使は最終手段とされます。<br> ぶりょくこうしはさいしゅうしゅだんとされます。 <br> The use of force is considered a last resort.	
汚職	[sound:k-3042_汚職.mp3]<br>おしょく <br> corruption
corruption	<b>汚職<b> <br> おしょく <br>[sound:k-3042_汚職.mp3]
[sound:k-3042_汚職.mp3]	corruption<br> <b>汚職</b> <br> (おしょく)
(<b>歓声</b>) 勝利の歓声が競技場に響き渡った。	[sound:s-3042_勝利の歓声が競技場に響き渡った。.mp3] <br> しょうりのかんせいがきょうぎじょうにひびきわたった。 <br>  The cheers of victory echoed through the stadium.
[sound:s-3032_彼は若い頃に柔道を習いました。.mp3]	(<b>武道</b>) 彼は若い頃に柔道を習いました。<br> かれはわかいころにじゅうどうをならいました。 <br> He learned judo when he was young.	
現職	[sound:k-3043_現職.mp3]<br>げんしょく <br> present post, current office, (an) incumbent
present post, current office, (an) incumbent	<b>現職<b> <br> げんしょく <br>[sound:k-3043_現職.mp3]
[sound:k-3043_現職.mp3]	present post, current office,<br> <b>an) incumbent (現職</b> <br> (げんしょく)
(<b>声援</b>) 彼はチームに声援を送った。	[sound:s-3043_彼はチームに声援を送った。.mp3] <br> かれはチームにせいえんをおくった。 <br>  He cheered for the team.
[sound:s-3033_平和な時代に武士は軍事技術を磨いた。.mp3]	(<b>武士</b>) 平和な時代に武士は軍事技術を磨いた。<br> へいわなじだいにぶしはぐんじぎじゅつをみがいた。 <br> During peaceful times, samurai honed their military skills.	
就職	[sound:k-3044_就職.mp3]<br>しゅうしょく <br> finding employment, inauguration
finding employment, inauguration	<b>就職<b> <br> しゅうしょく <br>[sound:k-3044_就職.mp3]
[sound:k-3044_就職.mp3]	finding employment, inauguration<br> <b>就職</b> <br> (しゅうしょく)
(<b>声楽</b>) 彼女は声楽コンクールで優勝しました。	[sound:s-3044_彼女は声楽コンクールで優勝しました。.mp3] <br> かのじょはせいがくこんくるでゆうしょうしました。 <br>  She won first place in the vocal competition.
[sound:s-3034_核武装国家との平和交渉が続いています。.mp3]	(<b>核武装</b>) 核武装国家との平和交渉が続いています。<br> かくぶそうこっかとのへいわこうしょうがつづいています。 <br> Peace negotiations with nuclear-armed states continue.	
職業	[sound:k-3045_職業.mp3]<br>しょくぎょう <br> occupation, business
occupation, business	<b>職業<b> <br> しょくぎょう <br>[sound:k-3045_職業.mp3]
[sound:k-3045_職業.mp3]	occupation, business<br> <b>職業</b> <br> (しょくぎょう)
(<b>第一声</b>) 赤ちゃんが生まれたとき、最初の泣き声が第一声です。	[sound:s-3045_赤ちゃんが生まれたとき、最初の泣き声が第一声です。.mp3] <br> あかちゃんがうまれたとき、さいしょのなきごえがだいいっせいです。 <br>  When a baby is born, the first cry is the first sound.
[sound:s-3035_その映画は武者の物語を描いています。.mp3]	(<b>武者</b>) その映画は武者の物語を描いています。<br> そのえいがはむしゃのものがたりをえがいています。 <br> The movie depicts the story of a warrior.	
職場	[sound:k-3046_職場.mp3]<br>しょくば <br> one's post, place of work, workplace
one's post, place of work, workplace	<b>職場<b> <br> しょくば <br>[sound:k-3046_職場.mp3]
[sound:k-3046_職場.mp3]	one's post, place of work, workplace<br> <b>職場</b> <br> (しょくば)
(<b>掛け声</b>) 応援団が掛け声をかけて選手を励ましました。	[sound:s-3046_応援団が掛け声をかけて選手を励ましました。.mp3] <br> おうえんだんがかけごえをかけてせんしゅをはげましました。 <br>  The cheering squad cheered and encouraged the players.
[sound:s-3036_戦国時代に多くの有名な武将が活躍しました。.mp3]	(<b>武将</b>) 戦国時代に多くの有名な武将が活躍しました。<br> せんごくじだいにおおくのゆうめいなぶしょうがかつやくしました。 <br> Many famous military commanders played active roles during the Warring States period.	
辞職	[sound:k-3047_辞職.mp3]<br>じしょく <br> resignation
resignation	<b>辞職<b> <br> じしょく <br>[sound:k-3047_辞職.mp3]
[sound:k-3047_辞職.mp3]	resignation<br> <b>辞職</b> <br> (じしょく)
(<b>歌声</b>) 彼女の歌声は心に響いた。	[sound:s-3047_彼女の歌声は心に響いた。.mp3] <br> かのじょのうたごえはこころにひびいた。 <br>  Her singing voice resonated in my heart.
[sound:s-3037_平安時代に武家の勢力が台頭しました。.mp3]	(<b>武家</b>) 平安時代に武家の勢力が台頭しました。<br> へいあんじだいにぶけのせいりょくがたいとうしました。 <br> The military power of the samurai rose to prominence during the Heian period.	
退職	[sound:k-3048_退職.mp3]<br>たいしょく <br> retirement (from office)
retirement (from office)	<b>退職<b> <br> たいしょく <br>[sound:k-3048_退職.mp3]
[sound:k-3048_退職.mp3]	retirement<br> <b>from office) (退職</b> <br> (たいしょく)
(<b>声高</b>) 彼の声がますます声高になった。	[sound:s-3048_彼の声がますます声高になった。.mp3] <br> かれのこえがますますこわくなった。 <br>  His voice became louder and louder.
[sound:s-3038_彼は文武両道の人物です。.mp3]	(<b>文武</b>) 彼は文武両道の人物です。<br> かれはぶんぶりょうどうのじんぶつです。 <br> He is proficient in both literary and military arts.	
無職	[sound:k-3049_無職.mp3]<br>むしょく <br> without an occupation
without an occupation	<b>無職<b> <br> むしょく <br>[sound:k-3049_無職.mp3]
[sound:k-3049_無職.mp3]	without an occupation<br> <b>無職</b> <br> (むしょく)
(<b>質</b>) その製品の質は高い評価を受けています。	[sound:s-3049_その製品の質は高い評価を受けています。.mp3] <br> そのせいひんのしつはたかいひょうかをうけています。 <br>  The quality of the product has received high praise.
[sound:s-3039_彼の声は部屋中に響き渡った。.mp3]	(<b>声</b>) 彼の声は部屋中に響き渡った。<br> かれのこえはへやじゅうにひびきわたった。 <br> His voice echoed throughout the room.	
証券	[sound:k-3050_証券.mp3]<br>しょうけん <br> securities, bonds, certificates
securities, bonds, certificates	<b>証券<b> <br> しょうけん <br>[sound:k-3050_証券.mp3]
[sound:k-3050_証券.mp3]	securities, bonds, certificates<br> <b>証券</b> <br> (しょうけん)
(<b>質問</b>) 質問があれば、いつでも聞いてください。	[sound:s-3050_質問があれば、いつでも聞いてください。.mp3] <br> しつもんがあれば、いつでもきいてください。 <br>  If you have any questions, feel free to ask anytime.
[sound:s-3040_会社からの公式な声明が発表された。.mp3]	(<b>声明</b>) 会社からの公式な声明が発表された。<br> かいしゃからのこうしきなせいめいがはっぴょうされた。 <br> An official statement from the company was released.	
証人	[sound:k-3051_証人.mp3]<br>しょうにん <br> witness
witness	<b>証人<b> <br> しょうにん <br>[sound:k-3051_証人.mp3]
[sound:k-3051_証人.mp3]	witness<br> <b>証人</b> <br> (しょうにん)
(<b>実質</b>) 彼の実質的な貢献は大きかった。	[sound:s-3051_彼の実質的な貢献は大きかった。.mp3] <br> かれのじっしつてきなこうけんはおおきかった。 <br>  His substantial contribution was significant.
[sound:s-3041_このビデオには日本語の音声が付いています。.mp3]	(<b>音声</b>) このビデオには日本語の音声が付いています。<br> このビデオにはにほんごのおんせいがついています。 <br> This video comes with Japanese audio.	
証言	[sound:k-3052_証言.mp3]<br>しょうげん <br> evidence, testimony
evidence, testimony	<b>証言<b> <br> しょうげん <br>[sound:k-3052_証言.mp3]
[sound:k-3052_証言.mp3]	evidence, testimony<br> <b>証言</b> <br> (しょうげん)
(<b>物質</b>) 科学者たちは新しい物質の発見を追求しています。	[sound:s-3052_科学者たちは新しい物質の発見を追求しています。.mp3] <br> かがくしゃたちはあたらしいぶっしつのはっけんをついきゅうしています。 <br>  Scientists are pursuing the discovery of new materials.
[sound:s-3042_勝利の歓声が競技場に響き渡った。.mp3]	(<b>歓声</b>) 勝利の歓声が競技場に響き渡った。<br> しょうりのかんせいがきょうぎじょうにひびきわたった。 <br> The cheers of victory echoed through the stadium.	
保証	[sound:k-3053_保証.mp3]<br>ほしょう <br> guarantee, security, assurance, pledge, warranty
guarantee, security, assurance, pledge, warranty	<b>保証<b> <br> ほしょう <br>[sound:k-3053_保証.mp3]
[sound:k-3053_保証.mp3]	guarantee, security, assurance, pledge, warranty<br> <b>保証</b> <br> (ほしょう)
(<b>実質的</b>) 彼は実質的なリーダーシップを発揮しています。	[sound:s-3053_彼は実質的なリーダーシップを発揮しています。.mp3] <br> かれはじっしつてきなりーだーしっぷをはっきしています。 <br>  He demonstrates substantial leadership.
[sound:s-3043_彼はチームに声援を送った。.mp3]	(<b>声援</b>) 彼はチームに声援を送った。<br> かれはチームにせいえんをおくった。 <br> He cheered for the team.	
証拠	[sound:k-3054_証拠.mp3]<br>しょうこ <br> evidence, proof
evidence, proof	<b>証拠<b> <br> しょうこ <br>[sound:k-3054_証拠.mp3]
[sound:k-3054_証拠.mp3]	evidence, proof<br> <b>証拠</b> <br> (しょうこ)
(<b>体質</b>) 彼女は弱い免疫体質を持っています。	[sound:s-3054_彼女は弱い免疫体質を持っています。.mp3] <br> かのじょはよわいめんえきたいしつをもっています。 <br>  She has a weak immune system.
[sound:s-3044_彼女は声楽コンクールで優勝しました。.mp3]	(<b>声楽</b>) 彼女は声楽コンクールで優勝しました。<br> かのじょはせいがくこんくるでゆうしょうしました。 <br> She won first place in the vocal competition.	
証明	[sound:k-3055_証明.mp3]<br>しょうめい <br> proof, verification
proof, verification	<b>証明<b> <br> しょうめい <br>[sound:k-3055_証明.mp3]
[sound:k-3055_証明.mp3]	proof, verification<br> <b>証明</b> <br> (しょうめい)
(<b>質疑</b>) 議員は討論中に質疑を行った。	[sound:s-3055_議員は討論中に質疑を行った。.mp3] <br> ぎいんはとうろんちゅうにしつぎをおこなった。 <br>  The parliament member conducted questioning during the debate.
[sound:s-3045_赤ちゃんが生まれたとき、最初の泣き声が第一声です。.mp3]	(<b>第一声</b>) 赤ちゃんが生まれたとき、最初の泣き声が第一声です。<br> あかちゃんがうまれたとき、さいしょのなきごえがだいいっせいです。 <br> When a baby is born, the first cry is the first sound.	
有価証券	[sound:k-3056_有価証券.mp3]<br>ゆうかしょうけん <br> marketable securities, stocks and bonds
marketable securities, stocks and bonds	<b>有価証券<b> <br> ゆうかしょうけん <br>[sound:k-3056_有価証券.mp3]
[sound:k-3056_有価証券.mp3]	marketable securities, stocks and bonds<br> <b>有価証券</b> <br> (ゆうかしょうけん)
(<b>本質</b>) 問題の本質を理解することが重要です。	[sound:s-3056_問題の本質を理解することが重要です。.mp3] <br> もんだいのほんしつをりかいすることがじゅうようです。 <br>  Understanding the essence of the problem is important.
[sound:s-3046_応援団が掛け声をかけて選手を励ましました。.mp3]	(<b>掛け声</b>) 応援団が掛け声をかけて選手を励ましました。<br> おうえんだんがかけごえをかけてせんしゅをはげましました。 <br> The cheering squad cheered and encouraged the players.	
証書	[sound:k-3057_証書.mp3]<br>しょうしょ <br> bond, deed, certificate
bond, deed, certificate	<b>証書<b> <br> しょうしょ <br>[sound:k-3057_証書.mp3]
[sound:k-3057_証書.mp3]	bond, deed, certificate<br> <b>証書</b> <br> (しょうしょ)
(<b>人質</b>) テロリストたちは人質を取った。	[sound:s-3057_テロリストたちは人質を取った。.mp3] <br> てろりすとたちはひとじちをとった。 <br>  The terrorists took hostages.
[sound:s-3047_彼女の歌声は心に響いた。.mp3]	(<b>歌声</b>) 彼女の歌声は心に響いた。<br> かのじょのうたごえはこころにひびいた。 <br> Her singing voice resonated in my heart.	
検証	[sound:k-3058_検証.mp3]<br>けんしょう <br> verification, inspection
verification, inspection	<b>検証<b> <br> けんしょう <br>[sound:k-3058_検証.mp3]
[sound:k-3058_検証.mp3]	verification, inspection<br> <b>検証</b> <br> (けんしょう)
(<b>品質</b>) この製品の品質は非常に高いです。	[sound:s-3058_この製品の品質は非常に高いです。.mp3] <br> このせいひんのひんしつはひじょうにたかいです。 <br>  The quality of this product is very high.
[sound:s-3048_彼の声がますます声高になった。.mp3]	(<b>声高</b>) 彼の声がますます声高になった。<br> かれのこえがますますこわくなった。 <br> His voice became louder and louder.	
証	[sound:k-3059_証.mp3]<br>あかし <br> proof, evidence, testimony; to testify (usu. Christian religious context)
proof, evidence, testimony; to testify (usu. Christian religious context)	<b>証<b> <br> あかし <br>[sound:k-3059_証.mp3]
[sound:k-3059_証.mp3]	proof, evidence, testimony; to testify<br> <b>usu. Christian religious context) (証</b> <br> (あかし)
(<b>念</b>) 彼は成功への強い念を持っている。	[sound:s-3059_彼は成功への強い念を持っている。.mp3] <br> かれはせいこうへのつよいねんをもっている。 <br>  He has a strong determination for success.
[sound:s-3049_その製品の質は高い評価を受けています。.mp3]	(<b>質</b>) その製品の質は高い評価を受けています。<br> そのせいひんのしつはたかいひょうかをうけています。 <br> The quality of the product has received high praise.	
土	[sound:k-3060_土.mp3]<br>つち, つし <br> earth, soil, dirt; the earth (historically, esp. as opposed to the heavens), the ground, the land; low-quality torinoko-gami (containing mud); (period of) refraining from construction in the direction of the god of the earth (in On'youdou)
earth, soil, dirt; the earth (historically, esp. as opposed to the heavens), the ground, the land; low-quality torinoko-gami (containing mud); (period of) refraining from construction in the direction of the god of the earth (in On'youdou)	<b>土<b> <br> つち, つし <br>[sound:k-3060_土.mp3]
[sound:k-3060_土.mp3]	earth, soil, dirt; the earth<br> <b>historically, esp. as opposed to the heavens), the ground, the land; low-quality torinoko-gami (containing mud); (period of) refraining from construction in the direction of the god of the earth (in On'youdou) (土</b> <br> (つち, つし)
(<b>記念</b>) このイベントは学校の創立記念日を祝うものです。	[sound:s-3060_このイベントは学校の創立記念日を祝うものです。.mp3] <br> このイベントはがっこうのそうりつきねんびをいわうものです。 <br>  This event celebrates the school's founding anniversary.
[sound:s-3050_質問があれば、いつでも聞いてください。.mp3]	(<b>質問</b>) 質問があれば、いつでも聞いてください。<br> しつもんがあれば、いつでもきいてください。 <br> If you have any questions, feel free to ask anytime.	
土地	[sound:k-3061_土地.mp3]<br>とち <br> plot of land, lot, soil
plot of land, lot, soil	<b>土地<b> <br> とち <br>[sound:k-3061_土地.mp3]
[sound:k-3061_土地.mp3]	plot of land, lot, soil<br> <b>土地</b> <br> (とち)
(<b>懸念</b>) その問題について多くの人が懸念を抱いている。	[sound:s-3061_その問題について多くの人が懸念を抱いている。.mp3] <br> そのもんだいについておおくのひとがけねんをだいている。 <br>  Many people have concerns about the issue.
[sound:s-3051_彼の実質的な貢献は大きかった。.mp3]	(<b>実質</b>) 彼の実質的な貢献は大きかった。<br> かれのじっしつてきなこうけんはおおきかった。 <br> His substantial contribution was significant.	
領土	[sound:k-3062_領土.mp3]<br>りょうど <br> dominion, territory, possession
dominion, territory, possession	<b>領土<b> <br> りょうど <br>[sound:k-3062_領土.mp3]
[sound:k-3062_領土.mp3]	dominion, territory, possession<br> <b>領土</b> <br> (りょうど)
(<b>残念</b>) 会議に参加できなくて残念です。	[sound:s-3062_会議に参加できなくて残念です。.mp3] <br> かいぎにさんかできなくてざんねんです。 <br>  It's regrettable that I can't attend the meeting.
[sound:s-3052_科学者たちは新しい物質の発見を追求しています。.mp3]	(<b>物質</b>) 科学者たちは新しい物質の発見を追求しています。<br> かがくしゃたちはあたらしいぶっしつのはっけんをついきゅうしています。 <br> Scientists are pursuing the discovery of new materials.	
土曜	[sound:k-3063_土曜.mp3]<br>どよう <br> Saturday
Saturday	<b>土曜<b> <br> どよう <br>[sound:k-3063_土曜.mp3]
[sound:k-3063_土曜.mp3]	Saturday<br> <b>土曜</b> <br> (どよう)
(<b>理念</b>) この団体の理念は社会貢献です。	[sound:s-3063_この団体の理念は社会貢献です。.mp3] <br> このだんたいのりねんはしゃかいこうけんです。 <br>  The organization's principle is social contribution.
[sound:s-3053_彼は実質的なリーダーシップを発揮しています。.mp3]	(<b>実質的</b>) 彼は実質的なリーダーシップを発揮しています。<br> かれはじっしつてきなりーだーしっぷをはっきしています。 <br> He demonstrates substantial leadership.	
国土	[sound:k-3064_国土.mp3]<br>こくど <br> country, territory, domain, realm
country, territory, domain, realm	<b>国土<b> <br> こくど <br>[sound:k-3064_国土.mp3]
[sound:k-3064_国土.mp3]	country, territory, domain, realm<br> <b>国土</b> <br> (こくど)
(<b>念頭</b>) 彼はいつも成功を念頭に置いている。	[sound:s-3064_彼はいつも成功を念頭に置いている。.mp3] <br> かれはいつもせいこうをねんとうにおいている。 <br>  He always keeps success in mind.
[sound:s-3054_彼女は弱い免疫体質を持っています。.mp3]	(<b>体質</b>) 彼女は弱い免疫体質を持っています。<br> かのじょはよわいめんえきたいしつをもっています。 <br> She has a weak immune system.	
土俵	[sound:k-3065_土俵.mp3]<br>どひょう <br> arena, esp. in sumo; forum (e.g. for discussion); sandbag, gabion
arena, esp. in sumo; forum (e.g. for discussion); sandbag, gabion	<b>土俵<b> <br> どひょう <br>[sound:k-3065_土俵.mp3]
[sound:k-3065_土俵.mp3]	arena, esp. in sumo; forum<br> <b>e.g. for discussion); sandbag, gabion (土俵</b> <br> (どひょう)
(<b>概念</b>) 自由とは個人の権利に関する概念です。	[sound:s-3065_自由とは個人の権利に関する概念です。.mp3] <br> じゆうとはこじんのけんりにかんするがいねんです。 <br>  Freedom is a concept related to individual rights.
[sound:s-3055_議員は討論中に質疑を行った。.mp3]	(<b>質疑</b>) 議員は討論中に質疑を行った。<br> ぎいんはとうろんちゅうにしつぎをおこなった。 <br> The parliament member conducted questioning during the debate.	
土木	[sound:k-3066_土木.mp3]<br>どぼく <br> public works
public works	<b>土木<b> <br> どぼく <br>[sound:k-3066_土木.mp3]
[sound:k-3066_土木.mp3]	public works<br> <b>土木</b> <br> (どぼく)
(<b>記念日</b>) 私たちは結婚記念日を祝っています。	[sound:s-3066_私たちは結婚記念日を祝っています。.mp3] <br> わたしたちはけっこんきねんびをいわっています。 <br>  We are celebrating our wedding anniversary.
[sound:s-3056_問題の本質を理解することが重要です。.mp3]	(<b>本質</b>) 問題の本質を理解することが重要です。<br> もんだいのほんしつをりかいすることがじゅうようです。 <br> Understanding the essence of the problem is important.	
全土	[sound:k-3067_全土.mp3]<br>ぜんど <br> the whole nation (land, country)
the whole nation (land, country)	<b>全土<b> <br> ぜんど <br>[sound:k-3067_全土.mp3]
[sound:k-3067_全土.mp3]	the whole nation<br> <b>land, country) (全土</b> <br> (ぜんど)
(<b>信念</b>) 彼は自分の信念に忠実です。	[sound:s-3067_彼は自分の信念に忠実です。.mp3] <br> かれはじぶんのしんねんにちゅうじつです。 <br>  He is faithful to his beliefs.
[sound:s-3057_テロリストたちは人質を取った。.mp3]	(<b>人質</b>) テロリストたちは人質を取った。<br> てろりすとたちはひとじちをとった。 <br> The terrorists took hostages.	
土壌	[sound:k-3068_土壌.mp3]<br>どじょう <br> soil
soil	<b>土壌<b> <br> どじょう <br>[sound:k-3068_土壌.mp3]
[sound:k-3068_土壌.mp3]	soil<br> <b>土壌</b> <br> (どじょう)
(<b>断念</b>) 彼は夢を諦めることを決心した。	[sound:s-3068_彼は夢を諦めることを決心した。.mp3] <br> かれはゆめをあきらめることをけっしんした。 <br>  He decided to give up on his dream.
[sound:s-3058_この製品の品質は非常に高いです。.mp3]	(<b>品質</b>) この製品の品質は非常に高いです。<br> このせいひんのひんしつはひじょうにたかいです。 <br> The quality of this product is very high.	
風土	[sound:k-3069_風土.mp3]<br>ふうど <br> natural features, topography, climate, spiritual features
natural features, topography, climate, spiritual features	<b>風土<b> <br> ふうど <br>[sound:k-3069_風土.mp3]
[sound:k-3069_風土.mp3]	natural features, topography, climate, spiritual features<br> <b>風土</b> <br> (ふうど)
(<b>期待</b>) 彼は大会に向けて高い期待を寄せている。	[sound:s-3069_彼は大会に向けて高い期待を寄せている。.mp3] <br> かれはたいかいにむけてたかいきたいをよせている。 <br> He has high expectations for the tournament.
[sound:s-3059_彼は成功への強い念を持っている。.mp3]	(<b>念</b>) 彼は成功への強い念を持っている。<br> かれはせいこうへのつよいねんをもっている。 <br> He has a strong determination for success.	
与党	[sound:k-3070_与党.mp3]<br>よとう <br> government party, (ruling) party in power, government
government party, (ruling) party in power, government	<b>与党<b> <br> よとう <br>[sound:k-3070_与党.mp3]
[sound:k-3070_与党.mp3]	government party,<br> <b>ruling) party in power, government (与党</b> <br> (よとう)
(<b>招待</b>) 彼女は友達をパーティーに招待した。	[sound:s-3070_彼女は友達をパーティーに招待した。.mp3] <br> かのじょはともだちをパーティーにしょうたいした。 <br> She invited her friends to the party.
[sound:s-3060_このイベントは学校の創立記念日を祝うものです。.mp3]	(<b>記念</b>) このイベントは学校の創立記念日を祝うものです。<br> このイベントはがっこうのそうりつきねんびをいわうものです。 <br> This event celebrates the school's founding anniversary.	
与野党	[sound:k-3071_与野党.mp3]<br>よやとう <br> (political) parties in and out of power, majority and minority parties
(political) parties in and out of power, majority and minority parties	<b>与野党<b> <br> よやとう <br>[sound:k-3071_与野党.mp3]
[sound:k-3071_与野党.mp3]	(political) parties in and out of power, majority and minority parties<br> <b>与野党</b> <br> (よやとう)
(<b>待遇</b>) この会社の待遇はとても良いです。	[sound:s-3071_この会社の待遇はとても良いです。.mp3] <br> このかいしゃのたいぐうはとてもいいです。 <br> The treatment at this company is very good.
[sound:s-3061_その問題について多くの人が懸念を抱いている。.mp3]	(<b>懸念</b>) その問題について多くの人が懸念を抱いている。<br> そのもんだいについておおくのひとがけねんをだいている。 <br> Many people have concerns about the issue.	
関与	[sound:k-3072_関与.mp3]<br>かんよ <br> participation, taking part in, participating in, being concerned in
participation, taking part in, participating in, being concerned in	<b>関与<b> <br> かんよ <br>[sound:k-3072_関与.mp3]
[sound:k-3072_関与.mp3]	participation, taking part in, participating in, being concerned in<br> <b>関与</b> <br> (かんよ)
(<b>待ち</b>) 彼女は友達を待っています。	[sound:s-3072_彼女は友達を待っています。.mp3] <br> かのじょはともだちをまっています。 <br> She is waiting for her friend.
[sound:s-3062_会議に参加できなくて残念です。.mp3]	(<b>残念</b>) 会議に参加できなくて残念です。<br> かいぎにさんかできなくてざんねんです。 <br> It's regrettable that I can't attend the meeting.	
給与	[sound:k-3073_給与.mp3]<br>きゅうよ <br> pay, salary, wages, allowance, grant, supply
pay, salary, wages, allowance, grant, supply	<b>給与<b> <br> きゅうよ <br>[sound:k-3073_給与.mp3]
[sound:k-3073_給与.mp3]	pay, salary, wages, allowance, grant, supply<br> <b>給与</b> <br> (きゅうよ)
(<b>接待</b>) 社長は重要な客を接待している。	[sound:s-3073_社長は重要な客を接待している。.mp3] <br> しゃちょうはじゅうようなきゃくをせったいしている。 <br> The president is entertaining an important client.
[sound:s-3063_この団体の理念は社会貢献です。.mp3]	(<b>理念</b>) この団体の理念は社会貢献です。<br> このだんたいのりねんはしゃかいこうけんです。 <br> The organization's principle is social contribution.	
供与	[sound:k-3074_供与.mp3]<br>きょうよ <br> giving, provision, furnishing
giving, provision, furnishing	<b>供与<b> <br> きょうよ <br>[sound:k-3074_供与.mp3]
[sound:k-3074_供与.mp3]	giving, provision, furnishing<br> <b>供与</b> <br> (きょうよ)
(<b>期待感</b>) 彼の目からは期待感がにじみ出ている。	[sound:s-3074_彼の目からは期待感がにじみ出ている。.mp3] <br> かれのめからはきたいかんがにじみでている。 <br> Expectation is evident in his eyes.
[sound:s-3064_彼はいつも成功を念頭に置いている。.mp3]	(<b>念頭</b>) 彼はいつも成功を念頭に置いている。<br> かれはいつもせいこうをねんとうにおいている。 <br> He always keeps success in mind.	
投与	[sound:k-3075_投与.mp3]<br>とうよ <br> prescribing medicine, administering (medicine)
prescribing medicine, administering (medicine)	<b>投与<b> <br> とうよ <br>[sound:k-3075_投与.mp3]
[sound:k-3075_投与.mp3]	prescribing medicine, administering<br> <b>medicine) (投与</b> <br> (とうよ)
(<b>虐待</b>) 子供に対する虐待は許されません。	[sound:s-3075_子供に対する虐待は許されません。.mp3] <br> こどもにたいするぎゃくたいはゆるされません。 <br> Abuse against children is not tolerated.
[sound:s-3065_自由とは個人の権利に関する概念です。.mp3]	(<b>概念</b>) 自由とは個人の権利に関する概念です。<br> じゆうとはこじんのけんりにかんするがいねんです。 <br> Freedom is a concept related to individual rights.	
付与	[sound:k-3076_付与.mp3]<br>ふよ <br> grant, allowance, endowment, bestowal, assignment, conferment
grant, allowance, endowment, bestowal, assignment, conferment	<b>付与<b> <br> ふよ <br>[sound:k-3076_付与.mp3]
[sound:k-3076_付与.mp3]	grant, allowance, endowment, bestowal, assignment, conferment<br> <b>付与</b> <br> (ふよ)
(<b>待つ</b>) 彼はバスを待っています。	[sound:s-3076_彼はバスを待っています。.mp3] <br> かれはバスをまっています。 <br> He is waiting for the bus.
[sound:s-3066_私たちは結婚記念日を祝っています。.mp3]	(<b>記念日</b>) 私たちは結婚記念日を祝っています。<br> わたしたちはけっこんきねんびをいわっています。 <br> We are celebrating our wedding anniversary.	
参与	[sound:k-3077_参与.mp3]<br>さんよ <br> participation, taking part; consultant, councillor, adviser
participation, taking part; consultant, councillor, adviser	<b>参与<b> <br> さんよ <br>[sound:k-3077_参与.mp3]
[sound:k-3077_参与.mp3]	participation, taking part; consultant, councillor, adviser<br> <b>参与</b> <br> (さんよ)
(<b>待機</b>) チームは準備のために待機しています。	[sound:s-3077_チームは準備のために待機しています。.mp3] <br> ちーむはじゅんびのためにたいきしています。 <br> The team is on standby for preparation.
[sound:s-3067_彼は自分の信念に忠実です。.mp3]	(<b>信念</b>) 彼は自分の信念に忠実です。<br> かれはじぶんのしんねんにちゅうじつです。 <br> He is faithful to his beliefs.	
賞与	[sound:k-3078_賞与.mp3]<br>しょうよ <br> reward, prize, bonus
reward, prize, bonus	<b>賞与<b> <br> しょうよ <br>[sound:k-3078_賞与.mp3]
[sound:k-3078_賞与.mp3]	reward, prize, bonus<br> <b>賞与</b> <br> (しょうよ)
(<b>待望</b>) 彼の帰りを待望しています。	[sound:s-3078_彼の帰りを待望しています。.mp3] <br> かれのかえりをたいぼうしています。 <br> I eagerly await his return.
[sound:s-3068_彼は夢を諦めることを決心した。.mp3]	(<b>断念</b>) 彼は夢を諦めることを決心した。<br> かれはゆめをあきらめることをけっしんした。 <br> He decided to give up on his dream.	
贈与	[sound:k-3079_贈与.mp3]<br>ぞうよ <br> donation, presentation
donation, presentation	<b>贈与<b> <br> ぞうよ <br>[sound:k-3079_贈与.mp3]
[sound:k-3079_贈与.mp3]	donation, presentation<br> <b>贈与</b> <br> (ぞうよ)
(<b>試み</b>) 彼は新しい方法を試みてみました。	[sound:s-3079_彼は新しい方法を試みてみました。.mp3] <br> かれはあたらしいほうほうをこころみてみました。 <br> He tried a new approach.
[sound:s-3069_彼は大会に向けて高い期待を寄せている。.mp3]	(<b>期待</b>) 彼は大会に向けて高い期待を寄せている。<br> かれはたいかいにむけてたかいきたいをよせている。 <br>He has high expectations for the tournament.	
急	[sound:k-3080_急.mp3]<br>きゅう <br> urgent, sudden, abrupt; sharp, steep, precipitous; rapid, swift, fast; emergency, crisis
urgent, sudden, abrupt; sharp, steep, precipitous; rapid, swift, fast; emergency, crisis	<b>急<b> <br> きゅう <br>[sound:k-3080_急.mp3]
[sound:k-3080_急.mp3]	urgent, sudden, abrupt; sharp, steep, precipitous; rapid, swift, fast; emergency, crisis<br> <b>急</b> <br> (きゅう)
(<b>試合</b>) 明日の試合に勝つために頑張ろう。	[sound:s-3080_明日の試合に勝つために頑張ろう。.mp3] <br> あしたのしあいにかつためにがんばろう。 <br> Let's do our best to win tomorrow's match.
[sound:s-3070_彼女は友達をパーティーに招待した。.mp3]	(<b>招待</b>) 彼女は友達をパーティーに招待した。<br> かのじょはともだちをパーティーにしょうたいした。 <br>She invited her friends to the party.	
急いで	[sound:k-3081_急いで.mp3]<br>いそいで <br> hurriedly
hurriedly	<b>急いで<b> <br> いそいで <br>[sound:k-3081_急いで.mp3]
[sound:k-3081_急いで.mp3]	hurriedly<br> <b>急いで</b> <br> (いそいで)
(<b>試験</b>) 来週は重要な試験があります。	[sound:s-3081_来週は重要な試験があります。.mp3] <br> らいしゅうはじゅうようなしけんがあります。 <br> There is an important exam next week.
[sound:s-3071_この会社の待遇はとても良いです。.mp3]	(<b>待遇</b>) この会社の待遇はとても良いです。<br> このかいしゃのたいぐうはとてもいいです。 <br>The treatment at this company is very good.	
急きょ	[sound:k-3082_急きょ.mp3]<br>きゅうきょ <br> hurriedly, in a hurry
hurriedly, in a hurry	<b>急きょ<b> <br> きゅうきょ <br>[sound:k-3082_急きょ.mp3]
[sound:k-3082_急きょ.mp3]	hurriedly, in a hurry<br> <b>急きょ</b> <br> (きゅうきょ)
(<b>入試</b>) 彼は入試に合格しました。	[sound:s-3082_彼は入試に合格しました。.mp3] <br> かれはにゅうしにごうかくしました。 <br> He passed the entrance exam.
[sound:s-3072_彼女は友達を待っています。.mp3]	(<b>待ち</b>) 彼女は友達を待っています。<br> かのじょはともだちをまっています。 <br>She is waiting for her friend.	
緊急	[sound:k-3083_緊急.mp3]<br>きんきゅう <br> urgent, pressing, emergency
urgent, pressing, emergency	<b>緊急<b> <br> きんきゅう <br>[sound:k-3083_緊急.mp3]
[sound:k-3083_緊急.mp3]	urgent, pressing, emergency<br> <b>緊急</b> <br> (きんきゅう)
(<b>試算</b>) プロジェクトの試算を行います。	[sound:s-3083_プロジェクトの試算を行います。.mp3] <br> プロジェクトのしさんをおこないます。 <br> We will make a project estimate.
[sound:s-3073_社長は重要な客を接待している。.mp3]	(<b>接待</b>) 社長は重要な客を接待している。<br> しゃちょうはじゅうようなきゃくをせったいしている。 <br>The president is entertaining an important client.	
急速	[sound:k-3084_急速.mp3]<br>きゅうそく <br> rapid (e.g. progress)
rapid (e.g. progress)	<b>急速<b> <br> きゅうそく <br>[sound:k-3084_急速.mp3]
[sound:k-3084_急速.mp3]	rapid<br> <b>e.g. progress) (急速</b> <br> (きゅうそく)
(<b>試案</b>) 彼の試案はとても興味深いです。	[sound:s-3084_彼の試案はとても興味深いです。.mp3] <br> かれのしあんはとてもきょうみぶかいです。 <br> His proposal is very interesting.
[sound:s-3074_彼の目からは期待感がにじみ出ている。.mp3]	(<b>期待感</b>) 彼の目からは期待感がにじみ出ている。<br> かれのめからはきたいかんがにじみでている。 <br>Expectation is evident in his eyes.	
早急	[sound:k-3085_早急.mp3]<br>さっきゅう, そうきゅう <br> urgent
urgent	<b>早急<b> <br> さっきゅう, そうきゅう <br>[sound:k-3085_早急.mp3]
[sound:k-3085_早急.mp3]	urgent<br> <b>早急</b> <br> (さっきゅう, そうきゅう)
(<b>試練</b>) 困難な試練に立ち向かう。	[sound:s-3085_困難な試練に立ち向かう。.mp3] <br> こんなんなしれんにたちむかう。 <br> Confronting difficult trials.
[sound:s-3075_子供に対する虐待は許されません。.mp3]	(<b>虐待</b>) 子供に対する虐待は許されません。<br> こどもにたいするぎゃくたいはゆるされません。 <br>Abuse against children is not tolerated.	
急激	[sound:k-3086_急激.mp3]<br>きゅうげき <br> sudden, precipitous, radical
sudden, precipitous, radical	<b>急激<b> <br> きゅうげき <br>[sound:k-3086_急激.mp3]
[sound:k-3086_急激.mp3]	sudden, precipitous, radical<br> <b>急激</b> <br> (きゅうげき)
(<b>試す</b>) この新しいアプリを試してみてください。	[sound:s-3086_この新しいアプリを試してみてください。.mp3] <br> このあたらしいアプリをためしてみてください。 <br> Please try this new app.
[sound:s-3076_彼はバスを待っています。.mp3]	(<b>待つ</b>) 彼はバスを待っています。<br> かれはバスをまっています。 <br>He is waiting for the bus.	
急性	[sound:k-3087_急性.mp3]<br>きゅうせい <br> acute (e.g. illness)
acute (e.g. illness)	<b>急性<b> <br> きゅうせい <br>[sound:k-3087_急性.mp3]
[sound:k-3087_急性.mp3]	acute<br> <b>e.g. illness) (急性</b> <br> (きゅうせい)
(<b>試作</b>) 製品の試作を開始します。	[sound:s-3087_製品の試作を開始します。.mp3] <br> せいひんのしさくをかいしします。 <br> We will start the trial production of the product.
[sound:s-3077_チームは準備のために待機しています。.mp3]	(<b>待機</b>) チームは準備のために待機しています。<br> ちーむはじゅんびのためにたいきしています。 <br>The team is on standby for preparation.	
急進	[sound:k-3088_急進.mp3]<br>きゅうしん <br> rapid progress, radical
rapid progress, radical	<b>急進<b> <br> きゅうしん <br>[sound:k-3088_急進.mp3]
[sound:k-3088_急進.mp3]	rapid progress, radical<br> <b>急進</b> <br> (きゅうしん)
(<b>試金石</b>) この問題が彼の忠誠心の試金石です。	[sound:s-3088_この問題が彼の忠誠心の試金石です。.mp3] <br> このもんだいがかれのちゅうせいしんのしきんせきです。 <br> This issue is the touchstone of his loyalty.
[sound:s-3078_彼の帰りを待望しています。.mp3]	(<b>待望</b>) 彼の帰りを待望しています。<br> かれのかえりをたいぼうしています。 <br>I eagerly await his return.	
急増	[sound:k-3089_急増.mp3]<br>きゅうぞう <br> explosion, proliferation, surge
explosion, proliferation, surge	<b>急増<b> <br> きゅうぞう <br>[sound:k-3089_急増.mp3]
[sound:k-3089_急増.mp3]	explosion, proliferation, surge<br> <b>急増</b> <br> (きゅうぞう)
(<b>家族</b>) 家族でピクニックに行きます。	[sound:s-3089_家族でピクニックに行きます。.mp3] <br> かぞくでピクニックにいきます。 <br> We're going on a picnic with the family.
[sound:s-3079_彼は新しい方法を試みてみました。.mp3]	(<b>試み</b>) 彼は新しい方法を試みてみました。<br> かれはあたらしいほうほうをこころみてみました。 <br>He tried a new approach.	
禁止	[sound:k-3090_禁止.mp3]<br>きんし <br> prohibition, inhibition, ban
prohibition, inhibition, ban	<b>禁止<b> <br> きんし <br>[sound:k-3090_禁止.mp3]
[sound:k-3090_禁止.mp3]	prohibition, inhibition, ban<br> <b>禁止</b> <br> (きんし)
(<b>族</b>) 彼は先住民族の一員です。	[sound:s-3090_彼は先住民族の一員です。.mp3] <br> かれはせんじゅうみんぞくのいちいんです。 <br> He is a member of an indigenous tribe.
[sound:s-3080_明日の試合に勝つために頑張ろう。.mp3]	(<b>試合</b>) 明日の試合に勝つために頑張ろう。<br> あしたのしあいにかつためにがんばろう。 <br>Let's do our best to win tomorrow's match.	
停止	[sound:k-3091_停止.mp3]<br>ていし <br> suspension, interruption, stoppage, ban, standstill, halt, hang-up, deadlock, stalemate, abeyance
suspension, interruption, stoppage, ban, standstill, halt, hang-up, deadlock, stalemate, abeyance	<b>停止<b> <br> ていし <br>[sound:k-3091_停止.mp3]
[sound:k-3091_停止.mp3]	suspension, interruption, stoppage, ban, standstill, halt, hang-up, deadlock, stalemate, abeyance<br> <b>停止</b> <br> (ていし)
(<b>民族</b>) その国には多様な民族が暮らしています。	[sound:s-3091_その国には多様な民族が暮らしています。.mp3] <br> そのくににはたようなみんぞくがくらしています。 <br> Various ethnic groups live in that country.
[sound:s-3081_来週は重要な試験があります。.mp3]	(<b>試験</b>) 来週は重要な試験があります。<br> らいしゅうはじゅうようなしけんがあります。 <br>There is an important exam next week.	
防止	[sound:k-3092_防止.mp3]<br>ぼうし <br> prevention, check
prevention, check	<b>防止<b> <br> ぼうし <br>[sound:k-3092_防止.mp3]
[sound:k-3092_防止.mp3]	prevention, check<br> <b>防止</b> <br> (ぼうし)
(<b>遺族</b>) 戦争で亡くなった兵士の遺族に支援を提供します。	[sound:s-3092_戦争で亡くなった兵士の遺族に支援を提供します。.mp3] <br> せんそうでなくなったへいしのいぞくにしえんをていきゅうします。 <br> We provide support to the families of soldiers who died in war.
[sound:s-3082_彼は入試に合格しました。.mp3]	(<b>入試</b>) 彼は入試に合格しました。<br> かれはにゅうしにごうかくしました。 <br>He passed the entrance exam.	
中止	[sound:k-3093_中止.mp3]<br>ちゅうし <br> suspension, stoppage, discontinuance, interruption
suspension, stoppage, discontinuance, interruption	<b>中止<b> <br> ちゅうし <br>[sound:k-3093_中止.mp3]
[sound:k-3093_中止.mp3]	suspension, stoppage, discontinuance, interruption<br> <b>中止</b> <br> (ちゅうし)
(<b>民族主義</b>) 彼は強い民族主義者です。	[sound:s-3093_彼は強い民族主義者です。.mp3] <br> かれはつよいみんぞくしゅぎしゃです。 <br> He is a strong nationalist.
[sound:s-3083_プロジェクトの試算を行います。.mp3]	(<b>試算</b>) プロジェクトの試算を行います。<br> プロジェクトのしさんをおこないます。 <br>We will make a project estimate.	
廃止	[sound:k-3094_廃止.mp3]<br>はいし <br> abolition, repeal
abolition, repeal	<b>廃止<b> <br> はいし <br>[sound:k-3094_廃止.mp3]
[sound:k-3094_廃止.mp3]	abolition, repeal<br> <b>廃止</b> <br> (はいし)
(<b>親族</b>) 葬儀には親族だけを招待します。	[sound:s-3094_葬儀には親族だけを招待します。.mp3] <br> そうぎにはしんぞくだけをしょうたいします。 <br> Only close relatives are invited to the funeral.
[sound:s-3084_彼の試案はとても興味深いです。.mp3]	(<b>試案</b>) 彼の試案はとても興味深いです。<br> かれのしあんはとてもきょうみぶかいです。 <br>His proposal is very interesting.	
歯止め	[sound:k-3095_歯止め.mp3]<br>はどめ <br> brake, skid, pawl; restraint, curtailment, self-imposed limit, check
brake, skid, pawl; restraint, curtailment, self-imposed limit, check	<b>歯止め<b> <br> はどめ <br>[sound:k-3095_歯止め.mp3]
[sound:k-3095_歯止め.mp3]	brake, skid, pawl; restraint, curtailment, self-imposed limit, check<br> <b>歯止め</b> <br> (はどめ)
(<b>一族</b>) 彼女は昔からの名門の一族です。	[sound:s-3095_彼女は昔からの名門の一族です。.mp3] <br> かのじょはむかしからのめいもんのいちぞくです。 <br> She is from an ancient noble family.
[sound:s-3085_困難な試練に立ち向かう。.mp3]	(<b>試練</b>) 困難な試練に立ち向かう。<br> こんなんなしれんにたちむかう。 <br>Confronting difficult trials.	
受け止める	[sound:k-3096_受け止める.mp3]<br>うけとめる <br> to catch, to stop the blow, to react to, to take
to catch, to stop the blow, to react to, to take	<b>受け止める<b> <br> うけとめる <br>[sound:k-3096_受け止める.mp3]
[sound:k-3096_受け止める.mp3]	to catch, to stop the blow, to react to, to take<br> <b>受け止める</b> <br> (うけとめる)
(<b>部族</b>) その地域には複数の部族が住んでいる。	[sound:s-3096_その地域には複数の部族が住んでいる。.mp3] <br> そのちいきにはふくすうのぶぞくがすんでいる。 <br> Several tribes live in that region.
[sound:s-3086_この新しいアプリを試してみてください。.mp3]	(<b>試す</b>) この新しいアプリを試してみてください。<br> このあたらしいアプリをためしてみてください。 <br>Please try this new app.	
阻止	[sound:k-3097_阻止.mp3]<br>そし <br> obstruction, check, hindrance, prevention, interdiction
obstruction, check, hindrance, prevention, interdiction	<b>阻止<b> <br> そし <br>[sound:k-3097_阻止.mp3]
[sound:k-3097_阻止.mp3]	obstruction, check, hindrance, prevention, interdiction<br> <b>阻止</b> <br> (そし)
(<b>家族計画</b>) 彼らは家族計画について話し合っています。	[sound:s-3097_彼らは家族計画について話し合っています。.mp3] <br> かれらはかぞくけいかくについてはなしあっています。 <br> They are discussing family planning.
[sound:s-3087_製品の試作を開始します。.mp3]	(<b>試作</b>) 製品の試作を開始します。<br> せいひんのしさくをかいしします。 <br>We will start the trial production of the product.	
止まる	[sound:k-3098_止まる.mp3]<br>とまる, とどまる <br> to stop, to halt; to remain, to abide, to stay (in the one place); to come to a halt; to be limited to
to stop, to halt; to remain, to abide, to stay (in the one place); to come to a halt; to be limited to	<b>止まる<b> <br> とまる, とどまる <br>[sound:k-3098_止まる.mp3]
[sound:k-3098_止まる.mp3]	to stop, to halt; to remain, to abide, to stay<br> <b>in the one place); to come to a halt; to be limited to (止まる</b> <br> (とまる, とどまる)
(<b>貴族</b>) 彼は貴族の家系に生まれました。	[sound:s-3098_彼は貴族の家系に生まれました。.mp3] <br> かれはきぞくのかけいにうまれました。 <br> He was born into a noble family.
[sound:s-3088_この問題が彼の忠誠心の試金石です。.mp3]	(<b>試金石</b>) この問題が彼の忠誠心の試金石です。<br> このもんだいがかれのちゅうせいしんのしきんせきです。 <br>This issue is the touchstone of his loyalty.	
差し止め	[sound:k-3099_差し止め.mp3]<br>さしとめ <br> prohibition, ban, suspension
prohibition, ban, suspension	<b>差し止め<b> <br> さしとめ <br>[sound:k-3099_差し止め.mp3]
[sound:k-3099_差し止め.mp3]	prohibition, ban, suspension<br> <b>差し止め</b> <br> (さしとめ)
(<b>対象</b>) このプログラムは子供たちを対象としています。	[sound:s-3099_このプログラムは子供たちを対象としています。.mp3] <br> このプログラムはこどもたちをたいしょうとしています。 <br> This program targets children.
