the same day	<b>同日</b> <br> どうじつ <br> [sound:4c-k-同日.mp3]
Japan-America	<b>日米</b> <br> にちべい <br> [sound:4c-k-日米.mp3]
Japanese person, Japanese people	<b>日本人</b> <br> にほんじん, にっぽんじん <br> [sound:4c-k-日本人.mp3]
one; for one thing (often used in itemized lists); (after a noun) only; (with a verb in negative form) (not) even; just (i.e. "just try it")	<b>一つ</b> <br> ひとつ <br> [sound:4c-k-一つ.mp3]
January	<b>一月</b> <br> いちがつ <br> [sound:4c-k-一月.mp3]
general, liberal, universal, ordinary, average	<b>一般</b> <br> いっぱん <br> [sound:4c-k-一般.mp3]
best, first, number one; game, round, bout, fall, event (in a meet)	<b>一番</b> <br> いちばん <br> [sound:4c-k-一番.mp3]
country, (the) state; region; province (of Japan); home (i.e. hometown, home country); land, earth	<b>国</b> <br> くに <br> [sound:4c-k-国.mp3]
foreign country	<b>外国</b> <br> がいこく <br> [sound:4c-k-外国.mp3]
foreigner	<b>外国人</b> <br> がいこくじん <br> [sound:4c-k-外国人.mp3]
(South) Korea	<b>韓国</b> <br> かんこく <br> [sound:4c-k-韓国.mp3]
committee, commission, board, panel, committee meeting	<b>委員会</b> <br> いいんかい <br> [sound:4c-k-委員会.mp3]
member, the membership	<b>会員</b> <br> かいいん <br> [sound:4c-k-会員.mp3]
meeting, conference, session, assembly, council, convention, congress	<b>会議</b> <br> かいぎ <br> [sound:4c-k-会議.mp3]
interview, audience	<b>会見</b> <br> かいけん <br> [sound:4c-k-会見.mp3]
foreigner	<b>外国人</b> <br> がいこくじん <br> [sound:4c-k-外国人.mp3]
individual, private person, personal, private	<b>個人</b> <br> こじん <br> [sound:4c-k-個人.mp3]
three people	<b>三人</b> <br> さんにん, みたり <br> [sound:4c-k-三人.mp3]
human being, man, person; character (of a person)	<b>人間</b> <br> にんげん <br> [sound:4c-k-人間.mp3]
year; age	<b>年</b> <br> とし <br> [sound:4c-k-年.mp3]
last year	<b>昨年</b> <br> さくねん <br> [sound:4c-k-昨年.mp3]
the preceding year, the previous year, last year	<b>前年</b> <br> ぜんねん <br> [sound:4c-k-前年.mp3]
year (period of)	<b>年間</b> <br> ねんかん <br> [sound:4c-k-年間.mp3]
big, large, great	<b>大きな</b> <br> おおきな <br> [sound:4c-k-大きな.mp3]
magnification, enlargement, expansion	<b>拡大</b> <br> かくだい <br> [sound:4c-k-拡大.mp3]
greatest, largest, maximum	<b>最大</b> <br> さいだい <br> [sound:4c-k-最大.mp3]
very, much, greatly, a lot of	<b>大いに</b> <br> おおいに <br> [sound:4c-k-大いに.mp3]
10, ten	<b>十</b> <br> じゅう, と, とお <br> [sound:4c-k-十.mp3]
11, eleven; Hodgson's hawk-cuckoo (Cuculus fugax)	<b>十一</b> <br> じゅういち, ジュウイチ <br> [sound:4c-k-十一.mp3]
November	<b>十一月</b> <br> じゅういちがつ <br> [sound:4c-k-十一月.mp3]
19, nineteen	<b>十九</b> <br> じゅうきゅう <br> [sound:4c-k-十九.mp3]
two	<b>二</b> <br> に, ふた, ふ, ふう <br> [sound:4c-k-二.mp3]
two	<b>二つ</b> <br> ふたつ <br> [sound:4c-k-二つ.mp3]
12, twelve	<b>十二</b> <br> じゅうに <br> [sound:4c-k-十二.mp3]
December	<b>十二月</b> <br> じゅうにがつ <br> [sound:4c-k-十二月.mp3]
foundation, basis, standard	<b>基本</b> <br> きほん <br> [sound:4c-k-基本.mp3]
Japanese person, Japanese people	<b>日本人</b> <br> にほんじん, にっぽんじん <br> [sound:4c-k-日本人.mp3]
head office, main office, headquarters; main shrine; this company, this shrine	<b>本社</b> <br> ほんしゃ, ほんじゃ <br> [sound:4c-k-本社.mp3]
headquarters	<b>本部</b> <br> ほんぶ <br> [sound:4c-k-本部.mp3]
centre, central, center, middle	<b>中央</b> <br> ちゅうおう <br> [sound:4c-k-中央.mp3]
China; South-west most region of Honshu, middle of a country, the Hiroshima area	<b>中国</b> <br> ちゅうごく <br> [sound:4c-k-中国.mp3]
center, centre, middle, heart, core, focus, pivot, emphasis, balance	<b>中心</b> <br> ちゅうしん <br> [sound:4c-k-中心.mp3]
among (other things), inter alia; above all (else)	<b>中でも</b> <br> なかでも <br> [sound:4c-k-中でも.mp3]
chief, head	<b>長</b> <br> ちょう, おさ <br> [sound:4c-k-長.mp3]
committee chairman	<b>委員長</b> <br> いいんちょう <br> [sound:4c-k-委員長.mp3]
president (of a society), chairman	<b>会長</b> <br> かいちょう <br> [sound:4c-k-会長.mp3]
chairman, speaker (e.g. of assembly), president (e.g. of council, senate, etc.), moderator (e.g. of a newsgroup)	<b>議長</b> <br> ぎちょう <br> [sound:4c-k-議長.mp3]
to take out, to get out; to put out, to reveal, to show; to submit (e.g. thesis), to turn in; to publish, to make public; to send (e.g. letter); to produce (a sound), to start (fire); to serve (food); to begin	<b>出す</b> <br> だす <br> [sound:4c-k-出す.mp3]
person's origin (town, city, country, etc.); institution from which one graduated; director in charge of employee relations	<b>出身</b> <br> しゅっしん <br> [sound:4c-k-出身.mp3]
export; efferent (medical)	<b>輸出</b> <br> ゆしゅつ, しゅしゅつ <br> [sound:4c-k-輸出.mp3]
(stage) appearance, participation, performance	<b>出場</b> <br> しゅつじょう <br> [sound:4c-k-出場.mp3]
three	<b>三</b> <br> さん, み <br> [sound:4c-k-三.mp3]
three	<b>三つ</b> <br> みっつ <br> [sound:4c-k-三つ.mp3]
March	<b>三月</b> <br> さんがつ <br> [sound:4c-k-三月.mp3]
three people	<b>三人</b> <br> さんにん, みたり <br> [sound:4c-k-三人.mp3]
simultaneous(ly), concurrent, same time, synchronous, together	<b>同時</b> <br> どうじ <br> [sound:4c-k-同時.mp3]
the same firm	<b>同社</b> <br> どうしゃ <br> [sound:4c-k-同社.mp3]
the same day	<b>同日</b> <br> どうじつ <br> [sound:4c-k-同日.mp3]
doing together (as equals), sharing, common (land, etc.), joint (statement, etc.), cooperation, co-operation, collaboration, association	<b>共同</b> <br> きょうどう <br> [sound:4c-k-共同.mp3]
time, hour; occasion, moment	<b>時</b> <br> とき <br> [sound:4c-k-時.mp3]
time; hours	<b>時間</b> <br> じかん <br> [sound:4c-k-時間.mp3]
time, season, period; soon, shortly	<b>時期</b> <br> じき <br> [sound:4c-k-時期.mp3]
period, epoch, era, age; the times, those days; oldness, ancientness, antiquity; antique, period piece	<b>時代</b> <br> じだい <br> [sound:4c-k-時代.mp3]
rule, government	<b>政</b> <br> まつりごと <br> [sound:4c-k-政.mp3]
administration	<b>行政</b> <br> ぎょうせい <br> [sound:4c-k-行政.mp3]
financial affairs, public finance	<b>財政</b> <br> ざいせい <br> [sound:4c-k-財政.mp3]
political world	<b>政界</b> <br> せいかい <br> [sound:4c-k-政界.mp3]
thing, matter, fact, circumstances, business, reason, experience	<b>事</b> <br> こと <br> [sound:4c-k-事.mp3]
executive secretary, coordinator, organizer, person in charge of making arrangements	<b>幹事</b> <br> かんじ <br> [sound:4c-k-幹事.mp3]
article, news story, report, account	<b>記事</b> <br> きじ <br> [sound:4c-k-記事.mp3]
military affairs	<b>軍事</b> <br> ぐんじ <br> [sound:4c-k-軍事.mp3]
for one's self, personally	<b>自ら</b> <br> みずから <br> [sound:4c-k-自ら.mp3]
self-defence force, self-defense force; Japan Self-Defence Force, JSDF	<b>自衛隊</b> <br> じえいたい <br> [sound:4c-k-自衛隊.mp3]
by oneself, personally	<b>自身</b> <br> じしん <br> [sound:4c-k-自身.mp3]
nature, spontaneity; naturally, spontaneously	<b>自然</b> <br> しぜん <br> [sound:4c-k-自然.mp3]
to perform, to do, to conduct oneself, to carry out	<b>行う</b> <br> おこなう <br> [sound:4c-k-行う.mp3]
line (i.e. of text), row, verse; carya (austerities); samskara (formations); running script (a semi-cursive style of kanji)	<b>行</b> <br> ぎょう <br> [sound:4c-k-行.mp3]
bank	<b>銀行</b> <br> ぎんこう <br> [sound:4c-k-銀行.mp3]
administration	<b>行政</b> <br> ぎょうせい <br> [sound:4c-k-行政.mp3]
company, corporation; workplace	<b>会社</b> <br> かいしゃ <br> [sound:4c-k-会社.mp3]
society, public	<b>社会</b> <br> しゃかい <br> [sound:4c-k-社会.mp3]
Socialist Party	<b>社会党</b> <br> しゃかいとう <br> [sound:4c-k-社会党.mp3]
company president, manager, director	<b>社長</b> <br> しゃちょう <br> [sound:4c-k-社長.mp3]
opinion, view	<b>意見</b> <br> いけん <br> [sound:4c-k-意見.mp3]
interview, audience	<b>会見</b> <br> かいけん <br> [sound:4c-k-会見.mp3]
review, reconsideration, revision	<b>見直し</b> <br> みなおし <br> [sound:4c-k-見直し.mp3]
viewpoint	<b>見方</b> <br> みかた <br> [sound:4c-k-見方.mp3]
January	<b>一月</b> <br> いちがつ <br> [sound:4c-k-一月.mp3]
September	<b>九月</b> <br> くがつ <br> [sound:4c-k-九月.mp3]
May	<b>五月</b> <br> ごがつ <br> [sound:4c-k-五月.mp3]
this month	<b>今月</b> <br> こんげつ <br> [sound:4c-k-今月.mp3]
sharing, division; draw, tie	<b>分け</b> <br> わけ <br> [sound:4c-k-分け.mp3]
to divide, to separate, to make distinctions, to differentiate (between)	<b>分ける</b> <br> わける <br> [sound:4c-k-分ける.mp3]
myself, yourself, oneself, himself, herself; I, me	<b>自分</b> <br> じぶん <br> [sound:4c-k-自分.mp3]
portion, section, part	<b>部分</b> <br> ぶぶん <br> [sound:4c-k-部分.mp3]
meeting, conference, session, assembly, council, convention, congress	<b>会議</b> <br> かいぎ <br> [sound:4c-k-会議.mp3]
member of the Diet, congress or parliament	<b>議員</b> <br> ぎいん <br> [sound:4c-k-議員.mp3]
Diet, congress, parliament	<b>議会</b> <br> ぎかい <br> [sound:4c-k-議会.mp3]
chairman, speaker (e.g. of assembly), president (e.g. of council, senate, etc.), moderator (e.g. of a newsgroup)	<b>議長</b> <br> ぎちょう <br> [sound:4c-k-議長.mp3]
behind, rear; after, later; after one's death; remainder, the rest; descendant, successor, heir; past/previous; more (i.e. five more minutes)	<b>後</b> <br> あと <br> [sound:4c-k-後.mp3]
afternoon, p.m.	<b>午後</b> <br> ごご <br> [sound:4c-k-午後.mp3]
back, behind, rear	<b>後ろ</b> <br> うしろ <br> [sound:4c-k-後ろ.mp3]
from now on, hereafter	<b>今後</b> <br> こんご <br> [sound:4c-k-今後.mp3]
morning, a.m.	<b>午前</b> <br> ごぜん <br> [sound:4c-k-午前.mp3]
the preceding year, the previous year, last year	<b>前年</b> <br> ぜんねん <br> [sound:4c-k-前年.mp3]
last time, last installment, last instalment, last session	<b>前回</b> <br> ぜんかい <br> [sound:4c-k-前回.mp3]
preamble, premise, reason, prerequisite, condition, assumption, hypothesis	<b>前提</b> <br> ぜんてい <br> [sound:4c-k-前提.mp3]
nation, people	<b>民</b> <br> たみ <br> [sound:4c-k-民.mp3]
nation, nationality, people, citizen	<b>国民</b> <br> こくみん <br> [sound:4c-k-国民.mp3]
citizen, townspeople	<b>市民</b> <br> しみん <br> [sound:4c-k-市民.mp3]
citizens, inhabitants, residents, population	<b>住民</b> <br> じゅうみん <br> [sound:4c-k-住民.mp3]
to live, to exist	<b>生きる</b> <br> いきる <br> [sound:4c-k-生きる.mp3]
student (esp. a university student)	<b>学生</b> <br> がくせい <br> [sound:4c-k-学生.mp3]
living, life (one's daily existence), livelihood	<b>生活</b> <br> せいかつ <br> [sound:4c-k-生活.mp3]
production, manufacture	<b>生産</b> <br> せいさん <br> [sound:4c-k-生産.mp3]
(taxonomical) tribe; quinella (quiniela); party, company, group; two reams (i.e. 1000 sheets of paper)	<b>連</b> <br> れん <br> [sound:4c-k-連.mp3]
relation, connection, relevance	<b>関連</b> <br> かんれん <br> [sound:4c-k-関連.mp3]
UN, United Nations	<b>国連</b> <br> こくれん <br> [sound:4c-k-国連.mp3]
union, alliance, combination	<b>連合</b> <br> れんごう <br> [sound:4c-k-連合.mp3]
five	<b>五</b> <br> ご, いつ, い <br> [sound:4c-k-五.mp3]
May	<b>五月</b> <br> ごがつ <br> [sound:4c-k-五月.mp3]
15, fifteen	<b>十五</b> <br> じゅうご <br> [sound:4c-k-十五.mp3]
the Olympics	<b>五輪</b> <br> ごりん <br> [sound:4c-k-五輪.mp3]
departure, departing (from ...), departing (at time ...); beginning; issued by (e.g. document); counter for gunshots, counter for blows (punches)	<b>発</b> <br> はつ <br> [sound:4c-k-発.mp3]
development, exploitation	<b>開発</b> <br> かいはつ <br> [sound:4c-k-開発.mp3]
utterance, speech, proposal	<b>発言</b> <br> はつげん <br> [sound:4c-k-発言.mp3]
issue (publications), publishing; raising an event (software)	<b>発行</b> <br> はっこう <br> [sound:4c-k-発行.mp3]
space (between), gap, interval, distance; time (between), pause, break; span (temporal or spatial), stretch, period (while); relationship (between, among); members (within, among); due to, because of	<b>間</b> <br> あいだ <br> [sound:4c-k-間.mp3]
soon, before long, in a short time; (after verb) lacking time to ..., without time to ...	<b>間もなく</b> <br> まもなく <br> [sound:4c-k-間もなく.mp3]
period, term, interval	<b>期間</b> <br> きかん <br> [sound:4c-k-期間.mp3]
time; hours	<b>時間</b> <br> じかん <br> [sound:4c-k-時間.mp3]
interaction, correspondence, coping with, dealing with, support	<b>対応</b> <br> たいおう <br> [sound:4c-k-対応.mp3]
counter-plan, counter-measure	<b>対策</b> <br> たいさく <br> [sound:4c-k-対策.mp3]
target, object (of worship, study, etc.), subject (of taxation, etc.)	<b>対象</b> <br> たいしょう <br> [sound:4c-k-対象.mp3]
opposition, resistance, antagonism, hostility, contrast, objection, dissension, reverse, opposite, vice versa	<b>反対</b> <br> はんたい <br> [sound:4c-k-反対.mp3]
doomed, in a bad state, poor (e.g. business)	<b>上がったり</b> <br> あがったり <br> [sound:4c-k-上がったり.mp3]
historical	<b>史上</b> <br> しじょう <br> [sound:4c-k-史上.mp3]
(as a) matter of fact, actually, in reality	<b>事実上</b> <br> じじつじょう <br> [sound:4c-k-事実上.mp3]
rise in price, making a tuck	<b>上げ</b> <br> あげ <br> [sound:4c-k-上げ.mp3]
one part, one portion, one section, some; one copy (e.g. of a document)	<b>一部</b> <br> いちぶ <br> [sound:4c-k-一部.mp3]
management, (executive) staff, leaders, leadership, top brass, upper echelons	<b>幹部</b> <br> かんぶ <br> [sound:4c-k-幹部.mp3]
head (chief, director) of a section or department; head of a (school) club, head of a (school) team	<b>部長</b> <br> ぶちょう <br> [sound:4c-k-部長.mp3]
portion, section, part	<b>部分</b> <br> ぶぶん <br> [sound:4c-k-部分.mp3]
east	<b>東</b> <br> ひがし, ひむかし, ひんがし <br> [sound:4c-k-東.mp3]
Tokyo (current capital of Japan)	<b>東京</b> <br> とうきょう <br> [sound:4c-k-東京.mp3]
Middle East	<b>中東</b> <br> ちゅうとう <br> [sound:4c-k-中東.mp3]
region south of Tokyo on Pacific Ocean side of Japan, eastern sea	<b>東海</b> <br> とうかい <br> [sound:4c-k-東海.mp3]
(a) patient	<b>患者</b> <br> かんじゃ <br> [sound:4c-k-患者.mp3]
authorized people, authorised people, person(s) concerned	<b>関係者</b> <br> かんけいしゃ <br> [sound:4c-k-関係者.mp3]
reporter	<b>記者</b> <br> きしゃ <br> [sound:4c-k-記者.mp3]
trader, merchant	<b>業者</b> <br> ぎょうしゃ <br> [sound:4c-k-業者.mp3]
party (political); faction, -ite	<b>党</b> <br> とう <br> [sound:4c-k-党.mp3]
Communist Party	<b>共産党</b> <br> きょうさんとう <br> [sound:4c-k-共産党.mp3]
Socialist Party	<b>社会党</b> <br> しゃかいとう <br> [sound:4c-k-社会党.mp3]
new (political) party	<b>新党</b> <br> しんとう <br> [sound:4c-k-新党.mp3]
earth, ground, land, soil; place; territory; bottom (of a package, book, etc.)	<b>地</b> <br> ち <br> [sound:4c-k-地.mp3]
actual place, local	<b>現地</b> <br> げんち <br> [sound:4c-k-現地.mp3]
area, region	<b>地域</b> <br> ちいき <br> [sound:4c-k-地域.mp3]
the earth	<b>地球</b> <br> ちきゅう <br> [sound:4c-k-地球.mp3]
0.18039 litres (liters); 0.3306 metres square (meters); one-tenth of the way from the base to the summit of a mountain; (astronomical) conjunction; counter for covered containers; counter for matches, battles, etc.	<b>合</b> <br> ごう <br> [sound:4c-k-合.mp3]
agreement, consent, mutual understanding	<b>合意</b> <br> ごうい <br> [sound:4c-k-合意.mp3]
match, game, bout, contest	<b>試合</b> <br> しあい <br> [sound:4c-k-試合.mp3]
union, alliance, combination	<b>連合</b> <br> れんごう <br> [sound:4c-k-連合.mp3]
(town) market; (the) marketplace	<b>市場</b> <br> いちば <br> [sound:4c-k-市場.mp3]
(within a) city, local	<b>市内</b> <br> しない <br> [sound:4c-k-市内.mp3]
citizen, townspeople	<b>市民</b> <br> しみん <br> [sound:4c-k-市民.mp3]
town, city, municipal, urban	<b>都市</b> <br> とし <br> [sound:4c-k-都市.mp3]
karma (i.e. actions committed in a former life)	<b>業</b> <br> ごう <br> [sound:4c-k-業.mp3]
enterprise, undertaking, corporation, business	<b>企業</b> <br> きぎょう <br> [sound:4c-k-企業.mp3]
industry, business	<b>業界</b> <br> ぎょうかい <br> [sound:4c-k-業界.mp3]
trader, merchant	<b>業者</b> <br> ぎょうしゃ <br> [sound:4c-k-業者.mp3]
inside, within; while; among, amongst, between; we (referring to one's in-group, i.e. company, etc.); my spouse; imperial palace grounds; emperor; I (primarily used by women and children), me	<b>内</b> <br> うち <br> [sound:4c-k-内.mp3]
internal, domestic	<b>国内</b> <br> こくない <br> [sound:4c-k-国内.mp3]
(within a) city, local	<b>市内</b> <br> しない <br> [sound:4c-k-市内.mp3]
metropolitan area	<b>都内</b> <br> とない <br> [sound:4c-k-都内.mp3]
Foreign Minister	<b>外相</b> <br> がいしょう <br> [sound:4c-k-外相.mp3]
Prime Minister, Chancellor (Germany, Austria, etc.), Premier	<b>首相</b> <br> しゅしょう <br> [sound:4c-k-首相.mp3]
companion, partner, company; other party, addressee; opponent (sports, etc.)	<b>相手</b> <br> あいて <br> [sound:4c-k-相手.mp3]
consultation, discussion	<b>相談</b> <br> そうだん <br> [sound:4c-k-相談.mp3]
one (esp. of two), the other, one way, the other way, one direction, the other direction, one side, the other side, one party, the other party; on the one hand, on the other hand; whereas, although, but at the same time, meanwhile, in turn; (after noun, adjective-stem or plain verb) just keeps, being inclined to ..., tending to be ..., tending to do ..., ntinuously ..., just keeps on ...ing, only	<b>一方</b> <br> いっぽう <br> [sound:4c-k-一方.mp3]
viewpoint	<b>見方</b> <br> みかた <br> [sound:4c-k-見方.mp3]
area, locality, district, region, province; countryside, rural area; coast (esp. as seen from the water); person singing ballads in Noh, person in charge of music in a Japanese dance performance	<b>地方</b> <br> ちほう, じかた <br> [sound:4c-k-地方.mp3]
direction, orientation, bearing, way; course (e.g. of action)	<b>方向</b> <br> ほうこう <br> [sound:4c-k-方向.mp3]
four	<b>四</b> <br> よん, し, よ <br> [sound:4c-k-四.mp3]
four	<b>四つ</b> <br> よっつ <br> [sound:4c-k-四つ.mp3]
April	<b>四月</b> <br> しがつ <br> [sound:4c-k-四月.mp3]
14, fourteen	<b>十四</b> <br> じゅうし, じゅうよん <br> [sound:4c-k-十四.mp3]
arrangement, pact, agreement	<b>協定</b> <br> きょうてい <br> [sound:4c-k-協定.mp3]
decision, determination	<b>決定</b> <br> けってい <br> [sound:4c-k-決定.mp3]
plans, arrangement, schedule, program, programme, expectation, estimate	<b>予定</b> <br> よてい <br> [sound:4c-k-予定.mp3]
stability, equilibrium	<b>安定</b> <br> あんてい <br> [sound:4c-k-安定.mp3]
now, the present time, just now, soon, immediately, (one) more	<b>今</b> <br> いま <br> [sound:4c-k-今.mp3]
now	<b>今や</b> <br> いまや <br> [sound:4c-k-今や.mp3]
now, this time, lately	<b>今回</b> <br> こんかい <br> [sound:4c-k-今回.mp3]
this month	<b>今月</b> <br> こんげつ <br> [sound:4c-k-今月.mp3]
counter for occurrences; counter for innings (baseball)	<b>回</b> <br> かい <br> [sound:4c-k-回.mp3]
recovery (from illness), improvement, rehabilitation, restoration, convalescence	<b>回復</b> <br> かいふく <br> [sound:4c-k-回復.mp3]
now, this time, lately	<b>今回</b> <br> こんかい <br> [sound:4c-k-今回.mp3]
reply, answer	<b>回答</b> <br> かいとう <br> [sound:4c-k-回答.mp3]
new, fresh, novel; newly, freshly, re-	<b>新た</b> <br> あらた <br> [sound:4c-k-新た.mp3]
new (political) party	<b>新党</b> <br> しんとう <br> [sound:4c-k-新党.mp3]
newspaper	<b>新聞</b> <br> しんぶん <br> [sound:4c-k-新聞.mp3]
new face, newcomer; modern humans (from Cro-Magnon man onwards)	<b>新人</b> <br> しんじん <br> [sound:4c-k-新人.mp3]
actual spot, scene, scene of the crime	<b>現場</b> <br> げんば, げんじょう <br> [sound:4c-k-現場.mp3]
(town) market; (the) marketplace	<b>市場</b> <br> いちば <br> [sound:4c-k-市場.mp3]
place, location	<b>場所</b> <br> ばしょ <br> [sound:4c-k-場所.mp3]
standpoint, position, situation	<b>立場</b> <br> たちば <br> [sound:4c-k-立場.mp3]
money	<b>お金</b> <br> おかね <br> [sound:4c-k-お金.mp3]
financing, credit transacting, loaning of money, circulation of money	<b>金融</b> <br> きんゆう <br> [sound:4c-k-金融.mp3]
interest rates	<b>金利</b> <br> きんり <br> [sound:4c-k-金利.mp3]
donation, contribution, offering	<b>献金</b> <br> けんきん <br> [sound:4c-k-献金.mp3]
committee member	<b>委員</b> <br> いいん <br> [sound:4c-k-委員.mp3]
committee, commission, board, panel, committee meeting	<b>委員会</b> <br> いいんかい <br> [sound:4c-k-委員会.mp3]
committee chairman	<b>委員長</b> <br> いいんちょう <br> [sound:4c-k-委員長.mp3]
member, the membership	<b>会員</b> <br> かいいん <br> [sound:4c-k-会員.mp3]
nine	<b>九</b> <br> きゅう, く, ここの, この, ここ <br> [sound:4c-k-九.mp3]
September	<b>九月</b> <br> くがつ <br> [sound:4c-k-九月.mp3]
19, nineteen	<b>十九</b> <br> じゅうきゅう <br> [sound:4c-k-十九.mp3]
Kyushu (southernmost of the four main islands of Japan)	<b>九州</b> <br> きゅうしゅう <br> [sound:4c-k-九州.mp3]
entering; setting (of the sun); containing, content, audience; income; beginning	<b>入り</b> <br> いり <br> [sound:4c-k-入り.mp3]
importation, import, introduction	<b>輸入</b> <br> ゆにゅう, しゅにゅう <br> [sound:4c-k-輸入.mp3]
purchase, buy	<b>購入</b> <br> こうにゅう <br> [sound:4c-k-購入.mp3]
income, receipts, revenue	<b>収入</b> <br> しゅうにゅう <br> [sound:4c-k-収入.mp3]
selection, choice, election; compilation, editing	<b>選</b> <br> せん <br> [sound:4c-k-選.mp3]
to choose, to select	<b>選ぶ</b> <br> えらぶ <br> [sound:4c-k-選ぶ.mp3]
election	<b>選挙</b> <br> せんきょ <br> [sound:4c-k-選挙.mp3]
player (in game), team member	<b>選手</b> <br> せんしゅ <br> [sound:4c-k-選手.mp3]
standpoint, position, situation	<b>立場</b> <br> たちば <br> [sound:4c-k-立場.mp3]
alliance, coalition	<b>連立</b> <br> れんりつ <br> [sound:4c-k-連立.mp3]
national	<b>国立</b> <br> こくりつ <br> [sound:4c-k-国立.mp3]
coming into existence, arrangements, establishment, conclusion, completion	<b>成立</b> <br> せいりつ <br> [sound:4c-k-成立.mp3]
development, exploitation	<b>開発</b> <br> かいはつ <br> [sound:4c-k-開発.mp3]
holding a meeting, open an exhibition	<b>開催</b> <br> かいさい <br> [sound:4c-k-開催.mp3]
start, commencement, beginning, initiation	<b>開始</b> <br> かいし <br> [sound:4c-k-開始.mp3]
open, throw open, liberalization, liberalisation	<b>開放</b> <br> かいほう <br> [sound:4c-k-開放.mp3]
hand, arm; forepaw, foreleg; handle; hand, worker, help; trouble, care, effort; means, way, trick, move, technique, workmanship; hand, handwriting; kind, type, sort; one's hands, one's possession; ability to cope; hand (of cards)	<b>手</b> <br> て <br> [sound:4c-k-手.mp3]
player (in game), team member	<b>選手</b> <br> せんしゅ <br> [sound:4c-k-選手.mp3]
championship, title (of champion)	<b>選手権</b> <br> せんしゅけん <br> [sound:4c-k-選手権.mp3]
companion, partner, company; other party, addressee; opponent (sports, etc.)	<b>相手</b> <br> あいて <br> [sound:4c-k-相手.mp3]
Japan-America	<b>日米</b> <br> にちべい <br> [sound:4c-k-日米.mp3]
America, USA	<b>米国</b> <br> べいこく <br> [sound:4c-k-米国.mp3]
all-America, pan-American	<b>全米</b> <br> ぜんべい <br> [sound:4c-k-全米.mp3]
relating to the USA, toward America, with America	<b>対米</b> <br> たいべい <br> [sound:4c-k-対米.mp3]
influence, power, might, strength, potency, force, energy	<b>勢力</b> <br> せいりょく <br> [sound:4c-k-勢力.mp3]
great effort, exertion, endeavour, endeavor, effort	<b>努力</b> <br> どりょく <br> [sound:4c-k-努力.mp3]
cooperation, collaboration	<b>協力</b> <br> きょうりょく <br> [sound:4c-k-協力.mp3]
(political) power, authority, influence	<b>権力</b> <br> けんりょく <br> [sound:4c-k-権力.mp3]
school	<b>学校</b> <br> がっこう <br> [sound:4c-k-学校.mp3]
student (esp. a university student)	<b>学生</b> <br> がくせい <br> [sound:4c-k-学生.mp3]
post-secondary education institution, incl. university, college, etc.; the Great Learning - one of the Four Books	<b>大学</b> <br> だいがく <br> [sound:4c-k-大学.mp3]
medical science, medicine	<b>医学</b> <br> いがく <br> [sound:4c-k-医学.mp3]
to ask, to question, to inquire; to charge (i.e. with a crime), to accuse; to care (about); without regard to (with negative verb)	<b>問う</b> <br> とう <br> [sound:4c-k-問う.mp3]
counter for questions	<b>問</b> <br> もん <br> [sound:4c-k-問.mp3]
question, inquiry, enquiry	<b>質問</b> <br> しつもん <br> [sound:4c-k-質問.mp3]
call, visit	<b>訪問</b> <br> ほうもん <br> [sound:4c-k-訪問.mp3]
height	<b>高さ</b> <br> たかさ <br> [sound:4c-k-高さ.mp3]
senior high school	<b>高校</b> <br> こうこう <br> [sound:4c-k-高校.mp3]
highest, supreme, the most	<b>最高</b> <br> さいこう <br> [sound:4c-k-最高.mp3]
high-valued yen, exchange in favor (favour) of the yen	<b>円高</b> <br> えんだか <br> [sound:4c-k-円高.mp3]
substitute, deputy, proxy, alternate, relief, compensation, second helping; in place of, as a substitute for	<b>代わり</b> <br> かわり, がわり <br> [sound:4c-k-代わり.mp3]
period, epoch, era, age; the times, those days; oldness, ancientness, antiquity; antique, period piece	<b>時代</b> <br> じだい <br> [sound:4c-k-時代.mp3]
representative, representation, delegation, type, example, model	<b>代表</b> <br> だいひょう <br> [sound:4c-k-代表.mp3]
nowadays, modern era, modern times, present-day	<b>現代</b> <br> げんだい <br> [sound:4c-k-現代.mp3]
obvious, evident, clear, plain	<b>明らか</b> <br> あきらか <br> [sound:4c-k-明らか.mp3]
declaration, statement, proclamation	<b>声明</b> <br> せいめい <br> [sound:4c-k-声明.mp3]
explanation, exposition	<b>説明</b> <br> せつめい <br> [sound:4c-k-説明.mp3]
unknown, obscure, indistinct, uncertain, ambiguous, ignorant, lack of wisdom, anonymous, unidentified	<b>不明</b> <br> ふめい <br> [sound:4c-k-不明.mp3]
truth, reality; sincerity, honesty, fidelity; content, substance; (good) result	<b>実</b> <br> じつ, じち <br> [sound:4c-k-実.mp3]
as a matter of fact, by the way, to tell you the truth, to be honest, frankly	<b>実は</b> <br> じつは <br> [sound:4c-k-実は.mp3]
indeed, really, absolutely, truly, actually, very, quite	<b>実に</b> <br> じつに, まことに, げに, しんに <br> [sound:4c-k-実に.mp3]
reality	<b>現実</b> <br> げんじつ <br> [sound:4c-k-現実.mp3]
Yen, money; circle	<b>円</b> <br> えん, まる <br> [sound:4c-k-円.mp3]
high-valued yen, exchange in favor (favour) of the yen	<b>円高</b> <br> えんだか <br> [sound:4c-k-円高.mp3]
cheap yen	<b>円安</b> <br> えんやす <br> [sound:4c-k-円安.mp3]
yen exchange rate	<b>円相場</b> <br> えんそうば <br> [sound:4c-k-円相場.mp3]
barrier, gate	<b>関</b> <br> せき <br> [sound:4c-k-関.mp3]
relation, connection	<b>関係</b> <br> かんけい <br> [sound:4c-k-関係.mp3]
authorized people, authorised people, person(s) concerned	<b>関係者</b> <br> かんけいしゃ <br> [sound:4c-k-関係者.mp3]
concern, interest	<b>関心</b> <br> かんしん <br> [sound:4c-k-関心.mp3]
always, without fail, usually, regularly	<b>決まって</b> <br> きまって <br> [sound:4c-k-決まって.mp3]
never, by no means, decidedly, indisputably	<b>決して</b> <br> けっして, けして <br> [sound:4c-k-決して.mp3]
settlement, solution, resolution	<b>解決</b> <br> かいけつ <br> [sound:4c-k-解決.mp3]
resolution, vote, decision	<b>決議</b> <br> けつぎ <br> [sound:4c-k-決議.mp3]
child; young (animal); young woman, young geisha; offshoot; interest; new shares; bird egg; (after a noun or -masu stem) -er (often of young women)	<b>子</b> <br> こ <br> [sound:4c-k-子.mp3]
child, children	<b>子供</b> <br> こども <br> [sound:4c-k-子供.mp3]
woman, girl	<b>女子</b> <br> じょし, おなご <br> [sound:4c-k-女子.mp3]
youth, young man	<b>男子</b> <br> だんし <br> [sound:4c-k-男子.mp3]
motion, change, confusion	<b>動</b> <br> どう <br> [sound:4c-k-動.mp3]
movement, activity, trend, development, change	<b>動き</b> <br> うごき <br> [sound:4c-k-動き.mp3]
motion, exercise	<b>運動</b> <br> うんどう <br> [sound:4c-k-運動.mp3]
action, activity	<b>活動</b> <br> かつどう <br> [sound:4c-k-活動.mp3]
imperial capital (esp. Kyoto); final word of an iroha-uta; 10^16, 10,000,000,000,000,000, ten quadrillion (American), (obs) ten thousand billion (British)	<b>京</b> <br> きょう, けい <br> [sound:4c-k-京.mp3]
Tokyo (current capital of Japan)	<b>東京</b> <br> とうきょう <br> [sound:4c-k-東京.mp3]
Beijing (China), Peking	<b>北京</b> <br> ぺきん <br> [sound:4c-k-北京.mp3]
Kyoto	<b>京都</b> <br> きょうと <br> [sound:4c-k-京都.mp3]
safety; security	<b>安全</b> <br> あんぜん <br> [sound:4c-k-安全.mp3]
whole, entirety, whatever (is the matter)	<b>全体</b> <br> ぜんたい <br> [sound:4c-k-全体.mp3]
country-wide, nation-wide, whole country, national	<b>全国</b> <br> ぜんこく, ぜんごく <br> [sound:4c-k-全国.mp3]
security guarantee (e.g. military security, network security, etc.)	<b>安全保障</b> <br> あんぜんほしょう <br> [sound:4c-k-安全保障.mp3]
purpose, goal, aim, objective, intention	<b>目的</b> <br> もくてき <br> [sound:4c-k-目的.mp3]
mark, objective, target	<b>目標</b> <br> もくひょう <br> [sound:4c-k-目標.mp3]
notice, attention, observation	<b>注目</b> <br> ちゅうもく <br> [sound:4c-k-注目.mp3]
(data) item, entry	<b>項目</b> <br> こうもく <br> [sound:4c-k-項目.mp3]
surface; face (i.e. the visible side of an object); front (of a building, etc.), obverse side (i.e. "head") of a coin; outside, exterior; appearance; public; first half (of an innings), top (of an inning); cover (for tatami mats, etc.); foreground	<b>表</b> <br> おもて <br> [sound:4c-k-表.mp3]
representative, representation, delegation, type, example, model	<b>代表</b> <br> だいひょう <br> [sound:4c-k-代表.mp3]
announcement, publication	<b>発表</b> <br> はっぴょう <br> [sound:4c-k-発表.mp3]
expression, presentation; representation, notation	<b>表現</b> <br> ひょうげん <br> [sound:4c-k-表現.mp3]
battle, fight, struggle, conflict	<b>戦い</b> <br> たたかい <br> [sound:4c-k-戦い.mp3]
war	<b>戦争</b> <br> せんそう <br> [sound:4c-k-戦争.mp3]
postwar period, period after Second World War	<b>戦後</b> <br> せんご <br> [sound:4c-k-戦後.mp3]
tactics, strategy; military or naval operations	<b>作戦</b> <br> さくせん <br> [sound:4c-k-作戦.mp3]
sutra, Buddhist scriptures	<b>経</b> <br> きょう <br> [sound:4c-k-経.mp3]
management, administration	<b>経営</b> <br> けいえい <br> [sound:4c-k-経営.mp3]
economics, business, finance, economy	<b>経済</b> <br> けいざい <br> [sound:4c-k-経済.mp3]
experience	<b>経験</b> <br> けいけん <br> [sound:4c-k-経験.mp3]
in accordance with ..., following ...; .. Street, .. Avenue	<b>通り</b> <br> どおり <br> [sound:4c-k-通り.mp3]
correspondence, communication, transmission, news, signal	<b>通信</b> <br> つうしん <br> [sound:4c-k-通信.mp3]
perspective, unobstructed view, outlook, forecast, prospect, insight, foresight, visibility	<b>見通し</b> <br> みとおし <br> [sound:4c-k-見通し.mp3]
commonness, community	<b>共通</b> <br> きょうつう <br> [sound:4c-k-共通.mp3]
other (esp. places and things), the rest	<b>外</b> <br> ほか <br> [sound:4c-k-外.mp3]
foreign, abroad, overseas	<b>海外</b> <br> かいがい <br> [sound:4c-k-海外.mp3]
diplomacy	<b>外交</b> <br> がいこう <br> [sound:4c-k-外交.mp3]
foreign country	<b>外国</b> <br> がいこく <br> [sound:4c-k-外国.mp3]
most, extremely	<b>最も</b> <br> もっとも <br> [sound:4c-k-最も.mp3]
latest, most recent, nowadays	<b>最近</b> <br> さいきん <br> [sound:4c-k-最近.mp3]
last, end, conclusion; (after -tara form or -ta form followed by "ga") no sooner than, right after (often having negative consequences); one's final moments	<b>最後</b> <br> さいご <br> [sound:4c-k-最後.mp3]
highest, supreme, the most	<b>最高</b> <br> さいこう <br> [sound:4c-k-最高.mp3]
so to speak, so to call it, as it were	<b>言わば</b> <br> いわば <br> [sound:4c-k-言わば.mp3]
to say; to call (i.e. to give a name)	<b>言う</b> <br> いう, ゆう <br> [sound:4c-k-言う.mp3]
word, remark, statement	<b>言</b> <br> げん, こと <br> [sound:4c-k-言.mp3]
language, dialect; word, words, phrase, term, expression, remark; speech, (manner of) speaking	<b>言葉</b> <br> ことば, けとば <br> [sound:4c-k-言葉.mp3]
family name, lineage, birth	<b>氏</b> <br> うじ <br> [sound:4c-k-氏.mp3]
full name, identity	<b>氏名</b> <br> しめい <br> [sound:4c-k-氏名.mp3]
the said person, he, she, same person	<b>同氏</b> <br> どうし <br> [sound:4c-k-同氏.mp3]
both persons	<b>両氏</b> <br> りょうし <br> [sound:4c-k-両氏.mp3]
now, current, present, present time, as of	<b>現在</b> <br> げんざい <br> [sound:4c-k-現在.mp3]
reality	<b>現実</b> <br> げんじつ <br> [sound:4c-k-現実.mp3]
actual spot, scene, scene of the crime	<b>現場</b> <br> げんば, げんじょう <br> [sound:4c-k-現場.mp3]
actual place, local	<b>現地</b> <br> げんち <br> [sound:4c-k-現地.mp3]
reason, principle, logic; general principle (as opposed to individual concrete phenomenon); (in neo-Confucianism) the underlying principles of the cosmos	<b>理</b> <br> り <br> [sound:4c-k-理.mp3]
control, management (e.g. of a business)	<b>管理</b> <br> かんり <br> [sound:4c-k-管理.mp3]
director, board of directors	<b>理事</b> <br> りじ <br> [sound:4c-k-理事.mp3]
reason, pretext, motive	<b>理由</b> <br> りゆう <br> [sound:4c-k-理由.mp3]
investigation, inspection, examination; tune, note, melody	<b>調べ</b> <br> しらべ <br> [sound:4c-k-調べ.mp3]
investigation, examination, inquiry, enquiry, survey	<b>調査</b> <br> ちょうさ <br> [sound:4c-k-調査.mp3]
regulation, adjustment, tuning, modification, alteration	<b>調整</b> <br> ちょうせい <br> [sound:4c-k-調整.mp3]
cooperation, conciliation, harmony; firm (market) tone	<b>協調</b> <br> きょうちょう <br> [sound:4c-k-協調.mp3]
body; health	<b>体</b> <br> からだ, しんたい <br> [sound:4c-k-体.mp3]
concrete, tangible, definite, specific	<b>具体的</b> <br> ぐたいてき <br> [sound:4c-k-具体的.mp3]
whole, entirety, whatever (is the matter)	<b>全体</b> <br> ぜんたい <br> [sound:4c-k-全体.mp3]
order, system, structure, set-up, organization, organisation	<b>体制</b> <br> たいせい <br> [sound:4c-k-体制.mp3]
strengthen, intensify, reinforce, solidify, enhancement	<b>強化</b> <br> きょうか <br> [sound:4c-k-強化.mp3]
culture, civilization, civilisation; Bunka era (1804.2.11-1818.4.22)	<b>文化</b> <br> ぶんか <br> [sound:4c-k-文化.mp3]
change, variation, alteration, mutation, transition, transformation, transfiguration, metamorphosis; variety, diversity; inflection, declension, conjugation; sidestepping (sumo)	<b>変化</b> <br> へんか <br> [sound:4c-k-変化.mp3]
(suffer) deterioration, growing worse, aggravation, degeneration, corruption	<b>悪化</b> <br> あっか <br> [sound:4c-k-悪化.mp3]
high rice field, very fertile rice field	<b>上田</b> <br> じょうでん <br> [sound:4c-k-上田.mp3]
(water-filled) paddy field	<b>水田</b> <br> すいでん <br> [sound:4c-k-水田.mp3]
oil field	<b>油田</b> <br> ゆでん <br> [sound:4c-k-油田.mp3]
rural area, countryside, the sticks; hometown	<b>田舎</b> <br> いなか <br> [sound:4c-k-田舎.mp3]
authorities; this office	<b>当局</b> <br> とうきょく <br> [sound:4c-k-当局.mp3]
at that time, in those days	<b>当時</b> <br> とうじ <br> [sound:4c-k-当時.mp3]
at first	<b>当初</b> <br> とうしょ <br> [sound:4c-k-当初.mp3]
(in) charge	<b>担当</b> <br> たんとう <br> [sound:4c-k-担当.mp3]
eight	<b>八</b> <br> はち, や <br> [sound:4c-k-八.mp3]
18, eighteen	<b>十八</b> <br> じゅうはち <br> [sound:4c-k-十八.mp3]
August	<b>八月</b> <br> はちがつ <br> [sound:4c-k-八月.mp3]
eighty	<b>八十</b> <br> はちじゅう, やそ <br> [sound:4c-k-八十.mp3]
six	<b>六</b> <br> ろく, む, むう <br> [sound:4c-k-六.mp3]
June	<b>六月</b> <br> ろくがつ <br> [sound:4c-k-六月.mp3]
sixty	<b>六十</b> <br> ろくじゅう, むそ <br> [sound:4c-k-六十.mp3]
64th note	<b>六十四分音符</b> <br> ろくじゅうしぶおんぷ <br> [sound:4c-k-六十四分音符.mp3]
contract, compact, agreement	<b>契約</b> <br> けいやく <br> [sound:4c-k-契約.mp3]
treaty, pact	<b>条約</b> <br> じょうやく <br> [sound:4c-k-条約.mp3]
public commitment or promise	<b>公約</b> <br> こうやく <br> [sound:4c-k-公約.mp3]
arrangement, promise, appointment, pact, engagement; convention, rule	<b>約束</b> <br> やくそく <br> [sound:4c-k-約束.mp3]
mainly, primarily	<b>主に</b> <br> おもに <br> [sound:4c-k-主に.mp3]
chief mourner	<b>喪主</b> <br> もしゅ <br> [sound:4c-k-喪主.mp3]
democracy, popular sovereignty; democratic	<b>民主</b> <br> みんしゅ <br> [sound:4c-k-民主.mp3]
doctrine, rule, principle	<b>主義</b> <br> しゅぎ <br> [sound:4c-k-主義.mp3]
subject, theme, task, challenge, issue	<b>課題</b> <br> かだい <br> [sound:4c-k-課題.mp3]
problem, question	<b>問題</b> <br> もんだい <br> [sound:4c-k-問題.mp3]
topic, subject	<b>話題</b> <br> わだい <br> [sound:4c-k-話題.mp3]
title, subject, theme, topic; problem (on a test), question; counter for questions (on a test)	<b>題</b> <br> だい <br> [sound:4c-k-題.mp3]
under (esp. influence or guidance)	<b>下</b> <br> もと <br> [sound:4c-k-下.mp3]
to hang, to lower, to move back, to wear, to dismiss, to grant	<b>下げる</b> <br> さげる <br> [sound:4c-k-下げる.mp3]
reduction, cut	<b>引き下げ</b> <br> ひきさげ <br> [sound:4c-k-引き下げ.mp3]
down-train (going away from Tokyo); down-slope, downward going	<b>下り</b> <br> くだり <br> [sound:4c-k-下り.mp3]
neck; head; unemployed person	<b>首</b> <br> くび, クビ <br> [sound:4c-k-首.mp3]
Prime Minister, Chancellor (Germany, Austria, etc.), Premier	<b>首相</b> <br> しゅしょう <br> [sound:4c-k-首相.mp3]
head, brains, leading spirit	<b>首脳</b> <br> しゅのう <br> [sound:4c-k-首脳.mp3]
capital city, metropolis	<b>首都</b> <br> しゅと <br> [sound:4c-k-首都.mp3]
opinion, view	<b>意見</b> <br> いけん <br> [sound:4c-k-意見.mp3]
meaning, significance	<b>意味</b> <br> いみ <br> [sound:4c-k-意味.mp3]
agreement, consent, mutual understanding	<b>合意</b> <br> ごうい <br> [sound:4c-k-合意.mp3]
intention, idea, inclination	<b>意向</b> <br> いこう <br> [sound:4c-k-意向.mp3]
constitution	<b>憲法</b> <br> けんぽう <br> [sound:4c-k-憲法.mp3]
method, process, manner, way, means, technique	<b>方法</b> <br> ほうほう <br> [sound:4c-k-方法.mp3]
bill (law)	<b>法案</b> <br> ほうあん <br> [sound:4c-k-法案.mp3]
corporate body, corporation, (legal) person, (juridical) person	<b>法人</b> <br> ほうじん <br> [sound:4c-k-法人.mp3]
real estate	<b>不動産</b> <br> ふどうさん <br> [sound:4c-k-不動産.mp3]
dissatisfaction, displeasure, discontent, complaints, unhappiness, disgruntled	<b>不満</b> <br> ふまん <br> [sound:4c-k-不満.mp3]
unknown, obscure, indistinct, uncertain, ambiguous, ignorant, lack of wisdom, anonymous, unidentified	<b>不明</b> <br> ふめい <br> [sound:4c-k-不明.mp3]
heart failure	<b>心不全</b> <br> しんふぜん <br> [sound:4c-k-心不全.mp3]
future (usually near), prospects	<b>将来</b> <br> しょうらい <br> [sound:4c-k-将来.mp3]
next year	<b>来年</b> <br> らいねん <br> [sound:4c-k-来年.mp3]
essentially, naturally, by nature, in (and of) itself, originally	<b>本来</b> <br> ほんらい <br> [sound:4c-k-本来.mp3]
next month	<b>来月</b> <br> らいげつ <br> [sound:4c-k-来月.mp3]
work, operation, manufacturing, fatigue duty	<b>作業</b> <br> さぎょう <br> [sound:4c-k-作業.mp3]
work (e.g. book, film, composition, etc.), opus, performance, production	<b>作品</b> <br> さくひん <br> [sound:4c-k-作品.mp3]
author, writer, novelist, artist	<b>作家</b> <br> さっか <br> [sound:4c-k-作家.mp3]
tactics, strategy; military or naval operations	<b>作戦</b> <br> さくせん <br> [sound:4c-k-作戦.mp3]
character, personality	<b>性格</b> <br> せいかく <br> [sound:4c-k-性格.mp3]
necessity	<b>必要性</b> <br> ひつようせい <br> [sound:4c-k-必要性.mp3]
activity	<b>活性</b> <br> かっせい <br> [sound:4c-k-活性.mp3]
individuality, personality, idiosyncrasy	<b>個性</b> <br> こせい <br> [sound:4c-k-個性.mp3]
international	<b>国際的</b> <br> こくさいてき <br> [sound:4c-k-国際的.mp3]
fundamental, standard, basic	<b>基本的</b> <br> きほんてき <br> [sound:4c-k-基本的.mp3]
public, official	<b>公的</b> <br> こうてき <br> [sound:4c-k-公的.mp3]
political	<b>政治的</b> <br> せいじてき <br> [sound:4c-k-政治的.mp3]
chief, main, principal, major	<b>主要</b> <br> しゅよう <br> [sound:4c-k-主要.mp3]
demand, request	<b>需要</b> <br> じゅよう <br> [sound:4c-k-需要.mp3]
claim, demand, request, application	<b>要請</b> <br> ようせい <br> [sound:4c-k-要請.mp3]
necessity	<b>必要性</b> <br> ひつようせい <br> [sound:4c-k-必要性.mp3]
cost, expense	<b>費用</b> <br> ひよう <br> [sound:4c-k-費用.mp3]
use, utilization, utilisation, application	<b>利用</b> <br> りよう <br> [sound:4c-k-利用.mp3]
making use of, application, investment, practical use	<b>運用</b> <br> うんよう <br> [sound:4c-k-運用.mp3]
passenger vehicle, automobile	<b>乗用車</b> <br> じょうようしゃ <br> [sound:4c-k-乗用車.mp3]
order, system, structure, set-up, organization, organisation	<b>体制</b> <br> たいせい <br> [sound:4c-k-体制.mp3]
restraint, sanctions, punishment	<b>制裁</b> <br> せいさい <br> [sound:4c-k-制裁.mp3]
tax system	<b>税制</b> <br> ぜいせい <br> [sound:4c-k-税制.mp3]
obligation, coercion, compulsion, enforcement	<b>強制</b> <br> きょうせい <br> [sound:4c-k-強制.mp3]
self-government, autonomy	<b>自治</b> <br> じち <br> [sound:4c-k-自治.mp3]
self-governing body, municipality, autonomous entity	<b>自治体</b> <br> じちたい <br> [sound:4c-k-自治体.mp3]
political	<b>政治的</b> <br> せいじてき <br> [sound:4c-k-政治的.mp3]
Meiji era (1868.9.8-1912.7.30)	<b>明治</b> <br> めいじ <br> [sound:4c-k-明治.mp3]
attitude, manner, behaviour	<b>態度</b> <br> たいど <br> [sound:4c-k-態度.mp3]
how many times?, how often?	<b>何度</b> <br> なんど <br> [sound:4c-k-何度.mp3]
preceding fiscal year	<b>前年度</b> <br> ぜんねんど <br> [sound:4c-k-前年度.mp3]
year, fiscal year, school year, term	<b>年度</b> <br> ねんど <br> [sound:4c-k-年度.mp3]
secretariat, executive office	<b>事務局</b> <br> じむきょく <br> [sound:4c-k-事務局.mp3]
office	<b>事務所</b> <br> じむしょ <br> [sound:4c-k-事務所.mp3]
business, affairs, duties, work, procedure, task, action, function	<b>業務</b> <br> ぎょうむ <br> [sound:4c-k-業務.mp3]
managing director, executive director; routine business, regular business	<b>常務</b> <br> じょうむ <br> [sound:4c-k-常務.mp3]
study; diligence; discount, reduction	<b>勉強</b> <br> べんきょう <br> [sound:4c-k-勉強.mp3]
to strengthen, to emphasize, to emphasise	<b>強める</b> <br> つよめる <br> [sound:4c-k-強める.mp3]
firm, vigorous, unbending, unyielding, strong, stubborn	<b>強硬</b> <br> きょうこう <br> [sound:4c-k-強硬.mp3]
powerful, strong	<b>強力</b> <br> きょうりょく <br> [sound:4c-k-強力.mp3]
feeling, sensation, mood	<b>気持ち</b> <br> きもち <br> [sound:4c-k-気持ち.mp3]
electricity; (electric) light	<b>電気</b> <br> でんき <br> [sound:4c-k-電気.mp3]
illness, disease, sickness	<b>病気</b> <br> びょうき <br> [sound:4c-k-病気.mp3]
drink! (said repeatedly as a party cheer)	<b>一気</b> <br> いっき <br> [sound:4c-k-一気.mp3]
elementary school student, primary school student, grade school student	<b>小学生</b> <br> しょうがくせい <br> [sound:4c-k-小学生.mp3]
small to medium enterprises, smaller companies	<b>中小企業</b> <br> ちゅうしょうきぎょう <br> [sound:4c-k-中小企業.mp3]
elementary school, primary school, grade school	<b>小学</b> <br> しょうがく <br> [sound:4c-k-小学.mp3]
small size, tiny	<b>小型</b> <br> こがた <br> [sound:4c-k-小型.mp3]
seventy	<b>七十</b> <br> しちじゅう, ななじゅう, ななそ <br> [sound:4c-k-七十.mp3]
The 47 Ronin	<b>四十七士</b> <br> しじゅうしちし <br> [sound:4c-k-四十七士.mp3]
seven	<b>七つ</b> <br> ななつ <br> [sound:4c-k-七つ.mp3]
49th day after death	<b>七七日</b> <br> しちしちにち, なななぬか, なななのか <br> [sound:4c-k-七七日.mp3]
coming into existence, arrangements, establishment, conclusion, completion	<b>成立</b> <br> せいりつ <br> [sound:4c-k-成立.mp3]
composition, formation, organization, organisation, compilation	<b>編成</b> <br> へんせい <br> [sound:4c-k-編成.mp3]
formation	<b>結成</b> <br> けっせい <br> [sound:4c-k-結成.mp3]
organization, organisation, configuration, composition	<b>構成</b> <br> こうせい <br> [sound:4c-k-構成.mp3]
early stage	<b>早期</b> <br> そうき <br> [sound:4c-k-早期.mp3]
long time period	<b>長期</b> <br> ちょうき <br> [sound:4c-k-長期.mp3]
term, period, time frame; time limit, deadline, cutoff (date)	<b>期限</b> <br> きげん <br> [sound:4c-k-期限.mp3]
next term, next period; next version, next release	<b>次期</b> <br> じき <br> [sound:4c-k-次期.mp3]
public, community, public service, society, communal	<b>公共</b> <br> こうきょう <br> [sound:4c-k-公共.mp3]
formality, formal, official; formula	<b>公式</b> <br> こうしき <br> [sound:4c-k-公式.mp3]
New Komeito (Japanese political party), New Clean Government Party, Justice Party	<b>公明党</b> <br> こうめいとう <br> [sound:4c-k-公明党.mp3]
public, official	<b>公的</b> <br> こうてき <br> [sound:4c-k-公的.mp3]
hold, charge, keep possession, in charge; wear, durability, life, draw; usage	<b>持ち</b> <br> もち <br> [sound:4c-k-持ち.mp3]
to hold, to carry; to possess	<b>持つ</b> <br> もつ <br> [sound:4c-k-持つ.mp3]
to lodge, to take something into ..., to bring in	<b>持ち込む</b> <br> もちこむ <br> [sound:4c-k-持ち込む.mp3]
retention, maintenance, preservation	<b>保持</b> <br> ほじ <br> [sound:4c-k-保持.mp3]
opposition party, political opposition, opposition	<b>野党</b> <br> やとう <br> [sound:4c-k-野党.mp3]
(political) parties in and out of power, majority and minority parties	<b>与野党</b> <br> よやとう <br> [sound:4c-k-与野党.mp3]
vegetable	<b>野菜</b> <br> やさい <br> [sound:4c-k-野菜.mp3]
section of Tokyo	<b>上野</b> <br> うえの <br> [sound:4c-k-上野.mp3]
arrangement, pact, agreement	<b>協定</b> <br> きょうてい <br> [sound:4c-k-協定.mp3]
cooperation, collaboration	<b>協力</b> <br> きょうりょく <br> [sound:4c-k-協力.mp3]
cooperation, conciliation, harmony; firm (market) tone	<b>協調</b> <br> きょうちょう <br> [sound:4c-k-協調.mp3]
compromise, giving in	<b>妥協</b> <br> だきょう <br> [sound:4c-k-妥協.mp3]
handle, grip, knob	<b>取っ手</b> <br> とって, はしゅ <br> [sound:4c-k-取っ手.mp3]
company director, board member	<b>取締役</b> <br> とりしまりやく <br> [sound:4c-k-取締役.mp3]
listening, hearing, audition, radio reception	<b>聴取</b> <br> ちょうしゅ <br> [sound:4c-k-聴取.mp3]
bout (in sports, etc.), match; effort, initiative, dealing with, grappling with, wrestling with	<b>取り組み</b> <br> とりくみ <br> [sound:4c-k-取り組み.mp3]
Kyoto	<b>京都</b> <br> きょうと <br> [sound:4c-k-京都.mp3]
capital city, metropolis	<b>首都</b> <br> しゅと <br> [sound:4c-k-首都.mp3]
the capital city (often Tokyo) area (typically within 50 km of city's centre) (center)	<b>首都圏</b> <br> しゅとけん <br> [sound:4c-k-首都圏.mp3]
administrative divisions of Japan: Tokyo-to, Hokkai-do, Osaka-fu, Kyoto-fu and remaining prefectures	<b>都道府県</b> <br> とどうふけん <br> [sound:4c-k-都道府県.mp3]
relief, mitigation, alleviation, relaxation, softening	<b>緩和</b> <br> かんわ <br> [sound:4c-k-緩和.mp3]
Democratic People's Republic of Korea (North Korea), DPRK	<b>朝鮮民主主義人民共和国</b> <br> ちょうせんみんしゅしゅぎじんみんきょうわこく <br> [sound:4c-k-朝鮮民主主義人民共和国.mp3]
reconciliation, settlement, accommodation, compromise, mediation, rapprochement; (legal) settlement; translation of a foreign language into Japanese	<b>和解</b> <br> わかい, わげ <br> [sound:4c-k-和解.mp3]
republicanism, cooperation	<b>共和</b> <br> きょうわ <br> [sound:4c-k-共和.mp3]
integration, unification, synthesis; integrated, built-in	<b>統合</b> <br> とうごう <br> [sound:4c-k-統合.mp3]
statistics	<b>統計</b> <br> とうけい <br> [sound:4c-k-統計.mp3]
rule, reign, government, governing	<b>統治</b> <br> とうち, とうじ <br> [sound:4c-k-統治.mp3]
traditional, conventional	<b>伝統的</b> <br> でんとうてき <br> [sound:4c-k-伝統的.mp3]
not exceeding, and downward, ... and below; below (e.g. standard), under (e.g. a level); the below-mentioned, the following, the rest	<b>以下</b> <br> いか, いげ <br> [sound:4c-k-以下.mp3]
after this, from now on, hereafter; thereafter, since (verb) (after -te form of verb), after (time), since (then)	<b>以後</b> <br> いご <br> [sound:4c-k-以後.mp3]
not less than, ... and more, ... and upwards; beyond ... (e.g. one's means), further (e.g. nothing further to say), more than ... (e.g. cannot pay more than that); above-mentioned, foregoing; since ..., seeing that ...; this is all, that is the end, the end	<b>以上</b> <br> いじょう <br> [sound:4c-k-以上.mp3]
on and after, as from, hereafter, thereafter, since	<b>以降</b> <br> いこう <br> [sound:4c-k-以降.mp3]
function, facility, faculty, feature	<b>機能</b> <br> きのう <br> [sound:4c-k-機能.mp3]
chance, opportunity	<b>機会</b> <br> きかい <br> [sound:4c-k-機会.mp3]
machine, mechanism; instrument, appliance, apparatus	<b>機械</b> <br> きかい <br> [sound:4c-k-機械.mp3]
machinery and tools	<b>機器</b> <br> きき <br> [sound:4c-k-機器.mp3]
Pacific Ocean	<b>太平洋</b> <br> たいへいよう <br> [sound:4c-k-太平洋.mp3]
Heisei era (1989.1.8- )	<b>平成</b> <br> へいせい <br> [sound:4c-k-平成.mp3]
Pyongyang	<b>平壌</b> <br> へいじょう <br> [sound:4c-k-平壌.mp3]
equality, impartiality, evenness	<b>平等</b> <br> びょうどう <br> [sound:4c-k-平等.mp3]
synthesis, coordination, putting together, integration, composite; comprehensive	<b>総合</b> <br> そうごう <br> [sound:4c-k-総合.mp3]
sum total, total amount	<b>総額</b> <br> そうがく <br> [sound:4c-k-総額.mp3]
(college) president, secretary-general	<b>総長</b> <br> そうちょう <br> [sound:4c-k-総長.mp3]
general business (affairs), manager, director, adjutant general (mil)	<b>総務</b> <br> そうむ <br> [sound:4c-k-総務.mp3]
increase, increment, addition	<b>増加</b> <br> ぞうか <br> [sound:4c-k-増加.mp3]
participant, entrant	<b>参加者</b> <br> さんかしゃ <br> [sound:4c-k-参加者.mp3]
addition, supplement, append (e.g. to a file), appendix	<b>追加</b> <br> ついか <br> [sound:4c-k-追加.mp3]
becoming a member, joining, entry, admission, subscription, affiliation, adherence, signing	<b>加入</b> <br> かにゅう <br> [sound:4c-k-加入.mp3]
mountain-shaped	<b>山形</b> <br> やまがた <br> [sound:4c-k-山形.mp3]
mountain climbing	<b>登山</b> <br> とざん <br> [sound:4c-k-登山.mp3]
mountains	<b>山岳</b> <br> さんがく <br> [sound:4c-k-山岳.mp3]
hill, knoll	<b>小山</b> <br> こやま <br> [sound:4c-k-小山.mp3]
intention, purpose	<b>意思</b> <br> いし <br> [sound:4c-k-意思.mp3]
thought, idea, ideology	<b>思想</b> <br> しそう <br> [sound:4c-k-思想.mp3]
expectation, prediction, forecast; anticipation, speculation	<b>思惑</b> <br> おもわく <br> [sound:4c-k-思惑.mp3]
resolutely, boldly, daringly	<b>思い切って</b> <br> おもいきって <br> [sound:4c-k-思い切って.mp3]
politician, statesman	<b>政治家</b> <br> せいじか <br> [sound:4c-k-政治家.mp3]
author, writer, novelist, artist	<b>作家</b> <br> さっか <br> [sound:4c-k-作家.mp3]
specialist	<b>専門家</b> <br> せんもんか <br> [sound:4c-k-専門家.mp3]
farmer, farm family	<b>農家</b> <br> のうか <br> [sound:4c-k-農家.mp3]
topic, subject	<b>話題</b> <br> わだい <br> [sound:4c-k-話題.mp3]
discussion, conference	<b>話し合い</b> <br> はなしあい <br> [sound:4c-k-話し合い.mp3]
conversation	<b>会話</b> <br> かいわ <br> [sound:4c-k-会話.mp3]
looking after, help, aid, assistance	<b>世話</b> <br> せわ <br> [sound:4c-k-世話.mp3]
public opinion	<b>世論</b> <br> せろん, よろん <br> [sound:4c-k-世論.mp3]
global, international, world-famous	<b>世界的</b> <br> せかいてき <br> [sound:4c-k-世界的.mp3]
century, era	<b>世紀</b> <br> せいき <br> [sound:4c-k-世紀.mp3]
household, home, family, housekeeping	<b>世帯</b> <br> せたい, しょたい <br> [sound:4c-k-世帯.mp3]
winning (a prize)	<b>受賞</b> <br> じゅしょう <br> [sound:4c-k-受賞.mp3]
accepting orders	<b>受注</b> <br> じゅちゅう <br> [sound:4c-k-受注.mp3]
to catch, to stop the blow, to react to, to take	<b>受け止める</b> <br> うけとめる <br> [sound:4c-k-受け止める.mp3]
to accept, to receive	<b>受け入れる</b> <br> うけいれる <br> [sound:4c-k-受け入れる.mp3]
in the ward or borough	<b>区内</b> <br> くない <br> [sound:4c-k-区内.mp3]
limits, boundary, domain, zone, sphere, territory; area (e.g. in programming languages)	<b>区域</b> <br> くいき <br> [sound:4c-k-区域.mp3]
section (of track, etc.), segment, dimension	<b>区間</b> <br> くかん <br> [sound:4c-k-区間.mp3]
ward headman	<b>区長</b> <br> くちょう <br> [sound:4c-k-区長.mp3]
area, domain, territory, field, range, region, regime	<b>領域</b> <br> りょういき <br> [sound:4c-k-領域.mp3]
general plan, main points, summary, platform (e.g. for a campaign), mission statement	<b>綱領</b> <br> こうりょう <br> [sound:4c-k-綱領.mp3]
(within a) territory, domains	<b>領内</b> <br> りょうない <br> [sound:4c-k-領内.mp3]
possession	<b>領有</b> <br> りょうゆう <br> [sound:4c-k-領有.mp3]
the most	<b>最多</b> <br> さいた <br> [sound:4c-k-最多.mp3]
large amount of money	<b>多額</b> <br> たがく <br> [sound:4c-k-多額.mp3]
variegated, varicoloured, multi-colored, diverse	<b>多彩</b> <br> たさい <br> [sound:4c-k-多彩.mp3]
more or less, somewhat, a little, some	<b>多少</b> <br> たしょう <br> [sound:4c-k-多少.mp3]
within the prefecture	<b>県内</b> <br> けんない <br> [sound:4c-k-県内.mp3]
administrative divisions of Japan: Tokyo-to, Hokkai-do, Osaka-fu, Kyoto-fu and remaining prefectures	<b>都道府県</b> <br> とどうふけん <br> [sound:4c-k-都道府県.mp3]
prefectural assembly	<b>県議</b> <br> けんぎ <br> [sound:4c-k-県議.mp3]
prefectural (institution)	<b>県立</b> <br> けんりつ <br> [sound:4c-k-県立.mp3]
sequel, continuation, (also suffix) continuation (in time and space), second series, succession, spell	<b>続き</b> <br> つづき <br> [sound:4c-k-続き.mp3]
continuation	<b>持続</b> <br> じぞく <br> [sound:4c-k-持続.mp3]
duration, continuance	<b>存続</b> <br> そんぞく <br> [sound:4c-k-存続.mp3]
successively, one after another	<b>続々</b> <br> ぞくぞく <br> [sound:4c-k-続々.mp3]
progress, development	<b>進展</b> <br> しんてん <br> [sound:4c-k-進展.mp3]
promotion, acceleration, encouragement, facilitation, spurring on	<b>促進</b> <br> そくしん <br> [sound:4c-k-促進.mp3]
seniority, advance, leadership	<b>先進</b> <br> せんしん <br> [sound:4c-k-先進.mp3]
entering a higher-level school, esp. going on to university	<b>進学</b> <br> しんがく <br> [sound:4c-k-進学.mp3]
due form, official, formality	<b>正式</b> <br> せいしき <br> [sound:4c-k-正式.mp3]
normalcy, normality, normal	<b>正常</b> <br> せいじょう <br> [sound:4c-k-正常.mp3]
correction, revision	<b>是正</b> <br> ぜせい <br> [sound:4c-k-是正.mp3]
justice, right, righteousness, correct meaning	<b>正義</b> <br> せいぎ <br> [sound:4c-k-正義.mp3]
stability, equilibrium	<b>安定</b> <br> あんてい <br> [sound:4c-k-安定.mp3]
anxiety, uneasiness, insecurity, suspense	<b>不安</b> <br> ふあん <br> [sound:4c-k-不安.mp3]
solace, relaxation	<b>慰安</b> <br> いあん <br> [sound:4c-k-慰安.mp3]
safe hit (baseball)	<b>安打</b> <br> あんだ <br> [sound:4c-k-安打.mp3]
equipment, device, facilities, installation	<b>設備</b> <br> せつび <br> [sound:4c-k-設備.mp3]
plan, design, layout	<b>設計</b> <br> せっけい <br> [sound:4c-k-設計.mp3]
establishment, foundation, incorporation (of a business)	<b>設立</b> <br> せつりつ <br> [sound:4c-k-設立.mp3]
establishment, creation; options or preference settings (in computer software), configuration, assignment, setup	<b>設定</b> <br> せってい <br> [sound:4c-k-設定.mp3]
security guarantee (e.g. military security, network security, etc.)	<b>安全保障</b> <br> あんぜんほしょう <br> [sound:4c-k-安全保障.mp3]
guarantee, maintain, ensure, insure, secure, reservation	<b>確保</b> <br> かくほ <br> [sound:4c-k-確保.mp3]
insurance, guarantee	<b>保険</b> <br> ほけん <br> [sound:4c-k-保険.mp3]
maintenance, conservation	<b>保守</b> <br> ほしゅ <br> [sound:4c-k-保守.mp3]
remodeling, remodelling, restructuring; modding	<b>改造</b> <br> かいぞう <br> [sound:4c-k-改造.mp3]
to change, to alter, to revise, to replace; to reform, to correct, to mend, to improve; to examine, to check, to inspect; to do properly, to do formally	<b>改める</b> <br> あらためる <br> [sound:4c-k-改める.mp3]
reform	<b>改定</b> <br> かいてい <br> [sound:4c-k-改定.mp3]
constitutional change	<b>改憲</b> <br> かいけん <br> [sound:4c-k-改憲.mp3]
constant; literal	<b>定数</b> <br> ていすう <br> [sound:4c-k-定数.mp3]
minority, few	<b>少数</b> <br> しょうすう <br> [sound:4c-k-少数.mp3]
several, plural, plurality, multiple	<b>複数</b> <br> ふくすう <br> [sound:4c-k-複数.mp3]
majority	<b>過半数</b> <br> かはんすう <br> [sound:4c-k-過半数.mp3]
clerk, secretary	<b>書記</b> <br> しょき <br> [sound:4c-k-書記.mp3]
commemoration, memory	<b>記念</b> <br> きねん <br> [sound:4c-k-記念.mp3]
memory, recollection, remembrance; storage	<b>記憶</b> <br> きおく <br> [sound:4c-k-記憶.mp3]
to write down, to note; to remember	<b>記す</b> <br> しるす, きす <br> [sound:4c-k-記す.mp3]
lower house, lower (legislative) body	<b>下院</b> <br> かいん <br> [sound:4c-k-下院.mp3]
Upper House, Senate, Lords	<b>上院</b> <br> じょういん <br> [sound:4c-k-上院.mp3]
institute, academy	<b>学院</b> <br> がくいん <br> [sound:4c-k-学院.mp3]
graduate school	<b>大学院</b> <br> だいがくいん <br> [sound:4c-k-大学院.mp3]
man and woman, men and women	<b>男女</b> <br> だんじょ <br> [sound:4c-k-男女.mp3]
she, her; girl friend, girlfriend, sweetheart	<b>彼女</b> <br> かのじょ <br> [sound:4c-k-彼女.mp3]
actress	<b>女優</b> <br> じょゆう <br> [sound:4c-k-女優.mp3]
eldest daughter	<b>長女</b> <br> ちょうじょ <br> [sound:4c-k-長女.mp3]
first or opening day	<b>初日</b> <br> しょにち <br> [sound:4c-k-初日.mp3]
early (days), initial stage; initial	<b>初期</b> <br> しょき <br> [sound:4c-k-初期.mp3]
first generation, founder	<b>初代</b> <br> しょだい <br> [sound:4c-k-初代.mp3]
first match (in a series)	<b>初戦</b> <br> しょせん <br> [sound:4c-k-初戦.mp3]
North Korea	<b>北朝鮮</b> <br> きたちょうせん <br> [sound:4c-k-北朝鮮.mp3]
north-east; Northern most six prefectures of Honshu	<b>東北</b> <br> とうほく, ひがしきた <br> [sound:4c-k-東北.mp3]
south and north	<b>南北</b> <br> なんぼく <br> [sound:4c-k-南北.mp3]
northern (district), northward	<b>北方</b> <br> ほっぽう <br> [sound:4c-k-北方.mp3]
seventh sign of Chinese zodiac (The Horse, 11am-1pm, south, May)	<b>午</b> <br> うま <br> [sound:4c-k-午.mp3]
noon, midday; daytime; lunch	<b>午</b> <br> ひる <br> [sound:4c-k-午.mp3]
the meridian	<b>子午線</b> <br> しごせん <br> [sound:4c-k-子午線.mp3]
Boy's Day celebration (May 5th)	<b>端午</b> <br> たんご <br> [sound:4c-k-端午.mp3]
designation, specification, assignment, appointment, pointing at	<b>指定</b> <br> してい <br> [sound:4c-k-指定.mp3]
name, nominate, designate	<b>指名</b> <br> しめい <br> [sound:4c-k-指名.mp3]
indication, instruction, designation, directions	<b>指示</b> <br> しじ <br> [sound:4c-k-指示.mp3]
pointing out, identification	<b>指摘</b> <br> してき <br> [sound:4c-k-指摘.mp3]
(political) power, authority, influence	<b>権力</b> <br> けんりょく <br> [sound:4c-k-権力.mp3]
human rights, civil liberties	<b>人権</b> <br> じんけん <br> [sound:4c-k-人権.mp3]
power, authority, jurisdiction	<b>権限</b> <br> けんげん <br> [sound:4c-k-権限.mp3]
credit, claim	<b>債権</b> <br> さいけん <br> [sound:4c-k-債権.mp3]
from the bottom of one's heart, heart and soul, by nature	<b>心から</b> <br> しんから, こころから <br> [sound:4c-k-心から.mp3]
heart	<b>心臓</b> <br> しんぞう <br> [sound:4c-k-心臓.mp3]
worry, concern, anxiety; care, help, aid, assistance	<b>心配</b> <br> しんぱい <br> [sound:4c-k-心配.mp3]
mentality	<b>心理</b> <br> しんり <br> [sound:4c-k-心理.mp3]
financial world	<b>財界</b> <br> ざいかい <br> [sound:4c-k-財界.mp3]
limit, bound	<b>限界</b> <br> げんかい <br> [sound:4c-k-限界.mp3]
global, international, world-famous	<b>世界的</b> <br> せかいてき <br> [sound:4c-k-世界的.mp3]
economic world, financial circles	<b>経済界</b> <br> けいざいかい <br> [sound:4c-k-経済界.mp3]
branch store (office)	<b>支店</b> <br> してん <br> [sound:4c-k-支店.mp3]
rule, control, direction	<b>支配</b> <br> しはい <br> [sound:4c-k-支配.mp3]
branch, subdivision	<b>支部</b> <br> しぶ <br> [sound:4c-k-支部.mp3]
income and expenditure	<b>収支</b> <br> しゅうし <br> [sound:4c-k-収支.mp3]
leading person	<b>第一人者</b> <br> だいいちにんしゃ <br> [sound:4c-k-第一人者.mp3]
World War II	<b>第二次世界大戦</b> <br> だいにじせかいたいせん <br> [sound:4c-k-第二次世界大戦.mp3]
the front (of a battlefield), forefront	<b>第一線</b> <br> だいいっせん <br> [sound:4c-k-第一線.mp3]
first tone, first speech	<b>第一声</b> <br> だいいっせい <br> [sound:4c-k-第一声.mp3]
property, fortune, means, assets	<b>資産</b> <br> しさん <br> [sound:4c-k-資産.mp3]
real estate	<b>不動産</b> <br> ふどうさん <br> [sound:4c-k-不動産.mp3]
(former) Ministry of International Trade and Industry (now Ministry of Economy, Trade and Industry), MITI	<b>通産省</b> <br> つうさんしょう <br> [sound:4c-k-通産省.mp3]
communism; Communist Party	<b>共産</b> <br> きょうさん <br> [sound:4c-k-共産.mp3]
conclusion	<b>結論</b> <br> けつろん <br> [sound:4c-k-結論.mp3]
to tie, to bind, to link; to bear (fruit)	<b>結ぶ</b> <br> むすぶ <br> [sound:4c-k-結ぶ.mp3]
formation	<b>結成</b> <br> けっせい <br> [sound:4c-k-結成.mp3]
end, close	<b>終結</b> <br> しゅうけつ <br> [sound:4c-k-終結.mp3]
(department) store(s)	<b>百貨店</b> <br> ひゃっかてん <br> [sound:4c-k-百貨店.mp3]
1,000,000, one million; many	<b>百万</b> <br> ひゃくまん <br> [sound:4c-k-百万.mp3]
four hundred	<b>四百</b> <br> よんひゃく <br> [sound:4c-k-四百.mp3]
10,000,000,000, ten billion (American), (obs) ten milliard (British)	<b>百億</b> <br> ひゃくおく <br> [sound:4c-k-百億.mp3]
right wing	<b>右派</b> <br> うは <br> [sound:4c-k-右派.mp3]
left wing	<b>左派</b> <br> さは <br> [sound:4c-k-左派.mp3]
correspondent	<b>特派員</b> <br> とくはいん <br> [sound:4c-k-特派員.mp3]
tough elements, hard-liners, stalwart(s)	<b>硬派</b> <br> こうは <br> [sound:4c-k-硬派.mp3]
point in time, occasion	<b>時点</b> <br> じてん <br> [sound:4c-k-時点.mp3]
score, points made, marks obtained, runs	<b>得点</b> <br> とくてん <br> [sound:4c-k-得点.mp3]
opinion, point of view, visual point	<b>視点</b> <br> してん <br> [sound:4c-k-視点.mp3]
run charged to the pitcher	<b>失点</b> <br> しってん <br> [sound:4c-k-失点.mp3]
religion	<b>宗教</b> <br> しゅうきょう <br> [sound:4c-k-宗教.mp3]
classroom	<b>教室</b> <br> きょうしつ <br> [sound:4c-k-教室.mp3]
believer, adherent	<b>教徒</b> <br> きょうと <br> [sound:4c-k-教徒.mp3]
textbook, text book	<b>教科書</b> <br> きょうかしょ <br> [sound:4c-k-教科書.mp3]
(written) report	<b>報告書</b> <br> ほうこくしょ <br> [sound:4c-k-報告書.mp3]
PR, public relations, publicity, information	<b>広報</b> <br> こうほう <br> [sound:4c-k-広報.mp3]
remuneration, recompense, reward, toll	<b>報酬</b> <br> ほうしゅう <br> [sound:4c-k-報酬.mp3]
press corps	<b>報道陣</b> <br> ほうどうじん <br> [sound:4c-k-報道陣.mp3]
economic, economical	<b>経済的</b> <br> けいざいてき <br> [sound:4c-k-経済的.mp3]
economic world, financial circles	<b>経済界</b> <br> けいざいかい <br> [sound:4c-k-経済界.mp3]
Economic Planning Agency	<b>経済企画庁</b> <br> けいざいきかくちょう <br> [sound:4c-k-経済企画庁.mp3]
mutual aid	<b>共済</b> <br> きょうさい <br> [sound:4c-k-共済.mp3]
document, writing, letter, paperwork, note, records, archives	<b>文書</b> <br> ぶんしょ, もんじょ <br> [sound:4c-k-文書.mp3]
textbook, text book	<b>教科書</b> <br> きょうかしょ <br> [sound:4c-k-教科書.mp3]
bookshop, bookstore	<b>書店</b> <br> しょてん <br> [sound:4c-k-書店.mp3]
literary work, book	<b>著書</b> <br> ちょしょ <br> [sound:4c-k-著書.mp3]
prefectural police	<b>府警</b> <br> ふけい <br> [sound:4c-k-府警.mp3]
managed by an urban prefecture	<b>府立</b> <br> ふりつ <br> [sound:4c-k-府立.mp3]
Fuchuu (in Tokyo)	<b>府中</b> <br> ふちゅう <br> [sound:4c-k-府中.mp3]
state government	<b>州政府</b> <br> しゅうせいふ <br> [sound:4c-k-州政府.mp3]
activity	<b>活性</b> <br> かっせい <br> [sound:4c-k-活性.mp3]
activity (esp. energetic), great efforts, conspicuous service; to flourish, to participate actively, to play an active role	<b>活躍</b> <br> かつやく <br> [sound:4c-k-活躍.mp3]
revival (e.g. musical), come-back; restoration, rebirth, resurrection	<b>復活</b> <br> ふっかつ <br> [sound:4c-k-復活.mp3]
practical use, application; conjugation, declension, inflection	<b>活用</b> <br> かつよう <br> [sound:4c-k-活用.mp3]
plaintiff, accuser, prosecutor	<b>原告</b> <br> げんこく <br> [sound:4c-k-原告.mp3]
nuclear power plant, nuclear power supply	<b>原発</b> <br> げんぱつ <br> [sound:4c-k-原発.mp3]
crude oil	<b>原油</b> <br> げんゆ <br> [sound:4c-k-原油.mp3]
principle, theory, fundamental truth	<b>原理</b> <br> げんり <br> [sound:4c-k-原理.mp3]
teacher, master, doctor; with names of teachers, etc. as an honorific	<b>先生</b> <br> せんせい <br> [sound:4c-k-先生.mp3]
forerunner, advance party, going on ahead; being in a (team sports) match or game from the start, starting	<b>先発</b> <br> せんぱつ <br> [sound:4c-k-先発.mp3]
preference, priority, precedence	<b>優先</b> <br> ゆうせん <br> [sound:4c-k-優先.mp3]
seniority, advance, leadership	<b>先進</b> <br> せんしん <br> [sound:4c-k-先進.mp3]
sharing with, participate in, both, alike, together, along with, with, including	<b>共に</b> <br> ともに <br> [sound:4c-k-共に.mp3]
commonness, community	<b>共通</b> <br> きょうつう <br> [sound:4c-k-共通.mp3]
cooperative body, cooperative system, collective, community	<b>共同体</b> <br> きょうどうたい <br> [sound:4c-k-共同体.mp3]
public, community, public service, society, communal	<b>公共</b> <br> こうきょう <br> [sound:4c-k-公共.mp3]
score, points made, marks obtained, runs	<b>得点</b> <br> とくてん <br> [sound:4c-k-得点.mp3]
acquisition, possession	<b>獲得</b> <br> かくとく <br> [sound:4c-k-獲得.mp3]
persuasion	<b>説得</b> <br> せっとく <br> [sound:4c-k-説得.mp3]
number of votes polled, poll votes	<b>得票</b> <br> とくひょう <br> [sound:4c-k-得票.mp3]
understanding, comprehension	<b>理解</b> <br> りかい <br> [sound:4c-k-理解.mp3]
cancellation, rescinding, release, calling off, lifting (sanctions), delisting	<b>解除</b> <br> かいじょ <br> [sound:4c-k-解除.mp3]
release, unleashing, liberation, emancipation, setting free; deallocation (of computer memory)	<b>解放</b> <br> かいほう <br> [sound:4c-k-解放.mp3]
clarification, elucidation, explication	<b>解明</b> <br> かいめい <br> [sound:4c-k-解明.mp3]
name, nominate, designate	<b>指名</b> <br> しめい <br> [sound:4c-k-指名.mp3]
full name, identity	<b>氏名</b> <br> しめい <br> [sound:4c-k-氏名.mp3]
famous; fame	<b>有名</b> <br> ゆうめい <br> [sound:4c-k-有名.mp3]
signature	<b>署名</b> <br> しょめい <br> [sound:4c-k-署名.mp3]
exchange, interchange, switching, reciprocity, barter, substitution, replacement, clearing (of checks, cheques)	<b>交換</b> <br> こうかん <br> [sound:4c-k-交換.mp3]
communication, transportation, traffic, intercourse	<b>交通</b> <br> こうつう <br> [sound:4c-k-交通.mp3]
diplomatic relations	<b>国交</b> <br> こっこう <br> [sound:4c-k-国交.mp3]
alternation, change, relief, relay, shift, substitution (sports, etc.)	<b>交代</b> <br> こうたい <br> [sound:4c-k-交代.mp3]
property, fortune, means, assets	<b>資産</b> <br> しさん <br> [sound:4c-k-資産.mp3]
materials, data, document	<b>資料</b> <br> しりょう <br> [sound:4c-k-資料.mp3]
qualifications, requirements, capabilities	<b>資格</b> <br> しかく <br> [sound:4c-k-資格.mp3]
resources	<b>資源</b> <br> しげん <br> [sound:4c-k-資源.mp3]
expectation, anticipation, prediction, forecast	<b>予想</b> <br> よそう <br> [sound:4c-k-予想.mp3]
prediction, estimation	<b>予測</b> <br> よそく <br> [sound:4c-k-予測.mp3]
preparation, preliminaries, reserve, spare	<b>予備</b> <br> よび <br> [sound:4c-k-予備.mp3]
prevention, precaution, protection against	<b>予防</b> <br> よぼう <br> [sound:4c-k-予防.mp3]
mountain stream	<b>谷川</b> <br> たにがわ <br> [sound:4c-k-谷川.mp3]
Edo River	<b>江戸川</b> <br> えどがわ <br> [sound:4c-k-江戸川.mp3]
mouth of river, estuary	<b>川口</b> <br> かわぐち, かこう <br> [sound:4c-k-川口.mp3]
upper reaches of a river	<b>川上</b> <br> かわかみ <br> [sound:4c-k-川上.mp3]
direction, orientation, aspect, situation, exposure, suitability, tendency	<b>向き</b> <br> むき <br> [sound:4c-k-向き.mp3]
elevation, rise, improvement, advancement, progress	<b>向上</b> <br> こうじょう <br> [sound:4c-k-向上.mp3]
trend, tendency, movement, attitude	<b>動向</b> <br> どうこう <br> [sound:4c-k-動向.mp3]
facing, opposite, across the street, other side	<b>向い</b> <br> むかい <br> [sound:4c-k-向い.mp3]
practicality, practical; reality, actuality, actual conditions; bhutakoti (limit of reality)	<b>実際</b> <br> じっさい <br> [sound:4c-k-実際.mp3]
internationalization, internationalisation, i18n (in IT)	<b>国際化</b> <br> こくさいか <br> [sound:4c-k-国際化.mp3]
international laws	<b>国際法</b> <br> こくさいほう <br> [sound:4c-k-国際法.mp3]
company, friendship, association, society, acquaintance	<b>交際</b> <br> こうさい <br> [sound:4c-k-交際.mp3]
inspection (for compliance), investigation (tax, etc.)	<b>査察</b> <br> ささつ <br> [sound:4c-k-査察.mp3]
judging, inspection, examination, investigation	<b>審査</b> <br> しんさ <br> [sound:4c-k-審査.mp3]
factual investigation	<b>実態調査</b> <br> じったいちょうさ <br> [sound:4c-k-実態調査.mp3]
auditor, inspector	<b>監査役</b> <br> かんさやく <br> [sound:4c-k-監査役.mp3]
decision of a contest, finals (in sports)	<b>決勝</b> <br> けっしょう <br> [sound:4c-k-決勝.mp3]
victory, triumph, conquest, success, win	<b>勝利</b> <br> しょうり <br> [sound:4c-k-勝利.mp3]
victory or defeat, match, contest, game, bout	<b>勝負</b> <br> しょうぶ <br> [sound:4c-k-勝負.mp3]
consecutive victories, series of victories	<b>連勝</b> <br> れんしょう <br> [sound:4c-k-連勝.mp3]
scene, setting (e.g. of novel)	<b>場面</b> <br> ばめん <br> [sound:4c-k-場面.mp3]
terminal screen, scene, picture, the field (in TV), photo	<b>画面</b> <br> がめん <br> [sound:4c-k-画面.mp3]
checkerboard, aspect, situation	<b>局面</b> <br> きょくめん <br> [sound:4c-k-局面.mp3]
society or local news page	<b>社会面</b> <br> しゃかいめん <br> [sound:4c-k-社会面.mp3]
Fair Trade Commission	<b>公取委</b> <br> こうとりい <br> [sound:4c-k-公取委.mp3]
consign (goods (for sale) to a firm), entrust (person with something), commit	<b>委託</b> <br> いたく <br> [sound:4c-k-委託.mp3]
Board of Education	<b>教育委員会</b> <br> きょういくいいんかい <br> [sound:4c-k-教育委員会.mp3]
executive committee	<b>執行委員</b> <br> しっこういいん <br> [sound:4c-k-執行委員.mp3]
advertisement	<b>広告</b> <br> こうこく <br> [sound:4c-k-広告.mp3]
(written) report	<b>報告書</b> <br> ほうこくしょ <br> [sound:4c-k-報告書.mp3]
plaintiff, accuser, prosecutor	<b>原告</b> <br> げんこく <br> [sound:4c-k-原告.mp3]
advice, counsel, remonstrance, recommendation	<b>勧告</b> <br> かんこく <br> [sound:4c-k-勧告.mp3]
disarmament, limitation of arms	<b>軍縮</b> <br> ぐんしゅく <br> [sound:4c-k-軍縮.mp3]
Air Force	<b>空軍</b> <br> くうぐん <br> [sound:4c-k-空軍.mp3]
military personnel, soldier	<b>軍人</b> <br> ぐんじん <br> [sound:4c-k-軍人.mp3]
military authorities, army circles	<b>軍部</b> <br> ぐんぶ <br> [sound:4c-k-軍部.mp3]
document, writing, letter, paperwork, note, records, archives	<b>文書</b> <br> ぶんしょ, もんじょ <br> [sound:4c-k-文書.mp3]
letter (of alphabet), character; literal	<b>文字</b> <br> もじ, もんじ <br> [sound:4c-k-文字.mp3]
Ministry of Education, Culture, Sports, Science and Technology	<b>文部省</b> <br> もんぶしょう <br> [sound:4c-k-文部省.mp3]
order, request	<b>注文</b> <br> ちゅうもん <br> [sound:4c-k-注文.mp3]
reaction, response	<b>反応</b> <br> はんのう <br> [sound:4c-k-反応.mp3]
reflection, reconsideration, introspection, meditation, contemplation	<b>反省</b> <br> はんせい <br> [sound:4c-k-反省.mp3]
variable measure of fabric (28.8 cm in width), for kimonos: at least 10 m in length, for haori: at least 7.27 m in length, for other clothes: at least 6.06 m in length; 300 tsubo (991.74 meters square, 0.24506 acres); six ken (10.91 m)	<b>反</b> <br> たん <br> [sound:4c-k-反.mp3]
echo, reverberation, repercussion, reaction, influence	<b>反響</b> <br> はんきょう <br> [sound:4c-k-反響.mp3]
health(y), robust, vigor, vigour, energy, vitality, vim, stamina, spirit, courage, pep	<b>元気</b> <br> げんき <br> [sound:4c-k-元気.mp3]
New Year's Day	<b>元日</b> <br> がんじつ, がんにち <br> [sound:4c-k-元日.mp3]
person's identity, ID, past, background	<b>身元</b> <br> みもと <br> [sound:4c-k-身元.mp3]
at one's feet, underfoot; gait, pace, step; you, thou	<b>足元</b> <br> あしもと, そっか <br> [sound:4c-k-足元.mp3]
importance, weight, dignity, emphasis	<b>重み</b> <br> おもみ <br> [sound:4c-k-重み.mp3]
precious, valuable	<b>貴重</b> <br> きちょう <br> [sound:4c-k-貴重.mp3]
to pile up, to put something on another, to heap up, to add, to repeat	<b>重ねる</b> <br> かさねる <br> [sound:4c-k-重ねる.mp3]
importance, stress, serious consideration	<b>重視</b> <br> じゅうし <br> [sound:4c-k-重視.mp3]
Kinki Nippon Tetsudou (railway co.)	<b>近鉄</b> <br> きんてつ <br> [sound:4c-k-近鉄.mp3]
close associate, close aide, brains-truster	<b>側近</b> <br> そっきん <br> [sound:4c-k-側近.mp3]
neighbourhood, neighborhood	<b>近所</b> <br> きんじょ <br> [sound:4c-k-近所.mp3]
recent years	<b>近年</b> <br> きんねん <br> [sound:4c-k-近年.mp3]
thousand years; very long period, forever	<b>千代</b> <br> せんだい, ちよ <br> [sound:4c-k-千代.mp3]
1000 ri, (a) long distance	<b>千里</b> <br> せんり <br> [sound:4c-k-千里.mp3]
concluding festivities, final day of a sumo tournament, concluding program, concluding programme	<b>千秋楽</b> <br> せんしゅうらく <br> [sound:4c-k-千秋楽.mp3]
Kurile Islands	<b>千島</b> <br> ちしま <br> [sound:4c-k-千島.mp3]
selection, screening	<b>選考</b> <br> せんこう <br> [sound:4c-k-選考.mp3]
to consider, to think about	<b>考える</b> <br> かんがえる <br> [sound:4c-k-考える.mp3]
thought, consideration, thinking	<b>思考</b> <br> しこう <br> [sound:4c-k-思考.mp3]
archaeology, archeology	<b>考古学</b> <br> こうこがく <br> [sound:4c-k-考古学.mp3]
criticism, judgement, judgment, comment	<b>批判</b> <br> ひはん <br> [sound:4c-k-批判.mp3]
public hearing, trial	<b>公判</b> <br> こうはん <br> [sound:4c-k-公判.mp3]
court, courthouse	<b>裁判所</b> <br> さいばんしょ <br> [sound:4c-k-裁判所.mp3]
refereeing, trial, judgement, judgment, umpire, referee	<b>審判</b> <br> しんぱん, しんばん <br> [sound:4c-k-審判.mp3]
official recognition, authorization, authorisation, licence, license, accreditation	<b>公認</b> <br> こうにん <br> [sound:4c-k-公認.mp3]
authorization, authorisation, acknowledgment, acknowledgement, certification, recognition	<b>認定</b> <br> にんてい <br> [sound:4c-k-認定.mp3]
approval, license, licence, permission	<b>認可</b> <br> にんか <br> [sound:4c-k-認可.mp3]
approval	<b>容認</b> <br> ようにん <br> [sound:4c-k-容認.mp3]
planning, project, plan, design	<b>企画</b> <br> きかく <br> [sound:4c-k-企画.mp3]
picture, painting	<b>絵画</b> <br> かいが <br> [sound:4c-k-絵画.mp3]
terminal screen, scene, picture, the field (in TV), photo	<b>画面</b> <br> がめん <br> [sound:4c-k-画面.mp3]
painter, artist	<b>画家</b> <br> がか <br> [sound:4c-k-画家.mp3]
region south of Tokyo on Pacific Ocean side of Japan, eastern sea	<b>東海</b> <br> とうかい <br> [sound:4c-k-東海.mp3]
navy	<b>海軍</b> <br> かいぐん <br> [sound:4c-k-海軍.mp3]
(by, at, on) sea, maritime, marine	<b>海上</b> <br> かいじょう <br> [sound:4c-k-海上.mp3]
coast, beach	<b>海岸</b> <br> かいがん <br> [sound:4c-k-海岸.mp3]
participation	<b>参加</b> <br> さんか <br> [sound:4c-k-参加.mp3]
reference, bibliographical reference, consultation, browsing (e.g. when selecting a file to upload on a computer), checking out	<b>参照</b> <br> さんしょう <br> [sound:4c-k-参照.mp3]
councillor, councilor	<b>参事官</b> <br> さんじかん <br> [sound:4c-k-参事官.mp3]
sales, selling, marketing	<b>販売</b> <br> はんばい <br> [sound:4c-k-販売.mp3]
sale, selling; selling point, gimmick	<b>売り</b> <br> うり <br> [sound:4c-k-売り.mp3]
trade, business, commerce, transaction, occupation	<b>商売</b> <br> しょうばい <br> [sound:4c-k-商売.mp3]
place where things are sold, point of sale, POS, sales floor, counter (in shop)	<b>売り場</b> <br> うりば <br> [sound:4c-k-売り場.mp3]
advantage, benefit, profit, interest	<b>利</b> <br> り <br> [sound:4c-k-利.mp3]
interest rates	<b>金利</b> <br> きんり <br> [sound:4c-k-金利.mp3]
current profits, ordinary profit, income before income taxes	<b>経常利益</b> <br> けいじょうりえき <br> [sound:4c-k-経常利益.mp3]
decrease in interest rates	<b>利下げ</b> <br> りさげ <br> [sound:4c-k-利下げ.mp3]
set (of items); group (of people), class (of students), company (esp. construction), family (i.e. mafia), team; typesetting, composition	<b>組</b> <br> くみ <br> [sound:4c-k-組.mp3]
organization, organisation; structure, construction; tissue; system	<b>組織</b> <br> そしき <br> [sound:4c-k-組織.mp3]
labor union, labour union	<b>労働組合</b> <br> ろうどうくみあい <br> [sound:4c-k-労働組合.mp3]
boss (yakuza)	<b>組長</b> <br> くみちょう <br> [sound:4c-k-組長.mp3]
to know, to understand, to be acquainted with, to feel	<b>知る</b> <br> しる <br> [sound:4c-k-知る.mp3]
prefectural governor	<b>知事</b> <br> ちじ <br> [sound:4c-k-知事.mp3]
notice, notification, report, posting	<b>通知</b> <br> つうち <br> [sound:4c-k-通知.mp3]
lieutenant governor	<b>副知事</b> <br> ふくちじ <br> [sound:4c-k-副知事.mp3]
bill (law)	<b>法案</b> <br> ほうあん <br> [sound:4c-k-法案.mp3]
proposal, proposition, suggestion	<b>提案</b> <br> ていあん <br> [sound:4c-k-提案.mp3]
tentative	<b>試案</b> <br> しあん <br> [sound:4c-k-試案.mp3]
draft, draught, (rough) design	<b>立案</b> <br> りつあん <br> [sound:4c-k-立案.mp3]
road, street, way, path, course, route, lane; distance, ways (e.g. "a long ways"); the way (of proper conduct, etc.), one's way, morals; teachings (esp. Confucian or Buddhist), dogma; field (of medicine, etc.), subject; way, method, means	<b>道</b> <br> みち <br> [sound:4c-k-道.mp3]
information, report, journalism	<b>報道</b> <br> ほうどう <br> [sound:4c-k-報道.mp3]
press corps	<b>報道陣</b> <br> ほうどうじん <br> [sound:4c-k-報道陣.mp3]
highway, freeway, expressway, motorway	<b>高速道路</b> <br> こうそくどうろ <br> [sound:4c-k-高速道路.mp3]
honesty, fidelity; trust, reliance; (religious) faith; counter for received messages	<b>信</b> <br> しん <br> [sound:4c-k-信.mp3]
correspondence, communication, transmission, news, signal	<b>通信</b> <br> つうしん <br> [sound:4c-k-通信.mp3]
traffic lights, signal, semaphore	<b>信号</b> <br> しんごう <br> [sound:4c-k-信号.mp3]
reception (e.g. radio), receipt	<b>受信</b> <br> じゅしん <br> [sound:4c-k-受信.mp3]
political measures, policy	<b>政策</b> <br> せいさく <br> [sound:4c-k-政策.mp3]
counter-plan, counter-measure	<b>対策</b> <br> たいさく <br> [sound:4c-k-対策.mp3]
last resort, desperate measure taken under pressure of necessity	<b>苦肉の策</b> <br> くにくのさく <br> [sound:4c-k-苦肉の策.mp3]
national policy	<b>国策</b> <br> こくさく <br> [sound:4c-k-国策.mp3]
to collect, to assemble, to gather	<b>集める</b> <br> あつめる <br> [sound:4c-k-集める.mp3]
meeting, assembly	<b>集会</b> <br> しゅうかい <br> [sound:4c-k-集会.mp3]
collection, compilation	<b>集</b> <br> しゅう <br> [sound:4c-k-集.mp3]
feature (e.g. newspaper), special edition, report	<b>特集</b> <br> とくしゅう <br> [sound:4c-k-特集.mp3]
to be (usu. of inanimate objects), to exist, to live; to have; to be located; to be equipped with; to happen, to come about	<b>在る</b> <br> ある <br> [sound:4c-k-在る.mp3]
now, current, present, present time, as of	<b>現在</b> <br> げんざい <br> [sound:4c-k-現在.mp3]
being in, being at home	<b>在宅</b> <br> ざいたく <br> [sound:4c-k-在宅.mp3]
absence	<b>不在</b> <br> ふざい <br> [sound:4c-k-不在.mp3]
matter, case, item	<b>件</b> <br> けん <br> [sound:4c-k-件.mp3]
event, affair, incident, case, plot, trouble, scandal	<b>事件</b> <br> じけん <br> [sound:4c-k-事件.mp3]
requirement, important matter	<b>要件</b> <br> ようけん <br> [sound:4c-k-要件.mp3]
matter in question, subject	<b>案件</b> <br> あんけん <br> [sound:4c-k-案件.mp3]
organization, organisation, association	<b>団体</b> <br> だんたい <br> [sound:4c-k-団体.mp3]
group, mass	<b>集団</b> <br> しゅうだん <br> [sound:4c-k-集団.mp3]
incorporated foundation, juridical foundation	<b>財団法人</b> <br> ざいだんほうじん <br> [sound:4c-k-財団法人.mp3]
public corporation	<b>公団</b> <br> こうだん <br> [sound:4c-k-公団.mp3]
(not) particularly, nothing; separately, apart	<b>別に</b> <br> べつに <br> [sound:4c-k-別に.mp3]
farewell, leave-taking	<b>告別</b> <br> こくべつ <br> [sound:4c-k-告別.mp3]
distinction by sex, sex, gender	<b>性別</b> <br> せいべつ <br> [sound:4c-k-性別.mp3]
distinction, differentiation, classification	<b>区別</b> <br> くべつ <br> [sound:4c-k-区別.mp3]
character, personality, person, man, personage, talented man	<b>人物</b> <br> じんぶつ <br> [sound:4c-k-人物.mp3]
animal	<b>動物</b> <br> どうぶつ <br> [sound:4c-k-動物.mp3]
museum	<b>博物館</b> <br> はくぶつかん <br> [sound:4c-k-博物館.mp3]
goods, materials	<b>物資</b> <br> ぶっし <br> [sound:4c-k-物資.mp3]
near, close, beside, vicinity, proximity, besides, while; third person	<b>側</b> <br> そば, そく, はた <br> [sound:4c-k-側.mp3]
west side, west bank	<b>西側</b> <br> にしがわ <br> [sound:4c-k-西側.mp3]
the reverse, other side, lining	<b>裏側</b> <br> うらがわ <br> [sound:4c-k-裏側.mp3]
exterior, outside	<b>外側</b> <br> そとがわ, がいそく <br> [sound:4c-k-外側.mp3]
duty, responsibility; liability, onus	<b>責任</b> <br> せきにん <br> [sound:4c-k-責任.mp3]
to resign; resignation	<b>辞任</b> <br> じにん <br> [sound:4c-k-辞任.mp3]
person in charge, responsible official	<b>主任</b> <br> しゅにん <br> [sound:4c-k-主任.mp3]
duty, function, office, mission, task	<b>任務</b> <br> にんむ <br> [sound:4c-k-任務.mp3]
transactions, dealings, business	<b>取引</b> <br> とりひき <br> [sound:4c-k-取引.mp3]
reduction, cut	<b>引き下げ</b> <br> ひきさげ <br> [sound:4c-k-引き下げ.mp3]
continuing for a long time, in succession, without a break	<b>引き続き</b> <br> ひきつづき <br> [sound:4c-k-引き続き.mp3]
discount, reduction, rebate, tenths discounted	<b>割引</b> <br> わりびき <br> [sound:4c-k-割引.mp3]
to send, to dispatch, to despatch	<b>使わす</b> <br> つかわす <br> [sound:4c-k-使わす.mp3]
to use (a thing, method, etc.), to make use of, to put to use; to use (a person, animal, puppet, etc.), to employ, to handle, to manage, to manipulate; to use (time, money, etc.), to spend, to consume; to use (language), to speak; to take (one's lunch), to circulate (bad money)	<b>使う</b> <br> つかう <br> [sound:4c-k-使う.mp3]
special envoy	<b>特使</b> <br> とくし <br> [sound:4c-k-特使.mp3]
labour and management, labor and management	<b>労使</b> <br> ろうし <br> [sound:4c-k-労使.mp3]
demand, firm request, requisition, requirement, desire	<b>要求</b> <br> ようきゅう <br> [sound:4c-k-要求.mp3]
claim, demand, charge, application, request, billing (for a service)	<b>請求</b> <br> せいきゅう <br> [sound:4c-k-請求.mp3]
pursuing (goal), pursuit, seeking, search; to pursue (e.g. goal), to seek	<b>追求</b> <br> ついきゅう <br> [sound:4c-k-追求.mp3]
job hunting, seeking employment	<b>求職</b> <br> きゅうしょく <br> [sound:4c-k-求職.mp3]
office	<b>事務所</b> <br> じむしょ <br> [sound:4c-k-事務所.mp3]
place, location	<b>場所</b> <br> ばしょ <br> [sound:4c-k-場所.mp3]
attached to, belong to, member	<b>所属</b> <br> しょぞく <br> [sound:4c-k-所属.mp3]
independent	<b>無所属</b> <br> むしょぞく <br> [sound:4c-k-無所属.mp3]
vice-minister, undersecretary	<b>次官</b> <br> じかん <br> [sound:4c-k-次官.mp3]
permanent vice-president, undersecretary, vice-minister	<b>事務次官</b> <br> じむじかん <br> [sound:4c-k-事務次官.mp3]
parliamentary vice-minister	<b>政務次官</b> <br> せいむじかん <br> [sound:4c-k-政務次官.mp3]
the 53 Toukaidou stages	<b>五十三次</b> <br> ごじゅうさんつぎ <br> [sound:4c-k-五十三次.mp3]
water (cold, fresh)	<b>水</b> <br> みず <br> [sound:4c-k-水.mp3]
level, standard; water level	<b>水準</b> <br> すいじゅん <br> [sound:4c-k-水準.mp3]
water quality	<b>水質</b> <br> すいしつ <br> [sound:4c-k-水質.mp3]
drain, sewer, drainage system	<b>下水道</b> <br> げすいどう <br> [sound:4c-k-下水道.mp3]
half	<b>半</b> <br> はん <br> [sound:4c-k-半.mp3]
about an hour, short time; half past (the hour)	<b>時半</b> <br> じはん <br> [sound:4c-k-時半.mp3]
Korean peninsula	<b>朝鮮半島</b> <br> ちょうせんはんとう <br> [sound:4c-k-朝鮮半島.mp3]
half the number; haploid	<b>半数</b> <br> はんすう <br> [sound:4c-k-半数.mp3]
work (e.g. book, film, composition, etc.), opus, performance, production	<b>作品</b> <br> さくひん <br> [sound:4c-k-作品.mp3]
commodity, article of commerce, goods, stock, merchandise	<b>商品</b> <br> しょうひん <br> [sound:4c-k-商品.mp3]
kind (of goods), brand; (taxonomical) form; breed, cultivar	<b>品種</b> <br> ひんしゅ <br> [sound:4c-k-品種.mp3]
list of articles	<b>品目</b> <br> ひんもく <br> [sound:4c-k-品目.mp3]
last year	<b>昨年</b> <br> さくねん <br> [sound:4c-k-昨年.mp3]
year before last	<b>一昨年</b> <br> いっさくねん, おととし <br> [sound:4c-k-一昨年.mp3]
evening; last night	<b>昨夜</b> <br> ゆう, ゆうべ, さくや <br> [sound:4c-k-昨夜.mp3]
last winter	<b>昨冬</b> <br> さくとう <br> [sound:4c-k-昨冬.mp3]
discussion, argument, debate	<b>論議</b> <br> ろんぎ <br> [sound:4c-k-論議.mp3]
argument, discussion, dispute, controversy	<b>議論</b> <br> ぎろん <br> [sound:4c-k-議論.mp3]
controversy, dispute	<b>論争</b> <br> ろんそう <br> [sound:4c-k-論争.mp3]
logic; logical	<b>論理</b> <br> ろんり <br> [sound:4c-k-論理.mp3]
plan; meter, measuring device; (in) total, total (of)	<b>計</b> <br> けい <br> [sound:4c-k-計.mp3]
plan, project, schedule, scheme, program, programme	<b>計画</b> <br> けいかく <br> [sound:4c-k-計画.mp3]
totalization, totalisation, aggregate	<b>集計</b> <br> しゅうけい <br> [sound:4c-k-集計.mp3]
household economy, family finances	<b>家計</b> <br> かけい <br> [sound:4c-k-家計.mp3]
death, decease; death penalty (by strangulation or decapitation)	<b>死</b> <br> し <br> [sound:4c-k-死.mp3]
casualty, deceased	<b>死者</b> <br> ししゃ <br> [sound:4c-k-死者.mp3]
after death	<b>死後</b> <br> しご <br> [sound:4c-k-死後.mp3]
dead body, corpse, cadaver	<b>死体</b> <br> したい <br> [sound:4c-k-死体.mp3]
secretary (government), director, chief	<b>長官</b> <br> ちょうかん <br> [sound:4c-k-長官.mp3]
official residence	<b>官邸</b> <br> かんてい <br> [sound:4c-k-官邸.mp3]
government secretariat	<b>官房</b> <br> かんぼう <br> [sound:4c-k-官房.mp3]
Secretary of State	<b>国務長官</b> <br> こくむちょうかん <br> [sound:4c-k-国務長官.mp3]
increase, increment, addition	<b>増加</b> <br> ぞうか <br> [sound:4c-k-増加.mp3]
tax increase	<b>増税</b> <br> ぞうぜい <br> [sound:4c-k-増税.mp3]
increased (profit)	<b>増益</b> <br> ぞうえき <br> [sound:4c-k-増益.mp3]
increased amount	<b>増額</b> <br> ぞうがく <br> [sound:4c-k-増額.mp3]
official, duty, person in charge	<b>係</b> <br> かかり <br> [sound:4c-k-係.mp3]
relation, connection	<b>関係</b> <br> かんけい <br> [sound:4c-k-関係.mp3]
contention, dispute	<b>係争</b> <br> けいそう <br> [sound:4c-k-係争.mp3]
good teamwork play (baseball)	<b>連係プレー</b> <br> れんけいプレー <br> [sound:4c-k-連係プレー.mp3]
feeling, sense, impression	<b>感じ</b> <br> かんじ <br> [sound:4c-k-感じ.mp3]
sense, sensation, feeling	<b>感覚</b> <br> かんかく <br> [sound:4c-k-感覚.mp3]
sensitivity, sensitiveness, sense	<b>感性</b> <br> かんせい <br> [sound:4c-k-感性.mp3]
feelings (actual, true)	<b>実感</b> <br> じっかん <br> [sound:4c-k-実感.mp3]
particularly, especially	<b>特に</b> <br> とくに <br> [sound:4c-k-特に.mp3]
special	<b>特別</b> <br> とくべつ <br> [sound:4c-k-特別.mp3]
special envoy	<b>特使</b> <br> とくし <br> [sound:4c-k-特使.mp3]
feature (e.g. newspaper), special edition, report	<b>特集</b> <br> とくしゅう <br> [sound:4c-k-特集.mp3]
feelings, emotion, passion	<b>情</b> <br> じょう <br> [sound:4c-k-情.mp3]
circumstances, consideration, conditions, situation, reasons	<b>事情</b> <br> じじょう <br> [sound:4c-k-事情.mp3]
passion, enthusiasm, zeal	<b>情熱</b> <br> じょうねつ <br> [sound:4c-k-情熱.mp3]
love, affection	<b>愛情</b> <br> あいじょう <br> [sound:4c-k-愛情.mp3]
investment	<b>投資</b> <br> とうし <br> [sound:4c-k-投資.mp3]
(baseball) pitcher	<b>投手</b> <br> とうしゅ <br> [sound:4c-k-投手.mp3]
speculation, venture, stockjobbing, gambling (on stocks)	<b>投機</b> <br> とうき <br> [sound:4c-k-投機.mp3]
abandonment, giving up, throwing away	<b>投棄</b> <br> とうき <br> [sound:4c-k-投棄.mp3]
to denote, to show, to point out, to indicate, to exemplify	<b>示す</b> <br> しめす <br> [sound:4c-k-示す.mp3]
indication, instruction, designation, directions	<b>指示</b> <br> しじ <br> [sound:4c-k-指示.mp3]
presentation, exhibit, suggest, citation	<b>提示</b> <br> ていじ <br> [sound:4c-k-提示.mp3]
declaration of intention	<b>意思表示</b> <br> いしひょうじ <br> [sound:4c-k-意思表示.mp3]
another, different, various, particular, unusual, novel, peculiar	<b>変わった</b> <br> かわった <br> [sound:4c-k-変わった.mp3]
constant, invariant	<b>変わらない</b> <br> かわらない <br> [sound:4c-k-変わらない.mp3]
strange, odd, peculiar, weird, curious, queer, eccentric, funny, suspicious, fishy; unexpected; change; incident, disturbance, disaster, accident; flat (music)	<b>変</b> <br> へん <br> [sound:4c-k-変.mp3]
change, reform, revolution, upheaval; Reformation	<b>変革</b> <br> へんかく <br> [sound:4c-k-変革.mp3]
to hit (something inanimate), to strike, to beat (on something); to type, to tap (e.g. a key); to inject; to indulge in gambling; to visit (on a pilgrimage)	<b>打つ</b> <br> うつ <br> [sound:4c-k-打つ.mp3]
home run (baseball)	<b>本塁打</b> <br> ほんるいだ <br> [sound:4c-k-本塁打.mp3]
launch	<b>打ち上げ</b> <br> うちあげ <br> [sound:4c-k-打ち上げ.mp3]
break in the deadlock	<b>打開</b> <br> だかい <br> [sound:4c-k-打開.mp3]
man	<b>男</b> <br> おとこ <br> [sound:4c-k-男.mp3]
youth, young man	<b>男子</b> <br> だんし <br> [sound:4c-k-男子.mp3]
boy, eldest son	<b>一男</b> <br> いちなん <br> [sound:4c-k-一男.mp3]
actor	<b>男優</b> <br> だんゆう <br> [sound:4c-k-男優.mp3]
foundation, basis, standard	<b>基本</b> <br> きほん <br> [sound:4c-k-基本.mp3]
standard, basis, criterion, norm, reference, datum	<b>基準</b> <br> きじゅん <br> [sound:4c-k-基準.mp3]
mainstay, nucleus, key	<b>基幹</b> <br> きかん <br> [sound:4c-k-基幹.mp3]
key, yardstick, criterion, standard	<b>基軸</b> <br> きじく <br> [sound:4c-k-基軸.mp3]
I, me; private affairs, personal matter, secrecy; selfishness	<b>私</b> <br> わたし, わたくし <br> [sound:4c-k-私.mp3]
private (establishment)	<b>私立</b> <br> しりつ, わたくしりつ <br> [sound:4c-k-私立.mp3]
private document	<b>私文書</b> <br> しぶんしょ <br> [sound:4c-k-私文書.mp3]
private	<b>私設</b> <br> しせつ <br> [sound:4c-k-私設.mp3]
individual, each	<b>各自</b> <br> かくじ <br> [sound:4c-k-各自.mp3]
vocational school	<b>各種学校</b> <br> かくしゅがっこう <br> [sound:4c-k-各種学校.mp3]
each one	<b>各員</b> <br> かくいん <br> [sound:4c-k-各員.mp3]
every station	<b>各駅</b> <br> かくえき <br> [sound:4c-k-各駅.mp3]
start, commencement, beginning, initiation	<b>開始</b> <br> かいし <br> [sound:4c-k-開始.mp3]
origin, beginning	<b>始まり</b> <br> はじまり <br> [sound:4c-k-始まり.mp3]
first train	<b>始発</b> <br> しはつ <br> [sound:4c-k-始発.mp3]
outset	<b>手始め</b> <br> てはじめ <br> [sound:4c-k-手始め.mp3]
island; territory (of a prostitute, organized crime gang, etc.), turf	<b>島</b> <br> しま <br> [sound:4c-k-島.mp3]
Korean peninsula	<b>朝鮮半島</b> <br> ちょうせんはんとう <br> [sound:4c-k-朝鮮半島.mp3]
island country (sometimes used as a metaphor for Japan)	<b>島国</b> <br> しまぐに, とうごく <br> [sound:4c-k-島国.mp3]
isolated (outlying) island, departure from an island	<b>離島</b> <br> りとう <br> [sound:4c-k-離島.mp3]
soon, in a moment, before long, shortly; nearby, close; direct; spot transaction, cash transaction	<b>直</b> <br> じき <br> [sound:4c-k-直.mp3]
at once, immediately, directly, in person	<b>直ちに</b> <br> ただちに <br> [sound:4c-k-直ちに.mp3]
honesty, integrity, frankness; honestly, frankly	<b>正直</b> <br> しょうじき <br> [sound:4c-k-正直.mp3]
obedient, meek, docile, unaffected; honest, frank	<b>素直</b> <br> すなお <br> [sound:4c-k-素直.mp3]
both countries	<b>両国</b> <br> りょうこく, りょうごく <br> [sound:4c-k-両国.mp3]
both political parties	<b>両党</b> <br> りょうとう <br> [sound:4c-k-両党.mp3]
both sides, both parties	<b>両方</b> <br> りょうほう <br> [sound:4c-k-両方.mp3]
both sides, two sides, double-sided	<b>両面</b> <br> りょうめん <br> [sound:4c-k-両面.mp3]
morning	<b>朝</b> <br> あさ, あした <br> [sound:4c-k-朝.mp3]
North Korea	<b>北朝鮮</b> <br> きたちょうせん <br> [sound:4c-k-北朝鮮.mp3]
breakfast	<b>朝食</b> <br> ちょうしょく <br> [sound:4c-k-朝食.mp3]
every morning	<b>毎朝</b> <br> まいあさ, まいちょう <br> [sound:4c-k-毎朝.mp3]
skin, hide, leather, fur, pelt, bark, shell	<b>革</b> <br> かわ <br> [sound:4c-k-革.mp3]
reform, reformation, innovation	<b>改革</b> <br> かいかく <br> [sound:4c-k-改革.mp3]
agrarian reform	<b>農地改革</b> <br> のうちかいかく <br> [sound:4c-k-農地改革.mp3]
leather shoes	<b>革靴</b> <br> かわぐつ <br> [sound:4c-k-革靴.mp3]
price, value, cost	<b>価格</b> <br> かかく <br> [sound:4c-k-価格.mp3]
stock prices	<b>株価</b> <br> かぶか <br> [sound:4c-k-株価.mp3]
rice price	<b>米価</b> <br> べいか <br> [sound:4c-k-米価.mp3]
current value, price, market value	<b>時価</b> <br> じか <br> [sound:4c-k-時価.mp3]
stock (company)	<b>株式</b> <br> かぶしき <br> [sound:4c-k-株式.mp3]
formality, formal, official; formula	<b>公式</b> <br> こうしき <br> [sound:4c-k-公式.mp3]
public company, corporation, KK, formula for an incorporated public company	<b>株式会社</b> <br> かぶしきがいしゃ <br> [sound:4c-k-株式会社.mp3]
ceremony, rite, ritual, service	<b>儀式</b> <br> ぎしき <br> [sound:4c-k-儀式.mp3]
certain, sure, definite; if I'm not mistaken, if I remember correctly	<b>確か</b> <br> たしか <br> [sound:4c-k-確か.mp3]
certainty, reliability, soundness	<b>確実</b> <br> かくじつ <br> [sound:4c-k-確実.mp3]
probability, likelihood, chances	<b>確率</b> <br> かくりつ <br> [sound:4c-k-確率.mp3]
discord, antagonism	<b>確執</b> <br> かくしつ <br> [sound:4c-k-確執.mp3]
village	<b>村</b> <br> むら <br> [sound:4c-k-村.mp3]
cities, towns and villages, municipalities	<b>市町村</b> <br> しちょうそん <br> [sound:4c-k-市町村.mp3]
villager	<b>村民</b> <br> そんみん <br> [sound:4c-k-村民.mp3]
village assembly	<b>村議会</b> <br> そんぎかい <br> [sound:4c-k-村議会.mp3]
preamble, premise, reason, prerequisite, condition, assumption, hypothesis	<b>前提</b> <br> ぜんてい <br> [sound:4c-k-前提.mp3]
proposal, proposition, suggestion	<b>提案</b> <br> ていあん <br> [sound:4c-k-提案.mp3]
donor, contributer, provider	<b>提供者</b> <br> ていきょうしゃ <br> [sound:4c-k-提供者.mp3]
bring suit, file a claim, raise a question	<b>提起</b> <br> ていき <br> [sound:4c-k-提起.mp3]
fortune, luck	<b>運</b> <br> うん <br> [sound:4c-k-運.mp3]
to carry, to transport, to move, to convey; to come, to go; to wield (a tool, etc.), to use; to go (well, etc.), to proceed, to progress	<b>運ぶ</b> <br> はこぶ <br> [sound:4c-k-運ぶ.mp3]
progress, pace, carriage, step, stage	<b>運び</b> <br> はこび <br> [sound:4c-k-運び.mp3]
driver, chauffeur	<b>運転手</b> <br> うんてんしゅ <br> [sound:4c-k-運転手.mp3]
the end	<b>終わり</b> <br> おわり <br> [sound:4c-k-終わり.mp3]
last, final, closing	<b>最終</b> <br> さいしゅう <br> [sound:4c-k-最終.mp3]
all day, for a whole day	<b>終日</b> <br> しゅうじつ, ひねもす, ひめもす, ひもすがら <br> [sound:4c-k-終日.mp3]
endgame, final stage	<b>終盤</b> <br> しゅうばん <br> [sound:4c-k-終盤.mp3]
to raise, to elevate; to do up (one's hair); to fly (a kite, etc.), to launch (fireworks, etc.), to surface (a submarine, etc.); to land (a boat); to deep-fry; to show someone (into a room); (uk) to summon (for geishas, etc.); to send someone (away); to enrol (one's child in school) (enroll); to increase (price, quality, status, etc.); to make (a loud sound), to raise (one's voice); to earn (something desirable); to praise; to give (an example, etc.), to cite; to summon up (all of one's energy, etc.); to arrest; to nominate; to give; to offer up (incense, a prayer, etc.) to the gods (or Buddha, etc.); to bear (a child); to conduct (a ceremony, esp. a wedding); (of the tide) to come in; to vomit; (after the -te form of a verb) to do for (the sake of someone else); (after the -masu stem of a verb) to complete; used after the -masu stem of a humble verb to increase the level of humility	<b>挙げる</b> <br> あげる <br> [sound:4c-k-挙げる.mp3]
election	<b>選挙</b> <br> せんきょ <br> [sound:4c-k-選挙.mp3]
brilliant achievement	<b>快挙</b> <br> かいきょ <br> [sound:4c-k-快挙.mp3]
suffrage	<b>選挙権</b> <br> せんきょけん <br> [sound:4c-k-選挙権.mp3]
result, consequence	<b>結果</b> <br> けっか <br> [sound:4c-k-結果.mp3]
effect, effectiveness, efficacy, result	<b>効果</b> <br> こうか <br> [sound:4c-k-効果.mp3]
fruit, nut, berry	<b>果実</b> <br> かじつ <br> [sound:4c-k-果実.mp3]
resolute, determined, bold	<b>果敢</b> <br> かかん <br> [sound:4c-k-果敢.mp3]
west	<b>西</b> <br> にし <br> [sound:4c-k-西.mp3]
Kansai (south-western half of Japan, including Osaka)	<b>関西</b> <br> かんさい, かんせい <br> [sound:4c-k-関西.mp3]
western Japan	<b>西日本</b> <br> にしにほん, にしにっぽん <br> [sound:4c-k-西日本.mp3]
the west, Western countries	<b>西洋</b> <br> せいよう <br> [sound:4c-k-西洋.mp3]
force, vigor, vigour, energy, spirit, life; influence, authority, power, might; impetus, momentum, course (of events); naturally, necessarily	<b>勢い</b> <br> いきおい <br> [sound:4c-k-勢い.mp3]
bounce, spring, rebound; momentum, inertia; spur of the moment, impulse	<b>勢み</b> <br> はずみ <br> [sound:4c-k-勢み.mp3]
Isetan (department store)	<b>伊勢丹</b> <br> いせたん <br> [sound:4c-k-伊勢丹.mp3]
superiority, superior power, predominance, preponderance	<b>優勢</b> <br> ゆうせい <br> [sound:4c-k-優勢.mp3]
cut, reduction, curtailment	<b>削減</b> <br> さくげん <br> [sound:4c-k-削減.mp3]
tax reduction	<b>減税</b> <br> げんぜい <br> [sound:4c-k-減税.mp3]
reduction, diminution, abatement	<b>減額</b> <br> げんがく <br> [sound:4c-k-減額.mp3]
reduction in production	<b>減産</b> <br> げんさん <br> [sound:4c-k-減産.mp3]
stand, rack, table; support; belt; counter for machines, incl. vehicles; setting (e.g. in jewellery)	<b>台</b> <br> だい <br> [sound:4c-k-台.mp3]
Taiwan	<b>台湾</b> <br> たいわん <br> [sound:4c-k-台湾.mp3]
foundation, base, basis	<b>土台</b> <br> どだい <br> [sound:4c-k-土台.mp3]
cart, esp. food cart; (festival) float	<b>屋台</b> <br> やたい <br> [sound:4c-k-屋台.mp3]
spacious, vast, wide	<b>広い</b> <br> ひろい <br> [sound:4c-k-広い.mp3]
spread, span	<b>広がり</b> <br> ひろがり <br> [sound:4c-k-広がり.mp3]
extensive, wide, broad	<b>幅広い</b> <br> はばひろい <br> [sound:4c-k-幅広い.mp3]
huge, very large, vast, extensive, magnificent, grand	<b>広大</b> <br> こうだい <br> [sound:4c-k-広大.mp3]
subject, contents, matter, substance, detail, import	<b>内容</b> <br> ないよう <br> [sound:4c-k-内容.mp3]
suspect (person)	<b>容疑者</b> <br> ようぎしゃ <br> [sound:4c-k-容疑者.mp3]
full portrait, whole aspect, full story	<b>全容</b> <br> ぜんよう <br> [sound:4c-k-全容.mp3]
capacity, electrical capacitance	<b>容量</b> <br> ようりょう <br> [sound:4c-k-容量.mp3]
necessarily, certainly, without fail, positively, invariably	<b>必ず</b> <br> かならず <br> [sound:4c-k-必ず.mp3]
(not) always, (not) necessarily, (not) all, (not) entirely	<b>必ずしも</b> <br> かならずしも <br> [sound:4c-k-必ずしも.mp3]
certain victory	<b>必勝</b> <br> ひっしょう <br> [sound:4c-k-必勝.mp3]
inevitable, necessary	<b>必然的</b> <br> ひつぜんてき <br> [sound:4c-k-必然的.mp3]
to respond, to satisfy, to accept, to comply with, to apply for	<b>応じる</b> <br> おうじる <br> [sound:4c-k-応じる.mp3]
interaction, correspondence, coping with, dealing with, support	<b>対応</b> <br> たいおう <br> [sound:4c-k-対応.mp3]
adaptation, accommodation, conformity	<b>適応</b> <br> てきおう <br> [sound:4c-k-適応.mp3]
reply, answer, response	<b>応答</b> <br> おうとう <br> [sound:4c-k-応答.mp3]
speech, address	<b>演説</b> <br> えんぜつ <br> [sound:4c-k-演説.mp3]
public performance; sumo exhibition in a foreign country	<b>公演</b> <br> こうえん <br> [sound:4c-k-公演.mp3]
practice, practise, exercises, manoeuvres, maneuvers, practicum	<b>演習</b> <br> えんしゅう <br> [sound:4c-k-演習.mp3]
starring, playing the leading part	<b>主演</b> <br> しゅえん <br> [sound:4c-k-主演.mp3]
telephone	<b>電話</b> <br> でんわ <br> [sound:4c-k-電話.mp3]
electricity; (electric) light	<b>電気</b> <br> でんき <br> [sound:4c-k-電気.mp3]
generation (e.g. power)	<b>発電</b> <br> はつでん <br> [sound:4c-k-発電.mp3]
power plant, power station	<b>発電所</b> <br> はつでんしょ <br> [sound:4c-k-発電所.mp3]
annual expenditure	<b>歳出</b> <br> さいしゅつ <br> [sound:4c-k-歳出.mp3]
annual revenue or income	<b>歳入</b> <br> さいにゅう <br> [sound:4c-k-歳入.mp3]
year end	<b>歳末</b> <br> さいまつ <br> [sound:4c-k-歳末.mp3]
almanac of seasonal words (for haiku poets)	<b>歳時記</b> <br> さいじき <br> [sound:4c-k-歳時記.mp3]
dwelling, living	<b>住</b> <br> じゅう <br> [sound:4c-k-住.mp3]
residence, housing, residential building	<b>住宅</b> <br> じゅうたく <br> [sound:4c-k-住宅.mp3]
housing district, residential district	<b>住宅地</b> <br> じゅうたくち <br> [sound:4c-k-住宅地.mp3]
Sumitomo (company)	<b>住友</b> <br> すみとも <br> [sound:4c-k-住友.mp3]
dispute, strife, quarrel, dissension, conflict, rivalry, contest	<b>争い</b> <br> あらそい <br> [sound:4c-k-争い.mp3]
war	<b>戦争</b> <br> せんそう <br> [sound:4c-k-戦争.mp3]
to compete, to contest, to contend; to quarrel, to argue, to dispute, to be at variance, to oppose; (usu. in negative form) to deny (e.g. evidence)	<b>争う</b> <br> あらそう <br> [sound:4c-k-争う.mp3]
the Pacific War	<b>太平洋戦争</b> <br> たいへいようせんそう <br> [sound:4c-k-太平洋戦争.mp3]
conversation, conference, discussion, interview	<b>会談</b> <br> かいだん <br> [sound:4c-k-会談.mp3]
consultation, discussion	<b>相談</b> <br> そうだん <br> [sound:4c-k-相談.mp3]
talk, dialogue, conversation	<b>対談</b> <br> たいだん <br> [sound:4c-k-対談.mp3]
symposium, round-table discussion	<b>座談会</b> <br> ざだんかい <br> [sound:4c-k-座談会.mp3]
talent, gift, function; noh (theatre)	<b>能</b> <br> のう <br> [sound:4c-k-能.mp3]
possible, practicable, feasible	<b>可能</b> <br> かのう <br> [sound:4c-k-可能.mp3]
talent, ability	<b>才能</b> <br> さいのう <br> [sound:4c-k-才能.mp3]
ability, performance, efficiency	<b>性能</b> <br> せいのう <br> [sound:4c-k-性能.mp3]
free, no charge	<b>無料</b> <br> むりょう <br> [sound:4c-k-無料.mp3]
without an occupation	<b>無職</b> <br> むしょく <br> [sound:4c-k-無職.mp3]
existence or nonexistence, presence or absence; consent or refusal, yes or no; flag indicator, presence or absence marker	<b>有無</b> <br> うむ, ゆうむ <br> [sound:4c-k-有無.mp3]
baseball with no outs	<b>無死</b> <br> むし <br> [sound:4c-k-無死.mp3]
again, once more, a second time	<b>再び</b> <br> ふたたび <br> [sound:4c-k-再び.mp3]
reopening, resumption, restarting	<b>再開</b> <br> さいかい <br> [sound:4c-k-再開.mp3]
re-examination, review, reappraisal	<b>再検討</b> <br> さいけんとう <br> [sound:4c-k-再検討.mp3]
twice, again, second time	<b>再度</b> <br> さいど <br> [sound:4c-k-再度.mp3]
superior (rank not class); higher order (e.g. byte); host computer (of connected device)	<b>上位</b> <br> じょうい <br> [sound:4c-k-上位.mp3]
unit, denomination; credit (in school)	<b>単位</b> <br> たんい <br> [sound:4c-k-単位.mp3]
standard, basis, principle	<b>本位</b> <br> ほんい <br> [sound:4c-k-本位.mp3]
predominance, ascendancy, superiority	<b>優位</b> <br> ゆうい <br> [sound:4c-k-優位.mp3]
measure, step	<b>措置</b> <br> そち <br> [sound:4c-k-措置.mp3]
establishment, institution	<b>設置</b> <br> せっち <br> [sound:4c-k-設置.mp3]
deferment (e.g. of savings), leaving (a thing) as it stands	<b>据え置き</b> <br> すえおき <br> [sound:4c-k-据え置き.mp3]
placement, fixed position, mapping out, location	<b>位置付け</b> <br> いちづけ, いちつけ <br> [sound:4c-k-位置付け.mp3]
enterprise, undertaking, corporation, business	<b>企業</b> <br> きぎょう <br> [sound:4c-k-企業.mp3]
planning, project, plan, design	<b>企画</b> <br> きかく <br> [sound:4c-k-企画.mp3]
private enterprise	<b>私企業</b> <br> しきぎょう <br> [sound:4c-k-私企業.mp3]
(Japanese) Small and Medium Enterprise Agency	<b>中小企業庁</b> <br> ちゅうしょうきぎょうちょう <br> [sound:4c-k-中小企業庁.mp3]
photograph, photo; movie	<b>写真</b> <br> しゃしん <br> [sound:4c-k-写真.mp3]
true, real, genuine, proper, utter	<b>真の</b> <br> しんの <br> [sound:4c-k-真の.mp3]
total darkness, pitch dark; bleak future, poor prospects	<b>真っ暗</b> <br> まっくら <br> [sound:4c-k-真っ暗.mp3]
Pearl Harbor	<b>真珠湾</b> <br> しんじゅわん <br> [sound:4c-k-真珠湾.mp3]
stream, current, flow	<b>流れ</b> <br> ながれ <br> [sound:4c-k-流れ.mp3]
intercourse, (cultural) exchange, intermingling; alternating current, AC	<b>交流</b> <br> こうりゅう <br> [sound:4c-k-交流.mp3]
flow	<b>流動</b> <br> りゅうどう <br> [sound:4c-k-流動.mp3]
pyroclastic flow (type of volcanic eruption), stone wind	<b>火砕流</b> <br> かさいりゅう <br> [sound:4c-k-火砕流.mp3]
price, value, cost	<b>価格</b> <br> かかく <br> [sound:4c-k-価格.mp3]
qualitative difference, disparity	<b>格差</b> <br> かくさ <br> [sound:4c-k-格差.mp3]
regularization, regularisation, getting up speed, proceeding at full tilt	<b>本格化</b> <br> ほんかくか <br> [sound:4c-k-本格化.mp3]
standard, norm	<b>規格</b> <br> きかく <br> [sound:4c-k-規格.mp3]
existence; possession, having; limited company	<b>有</b> <br> ゆう <br> [sound:4c-k-有.mp3]
validity, legality, availability, effectiveness	<b>有効</b> <br> ゆうこう <br> [sound:4c-k-有効.mp3]
guilt, culpability	<b>有罪</b> <br> ゆうざい <br> [sound:4c-k-有罪.mp3]
marketable securities, stocks and bonds	<b>有価証券</b> <br> ゆうかしょうけん <br> [sound:4c-k-有価証券.mp3]
doubt, question, uncertainty, skepticism, scepticism, suspicion, distrust	<b>疑い</b> <br> うたがい <br> [sound:4c-k-疑い.mp3]
suspect (person)	<b>容疑者</b> <br> ようぎしゃ <br> [sound:4c-k-容疑者.mp3]
doubt, skepticism, scepticism, disbelief	<b>懐疑</b> <br> かいぎ <br> [sound:4c-k-懐疑.mp3]
doubtful, questionable, uncertain, disputable, suspicious	<b>疑わしい</b> <br> うたがわしい <br> [sound:4c-k-疑わしい.mp3]
mouth; opening, hole, gap, orifice; mouth (of a bottle), spout, nozzle, mouthpiece; gate, door, entrance, exit; speaking, speech, talk (i.e. gossip); taste, palate; mouth (to feed); opening (i.e. vacancy), available position; invitation, summons; kind, sort, type; opening (i.e. beginning); counter for mouthfuls, shares (of money), and swords	<b>口</b> <br> くち <br> [sound:4c-k-口.mp3]
population; common talk	<b>人口</b> <br> じんこう <br> [sound:4c-k-人口.mp3]
mouth of river, estuary	<b>川口</b> <br> かわぐち, かこう <br> [sound:4c-k-川口.mp3]
modus operandi, criminal technique, trick	<b>手口</b> <br> てぐち <br> [sound:4c-k-手口.mp3]
past, after; too (much), over (e.g. eating)	<b>過ぎ</b> <br> すぎ <br> [sound:4c-k-過ぎ.mp3]
the past, bygone days, the previous	<b>過去</b> <br> かこ <br> [sound:4c-k-過去.mp3]
excess, over-	<b>過剰</b> <br> かじょう <br> [sound:4c-k-過剰.mp3]
fault, error, indiscretion, faux pas	<b>過ち</b> <br> あやまち <br> [sound:4c-k-過ち.mp3]
channel (i.e. TV or radio), station, department; affair, situation	<b>局</b> <br> きょく <br> [sound:4c-k-局.mp3]
secretariat, executive office	<b>事務局</b> <br> じむきょく <br> [sound:4c-k-事務局.mp3]
post office	<b>郵便局</b> <br> ゆうびんきょく <br> [sound:4c-k-郵便局.mp3]
(playing) a game of go, shogi or chess, etc.	<b>対局</b> <br> たいきょく <br> [sound:4c-k-対局.mp3]
small quantity, little, few, something; little while; short distance	<b>少し</b> <br> すこし <br> [sound:4c-k-少し.mp3]
at least	<b>少なくとも</b> <br> すくなくとも <br> [sound:4c-k-少なくとも.mp3]
few, a little, scarce, insufficient, seldom	<b>少ない</b> <br> すくない <br> [sound:4c-k-少ない.mp3]
considerably, not a little, in no small numbers	<b>少なからず</b> <br> すくなからず <br> [sound:4c-k-少なからず.mp3]
to let go, to abandon, to leave undone; to throw, to toss, to fling	<b>放る</b> <br> ほうる, ほる <br> [sound:4c-k-放る.mp3]
broadcast, broadcasting	<b>放送</b> <br> ほうそう <br> [sound:4c-k-放送.mp3]
radioactivity	<b>放射能</b> <br> ほうしゃのう <br> [sound:4c-k-放射能.mp3]
televising	<b>放映</b> <br> ほうえい <br> [sound:4c-k-放映.mp3]
customs, duty, tariff	<b>関税</b> <br> かんぜい <br> [sound:4c-k-関税.mp3]
tax reduction	<b>減税</b> <br> げんぜい <br> [sound:4c-k-減税.mp3]
tax, duty	<b>税金</b> <br> ぜいきん <br> [sound:4c-k-税金.mp3]
tax yields, revenue	<b>税収</b> <br> ぜいしゅう <br> [sound:4c-k-税収.mp3]
inspection (e.g. customs, factory), examination	<b>検査</b> <br> けんさ <br> [sound:4c-k-検査.mp3]
examination, prosecutor	<b>検察</b> <br> けんさつ <br> [sound:4c-k-検察.mp3]
medical examination	<b>検診</b> <br> けんしん <br> [sound:4c-k-検診.mp3]
inspection, examination	<b>検問</b> <br> けんもん <br> [sound:4c-k-検問.mp3]
wisteria, Wisteria floribunda	<b>藤</b> <br> ふじ <br> [sound:4c-k-藤.mp3]
conflict, complication, troubles, discord	<b>葛藤</b> <br> かっとう <br> [sound:4c-k-葛藤.mp3]
of Fujiwara descent	<b>藤原氏の出</b> <br> ふじわらしのしゅつ <br> [sound:4c-k-藤原氏の出.mp3]
thoroughwort, Eupatorium fortunei (species of boneset), Eupatorium japonicum	<b>藤袴</b> <br> ふじばかま, フジバカマ <br> [sound:4c-k-藤袴.mp3]
town, block, neighbourhood, neighborhood; street, road; 109.09 m; 0.99 hectares	<b>町</b> <br> まち, ちょう <br> [sound:4c-k-町.mp3]
cities, towns and villages, municipalities	<b>市町村</b> <br> しちょうそん <br> [sound:4c-k-市町村.mp3]
street (of stores and houses), townscape, (look of) stores and houses on street	<b>町並み</b> <br> まちなみ <br> [sound:4c-k-町並み.mp3]
Muromachi (era 1392-1573, or 1333-1573, or 1336-1573)	<b>室町</b> <br> むろまち <br> [sound:4c-k-室町.mp3]
ever, endless	<b>常</b> <br> とこ <br> [sound:4c-k-常.mp3]
always, constantly	<b>常に</b> <br> つねに <br> [sound:4c-k-常に.mp3]
ordinary	<b>経常</b> <br> けいじょう <br> [sound:4c-k-経常.mp3]
strangeness, abnormality, disorder	<b>異常</b> <br> いじょう <br> [sound:4c-k-異常.mp3]
school	<b>学校</b> <br> がっこう <br> [sound:4c-k-学校.mp3]
senior high school	<b>高校</b> <br> こうこう <br> [sound:4c-k-高校.mp3]
same school	<b>同校</b> <br> どうこう <br> [sound:4c-k-同校.mp3]
vocational school, technical school	<b>専門学校</b> <br> せんもんがっこう, せんもんガッコウ, せんもんガッコ <br> [sound:4c-k-専門学校.mp3]
materials, data, document	<b>資料</b> <br> しりょう <br> [sound:4c-k-資料.mp3]
free, no charge	<b>無料</b> <br> むりょう <br> [sound:4c-k-無料.mp3]
salary, wages	<b>給料</b> <br> きゅうりょう <br> [sound:4c-k-給料.mp3]
(a) drink	<b>飲料</b> <br> いんりょう <br> [sound:4c-k-飲料.mp3]
swamp, marsh; mountain stream, valley, dale	<b>沢</b> <br> さわ <br> [sound:4c-k-沢.mp3]
brilliance, polish, lustre, luster, glossy finish (of photographs)	<b>光沢</b> <br> こうたく <br> [sound:4c-k-光沢.mp3]
marsh, swamp	<b>沼沢</b> <br> しょうたく <br> [sound:4c-k-沼沢.mp3]
favour, favor, benefit	<b>恩沢</b> <br> おんたく, おんだく <br> [sound:4c-k-恩沢.mp3]
trial, judgement, judgment	<b>裁判</b> <br> さいばん <br> [sound:4c-k-裁判.mp3]
president	<b>総裁</b> <br> そうさい <br> [sound:4c-k-総裁.mp3]
judge	<b>裁判官</b> <br> さいばんかん <br> [sound:4c-k-裁判官.mp3]
admeasure, discretion	<b>裁量</b> <br> さいりょう <br> [sound:4c-k-裁量.mp3]
state of affairs (around you), situation, circumstances	<b>状況</b> <br> じょうきょう <br> [sound:4c-k-状況.mp3]
current status, condition, situation, circumstances, state	<b>状態</b> <br> じょうたい <br> [sound:4c-k-状態.mp3]
shape, form	<b>形状</b> <br> けいじょう <br> [sound:4c-k-形状.mp3]
distress, wretched condition	<b>窮状</b> <br> きゅうじょう <br> [sound:4c-k-窮状.mp3]
factory, plant, mill, workshop	<b>工場</b> <br> こうじょう, こうば <br> [sound:4c-k-工場.mp3]
(manufacturing) industry	<b>工業</b> <br> こうぎょう <br> [sound:4c-k-工業.mp3]
commerce and industry	<b>商工</b> <br> しょうこう <br> [sound:4c-k-商工.mp3]
carpenter	<b>大工</b> <br> だいく <br> [sound:4c-k-大工.mp3]
construction, establishment	<b>建設</b> <br> けんせつ <br> [sound:4c-k-建設.mp3]
construction, architecture	<b>建築</b> <br> けんちく <br> [sound:4c-k-建築.mp3]
structure	<b>建造物</b> <br> けんぞうぶつ <br> [sound:4c-k-建造物.mp3]
to be erected, to be built	<b>建つ</b> <br> たつ <br> [sound:4c-k-建つ.mp3]
to talk, to tell, to recite, to pledge, to conspire with	<b>語らう</b> <br> かたらう <br> [sound:4c-k-語らう.mp3]
to talk, to tell, to recite	<b>語る</b> <br> かたる <br> [sound:4c-k-語る.mp3]
language	<b>言語</b> <br> げんご, ごんご <br> [sound:4c-k-言語.mp3]
talking	<b>語り</b> <br> かたり <br> [sound:4c-k-語り.mp3]
baseball stadium	<b>球場</b> <br> きゅうじょう <br> [sound:4c-k-球場.mp3]
baseball team	<b>球団</b> <br> きゅうだん <br> [sound:4c-k-球団.mp3]
four balls, base on balls (baseball), a walk	<b>四球</b> <br> しきゅう <br> [sound:4c-k-四球.mp3]
pitching, throwing a ball, bowling (in cricket), pitched ball	<b>投球</b> <br> とうきゅう <br> [sound:4c-k-投球.mp3]
manager, proprietor	<b>経営者</b> <br> けいえいしゃ <br> [sound:4c-k-経営者.mp3]
state management	<b>国営</b> <br> こくえい <br> [sound:4c-k-国営.mp3]
camp (group of same ideological beliefs)	<b>陣営</b> <br> じんえい <br> [sound:4c-k-陣営.mp3]
private management	<b>民営</b> <br> みんえい <br> [sound:4c-k-民営.mp3]
air, atmosphere	<b>空気</b> <br> くうき <br> [sound:4c-k-空気.mp3]
aircraft, aeroplane, airplane	<b>航空機</b> <br> こうくうき <br> [sound:4c-k-航空機.mp3]
space, room, airspace	<b>空間</b> <br> くうかん <br> [sound:4c-k-空間.mp3]
aerial bombing	<b>空爆</b> <br> くうばく <br> [sound:4c-k-空爆.mp3]
present post, current office, (an) incumbent	<b>現職</b> <br> げんしょく <br> [sound:4c-k-現職.mp3]
finding employment, inauguration	<b>就職</b> <br> しゅうしょく <br> [sound:4c-k-就職.mp3]
occupation, business	<b>職業</b> <br> しょくぎょう <br> [sound:4c-k-職業.mp3]
one's post, place of work, workplace	<b>職場</b> <br> しょくば <br> [sound:4c-k-職場.mp3]
guarantee, security, assurance, pledge, warranty	<b>保証</b> <br> ほしょう <br> [sound:4c-k-保証.mp3]
evidence, proof	<b>証拠</b> <br> しょうこ <br> [sound:4c-k-証拠.mp3]
proof, verification	<b>証明</b> <br> しょうめい <br> [sound:4c-k-証明.mp3]
marketable securities, stocks and bonds	<b>有価証券</b> <br> ゆうかしょうけん <br> [sound:4c-k-有価証券.mp3]
Saturday	<b>土曜</b> <br> どよう <br> [sound:4c-k-土曜.mp3]
country, territory, domain, realm	<b>国土</b> <br> こくど <br> [sound:4c-k-国土.mp3]
arena, esp. in sumo; forum (e.g. for discussion); sandbag, gabion	<b>土俵</b> <br> どひょう <br> [sound:4c-k-土俵.mp3]
public works	<b>土木</b> <br> どぼく <br> [sound:4c-k-土木.mp3]
pay, salary, wages, allowance, grant, supply	<b>給与</b> <br> きゅうよ <br> [sound:4c-k-給与.mp3]
giving, provision, furnishing	<b>供与</b> <br> きょうよ <br> [sound:4c-k-供与.mp3]
prescribing medicine, administering (medicine)	<b>投与</b> <br> とうよ <br> [sound:4c-k-投与.mp3]
grant, allowance, endowment, bestowal, assignment, conferment	<b>付与</b> <br> ふよ <br> [sound:4c-k-付与.mp3]
urgent, pressing, emergency	<b>緊急</b> <br> きんきゅう <br> [sound:4c-k-緊急.mp3]
rapid (e.g. progress)	<b>急速</b> <br> きゅうそく <br> [sound:4c-k-急速.mp3]
urgent	<b>早急</b> <br> さっきゅう, そうきゅう <br> [sound:4c-k-早急.mp3]
sudden, precipitous, radical	<b>急激</b> <br> きゅうげき <br> [sound:4c-k-急激.mp3]
suspension, stoppage, discontinuance, interruption	<b>中止</b> <br> ちゅうし <br> [sound:4c-k-中止.mp3]
abolition, repeal	<b>廃止</b> <br> はいし <br> [sound:4c-k-廃止.mp3]
brake, skid, pawl; restraint, curtailment, self-imposed limit, check	<b>歯止め</b> <br> はどめ <br> [sound:4c-k-歯止め.mp3]
to catch, to stop the blow, to react to, to take	<b>受け止める</b> <br> うけとめる <br> [sound:4c-k-受け止める.mp3]
seeing off, sending off; funeral; escapement	<b>送り</b> <br> おくり <br> [sound:4c-k-送り.mp3]
postpone	<b>先送り</b> <br> さきおくり <br> [sound:4c-k-先送り.mp3]
seeing one off, farewell, escort	<b>見送り</b> <br> みおくり <br> [sound:4c-k-見送り.mp3]
to see off (e.g. to the station, an airport, etc.), to escort (e.g. home), to farewell; to see out, to send off; to let pass, to wait and see, to continue (e.g. in legal contexts); to let a pitch go by (baseball), to watch a batted ball go into the stands	<b>見送る</b> <br> みおくる <br> [sound:4c-k-見送る.mp3]
relief, rescue, reinforcement	<b>救援</b> <br> きゅうえん <br> [sound:4c-k-救援.mp3]
support, backing	<b>後援</b> <br> こうえん <br> [sound:4c-k-後援.mp3]
covering, protection, backing, relief	<b>援護</b> <br> えんご <br> [sound:4c-k-援護.mp3]
encouragement, cheering, support	<b>声援</b> <br> せいえん <br> [sound:4c-k-声援.mp3]
giving, provision, furnishing	<b>供与</b> <br> きょうよ <br> [sound:4c-k-供与.mp3]
affidavit, deposition, testimony	<b>供述</b> <br> きょうじゅつ <br> [sound:4c-k-供述.mp3]
companion, follower, attendant, retinue	<b>供</b> <br> とも <br> [sound:4c-k-供.mp3]
donor, contributer, provider	<b>提供者</b> <br> ていきょうしゃ <br> [sound:4c-k-提供者.mp3]
permission, approval, authorization	<b>許可</b> <br> きょか <br> [sound:4c-k-許可.mp3]
strange, funny, amusing, ridiculous	<b>可笑しい</b> <br> おかしい <br> [sound:4c-k-可笑しい.mp3]
approval, license, licence, permission	<b>認可</b> <br> にんか <br> [sound:4c-k-認可.mp3]
indispensable, essential	<b>不可欠</b> <br> ふかけつ <br> [sound:4c-k-不可欠.mp3]
company director, board member	<b>取締役</b> <br> とりしまりやく <br> [sound:4c-k-取締役.mp3]
penal servitude, imprisonment with hard labor (hard labour)	<b>懲役</b> <br> ちょうえき <br> [sound:4c-k-懲役.mp3]
active duty, active service	<b>現役</b> <br> げんえき <br> [sound:4c-k-現役.mp3]
three highest ranks (wrestling, unions, etc.)	<b>三役</b> <br> さんやく <br> [sound:4c-k-三役.mp3]
organization, organisation, configuration, composition	<b>構成</b> <br> こうせい <br> [sound:4c-k-構成.mp3]
construction	<b>構築</b> <br> こうちく <br> [sound:4c-k-構築.mp3]
composition	<b>構図</b> <br> こうず <br> [sound:4c-k-構図.mp3]
splendid, nice, wonderful, delicious, sweet; sufficient, fine (in the sense of "I'm fine"), (by implication) no thank you; well enough, OK, tolerable; reasonably, fairly, tolerably; construction, architecture	<b>結構</b> <br> けっこう <br> [sound:4c-k-結構.mp3]
public works	<b>土木</b> <br> どぼく <br> [sound:4c-k-土木.mp3]
lumber, timber, wood	<b>木材</b> <br> もくざい <br> [sound:4c-k-木材.mp3]
logs in bark, rough wood	<b>荒木</b> <br> あらき <br> [sound:4c-k-荒木.mp3]
trees and shrubs, arbour, arbor	<b>樹木</b> <br> じゅもく <br> [sound:4c-k-樹木.mp3]
partition, division, separation, segmenting, splitting	<b>分割</b> <br> ぶんかつ <br> [sound:4c-k-分割.mp3]
discount, reduction, rebate, tenths discounted	<b>割引</b> <br> わりびき <br> [sound:4c-k-割引.mp3]
comparatively high, fairly expensive	<b>割高</b> <br> わりだか <br> [sound:4c-k-割高.mp3]
economical, comparatively cheap	<b>割安</b> <br> わりやす <br> [sound:4c-k-割安.mp3]
hearer, listener, audience; interviewer, questioner	<b>聞き手</b> <br> ききて <br> [sound:4c-k-聞き手.mp3]
newsprint, newspaper	<b>新聞紙</b> <br> しんぶんし <br> [sound:4c-k-新聞紙.mp3]
unheard-of, unprecedented, unparalleled in history (unparallelled), record-breaking	<b>前代未聞</b> <br> ぜんだいみもん <br> [sound:4c-k-前代未聞.mp3]
newspaper story (article, account)	<b>新聞記事</b> <br> しんぶんきじ <br> [sound:4c-k-新聞記事.mp3]
contents, interior, substance, filling, (sword) blade	<b>中身</b> <br> なかみ <br> [sound:4c-k-中身.mp3]
height (of body), stature	<b>身長</b> <br> しんちょう <br> [sound:4c-k-身長.mp3]
whole (body), full-length (e.g. portrait); systemic	<b>全身</b> <br> ぜんしん <br> [sound:4c-k-全身.mp3]
alumnus (alumnae), graduate, old boy (girl); former member of an organization; former inhabitant (country, region, etc.)	<b>出身者</b> <br> しゅっしんしゃ <br> [sound:4c-k-出身者.mp3]
cost, expense	<b>費用</b> <br> ひよう <br> [sound:4c-k-費用.mp3]
expenses, cost, outlay	<b>経費</b> <br> けいひ <br> [sound:4c-k-経費.mp3]
personnel expenses, labor cost, labour cost; indirect labour costs, indirect labor costs	<b>人件費</b> <br> じんけんひ <br> [sound:4c-k-人件費.mp3]
membership fee	<b>会費</b> <br> かいひ <br> [sound:4c-k-会費.mp3]
delivering, handing over, furnishing (e.g. with copies), issuance, issuing	<b>交付</b> <br> こうふ <br> [sound:4c-k-交付.mp3]
association, socializing, socialising, fellowship	<b>付き合い</b> <br> つきあい <br> [sound:4c-k-付き合い.mp3]
loan	<b>貸付</b> <br> かしつけ <br> [sound:4c-k-貸付.mp3]
date, dating	<b>日付</b> <br> ひづけ <br> [sound:4c-k-日付.mp3]
policy, measure	<b>施策</b> <br> しさく <br> [sound:4c-k-施策.mp3]
execution, enforcing, carrying out; giving alms, giving food to the poor or monks	<b>施行</b> <br> しこう, せぎょう, せこう, しぎょう <br> [sound:4c-k-施行.mp3]
government, administration, statesmanship	<b>施政</b> <br> しせい <br> [sound:4c-k-施政.mp3]
execution (building contract), carrying out	<b>施工</b> <br> せこう, しこう <br> [sound:4c-k-施工.mp3]
pertinent, appropriate, adequate, relevance	<b>適切</b> <br> てきせつ <br> [sound:4c-k-適切.mp3]
limits, end, bounds, period, place to leave off, closing sentence, all there is, only, since	<b>切り</b> <br> きり <br> [sound:4c-k-切り.mp3]
resolutely, boldly, daringly	<b>思い切って</b> <br> おもいきって <br> [sound:4c-k-思い切って.mp3]
to be out of, to run out of, to be short of, to be out of stock	<b>切らす</b> <br> きらす <br> [sound:4c-k-切らす.mp3]
go by the way, via	<b>経由</b> <br> けいゆ <br> [sound:4c-k-経由.mp3]
discomfort, inconvenience; poverty, want, destitution; disability, impairment (physical, mental, etc.)	<b>不自由</b> <br> ふじゆう <br> [sound:4c-k-不自由.mp3]
liberalization, liberalisation, freeing	<b>自由化</b> <br> じゆうか <br> [sound:4c-k-自由化.mp3]
freestyle (e.g. swimming event)	<b>自由形</b> <br> じゆうがた <br> [sound:4c-k-自由形.mp3]
explanation, commentary, exposition, elucidation	<b>解説</b> <br> かいせつ <br> [sound:4c-k-解説.mp3]
persuasion	<b>説得</b> <br> せっとく <br> [sound:4c-k-説得.mp3]
tradition, legend, folklore	<b>伝説</b> <br> でんせつ <br> [sound:4c-k-伝説.mp3]
election tour, election campaign, stumping	<b>遊説</b> <br> ゆうぜい <br> [sound:4c-k-遊説.mp3]
moving, transfer, demise	<b>移転</b> <br> いてん <br> [sound:4c-k-移転.mp3]
driver, chauffeur	<b>運転手</b> <br> うんてんしゅ <br> [sound:4c-k-運転手.mp3]
bicycle	<b>自転車</b> <br> じてんしゃ, じでんしゃ <br> [sound:4c-k-自転車.mp3]
rotation (usu. around something), revolution, turning	<b>回転</b> <br> かいてん <br> [sound:4c-k-回転.mp3]
food	<b>食料</b> <br> しょくりょう <br> [sound:4c-k-食料.mp3]
provisions, rations, food supply	<b>食糧</b> <br> しょくりょう <br> [sound:4c-k-食糧.mp3]
lunch, midday meal; food served at a tea party (tea ceremony)	<b>昼食</b> <br> ちゅうしょく, ちゅうじき, ひるげ <br> [sound:4c-k-昼食.mp3]
food and drink, eating and drinking	<b>飲食</b> <br> いんしょく <br> [sound:4c-k-飲食.mp3]
comparison	<b>比較</b> <br> ひかく <br> [sound:4c-k-比較.mp3]
contest, comparison, competition	<b>比べ</b> <br> くらべ <br> [sound:4c-k-比べ.mp3]
ratio, proportion; match, equal; explicit comparison (style of the Shi Jing); Philippines	<b>比</b> <br> ひ <br> [sound:4c-k-比.mp3]
specific gravity, weight, part; relative weight, relative importance	<b>比重</b> <br> ひじゅう <br> [sound:4c-k-比重.mp3]
difficulty, distress	<b>困難</b> <br> こんなん <br> [sound:4c-k-困難.mp3]
taking refuge, finding shelter, evacuation, escape	<b>避難</b> <br> ひなん <br> [sound:4c-k-避難.mp3]
blame, attack, criticism	<b>非難</b> <br> ひなん <br> [sound:4c-k-非難.mp3]
disapproval	<b>難色</b> <br> なんしょく <br> [sound:4c-k-難色.mp3]
Japan Defense Agency (Defence) (became Japanese Ministry of Defense in Jan. 2007)	<b>防衛庁</b> <br> ぼうえいちょう <br> [sound:4c-k-防衛庁.mp3]
prevention, precaution, protection against	<b>予防</b> <br> よぼう <br> [sound:4c-k-予防.mp3]
offense and defense, offence and defence	<b>攻防</b> <br> こうぼう <br> [sound:4c-k-攻防.mp3]
fire fighting, fire department	<b>消防</b> <br> しょうぼう <br> [sound:4c-k-消防.mp3]
announcing candidacy	<b>立候補</b> <br> りっこうほ <br> [sound:4c-k-立候補.mp3]
revised or supplementary budget	<b>補正予算</b> <br> ほせいよさん <br> [sound:4c-k-補正予算.mp3]
aid, help, assistance, assistant, counselor, counsellor, adviser, advisor	<b>補佐</b> <br> ほさ <br> [sound:4c-k-補佐.mp3]
supply, supplying, replenishment	<b>補給</b> <br> ほきゅう <br> [sound:4c-k-補給.mp3]
passenger vehicle, automobile	<b>乗用車</b> <br> じょうようしゃ <br> [sound:4c-k-乗用車.mp3]
bicycle	<b>自転車</b> <br> じてんしゃ, じでんしゃ <br> [sound:4c-k-自転車.mp3]
rolling stock, railroad cars, vehicles	<b>車両</b> <br> しゃりょう <br> [sound:4c-k-車両.mp3]
(electric) train	<b>電車</b> <br> でんしゃ <br> [sound:4c-k-電車.mp3]
actress	<b>女優</b> <br> じょゆう <br> [sound:4c-k-女優.mp3]
superiority, excellence	<b>優秀</b> <br> ゆうしゅう <br> [sound:4c-k-優秀.mp3]
favorable treatment, favourable treatment, hospitality, warm reception, good treatment, hearty welcome	<b>優遇</b> <br> ゆうぐう <br> [sound:4c-k-優遇.mp3]
tender, kind, gentle, graceful, affectionate, amiable, suave	<b>優しい</b> <br> やさしい <br> [sound:4c-k-優しい.mp3]
man and wife, married couple	<b>夫妻</b> <br> ふさい <br> [sound:4c-k-夫妻.mp3]
scheme, device, scheming, devising, figuring out, coming up with, solving ingeniously; dedication to spiritual improvement (esp. through Zen meditation)	<b>工夫</b> <br> くふう <br> [sound:4c-k-工夫.mp3]
safe, all right, OK, okay	<b>大丈夫</b> <br> だいじょうぶ <br> [sound:4c-k-大丈夫.mp3]
healthy, robust, strong, solid, durable	<b>丈夫</b> <br> じょうぶ <br> [sound:4c-k-丈夫.mp3]
researcher	<b>研究者</b> <br> けんきゅうしゃ <br> [sound:4c-k-研究者.mp3]
researcher	<b>研究員</b> <br> けんきゅういん <br> [sound:4c-k-研究員.mp3]
laboratory; seminar room; professor's office	<b>研究室</b> <br> けんきゅうしつ <br> [sound:4c-k-研究室.mp3]
researcher, student (of)	<b>研究家</b> <br> けんきゅうか <br> [sound:4c-k-研究家.mp3]
earnings, proceeds, returns	<b>収益</b> <br> しゅうえき <br> [sound:4c-k-収益.mp3]
accepting bribes, corruption, graft	<b>収賄</b> <br> しゅうわい <br> [sound:4c-k-収賄.mp3]
tax yields, revenue	<b>税収</b> <br> ぜいしゅう <br> [sound:4c-k-税収.mp3]
buying, purchase; corruption, bribery	<b>買収</b> <br> ばいしゅう <br> [sound:4c-k-買収.mp3]
diagnosis	<b>診断</b> <br> しんだん <br> [sound:4c-k-診断.mp3]
to refuse, to reject, to dismiss, to turn down, to decline; to inform, to give notice; to ask leave, to excuse oneself (from)	<b>断る</b> <br> ことわる <br> [sound:4c-k-断る.mp3]
without permission	<b>断らず</b> <br> ことわらず <br> [sound:4c-k-断らず.mp3]
abandoning (hope, plans), giving up	<b>断念</b> <br> だんねん <br> [sound:4c-k-断念.mp3]
oil well	<b>油井</b> <br> ゆせい <br> [sound:4c-k-油井.mp3]
round well	<b>筒井</b> <br> つつい <br> [sound:4c-k-筒井.mp3]
well digging, well digger	<b>井戸掘り</b> <br> いどほり <br> [sound:4c-k-井戸掘り.mp3]
well crib	<b>井筒</b> <br> いづつ <br> [sound:4c-k-井筒.mp3]
something, something or other, so-and-so; somehow, anyhow, one way or another	<b>何とか</b> <br> なんとか <br> [sound:4c-k-何とか.mp3]
which, what (way)	<b>何の</b> <br> どの <br> [sound:4c-k-何の.mp3]
most, best, above all	<b>何より</b> <br> なにより <br> [sound:4c-k-何より.mp3]
any, whatever one likes, by all means, anything, everything	<b>何でも</b> <br> なんでも <br> [sound:4c-k-何でも.mp3]
south-east	<b>東南</b> <br> とうなん, ひがしみなみ <br> [sound:4c-k-東南.mp3]
southern part	<b>南部</b> <br> なんぶ <br> [sound:4c-k-南部.mp3]
southwest	<b>南西</b> <br> なんせい, みなみにし <br> [sound:4c-k-南西.mp3]
Central and South America	<b>中南米</b> <br> ちゅうなんべい <br> [sound:4c-k-中南米.mp3]
coal	<b>石炭</b> <br> せきたん <br> [sound:4c-k-石炭.mp3]
stone bridge	<b>石橋</b> <br> いしばし, せっきょう <br> [sound:4c-k-石橋.mp3]
gem, jewel	<b>宝石</b> <br> ほうせき <br> [sound:4c-k-宝石.mp3]
stone wall	<b>石垣</b> <br> いしがき <br> [sound:4c-k-石垣.mp3]
satisfaction; sufficiency	<b>満足</b> <br> まんぞく <br> [sound:4c-k-満足.mp3]
pace, step	<b>足並み</b> <br> あしなみ <br> [sound:4c-k-足並み.mp3]
at one's feet, underfoot; gait, pace, step; you, thou	<b>足元</b> <br> あしもと, そっか <br> [sound:4c-k-足元.mp3]
one's hands and feet, limbs	<b>手足</b> <br> てあし <br> [sound:4c-k-手足.mp3]
illegal, illegality, invalid, unlawfulness	<b>違法</b> <br> いほう <br> [sound:4c-k-違法.mp3]
mistake	<b>間違い</b> <br> まちがい <br> [sound:4c-k-間違い.mp3]
difference, discrepancy, variation	<b>相違</b> <br> そうい <br> [sound:4c-k-相違.mp3]
uncomfortable feeling, feeling out of place, sense of discomfort; malaise, physical unease	<b>違和感</b> <br> いわかん <br> [sound:4c-k-違和感.mp3]
cancellation, liquidation, resolution, reduction (e.g. of stress)	<b>解消</b> <br> かいしょう <br> [sound:4c-k-解消.mp3]
negative, half-hearted, passive, unmotivated	<b>消極的</b> <br> しょうきょくてき <br> [sound:4c-k-消極的.mp3]
fire fighting, fire department	<b>消防</b> <br> しょうぼう <br> [sound:4c-k-消防.mp3]
eraser, India rubber	<b>消しゴム</b> <br> けしゴム <br> [sound:4c-k-消しゴム.mp3]
Environment Agency	<b>環境庁</b> <br> かんきょうちょう <br> [sound:4c-k-環境庁.mp3]
mental state	<b>心境</b> <br> しんきょう <br> [sound:4c-k-心境.mp3]
boundary	<b>境界</b> <br> きょうかい <br> [sound:4c-k-境界.mp3]
trouble, crisis, predicament, squeeze, pinch	<b>苦境</b> <br> くきょう <br> [sound:4c-k-苦境.mp3]
nerve, sensitivity	<b>神経</b> <br> しんけい <br> [sound:4c-k-神経.mp3]
Shinto shrine	<b>神社</b> <br> じんじゃ <br> [sound:4c-k-神社.mp3]
mental, emotional	<b>精神的</b> <br> せいしんてき <br> [sound:4c-k-精神的.mp3]
Shinto shrine	<b>神宮</b> <br> じんぐう <br> [sound:4c-k-神宮.mp3]
performance, take, going before an audience or on-air; game, season, crucial moment; actual sexual intercourse (i.e. not simulated)	<b>本番</b> <br> ほんばん <br> [sound:4c-k-本番.mp3]
(yarn) count; n-th place (e.g. in a race), n-th in position (e.g. a starting lineup)	<b>番手</b> <br> ばんて <br> [sound:4c-k-番手.mp3]
one's turn	<b>出番</b> <br> でばん <br> [sound:4c-k-出番.mp3]
second, number two, runner-up	<b>二番</b> <br> にばん <br> [sound:4c-k-二番.mp3]
large-scale	<b>大規模</b> <br> だいきぼ <br> [sound:4c-k-大規模.mp3]
new, fresh; new customer; new rules or regulations	<b>新規</b> <br> しんき <br> [sound:4c-k-新規.mp3]
rules, regulations, conventions	<b>規則</b> <br> きそく <br> [sound:4c-k-規則.mp3]
standard, norm	<b>規格</b> <br> きかく <br> [sound:4c-k-規格.mp3]
surgical operation	<b>手術</b> <br> しゅじゅつ <br> [sound:4c-k-手術.mp3]
art gallery, art museum	<b>美術館</b> <br> びじゅつかん <br> [sound:4c-k-美術館.mp3]
tactics	<b>戦術</b> <br> せんじゅつ <br> [sound:4c-k-戦術.mp3]
engineer, technical expert, technician, crafts-person	<b>技術者</b> <br> ぎじゅつしゃ <br> [sound:4c-k-技術者.mp3]
nursing	<b>介護</b> <br> かいご <br> [sound:4c-k-介護.mp3]
nursing, (army) nurse	<b>看護</b> <br> かんご <br> [sound:4c-k-看護.mp3]
defense, defence, pleading, advocacy	<b>弁護</b> <br> べんご <br> [sound:4c-k-弁護.mp3]
protecting the constitution	<b>護憲</b> <br> ごけん <br> [sound:4c-k-護憲.mp3]
exhibition, display	<b>展示</b> <br> てんじ <br> [sound:4c-k-展示.mp3]
view, outlook, prospect	<b>展望</b> <br> てんぼう <br> [sound:4c-k-展望.mp3]
exhibition	<b>展覧会</b> <br> てんらんかい <br> [sound:4c-k-展覧会.mp3]
one-man exhibition, one-woman exhibition	<b>個展</b> <br> こてん <br> [sound:4c-k-個展.mp3]
attitude, manner, behaviour	<b>態度</b> <br> たいど <br> [sound:4c-k-態度.mp3]
mess, sorry state, plight, sad sight; way, manner	<b>態</b> <br> ざま <br> [sound:4c-k-態.mp3]
attitude, conditions, preparations	<b>態勢</b> <br> たいせい <br> [sound:4c-k-態勢.mp3]
form, shape, figure	<b>形態</b> <br> けいたい <br> [sound:4c-k-形態.mp3]
semiconductor, solid-state	<b>半導体</b> <br> はんどうたい <br> [sound:4c-k-半導体.mp3]
hegemony, leadership, initiative	<b>主導権</b> <br> しゅどうけん <br> [sound:4c-k-主導権.mp3]
guidance, leading, induction, introduction, incitement, inducement	<b>誘導</b> <br> ゆうどう <br> [sound:4c-k-誘導.mp3]
superconductivity	<b>超電導</b> <br> ちょうでんどう <br> [sound:4c-k-超電導.mp3]
Democratic People's Republic of Korea (North Korea), DPRK	<b>朝鮮民主主義人民共和国</b> <br> ちょうせんみんしゅしゅぎじんみんきょうわこく <br> [sound:4c-k-朝鮮民主主義人民共和国.mp3]
Korean peninsula	<b>朝鮮半島</b> <br> ちょうせんはんとう <br> [sound:4c-k-朝鮮半島.mp3]
vivid, clear, distinct	<b>鮮明</b> <br> せんめい <br> [sound:4c-k-鮮明.mp3]
fresh	<b>新鮮</b> <br> しんせん <br> [sound:4c-k-新鮮.mp3]
to furnish, to provide for, to equip, to install; to have ready, to prepare for; to possess, to have, to be endowed with, to be armed with	<b>備える</b> <br> そなえる <br> [sound:4c-k-備える.mp3]
defense, defence, guard, policing, security	<b>警備</b> <br> けいび <br> [sound:4c-k-警備.mp3]
defense, defence	<b>守備</b> <br> しゅび <br> [sound:4c-k-守備.mp3]
preparation, preliminaries, reserve, spare	<b>予備</b> <br> よび <br> [sound:4c-k-予備.mp3]
being in, being at home	<b>在宅</b> <br> ざいたく <br> [sound:4c-k-在宅.mp3]
domicile, premises	<b>家宅</b> <br> かたく <br> [sound:4c-k-家宅.mp3]
housing district, residential district	<b>住宅地</b> <br> じゅうたくち <br> [sound:4c-k-住宅地.mp3]
building lot, residential land	<b>宅地</b> <br> たくち <br> [sound:4c-k-宅地.mp3]
damage, injury, loss	<b>損害</b> <br> そんがい <br> [sound:4c-k-損害.mp3]
(physically) handicapped person, disabled person	<b>障害者</b> <br> しょうがいしゃ <br> [sound:4c-k-障害者.mp3]
pollution, public nuisance, contamination	<b>公害</b> <br> こうがい <br> [sound:4c-k-公害.mp3]
victim, injured party, sufferer	<b>被害者</b> <br> ひがいしゃ <br> [sound:4c-k-被害者.mp3]
consideration, concern, forethought	<b>配慮</b> <br> はいりょ <br> [sound:4c-k-配慮.mp3]
dividend, share	<b>配当</b> <br> はいとう <br> [sound:4c-k-配当.mp3]
indication, sign, hint, presence, trend; quotation (esp. stock market)	<b>気配</b> <br> けはい, きはい <br> [sound:4c-k-気配.mp3]
arrangement (of resources), deployment, stationing, posting, disposition	<b>配置</b> <br> はいち <br> [sound:4c-k-配置.mp3]
extra prize	<b>副賞</b> <br> ふくしょう <br> [sound:4c-k-副賞.mp3]
subtitle, subheading	<b>副題</b> <br> ふくだい <br> [sound:4c-k-副題.mp3]
byproduct, side line	<b>副産物</b> <br> ふくさんぶつ <br> [sound:4c-k-副産物.mp3]
burial accessories	<b>副葬品</b> <br> ふくそうひん <br> [sound:4c-k-副葬品.mp3]
calculation, reckoning, count; forecast	<b>計算</b> <br> けいさん <br> [sound:4c-k-計算.mp3]
revised or supplementary budget	<b>補正予算</b> <br> ほせいよさん <br> [sound:4c-k-補正予算.mp3]
probability, likelihood	<b>公算</b> <br> こうさん <br> [sound:4c-k-公算.mp3]
approximation, rough estimate	<b>概算</b> <br> がいさん <br> [sound:4c-k-概算.mp3]
importance, stress, serious consideration	<b>重視</b> <br> じゅうし <br> [sound:4c-k-重視.mp3]
ratings (of a television program) (programme)	<b>視聴率</b> <br> しちょうりつ <br> [sound:4c-k-視聴率.mp3]
field of vision, outlook	<b>視野</b> <br> しや <br> [sound:4c-k-視野.mp3]
inspection, observation	<b>視察</b> <br> しさつ <br> [sound:4c-k-視察.mp3]
regulations, rules, laws, acts, ordinance	<b>条例</b> <br> じょうれい <br> [sound:4c-k-条例.mp3]
conditionally, with conditions attached	<b>条件付き</b> <br> じょうけんつき <br> [sound:4c-k-条件付き.mp3]
unconditional	<b>無条件</b> <br> むじょうけん <br> [sound:4c-k-無条件.mp3]
working conditions	<b>労働条件</b> <br> ろうどうじょうけん <br> [sound:4c-k-労働条件.mp3]
bullet train (very high speed), Shinkansen	<b>新幹線</b> <br> しんかんせん <br> [sound:4c-k-新幹線.mp3]
basis, nucleus, root and branch	<b>根幹</b> <br> こんかん <br> [sound:4c-k-根幹.mp3]
main line, trunk line	<b>幹線</b> <br> かんせん <br> [sound:4c-k-幹線.mp3]
chief editor, managing editor; manager, person in charge	<b>主幹</b> <br> しゅかん <br> [sound:4c-k-主幹.mp3]
peculiarity, uniqueness, characteristic	<b>独特</b> <br> どくとく <br> [sound:4c-k-独特.mp3]
independent state or nation	<b>独立国</b> <br> どくりつこく <br> [sound:4c-k-独立国.mp3]
East Germany	<b>東独</b> <br> とうどく <br> [sound:4c-k-東独.mp3]
dictatorship, despotism	<b>独裁</b> <br> どくさい <br> [sound:4c-k-独裁.mp3]
vigilance, precaution, watch, lookout, altertness; to be vigilant, to be cautious, to guard (against)	<b>警戒</b> <br> けいかい <br> [sound:4c-k-警戒.mp3]
National Police Agency	<b>警察庁</b> <br> けいさつちょう <br> [sound:4c-k-警察庁.mp3]
defense, defence, guard, policing, security	<b>警備</b> <br> けいび <br> [sound:4c-k-警備.mp3]
policeman	<b>警官</b> <br> けいかん <br> [sound:4c-k-警官.mp3]
palace	<b>宮殿</b> <br> きゅうでん <br> [sound:4c-k-宮殿.mp3]
womb, uterus	<b>子宮</b> <br> しきゅう <br> [sound:4c-k-子宮.mp3]
imperial court	<b>宮中</b> <br> きゅうちゅう <br> [sound:4c-k-宮中.mp3]
crown prince	<b>東宮</b> <br> とうぐう <br> [sound:4c-k-東宮.mp3]
investigation (esp. in academic and scientific contexts)	<b>究明</b> <br> きゅうめい <br> [sound:4c-k-究明.mp3]
researcher	<b>研究員</b> <br> けんきゅういん <br> [sound:4c-k-研究員.mp3]
laboratory; seminar room; professor's office	<b>研究室</b> <br> けんきゅうしつ <br> [sound:4c-k-研究室.mp3]
researcher, student (of)	<b>研究家</b> <br> けんきゅうか <br> [sound:4c-k-研究家.mp3]
nursing, nurturing, rearing, lactation, suckling	<b>保育</b> <br> ほいく <br> [sound:4c-k-保育.mp3]
rearing, training, nurture, cultivation, promotion	<b>育成</b> <br> いくせい <br> [sound:4c-k-育成.mp3]
breeding, growth	<b>育ち</b> <br> そだち <br> [sound:4c-k-育ち.mp3]
breeding, raising, rearing	<b>飼育</b> <br> しいく <br> [sound:4c-k-飼育.mp3]
attendance, presence, appearance; to attend, to be present, to appear	<b>出席</b> <br> しゅっせき <br> [sound:4c-k-出席.mp3]
batter's box (baseball), one's turn at bat	<b>打席</b> <br> だせき <br> [sound:4c-k-打席.mp3]
at the meeting	<b>席上</b> <br> せきじょう <br> [sound:4c-k-席上.mp3]
presence, sitting with, being with	<b>同席</b> <br> どうせき <br> [sound:4c-k-同席.mp3]
transportation	<b>運輸</b> <br> うんゆ <br> [sound:4c-k-運輸.mp3]
Ministry of Transport	<b>運輸省</b> <br> うんゆしょう <br> [sound:4c-k-運輸省.mp3]
embargo	<b>禁輸</b> <br> きんゆ <br> [sound:4c-k-禁輸.mp3]
smuggling, contraband trade	<b>密輸</b> <br> みつゆ <br> [sound:4c-k-密輸.mp3]
visit to China	<b>訪中</b> <br> ほうちゅう <br> [sound:4c-k-訪中.mp3]
visit to America	<b>訪米</b> <br> ほうべい <br> [sound:4c-k-訪米.mp3]
round of calls, tour of visitation	<b>歴訪</b> <br> れきほう <br> [sound:4c-k-歴訪.mp3]
visit, call, advent, arrival	<b>訪れ</b> <br> おとずれ <br> [sound:4c-k-訪れ.mp3]
musical instrument	<b>楽器</b> <br> がっき <br> [sound:4c-k-楽器.mp3]
club, fraternity, sorority, clubhouse	<b>倶楽部</b> <br> くらぶ, クラブ <br> [sound:4c-k-倶楽部.mp3]
pleasure, amusement	<b>娯楽</b> <br> ごらく <br> [sound:4c-k-娯楽.mp3]
Noh play	<b>能楽</b> <br> のうがく <br> [sound:4c-k-能楽.mp3]
to occur, to happen	<b>起こる</b> <br> おこる <br> [sound:4c-k-起こる.mp3]
bring suit, file a claim, raise a question	<b>提起</b> <br> ていき <br> [sound:4c-k-提起.mp3]
desperation, eagerness	<b>躍起</b> <br> やっき <br> [sound:4c-k-躍起.mp3]
jump to one's feet, stand up against, rising to action	<b>決起</b> <br> けっき <br> [sound:4c-k-決起.mp3]
tens of thousands	<b>数万</b> <br> すうまん <br> [sound:4c-k-数万.mp3]
thousands of miles	<b>万里</b> <br> ばんり <br> [sound:4c-k-万里.mp3]
all-purpose, utility; almighty, omnipotent	<b>万能</b> <br> ばんのう, まんのう <br> [sound:4c-k-万能.mp3]
by some chance, by some possibility, if by any chance, 10,000 to 1 odds	<b>万一</b> <br> まんいち, まんいつ <br> [sound:4c-k-万一.mp3]
adhesion	<b>癒着</b> <br> ゆちゃく <br> [sound:4c-k-癒着.mp3]
to wear (in modern Japanese, from the shoulders down), to put on; to bear (guilt, etc.)	<b>着る</b> <br> きる <br> [sound:4c-k-着る.mp3]
start of (construction) work	<b>着工</b> <br> ちゃっこう <br> [sound:4c-k-着工.mp3]
landing, alighting, touch down	<b>着陸</b> <br> ちゃくりく <br> [sound:4c-k-着陸.mp3]
to place on (something), to take on board, to give a ride, to let (one) take part, to impose on, to record, to mention, to load (luggage), to publish, to run (an ad)	<b>乗せる</b> <br> のせる <br> [sound:4c-k-乗せる.mp3]
crew	<b>乗員</b> <br> じょういん <br> [sound:4c-k-乗員.mp3]
crew	<b>乗組員</b> <br> のりくみいん <br> [sound:4c-k-乗組員.mp3]
riding together	<b>相乗り</b> <br> あいのり <br> [sound:4c-k-相乗り.mp3]
shop, store	<b>店舗</b> <br> てんぽ <br> [sound:4c-k-店舗.mp3]
shop, small store, business, firm	<b>商店</b> <br> しょうてん <br> [sound:4c-k-商店.mp3]
shop front, counter, shop, over-the-counter (financial)	<b>店頭</b> <br> てんとう <br> [sound:4c-k-店頭.mp3]
head office	<b>本店</b> <br> ほんてん <br> [sound:4c-k-本店.mp3]
speaking at a public hearing	<b>公述</b> <br> こうじゅつ <br> [sound:4c-k-公述.mp3]
writing, literary work	<b>著述</b> <br> ちょじゅつ <br> [sound:4c-k-著述.mp3]
aforementioned, above-mentioned	<b>前述</b> <br> ぜんじゅつ <br> [sound:4c-k-前述.mp3]
detailed explanation	<b>詳述</b> <br> しょうじゅつ <br> [sound:4c-k-詳述.mp3]
deplorable, bad luck, regret, disappointment	<b>残念</b> <br> ざんねん <br> [sound:4c-k-残念.mp3]
residual, residue; stay behind, stay back	<b>残留</b> <br> ざんりゅう <br> [sound:4c-k-残留.mp3]
(bank) balance, remainder	<b>残高</b> <br> ざんだか <br> [sound:4c-k-残高.mp3]
overtime (work)	<b>残業</b> <br> ざんぎょう <br> [sound:4c-k-残業.mp3]
impressions, thoughts	<b>感想</b> <br> かんそう <br> [sound:4c-k-感想.mp3]
expression (e.g. in music), idea, conception	<b>発想</b> <br> はっそう <br> [sound:4c-k-発想.mp3]
ideal, dream	<b>理想</b> <br> りそう <br> [sound:4c-k-理想.mp3]
imagination, guess	<b>想像</b> <br> そうぞう <br> [sound:4c-k-想像.mp3]
baseball lineup	<b>打線</b> <br> だせん <br> [sound:4c-k-打線.mp3]
(war) front	<b>戦線</b> <br> せんせん <br> [sound:4c-k-戦線.mp3]
the Thirty-eighth Parallel	<b>三十八度線</b> <br> さんじゅうはちどせん <br> [sound:4c-k-三十八度線.mp3]
wireless, radio	<b>無線</b> <br> むせん <br> [sound:4c-k-無線.mp3]
ratings (of a television program) (programme)	<b>視聴率</b> <br> しちょうりつ <br> [sound:4c-k-視聴率.mp3]
growth rate, coefficient of extension	<b>伸び率</b> <br> のびりつ <br> [sound:4c-k-伸び率.mp3]
frankness, candour, candor, openheartedness	<b>率直</b> <br> そっちょく <br> [sound:4c-k-率直.mp3]
batting average	<b>打率</b> <br> だりつ <br> [sound:4c-k-打率.mp3]
diabetes mellitus, sugar diabetes	<b>糖尿病</b> <br> とうにょうびょう <br> [sound:4c-k-糖尿病.mp3]
leukemia	<b>白血病</b> <br> はっけつびょう <br> [sound:4c-k-白血病.mp3]
condition of a disease (patient)	<b>病状</b> <br> びょうじょう <br> [sound:4c-k-病状.mp3]
(hospital) ward	<b>病棟</b> <br> びょうとう <br> [sound:4c-k-病棟.mp3]
agricultural cooperative	<b>農協</b> <br> のうきょう <br> [sound:4c-k-農協.mp3]
agricultural community, farm village, rural	<b>農村</b> <br> のうそん <br> [sound:4c-k-農村.mp3]
farmers, peasants	<b>農民</b> <br> のうみん <br> [sound:4c-k-農民.mp3]
agricultural chemical (i.e. pesticide, herbicide, fungicide, etc.), agrochemical, agrichemical	<b>農薬</b> <br> のうやく <br> [sound:4c-k-農薬.mp3]
capital (city) of a state	<b>州都</b> <br> しゅうと <br> [sound:4c-k-州都.mp3]
state government	<b>州政府</b> <br> しゅうせいふ <br> [sound:4c-k-州政府.mp3]
Guangzhou (China), Canton	<b>広州</b> <br> こうしゅう <br> [sound:4c-k-広州.mp3]
(Russian) maritime provinces	<b>沿海州</b> <br> えんかいしゅう <br> [sound:4c-k-沿海州.mp3]
martial arts, military arts, Bushido	<b>武道</b> <br> ぶどう <br> [sound:4c-k-武道.mp3]
warrior, samurai	<b>武士</b> <br> ぶし, ぶふ, もののふ <br> [sound:4c-k-武士.mp3]
nuclear arms	<b>核武装</b> <br> かくぶそう <br> [sound:4c-k-核武装.mp3]
warrior	<b>武者</b> <br> むしゃ <br> [sound:4c-k-武者.mp3]
cheer, shout of joy	<b>歓声</b> <br> かんせい <br> [sound:4c-k-歓声.mp3]
encouragement, cheering, support	<b>声援</b> <br> せいえん <br> [sound:4c-k-声援.mp3]
vocal music	<b>声楽</b> <br> せいがく <br> [sound:4c-k-声楽.mp3]
first tone, first speech	<b>第一声</b> <br> だいいっせい <br> [sound:4c-k-第一声.mp3]
material, substance	<b>物質</b> <br> ぶっしつ <br> [sound:4c-k-物質.mp3]
substantial	<b>実質的</b> <br> じっしつてき <br> [sound:4c-k-実質的.mp3]
constitution (physical), genetic make-up, predisposition (to disease)	<b>体質</b> <br> たいしつ <br> [sound:4c-k-体質.mp3]
question; interpellation	<b>質疑</b> <br> しつぎ <br> [sound:4c-k-質疑.mp3]
deplorable, bad luck, regret, disappointment	<b>残念</b> <br> ざんねん <br> [sound:4c-k-残念.mp3]
idea	<b>理念</b> <br> りねん <br> [sound:4c-k-理念.mp3]
mind	<b>念頭</b> <br> ねんとう <br> [sound:4c-k-念頭.mp3]
general idea, concept, notion	<b>概念</b> <br> がいねん <br> [sound:4c-k-概念.mp3]
waiting, waiting time	<b>待ち</b> <br> まち <br> [sound:4c-k-待ち.mp3]
reception, welcome, serving (food); business entertainment	<b>接待</b> <br> せったい <br> [sound:4c-k-接待.mp3]
feeling of expectation	<b>期待感</b> <br> きたいかん <br> [sound:4c-k-期待感.mp3]
ill-treatment, oppression	<b>虐待</b> <br> ぎゃくたい <br> [sound:4c-k-虐待.mp3]
entrance examination	<b>入試</b> <br> にゅうし <br> [sound:4c-k-入試.mp3]
trial calculation, preliminary calculation	<b>試算</b> <br> しさん <br> [sound:4c-k-試算.mp3]
tentative	<b>試案</b> <br> しあん <br> [sound:4c-k-試案.mp3]
test, trial, probation, ordeal, tribulation	<b>試練</b> <br> しれん <br> [sound:4c-k-試練.mp3]
bereaved family	<b>遺族</b> <br> いぞく <br> [sound:4c-k-遺族.mp3]
nationalism	<b>民族主義</b> <br> みんぞくしゅぎ <br> [sound:4c-k-民族主義.mp3]
relatives	<b>親族</b> <br> しんぞく <br> [sound:4c-k-親族.mp3]
family, relatives, dependents; household	<b>一族</b> <br> いちぞく <br> [sound:4c-k-一族.mp3]
phenomenon	<b>象</b> <br> しょう <br> [sound:4c-k-象.mp3]
Meteorological Agency	<b>気象庁</b> <br> きしょうちょう <br> [sound:4c-k-気象庁.mp3]
weather, climate	<b>気象</b> <br> きしょう <br> [sound:4c-k-気象.mp3]
symbol	<b>象徴</b> <br> しょうちょう <br> [sound:4c-k-象徴.mp3]
Sumitomo Bank	住友銀行	すみともぎんこう	4c-k-住友銀行.mp3