彼は常に冷静です。 <br><br> (常)	<b>かれはつねにれいせいです。</b> <br> He is always calm. <br> [sound:4c-s-彼は常に冷静です。.mp3]
He is always calm.	<b>彼は常に冷静です。</b> <br> かれはつねにれいせいです。 <br><br> (常) <br> [sound:4c-s-彼は常に冷静です。.mp3]
[sound:4c-k-常に.mp3]	<b>常に</b> <br> つねに <br> always, constantly
常に	<b>つねに</b> <br> always, constantly <br> [sound:4c-k-常に.mp3]
always, constantly	<b>常に</b> <br> つねに <br> [sound:4c-k-常に.mp3]
[sound:4c-s-安全を常に考えてください。.mp3]	<b>安全を常に考えてください。</b> <br> あんぜんをつねにかんがえてください。 <br><br> (常に) <br> Always consider safety.
安全を常に考えてください。 <br><br> (常に)	<b>あんぜんをつねにかんがえてください。</b> <br> Always consider safety. <br> [sound:4c-s-安全を常に考えてください。.mp3]
Always consider safety.	<b>安全を常に考えてください。</b> <br> あんぜんをつねにかんがえてください。 <br><br> (常に) <br> [sound:4c-s-安全を常に考えてください。.mp3]
[sound:4c-k-経常.mp3]	<b>経常</b> <br> けいじょう <br> ordinary
経常	<b>けいじょう</b> <br> ordinary <br> [sound:4c-k-経常.mp3]
ordinary	<b>経常</b> <br> けいじょう <br> [sound:4c-k-経常.mp3]
[sound:4c-s-会社の経常利益が増加しました。.mp3]	<b>会社の経常利益が増加しました。</b> <br> かいしゃのけいじょうりえきがぞうかしました。 <br><br> (経常) <br> The company's recurring profit has increased.
会社の経常利益が増加しました。 <br><br> (経常)	<b>かいしゃのけいじょうりえきがぞうかしました。</b> <br> The company's recurring profit has increased. <br> [sound:4c-s-会社の経常利益が増加しました。.mp3]
The company's recurring profit has increased.	<b>会社の経常利益が増加しました。</b> <br> かいしゃのけいじょうりえきがぞうかしました。 <br><br> (経常) <br> [sound:4c-s-会社の経常利益が増加しました。.mp3]
[sound:4c-k-異常.mp3]	<b>異常</b> <br> いじょう <br> strangeness, abnormality, disorder
異常	<b>いじょう</b> <br> strangeness, abnormality, disorder <br> [sound:4c-k-異常.mp3]
strangeness, abnormality, disorder	<b>異常</b> <br> いじょう <br> [sound:4c-k-異常.mp3]
[sound:4c-s-異常な気象が続いています。.mp3]	<b>異常な気象が続いています。</b> <br> いじょうなきしょうがつづいています。 <br><br> (異常) <br> Abnormal weather is continuing.
異常な気象が続いています。 <br><br> (異常)	<b>いじょうなきしょうがつづいています。</b> <br> Abnormal weather is continuing. <br> [sound:4c-s-異常な気象が続いています。.mp3]
Abnormal weather is continuing.	<b>異常な気象が続いています。</b> <br> いじょうなきしょうがつづいています。 <br><br> (異常) <br> [sound:4c-s-異常な気象が続いています。.mp3]
[sound:4c-k-学校.mp3]	<b>学校</b> <br> がっこう <br> school
学校	<b>がっこう</b> <br> school <br> [sound:4c-k-学校.mp3]
school	<b>学校</b> <br> がっこう <br> [sound:4c-k-学校.mp3]
[sound:4c-s-学校へ行きます。.mp3]	<b>学校へ行きます。</b> <br> がっこうへいきます。 <br><br> (学校) <br> I am going to school.
学校へ行きます。 <br><br> (学校)	<b>がっこうへいきます。</b> <br> I am going to school. <br> [sound:4c-s-学校へ行きます。.mp3]
I am going to school.	<b>学校へ行きます。</b> <br> がっこうへいきます。 <br><br> (学校) <br> [sound:4c-s-学校へ行きます。.mp3]
[sound:4c-k-高校.mp3]	<b>高校</b> <br> こうこう <br> senior high school
高校	<b>こうこう</b> <br> senior high school <br> [sound:4c-k-高校.mp3]
senior high school	<b>高校</b> <br> こうこう <br> [sound:4c-k-高校.mp3]
[sound:4c-s-高校で数学を学んでいます。.mp3]	<b>高校で数学を学んでいます。</b> <br> こうこうですうがくをまなんでいます。 <br><br> (高校) <br> I am studying mathematics in high school.
高校で数学を学んでいます。 <br><br> (高校)	<b>こうこうですうがくをまなんでいます。</b> <br> I am studying mathematics in high school. <br> [sound:4c-s-高校で数学を学んでいます。.mp3]
I am studying mathematics in high school.	<b>高校で数学を学んでいます。</b> <br> こうこうですうがくをまなんでいます。 <br><br> (高校) <br> [sound:4c-s-高校で数学を学んでいます。.mp3]
[sound:4c-k-同校.mp3]	<b>同校</b> <br> どうこう <br> same school
同校	<b>どうこう</b> <br> same school <br> [sound:4c-k-同校.mp3]
same school	<b>同校</b> <br> どうこう <br> [sound:4c-k-同校.mp3]
[sound:4c-s-彼は同校の卒業生です。.mp3]	<b>彼は同校の卒業生です。</b> <br> かれはどうこうのそつぎょうせいです。 <br><br> (同校) <br> He is a graduate of the same school.
彼は同校の卒業生です。 <br><br> (同校)	<b>かれはどうこうのそつぎょうせいです。</b> <br> He is a graduate of the same school. <br> [sound:4c-s-彼は同校の卒業生です。.mp3]
He is a graduate of the same school.	<b>彼は同校の卒業生です。</b> <br> かれはどうこうのそつぎょうせいです。 <br><br> (同校) <br> [sound:4c-s-彼は同校の卒業生です。.mp3]
[sound:4c-k-専門学校.mp3]	<b>専門学校</b> <br> せんもんがっこう, せんもんガッコウ, せんもんガッコ <br> vocational school, technical school
専門学校	<b>せんもんがっこう, せんもんガッコウ, せんもんガッコ</b> <br> vocational school, technical school <br> [sound:4c-k-専門学校.mp3]
vocational school, technical school	<b>専門学校</b> <br> せんもんがっこう, せんもんガッコウ, せんもんガッコ <br> [sound:4c-k-専門学校.mp3]
[sound:4c-s-専門学校で技術を学びます。.mp3]	<b>専門学校で技術を学びます。</b> <br> せんもんがっこうでぎじゅつをまなびます。 <br><br> (専門学校) <br> I am learning technical skills at a vocational school.
専門学校で技術を学びます。 <br><br> (専門学校)	<b>せんもんがっこうでぎじゅつをまなびます。</b> <br> I am learning technical skills at a vocational school. <br> [sound:4c-s-専門学校で技術を学びます。.mp3]
I am learning technical skills at a vocational school.	<b>専門学校で技術を学びます。</b> <br> せんもんがっこうでぎじゅつをまなびます。 <br><br> (専門学校) <br> [sound:4c-s-専門学校で技術を学びます。.mp3]
[sound:4c-k-資料.mp3]	<b>資料</b> <br> しりょう <br> materials, data, document
資料	<b>しりょう</b> <br> materials, data, document <br> [sound:4c-k-資料.mp3]
materials, data, document	<b>資料</b> <br> しりょう <br> [sound:4c-k-資料.mp3]
[sound:4c-s-会議の資料を用意しました。.mp3]	<b>会議の資料を用意しました。</b> <br> かいぎのしりょうをよういしました。 <br><br> (資料) <br> I prepared materials for the meeting.
会議の資料を用意しました。 <br><br> (資料)	<b>かいぎのしりょうをよういしました。</b> <br> I prepared materials for the meeting. <br> [sound:4c-s-会議の資料を用意しました。.mp3]
I prepared materials for the meeting.	<b>会議の資料を用意しました。</b> <br> かいぎのしりょうをよういしました。 <br><br> (資料) <br> [sound:4c-s-会議の資料を用意しました。.mp3]
[sound:4c-k-無料.mp3]	<b>無料</b> <br> むりょう <br> free, no charge
無料	<b>むりょう</b> <br> free, no charge <br> [sound:4c-k-無料.mp3]
free, no charge	<b>無料</b> <br> むりょう <br> [sound:4c-k-無料.mp3]
[sound:4c-s-このサービスは無料です。.mp3]	<b>このサービスは無料です。</b> <br> このサービスはむりょうです。 <br><br> (無料) <br> This service is free.
このサービスは無料です。 <br><br> (無料)	<b>このサービスはむりょうです。</b> <br> This service is free. <br> [sound:4c-s-このサービスは無料です。.mp3]
This service is free.	<b>このサービスは無料です。</b> <br> このサービスはむりょうです。 <br><br> (無料) <br> [sound:4c-s-このサービスは無料です。.mp3]
[sound:4c-k-給料.mp3]	<b>給料</b> <br> きゅうりょう <br> salary, wages
給料	<b>きゅうりょう</b> <br> salary, wages <br> [sound:4c-k-給料.mp3]
salary, wages	<b>給料</b> <br> きゅうりょう <br> [sound:4c-k-給料.mp3]
[sound:4c-s-給料が振り込まれました。.mp3]	<b>給料が振り込まれました。</b> <br> きゅうりょうがふりこまれました。 <br><br> (給料) <br> My salary has been deposited.
給料が振り込まれました。 <br><br> (給料)	<b>きゅうりょうがふりこまれました。</b> <br> My salary has been deposited. <br> [sound:4c-s-給料が振り込まれました。.mp3]
My salary has been deposited.	<b>給料が振り込まれました。</b> <br> きゅうりょうがふりこまれました。 <br><br> (給料) <br> [sound:4c-s-給料が振り込まれました。.mp3]
[sound:4c-k-飲料.mp3]	<b>飲料</b> <br> いんりょう <br> (a) drink
飲料	<b>いんりょう</b> <br> (a) drink <br> [sound:4c-k-飲料.mp3]
(a) drink	<b>飲料</b> <br> いんりょう <br> [sound:4c-k-飲料.mp3]
[sound:4c-s-この飲料は健康に良いです。.mp3]	<b>この飲料は健康に良いです。</b> <br> このいんりょうはけんこうによいです。 <br><br> (飲料) <br> This beverage is good for health.
この飲料は健康に良いです。 <br><br> (飲料)	<b>このいんりょうはけんこうによいです。</b> <br> This beverage is good for health. <br> [sound:4c-s-この飲料は健康に良いです。.mp3]
This beverage is good for health.	<b>この飲料は健康に良いです。</b> <br> このいんりょうはけんこうによいです。 <br><br> (飲料) <br> [sound:4c-s-この飲料は健康に良いです。.mp3]
[sound:4c-k-沢.mp3]	<b>沢</b> <br> さわ <br> swamp, marsh; mountain stream, valley, dale
沢	<b>さわ</b> <br> swamp, marsh; mountain stream, valley, dale <br> [sound:4c-k-沢.mp3]
swamp, marsh; mountain stream, valley, dale	<b>沢</b> <br> さわ <br> [sound:4c-k-沢.mp3]
[sound:4c-s-山には沢が流れています。.mp3]	<b>山には沢が流れています。</b> <br> やまにはさわがながれています。 <br><br> (沢) <br> A stream flows in the mountains.
山には沢が流れています。 <br><br> (沢)	<b>やまにはさわがながれています。</b> <br> A stream flows in the mountains. <br> [sound:4c-s-山には沢が流れています。.mp3]
A stream flows in the mountains.	<b>山には沢が流れています。</b> <br> やまにはさわがながれています。 <br><br> (沢) <br> [sound:4c-s-山には沢が流れています。.mp3]
[sound:4c-k-光沢.mp3]	<b>光沢</b> <br> こうたく <br> brilliance, polish, lustre, luster, glossy finish (of photographs)
光沢	<b>こうたく</b> <br> brilliance, polish, lustre, luster, glossy finish (of photographs) <br> [sound:4c-k-光沢.mp3]
brilliance, polish, lustre, luster, glossy finish (of photographs)	<b>光沢</b> <br> こうたく <br> [sound:4c-k-光沢.mp3]
[sound:4c-s-この車の塗装は光沢があります。.mp3]	<b>この車の塗装は光沢があります。</b> <br> このくるまのとそうはこうたくがあります。 <br><br> (光沢) <br> This car's paint has a glossy finish.
この車の塗装は光沢があります。 <br><br> (光沢)	<b>このくるまのとそうはこうたくがあります。</b> <br> This car's paint has a glossy finish. <br> [sound:4c-s-この車の塗装は光沢があります。.mp3]
This car's paint has a glossy finish.	<b>この車の塗装は光沢があります。</b> <br> このくるまのとそうはこうたくがあります。 <br><br> (光沢) <br> [sound:4c-s-この車の塗装は光沢があります。.mp3]
[sound:4c-k-沼沢.mp3]	<b>沼沢</b> <br> しょうたく <br> marsh, swamp
沼沢	<b>しょうたく</b> <br> marsh, swamp <br> [sound:4c-k-沼沢.mp3]
marsh, swamp	<b>沼沢</b> <br> しょうたく <br> [sound:4c-k-沼沢.mp3]
[sound:4c-s-この地域には沼沢地が多いです。.mp3]	<b>この地域には沼沢地が多いです。</b> <br> このちいきにはしょうたくちがおおいです。 <br><br> (沼沢) <br> There are many marshlands in this area.
この地域には沼沢地が多いです。 <br><br> (沼沢)	<b>このちいきにはしょうたくちがおおいです。</b> <br> There are many marshlands in this area. <br> [sound:4c-s-この地域には沼沢地が多いです。.mp3]
There are many marshlands in this area.	<b>この地域には沼沢地が多いです。</b> <br> このちいきにはしょうたくちがおおいです。 <br><br> (沼沢) <br> [sound:4c-s-この地域には沼沢地が多いです。.mp3]
[sound:4c-k-恩沢.mp3]	<b>恩沢</b> <br> おんたく, おんだく <br> favour, favor, benefit
恩沢	<b>おんたく, おんだく</b> <br> favour, favor, benefit <br> [sound:4c-k-恩沢.mp3]
favour, favor, benefit	<b>恩沢</b> <br> おんたく, おんだく <br> [sound:4c-k-恩沢.mp3]
[sound:4c-s-彼の恩沢に感謝しています。.mp3]	<b>彼の恩沢に感謝しています。</b> <br> かれのおんたくにかんしゃしています。 <br><br> (恩沢) <br> I appreciate his benevolence.
彼の恩沢に感謝しています。 <br><br> (恩沢)	<b>かれのおんたくにかんしゃしています。</b> <br> I appreciate his benevolence. <br> [sound:4c-s-彼の恩沢に感謝しています。.mp3]
I appreciate his benevolence.	<b>彼の恩沢に感謝しています。</b> <br> かれのおんたくにかんしゃしています。 <br><br> (恩沢) <br> [sound:4c-s-彼の恩沢に感謝しています。.mp3]
[sound:4c-k-裁判.mp3]	<b>裁判</b> <br> さいばん <br> trial, judgement, judgment
裁判	<b>さいばん</b> <br> trial, judgement, judgment <br> [sound:4c-k-裁判.mp3]
trial, judgement, judgment	<b>裁判</b> <br> さいばん <br> [sound:4c-k-裁判.mp3]
[sound:4c-s-裁判が始まりました。.mp3]	<b>裁判が始まりました。</b> <br> さいばんがはじまりました。 <br><br> (裁判) <br> The trial has started.
裁判が始まりました。 <br><br> (裁判)	<b>さいばんがはじまりました。</b> <br> The trial has started. <br> [sound:4c-s-裁判が始まりました。.mp3]
The trial has started.	<b>裁判が始まりました。</b> <br> さいばんがはじまりました。 <br><br> (裁判) <br> [sound:4c-s-裁判が始まりました。.mp3]
[sound:4c-k-総裁.mp3]	<b>総裁</b> <br> そうさい <br> president
総裁	<b>そうさい</b> <br> president <br> [sound:4c-k-総裁.mp3]
president	<b>総裁</b> <br> そうさい <br> [sound:4c-k-総裁.mp3]
[sound:4c-s-彼は総裁に選ばれました。.mp3]	<b>彼は総裁に選ばれました。</b> <br> かれはそうさいにえらばれました。 <br><br> (総裁) <br> He was chosen as the president.
彼は総裁に選ばれました。 <br><br> (総裁)	<b>かれはそうさいにえらばれました。</b> <br> He was chosen as the president. <br> [sound:4c-s-彼は総裁に選ばれました。.mp3]
He was chosen as the president.	<b>彼は総裁に選ばれました。</b> <br> かれはそうさいにえらばれました。 <br><br> (総裁) <br> [sound:4c-s-彼は総裁に選ばれました。.mp3]
[sound:4c-k-裁判官.mp3]	<b>裁判官</b> <br> さいばんかん <br> judge
裁判官	<b>さいばんかん</b> <br> judge <br> [sound:4c-k-裁判官.mp3]
judge	<b>裁判官</b> <br> さいばんかん <br> [sound:4c-k-裁判官.mp3]
[sound:4c-s-裁判官が判決を下しました。.mp3]	<b>裁判官が判決を下しました。</b> <br> さいばんかんがはんけつをくだしました。 <br><br> (裁判官) <br> The judge made a ruling.
裁判官が判決を下しました。 <br><br> (裁判官)	<b>さいばんかんがはんけつをくだしました。</b> <br> The judge made a ruling. <br> [sound:4c-s-裁判官が判決を下しました。.mp3]
The judge made a ruling.	<b>裁判官が判決を下しました。</b> <br> さいばんかんがはんけつをくだしました。 <br><br> (裁判官) <br> [sound:4c-s-裁判官が判決を下しました。.mp3]
[sound:4c-k-裁量.mp3]	<b>裁量</b> <br> さいりょう <br> admeasure, discretion
裁量	<b>さいりょう</b> <br> admeasure, discretion <br> [sound:4c-k-裁量.mp3]
admeasure, discretion	<b>裁量</b> <br> さいりょう <br> [sound:4c-k-裁量.mp3]
[sound:4c-s-仕事の裁量が大きいです。.mp3]	<b>仕事の裁量が大きいです。</b> <br> しごとのさいりょうがおおきいです。 <br><br> (裁量) <br> The job has a lot of discretion.
仕事の裁量が大きいです。 <br><br> (裁量)	<b>しごとのさいりょうがおおきいです。</b> <br> The job has a lot of discretion. <br> [sound:4c-s-仕事の裁量が大きいです。.mp3]
The job has a lot of discretion.	<b>仕事の裁量が大きいです。</b> <br> しごとのさいりょうがおおきいです。 <br><br> (裁量) <br> [sound:4c-s-仕事の裁量が大きいです。.mp3]
[sound:4c-k-状況.mp3]	<b>状況</b> <br> じょうきょう <br> state of affairs (around you), situation, circumstances
状況	<b>じょうきょう</b> <br> state of affairs (around you), situation, circumstances <br> [sound:4c-k-状況.mp3]
state of affairs (around you), situation, circumstances	<b>状況</b> <br> じょうきょう <br> [sound:4c-k-状況.mp3]
[sound:4c-s-現在の状況を説明します。.mp3]	<b>現在の状況を説明します。</b> <br> げんざいのじょうきょうをせつめいします。 <br><br> (状況) <br> I will explain the current situation.
現在の状況を説明します。 <br><br> (状況)	<b>げんざいのじょうきょうをせつめいします。</b> <br> I will explain the current situation. <br> [sound:4c-s-現在の状況を説明します。.mp3]
I will explain the current situation.	<b>現在の状況を説明します。</b> <br> げんざいのじょうきょうをせつめいします。 <br><br> (状況) <br> [sound:4c-s-現在の状況を説明します。.mp3]
[sound:4c-k-状態.mp3]	<b>状態</b> <br> じょうたい <br> current status, condition, situation, circumstances, state
状態	<b>じょうたい</b> <br> current status, condition, situation, circumstances, state <br> [sound:4c-k-状態.mp3]
current status, condition, situation, circumstances, state	<b>状態</b> <br> じょうたい <br> [sound:4c-k-状態.mp3]
[sound:4c-s-彼の健康状態は良好です。.mp3]	<b>彼の健康状態は良好です。</b> <br> かれのけんこうじょうたいはりょうこうです。 <br><br> (状態) <br> His health condition is good.
彼の健康状態は良好です。 <br><br> (状態)	<b>かれのけんこうじょうたいはりょうこうです。</b> <br> His health condition is good. <br> [sound:4c-s-彼の健康状態は良好です。.mp3]
His health condition is good.	<b>彼の健康状態は良好です。</b> <br> かれのけんこうじょうたいはりょうこうです。 <br><br> (状態) <br> [sound:4c-s-彼の健康状態は良好です。.mp3]
[sound:4c-k-形状.mp3]	<b>形状</b> <br> けいじょう <br> shape, form
形状	<b>けいじょう</b> <br> shape, form <br> [sound:4c-k-形状.mp3]
shape, form	<b>形状</b> <br> けいじょう <br> [sound:4c-k-形状.mp3]
[sound:4c-s-この商品の形状はユニークです。.mp3]	<b>この商品の形状はユニークです。</b> <br> このしょうひんのけいじょうはユニークです。 <br><br> (形状) <br> The shape of this product is unique.
この商品の形状はユニークです。 <br><br> (形状)	<b>このしょうひんのけいじょうはユニークです。</b> <br> The shape of this product is unique. <br> [sound:4c-s-この商品の形状はユニークです。.mp3]
The shape of this product is unique.	<b>この商品の形状はユニークです。</b> <br> このしょうひんのけいじょうはユニークです。 <br><br> (形状) <br> [sound:4c-s-この商品の形状はユニークです。.mp3]
[sound:4c-k-窮状.mp3]	<b>窮状</b> <br> きゅうじょう <br> distress, wretched condition
窮状	<b>きゅうじょう</b> <br> distress, wretched condition <br> [sound:4c-k-窮状.mp3]
distress, wretched condition	<b>窮状</b> <br> きゅうじょう <br> [sound:4c-k-窮状.mp3]
[sound:4c-s-彼の窮状に同情しました。.mp3]	<b>彼の窮状に同情しました。</b> <br> かれのきゅうじょうにどうじょうしました。 <br><br> (窮状) <br> I sympathized with his plight.
彼の窮状に同情しました。 <br><br> (窮状)	<b>かれのきゅうじょうにどうじょうしました。</b> <br> I sympathized with his plight. <br> [sound:4c-s-彼の窮状に同情しました。.mp3]
I sympathized with his plight.	<b>彼の窮状に同情しました。</b> <br> かれのきゅうじょうにどうじょうしました。 <br><br> (窮状) <br> [sound:4c-s-彼の窮状に同情しました。.mp3]
[sound:4c-k-工場.mp3]	<b>工場</b> <br> こうじょう, こうば <br> factory, plant, mill, workshop
工場	<b>こうじょう, こうば</b> <br> factory, plant, mill, workshop <br> [sound:4c-k-工場.mp3]
factory, plant, mill, workshop	<b>工場</b> <br> こうじょう, こうば <br> [sound:4c-k-工場.mp3]
[sound:4c-s-この工場では車を生産しています。.mp3]	<b>この工場では車を生産しています。</b> <br> このこうじょうではくるまをせいさんしています。 <br><br> (工場) <br> This factory produces cars.
この工場では車を生産しています。 <br><br> (工場)	<b>このこうじょうではくるまをせいさんしています。</b> <br> This factory produces cars. <br> [sound:4c-s-この工場では車を生産しています。.mp3]
This factory produces cars.	<b>この工場では車を生産しています。</b> <br> このこうじょうではくるまをせいさんしています。 <br><br> (工場) <br> [sound:4c-s-この工場では車を生産しています。.mp3]
[sound:4c-k-工業.mp3]	<b>工業</b> <br> こうぎょう <br> (manufacturing) industry
工業	<b>こうぎょう</b> <br> (manufacturing) industry <br> [sound:4c-k-工業.mp3]
(manufacturing) industry	<b>工業</b> <br> こうぎょう <br> [sound:4c-k-工業.mp3]
[sound:4c-s-この地域は工業が盛んです。.mp3]	<b>この地域は工業が盛んです。</b> <br> このちいきはこうぎょうがさかんです。 <br><br> (工業) <br> This region is industrially active.
この地域は工業が盛んです。 <br><br> (工業)	<b>このちいきはこうぎょうがさかんです。</b> <br> This region is industrially active. <br> [sound:4c-s-この地域は工業が盛んです。.mp3]
This region is industrially active.	<b>この地域は工業が盛んです。</b> <br> このちいきはこうぎょうがさかんです。 <br><br> (工業) <br> [sound:4c-s-この地域は工業が盛んです。.mp3]
[sound:4c-k-商工.mp3]	<b>商工</b> <br> しょうこう <br> commerce and industry
商工	<b>しょうこう</b> <br> commerce and industry <br> [sound:4c-k-商工.mp3]
commerce and industry	<b>商工</b> <br> しょうこう <br> [sound:4c-k-商工.mp3]
[sound:4c-s-商工会議所で会議が開かれました。.mp3]	<b>商工会議所で会議が開かれました。</b> <br> しょうこうかいぎしょでかいぎがひらかれました。 <br><br> (商工) <br> A meeting was held at the Chamber of Commerce.
商工会議所で会議が開かれました。 <br><br> (商工)	<b>しょうこうかいぎしょでかいぎがひらかれました。</b> <br> A meeting was held at the Chamber of Commerce. <br> [sound:4c-s-商工会議所で会議が開かれました。.mp3]
A meeting was held at the Chamber of Commerce.	<b>商工会議所で会議が開かれました。</b> <br> しょうこうかいぎしょでかいぎがひらかれました。 <br><br> (商工) <br> [sound:4c-s-商工会議所で会議が開かれました。.mp3]
[sound:4c-k-大工.mp3]	<b>大工</b> <br> だいく <br> carpenter
大工	<b>だいく</b> <br> carpenter <br> [sound:4c-k-大工.mp3]
carpenter	<b>大工</b> <br> だいく <br> [sound:4c-k-大工.mp3]
[sound:4c-s-彼は熟練した大工です。.mp3]	<b>彼は熟練した大工です。</b> <br> かれはじゅくれんしただいくです。 <br><br> (大工) <br> He is a skilled carpenter.
彼は熟練した大工です。 <br><br> (大工)	<b>かれはじゅくれんしただいくです。</b> <br> He is a skilled carpenter. <br> [sound:4c-s-彼は熟練した大工です。.mp3]
He is a skilled carpenter.	<b>彼は熟練した大工です。</b> <br> かれはじゅくれんしただいくです。 <br><br> (大工) <br> [sound:4c-s-彼は熟練した大工です。.mp3]
[sound:4c-k-建設.mp3]	<b>建設</b> <br> けんせつ <br> construction, establishment
建設	<b>けんせつ</b> <br> construction, establishment <br> [sound:4c-k-建設.mp3]
construction, establishment	<b>建設</b> <br> けんせつ <br> [sound:4c-k-建設.mp3]
[sound:4c-s-新しいビルが建設されています。.mp3]	<b>新しいビルが建設されています。</b> <br> あたらしいビルがけんせつされています。 <br><br> (建設) <br> A new building is under construction.
新しいビルが建設されています。 <br><br> (建設)	<b>あたらしいビルがけんせつされています。</b> <br> A new building is under construction. <br> [sound:4c-s-新しいビルが建設されています。.mp3]
A new building is under construction.	<b>新しいビルが建設されています。</b> <br> あたらしいビルがけんせつされています。 <br><br> (建設) <br> [sound:4c-s-新しいビルが建設されています。.mp3]
[sound:4c-k-建築.mp3]	<b>建築</b> <br> けんちく <br> construction, architecture
建築	<b>けんちく</b> <br> construction, architecture <br> [sound:4c-k-建築.mp3]
construction, architecture	<b>建築</b> <br> けんちく <br> [sound:4c-k-建築.mp3]
[sound:4c-s-彼は建築を学んでいます。.mp3]	<b>彼は建築を学んでいます。</b> <br> かれはけんちくをまなんでいます。 <br><br> (建築) <br> He is studying architecture.
彼は建築を学んでいます。 <br><br> (建築)	<b>かれはけんちくをまなんでいます。</b> <br> He is studying architecture. <br> [sound:4c-s-彼は建築を学んでいます。.mp3]
He is studying architecture.	<b>彼は建築を学んでいます。</b> <br> かれはけんちくをまなんでいます。 <br><br> (建築) <br> [sound:4c-s-彼は建築を学んでいます。.mp3]
[sound:4c-k-建造物.mp3]	<b>建造物</b> <br> けんぞうぶつ <br> structure
建造物	<b>けんぞうぶつ</b> <br> structure <br> [sound:4c-k-建造物.mp3]
structure	<b>建造物</b> <br> けんぞうぶつ <br> [sound:4c-k-建造物.mp3]
[sound:4c-s-歴史的な建造物を訪れました。.mp3]	<b>歴史的な建造物を訪れました。</b> <br> れきしてきなけんぞうぶつをおとずれました。 <br><br> (建造物) <br> I visited a historic building.
歴史的な建造物を訪れました。 <br><br> (建造物)	<b>れきしてきなけんぞうぶつをおとずれました。</b> <br> I visited a historic building. <br> [sound:4c-s-歴史的な建造物を訪れました。.mp3]
I visited a historic building.	<b>歴史的な建造物を訪れました。</b> <br> れきしてきなけんぞうぶつをおとずれました。 <br><br> (建造物) <br> [sound:4c-s-歴史的な建造物を訪れました。.mp3]
[sound:4c-k-建つ.mp3]	<b>建つ</b> <br> たつ <br> to be erected, to be built
建つ	<b>たつ</b> <br> to be erected, to be built <br> [sound:4c-k-建つ.mp3]
to be erected, to be built	<b>建つ</b> <br> たつ <br> [sound:4c-k-建つ.mp3]
[sound:4c-s-新しい家が建ちました。.mp3]	<b>新しい家が建ちました。</b> <br> あたらしいいえがたちました。 <br><br> (建つ) <br> A new house has been built.
新しい家が建ちました。 <br><br> (建つ)	<b>あたらしいいえがたちました。</b> <br> A new house has been built. <br> [sound:4c-s-新しい家が建ちました。.mp3]
A new house has been built.	<b>新しい家が建ちました。</b> <br> あたらしいいえがたちました。 <br><br> (建つ) <br> [sound:4c-s-新しい家が建ちました。.mp3]
[sound:4c-k-語らう.mp3]	<b>語らう</b> <br> かたらう <br> to talk, to tell, to recite, to pledge, to conspire with
語らう	<b>かたらう</b> <br> to talk, to tell, to recite, to pledge, to conspire with <br> [sound:4c-k-語らう.mp3]
to talk, to tell, to recite, to pledge, to conspire with	<b>語らう</b> <br> かたらう <br> [sound:4c-k-語らう.mp3]
[sound:4c-s-友人と将来について語らいました。.mp3]	<b>友人と将来について語らいました。</b> <br> ゆうじんとしょうらいについてかたらいました。 <br><br> (語らう) <br> I talked with my friend about the future.
友人と将来について語らいました。 <br><br> (語らう)	<b>ゆうじんとしょうらいについてかたらいました。</b> <br> I talked with my friend about the future. <br> [sound:4c-s-友人と将来について語らいました。.mp3]
I talked with my friend about the future.	<b>友人と将来について語らいました。</b> <br> ゆうじんとしょうらいについてかたらいました。 <br><br> (語らう) <br> [sound:4c-s-友人と将来について語らいました。.mp3]
[sound:4c-k-語る.mp3]	<b>語る</b> <br> かたる <br> to talk, to tell, to recite
語る	<b>かたる</b> <br> to talk, to tell, to recite <br> [sound:4c-k-語る.mp3]
to talk, to tell, to recite	<b>語る</b> <br> かたる <br> [sound:4c-k-語る.mp3]
[sound:4c-s-彼は経験を語った。.mp3]	<b>彼は経験を語った。</b> <br> かれはけいけんをかたった。 <br><br> (語る) <br> He shared his experience.
彼は経験を語った。 <br><br> (語る)	<b>かれはけいけんをかたった。</b> <br> He shared his experience. <br> [sound:4c-s-彼は経験を語った。.mp3]
He shared his experience.	<b>彼は経験を語った。</b> <br> かれはけいけんをかたった。 <br><br> (語る) <br> [sound:4c-s-彼は経験を語った。.mp3]
[sound:4c-k-言語.mp3]	<b>言語</b> <br> げんご, ごんご <br> language
言語	<b>げんご, ごんご</b> <br> language <br> [sound:4c-k-言語.mp3]
language	<b>言語</b> <br> げんご, ごんご <br> [sound:4c-k-言語.mp3]
[sound:4c-s-言語を学ぶことは重要です。.mp3]	<b>言語を学ぶことは重要です。</b> <br> げんごをまなぶことはじゅうようです。 <br><br> (言語) <br> Learning a language is important.
言語を学ぶことは重要です。 <br><br> (言語)	<b>げんごをまなぶことはじゅうようです。</b> <br> Learning a language is important. <br> [sound:4c-s-言語を学ぶことは重要です。.mp3]
Learning a language is important.	<b>言語を学ぶことは重要です。</b> <br> げんごをまなぶことはじゅうようです。 <br><br> (言語) <br> [sound:4c-s-言語を学ぶことは重要です。.mp3]
[sound:4c-k-語り.mp3]	<b>語り</b> <br> かたり <br> talking
語り	<b>かたり</b> <br> talking <br> [sound:4c-k-語り.mp3]
talking	<b>語り</b> <br> かたり <br> [sound:4c-k-語り.mp3]
[sound:4c-s-昔話を語りました。.mp3]	<b>昔話を語りました。</b> <br> むかしばなしをかたりました。 <br><br> (語り) <br> I told an old story.
昔話を語りました。 <br><br> (語り)	<b>むかしばなしをかたりました。</b> <br> I told an old story. <br> [sound:4c-s-昔話を語りました。.mp3]
I told an old story.	<b>昔話を語りました。</b> <br> むかしばなしをかたりました。 <br><br> (語り) <br> [sound:4c-s-昔話を語りました。.mp3]
[sound:4c-k-球場.mp3]	<b>球場</b> <br> きゅうじょう <br> baseball stadium
球場	<b>きゅうじょう</b> <br> baseball stadium <br> [sound:4c-k-球場.mp3]
baseball stadium	<b>球場</b> <br> きゅうじょう <br> [sound:4c-k-球場.mp3]
[sound:4c-s-野球の試合を球場で観戦しました。.mp3]	<b>野球の試合を球場で観戦しました。</b> <br> やきゅうのしあいをきゅうじょうでかんせんしました。 <br><br> (球場) <br> I watched a baseball game at the stadium.
野球の試合を球場で観戦しました。 <br><br> (球場)	<b>やきゅうのしあいをきゅうじょうでかんせんしました。</b> <br> I watched a baseball game at the stadium. <br> [sound:4c-s-野球の試合を球場で観戦しました。.mp3]
I watched a baseball game at the stadium.	<b>野球の試合を球場で観戦しました。</b> <br> やきゅうのしあいをきゅうじょうでかんせんしました。 <br><br> (球場) <br> [sound:4c-s-野球の試合を球場で観戦しました。.mp3]
[sound:4c-k-球団.mp3]	<b>球団</b> <br> きゅうだん <br> baseball team
球団	<b>きゅうだん</b> <br> baseball team <br> [sound:4c-k-球団.mp3]
baseball team	<b>球団</b> <br> きゅうだん <br> [sound:4c-k-球団.mp3]
[sound:4c-s-有名な球団に入団しました。.mp3]	<b>有名な球団に入団しました。</b> <br> ゆうめいなきゅうだんににゅうだんしました。 <br><br> (球団) <br> He joined a famous baseball team.
有名な球団に入団しました。 <br><br> (球団)	<b>ゆうめいなきゅうだんににゅうだんしました。</b> <br> He joined a famous baseball team. <br> [sound:4c-s-有名な球団に入団しました。.mp3]
He joined a famous baseball team.	<b>有名な球団に入団しました。</b> <br> ゆうめいなきゅうだんににゅうだんしました。 <br><br> (球団) <br> [sound:4c-s-有名な球団に入団しました。.mp3]
[sound:4c-k-四球.mp3]	<b>四球</b> <br> しきゅう <br> four balls, base on balls (baseball), a walk
四球	<b>しきゅう</b> <br> four balls, base on balls (baseball), a walk <br> [sound:4c-k-四球.mp3]
four balls, base on balls (baseball), a walk	<b>四球</b> <br> しきゅう <br> [sound:4c-k-四球.mp3]
[sound:4c-s-彼は四球を選びました。.mp3]	<b>彼は四球を選びました。</b> <br> かれはしきゅうをえらびました。 <br><br> (四球) <br> He took a walk (four balls).
彼は四球を選びました。 <br><br> (四球)	<b>かれはしきゅうをえらびました。</b> <br> He took a walk (four balls). <br> [sound:4c-s-彼は四球を選びました。.mp3]
He took a walk (four balls).	<b>彼は四球を選びました。</b> <br> かれはしきゅうをえらびました。 <br><br> (四球) <br> [sound:4c-s-彼は四球を選びました。.mp3]
[sound:4c-k-投球.mp3]	<b>投球</b> <br> とうきゅう <br> pitching, throwing a ball, bowling (in cricket), pitched ball
投球	<b>とうきゅう</b> <br> pitching, throwing a ball, bowling (in cricket), pitched ball <br> [sound:4c-k-投球.mp3]
pitching, throwing a ball, bowling (in cricket), pitched ball	<b>投球</b> <br> とうきゅう <br> [sound:4c-k-投球.mp3]
[sound:4c-s-彼の投球は速いです。.mp3]	<b>彼の投球は速いです。</b> <br> かれのとうきゅうははやいです。 <br><br> (投球) <br> His pitching is fast.
彼の投球は速いです。 <br><br> (投球)	<b>かれのとうきゅうははやいです。</b> <br> His pitching is fast. <br> [sound:4c-s-彼の投球は速いです。.mp3]
His pitching is fast.	<b>彼の投球は速いです。</b> <br> かれのとうきゅうははやいです。 <br><br> (投球) <br> [sound:4c-s-彼の投球は速いです。.mp3]
[sound:4c-k-経営者.mp3]	<b>経営者</b> <br> けいえいしゃ <br> manager, proprietor
経営者	<b>けいえいしゃ</b> <br> manager, proprietor <br> [sound:4c-k-経営者.mp3]
manager, proprietor	<b>経営者</b> <br> けいえいしゃ <br> [sound:4c-k-経営者.mp3]
[sound:4c-s-彼は会社の経営者です。.mp3]	<b>彼は会社の経営者です。</b> <br> かれはかいしゃのけいえいしゃです。 <br><br> (経営者) <br> He is the manager of a company.
彼は会社の経営者です。 <br><br> (経営者)	<b>かれはかいしゃのけいえいしゃです。</b> <br> He is the manager of a company. <br> [sound:4c-s-彼は会社の経営者です。.mp3]
He is the manager of a company.	<b>彼は会社の経営者です。</b> <br> かれはかいしゃのけいえいしゃです。 <br><br> (経営者) <br> [sound:4c-s-彼は会社の経営者です。.mp3]
[sound:4c-k-国営.mp3]	<b>国営</b> <br> こくえい <br> state management
国営	<b>こくえい</b> <br> state management <br> [sound:4c-k-国営.mp3]
state management	<b>国営</b> <br> こくえい <br> [sound:4c-k-国営.mp3]
[sound:4c-s-国営の企業で働いています。.mp3]	<b>国営の企業で働いています。</b> <br> こくえいのきぎょうではたらいています。 <br><br> (国営) <br> I work for a state-owned company.
国営の企業で働いています。 <br><br> (国営)	<b>こくえいのきぎょうではたらいています。</b> <br> I work for a state-owned company. <br> [sound:4c-s-国営の企業で働いています。.mp3]
I work for a state-owned company.	<b>国営の企業で働いています。</b> <br> こくえいのきぎょうではたらいています。 <br><br> (国営) <br> [sound:4c-s-国営の企業で働いています。.mp3]
[sound:4c-k-陣営.mp3]	<b>陣営</b> <br> じんえい <br> camp (group of same ideological beliefs)
陣営	<b>じんえい</b> <br> camp (group of same ideological beliefs) <br> [sound:4c-k-陣営.mp3]
camp (group of same ideological beliefs)	<b>陣営</b> <br> じんえい <br> [sound:4c-k-陣営.mp3]
[sound:4c-s-選挙の陣営が活動しています。.mp3]	<b>選挙の陣営が活動しています。</b> <br> せんきょのじんえいがかつどうしています。 <br><br> (陣営) <br> The election campaign is actively working.
選挙の陣営が活動しています。 <br><br> (陣営)	<b>せんきょのじんえいがかつどうしています。</b> <br> The election campaign is actively working. <br> [sound:4c-s-選挙の陣営が活動しています。.mp3]
The election campaign is actively working.	<b>選挙の陣営が活動しています。</b> <br> せんきょのじんえいがかつどうしています。 <br><br> (陣営) <br> [sound:4c-s-選挙の陣営が活動しています。.mp3]
[sound:4c-k-民営.mp3]	<b>民営</b> <br> みんえい <br> private management
民営	<b>みんえい</b> <br> private management <br> [sound:4c-k-民営.mp3]
private management	<b>民営</b> <br> みんえい <br> [sound:4c-k-民営.mp3]
[sound:4c-s-この鉄道は民営です。.mp3]	<b>この鉄道は民営です。</b> <br> このてつどうはみんえいです。 <br><br> (民営) <br> This railway is privately operated.
この鉄道は民営です。 <br><br> (民営)	<b>このてつどうはみんえいです。</b> <br> This railway is privately operated. <br> [sound:4c-s-この鉄道は民営です。.mp3]
This railway is privately operated.	<b>この鉄道は民営です。</b> <br> このてつどうはみんえいです。 <br><br> (民営) <br> [sound:4c-s-この鉄道は民営です。.mp3]
[sound:4c-k-空気.mp3]	<b>空気</b> <br> くうき <br> air, atmosphere
空気	<b>くうき</b> <br> air, atmosphere <br> [sound:4c-k-空気.mp3]
air, atmosphere	<b>空気</b> <br> くうき <br> [sound:4c-k-空気.mp3]
[sound:4c-s-山の空気は新鮮です。.mp3]	<b>山の空気は新鮮です。</b> <br> やまのくうきはしんせんです。 <br><br> (空気) <br> The air in the mountains is fresh.
山の空気は新鮮です。 <br><br> (空気)	<b>やまのくうきはしんせんです。</b> <br> The air in the mountains is fresh. <br> [sound:4c-s-山の空気は新鮮です。.mp3]
The air in the mountains is fresh.	<b>山の空気は新鮮です。</b> <br> やまのくうきはしんせんです。 <br><br> (空気) <br> [sound:4c-s-山の空気は新鮮です。.mp3]
[sound:4c-k-航空機.mp3]	<b>航空機</b> <br> こうくうき <br> aircraft, aeroplane, airplane
航空機	<b>こうくうき</b> <br> aircraft, aeroplane, airplane <br> [sound:4c-k-航空機.mp3]
aircraft, aeroplane, airplane	<b>航空機</b> <br> こうくうき <br> [sound:4c-k-航空機.mp3]
[sound:4c-s-航空機の設計を学びました。.mp3]	<b>航空機の設計を学びました。</b> <br> こうくうきのせっけいをまなびました。 <br><br> (航空機) <br> I studied aircraft design.
航空機の設計を学びました。 <br><br> (航空機)	<b>こうくうきのせっけいをまなびました。</b> <br> I studied aircraft design. <br> [sound:4c-s-航空機の設計を学びました。.mp3]
I studied aircraft design.	<b>航空機の設計を学びました。</b> <br> こうくうきのせっけいをまなびました。 <br><br> (航空機) <br> [sound:4c-s-航空機の設計を学びました。.mp3]
[sound:4c-k-空間.mp3]	<b>空間</b> <br> くうかん <br> space, room, airspace
空間	<b>くうかん</b> <br> space, room, airspace <br> [sound:4c-k-空間.mp3]
space, room, airspace	<b>空間</b> <br> くうかん <br> [sound:4c-k-空間.mp3]
[sound:4c-s-この部屋は広い空間があります。.mp3]	<b>この部屋は広い空間があります。</b> <br> このへやはひろいくうかんがあります。 <br><br> (空間) <br> This room has a spacious area.
この部屋は広い空間があります。 <br><br> (空間)	<b>このへやはひろいくうかんがあります。</b> <br> This room has a spacious area. <br> [sound:4c-s-この部屋は広い空間があります。.mp3]
This room has a spacious area.	<b>この部屋は広い空間があります。</b> <br> このへやはひろいくうかんがあります。 <br><br> (空間) <br> [sound:4c-s-この部屋は広い空間があります。.mp3]
[sound:4c-k-空爆.mp3]	<b>空爆</b> <br> くうばく <br> aerial bombing
空爆	<b>くうばく</b> <br> aerial bombing <br> [sound:4c-k-空爆.mp3]
aerial bombing	<b>空爆</b> <br> くうばく <br> [sound:4c-k-空爆.mp3]
[sound:4c-s-都市が空爆を受けました。.mp3]	<b>都市が空爆を受けました。</b> <br> としがくうばくをうけました。 <br><br> (空爆) <br> The city was bombed.
都市が空爆を受けました。 <br><br> (空爆)	<b>としがくうばくをうけました。</b> <br> The city was bombed. <br> [sound:4c-s-都市が空爆を受けました。.mp3]
The city was bombed.	<b>都市が空爆を受けました。</b> <br> としがくうばくをうけました。 <br><br> (空爆) <br> [sound:4c-s-都市が空爆を受けました。.mp3]
[sound:4c-k-現職.mp3]	<b>現職</b> <br> げんしょく <br> present post, current office, (an) incumbent
現職	<b>げんしょく</b> <br> present post, current office, (an) incumbent <br> [sound:4c-k-現職.mp3]
present post, current office, (an) incumbent	<b>現職</b> <br> げんしょく <br> [sound:4c-k-現職.mp3]
[sound:4c-s-彼は現職の市長です。.mp3]	<b>彼は現職の市長です。</b> <br> かれはげんしょくのしちょうです。 <br><br> (現職) <br> He is the incumbent mayor.
彼は現職の市長です。 <br><br> (現職)	<b>かれはげんしょくのしちょうです。</b> <br> He is the incumbent mayor. <br> [sound:4c-s-彼は現職の市長です。.mp3]
He is the incumbent mayor.	<b>彼は現職の市長です。</b> <br> かれはげんしょくのしちょうです。 <br><br> (現職) <br> [sound:4c-s-彼は現職の市長です。.mp3]
[sound:4c-k-就職.mp3]	<b>就職</b> <br> しゅうしょく <br> finding employment, inauguration
就職	<b>しゅうしょく</b> <br> finding employment, inauguration <br> [sound:4c-k-就職.mp3]
finding employment, inauguration	<b>就職</b> <br> しゅうしょく <br> [sound:4c-k-就職.mp3]
[sound:4c-s-新しい会社に就職しました。.mp3]	<b>新しい会社に就職しました。</b> <br> あたらしいかいしゃにしゅうしょくしました。 <br><br> (就職) <br> I got a job at a new company.
新しい会社に就職しました。 <br><br> (就職)	<b>あたらしいかいしゃにしゅうしょくしました。</b> <br> I got a job at a new company. <br> [sound:4c-s-新しい会社に就職しました。.mp3]
I got a job at a new company.	<b>新しい会社に就職しました。</b> <br> あたらしいかいしゃにしゅうしょくしました。 <br><br> (就職) <br> [sound:4c-s-新しい会社に就職しました。.mp3]
[sound:4c-k-職業.mp3]	<b>職業</b> <br> しょくぎょう <br> occupation, business
職業	<b>しょくぎょう</b> <br> occupation, business <br> [sound:4c-k-職業.mp3]
occupation, business	<b>職業</b> <br> しょくぎょう <br> [sound:4c-k-職業.mp3]
[sound:4c-s-彼の職業は医者です。.mp3]	<b>彼の職業は医者です。</b> <br> かれのしょくぎょうはいしゃです。 <br><br> (職業) <br> His profession is a doctor.
彼の職業は医者です。 <br><br> (職業)	<b>かれのしょくぎょうはいしゃです。</b> <br> His profession is a doctor. <br> [sound:4c-s-彼の職業は医者です。.mp3]
His profession is a doctor.	<b>彼の職業は医者です。</b> <br> かれのしょくぎょうはいしゃです。 <br><br> (職業) <br> [sound:4c-s-彼の職業は医者です。.mp3]
[sound:4c-k-職場.mp3]	<b>職場</b> <br> しょくば <br> one's post, place of work, workplace
職場	<b>しょくば</b> <br> one's post, place of work, workplace <br> [sound:4c-k-職場.mp3]
one's post, place of work, workplace	<b>職場</b> <br> しょくば <br> [sound:4c-k-職場.mp3]
[sound:4c-s-職場の環境が良いです。.mp3]	<b>職場の環境が良いです。</b> <br> しょくばのかんきょうがよいです。 <br><br> (職場) <br> The work environment is good.
職場の環境が良いです。 <br><br> (職場)	<b>しょくばのかんきょうがよいです。</b> <br> The work environment is good. <br> [sound:4c-s-職場の環境が良いです。.mp3]
The work environment is good.	<b>職場の環境が良いです。</b> <br> しょくばのかんきょうがよいです。 <br><br> (職場) <br> [sound:4c-s-職場の環境が良いです。.mp3]
[sound:4c-k-保証.mp3]	<b>保証</b> <br> ほしょう <br> guarantee, security, assurance, pledge, warranty
保証	<b>ほしょう</b> <br> guarantee, security, assurance, pledge, warranty <br> [sound:4c-k-保証.mp3]
guarantee, security, assurance, pledge, warranty	<b>保証</b> <br> ほしょう <br> [sound:4c-k-保証.mp3]
[sound:4c-s-この製品には保証があります。.mp3]	<b>この製品には保証があります。</b> <br> このせいひんにはほしょうがあります。 <br><br> (保証) <br> This product comes with a warranty.
この製品には保証があります。 <br><br> (保証)	<b>このせいひんにはほしょうがあります。</b> <br> This product comes with a warranty. <br> [sound:4c-s-この製品には保証があります。.mp3]
This product comes with a warranty.	<b>この製品には保証があります。</b> <br> このせいひんにはほしょうがあります。 <br><br> (保証) <br> [sound:4c-s-この製品には保証があります。.mp3]
[sound:4c-k-証拠.mp3]	<b>証拠</b> <br> しょうこ <br> evidence, proof
証拠	<b>しょうこ</b> <br> evidence, proof <br> [sound:4c-k-証拠.mp3]
evidence, proof	<b>証拠</b> <br> しょうこ <br> [sound:4c-k-証拠.mp3]
[sound:4c-s-証拠を提示してください。.mp3]	<b>証拠を提示してください。</b> <br> しょうこをていじしてください。 <br><br> (証拠) <br> Please provide evidence.
証拠を提示してください。 <br><br> (証拠)	<b>しょうこをていじしてください。</b> <br> Please provide evidence. <br> [sound:4c-s-証拠を提示してください。.mp3]
Please provide evidence.	<b>証拠を提示してください。</b> <br> しょうこをていじしてください。 <br><br> (証拠) <br> [sound:4c-s-証拠を提示してください。.mp3]
[sound:4c-k-証明.mp3]	<b>証明</b> <br> しょうめい <br> proof, verification
証明	<b>しょうめい</b> <br> proof, verification <br> [sound:4c-k-証明.mp3]
proof, verification	<b>証明</b> <br> しょうめい <br> [sound:4c-k-証明.mp3]
[sound:4c-s-彼の身元を証明しました。.mp3]	<b>彼の身元を証明しました。</b> <br> かれのみもとをしょうめいしました。 <br><br> (証明) <br> I verified his identity.
彼の身元を証明しました。 <br><br> (証明)	<b>かれのみもとをしょうめいしました。</b> <br> I verified his identity. <br> [sound:4c-s-彼の身元を証明しました。.mp3]
I verified his identity.	<b>彼の身元を証明しました。</b> <br> かれのみもとをしょうめいしました。 <br><br> (証明) <br> [sound:4c-s-彼の身元を証明しました。.mp3]
[sound:4c-k-有価証券.mp3]	<b>有価証券</b> <br> ゆうかしょうけん <br> marketable securities, stocks and bonds
有価証券	<b>ゆうかしょうけん</b> <br> marketable securities, stocks and bonds <br> [sound:4c-k-有価証券.mp3]
marketable securities, stocks and bonds	<b>有価証券</b> <br> ゆうかしょうけん <br> [sound:4c-k-有価証券.mp3]
[sound:4c-s-有価証券の取引を行いました。.mp3]	<b>有価証券の取引を行いました。</b> <br> ゆうかしょうけんのとりひきをおこないました。 <br><br> (有価証券) <br> I conducted securities trading.
有価証券の取引を行いました。 <br><br> (有価証券)	<b>ゆうかしょうけんのとりひきをおこないました。</b> <br> I conducted securities trading. <br> [sound:4c-s-有価証券の取引を行いました。.mp3]
I conducted securities trading.	<b>有価証券の取引を行いました。</b> <br> ゆうかしょうけんのとりひきをおこないました。 <br><br> (有価証券) <br> [sound:4c-s-有価証券の取引を行いました。.mp3]
[sound:4c-k-土曜.mp3]	<b>土曜</b> <br> どよう <br> Saturday
土曜	<b>どよう</b> <br> Saturday <br> [sound:4c-k-土曜.mp3]
Saturday	<b>土曜</b> <br> どよう <br> [sound:4c-k-土曜.mp3]
[sound:4c-s-土曜に映画を見に行きます。.mp3]	<b>土曜に映画を見に行きます。</b> <br> どようにえいがをみにいきます。 <br><br> (土曜) <br> I will watch a movie on Saturday.
土曜に映画を見に行きます。 <br><br> (土曜)	<b>どようにえいがをみにいきます。</b> <br> I will watch a movie on Saturday. <br> [sound:4c-s-土曜に映画を見に行きます。.mp3]
I will watch a movie on Saturday.	<b>土曜に映画を見に行きます。</b> <br> どようにえいがをみにいきます。 <br><br> (土曜) <br> [sound:4c-s-土曜に映画を見に行きます。.mp3]
[sound:4c-k-国土.mp3]	<b>国土</b> <br> こくど <br> country, territory, domain, realm
国土	<b>こくど</b> <br> country, territory, domain, realm <br> [sound:4c-k-国土.mp3]
country, territory, domain, realm	<b>国土</b> <br> こくど <br> [sound:4c-k-国土.mp3]
[sound:4c-s-日本の国土は広いです。.mp3]	<b>日本の国土は広いです。</b> <br> にほんのこくどはひろいです。 <br><br> (国土) <br> Japan's land is vast.
日本の国土は広いです。 <br><br> (国土)	<b>にほんのこくどはひろいです。</b> <br> Japan's land is vast. <br> [sound:4c-s-日本の国土は広いです。.mp3]
Japan's land is vast.	<b>日本の国土は広いです。</b> <br> にほんのこくどはひろいです。 <br><br> (国土) <br> [sound:4c-s-日本の国土は広いです。.mp3]
[sound:4c-k-土俵.mp3]	<b>土俵</b> <br> どひょう <br> arena, esp. in sumo; forum (e.g. for discussion); sandbag, gabion
土俵	<b>どひょう</b> <br> arena, esp. in sumo; forum (e.g. for discussion); sandbag, gabion <br> [sound:4c-k-土俵.mp3]
arena, esp. in sumo; forum (e.g. for discussion); sandbag, gabion	<b>土俵</b> <br> どひょう <br> [sound:4c-k-土俵.mp3]
[sound:4c-s-相撲の土俵に上がりました。.mp3]	<b>相撲の土俵に上がりました。</b> <br> すもうのどひょうにあがりました。 <br><br> (土俵) <br> I stepped onto the sumo ring.
相撲の土俵に上がりました。 <br><br> (土俵)	<b>すもうのどひょうにあがりました。</b> <br> I stepped onto the sumo ring. <br> [sound:4c-s-相撲の土俵に上がりました。.mp3]
I stepped onto the sumo ring.	<b>相撲の土俵に上がりました。</b> <br> すもうのどひょうにあがりました。 <br><br> (土俵) <br> [sound:4c-s-相撲の土俵に上がりました。.mp3]
[sound:4c-k-土木.mp3]	<b>土木</b> <br> どぼく <br> public works
土木	<b>どぼく</b> <br> public works <br> [sound:4c-k-土木.mp3]
public works	<b>土木</b> <br> どぼく <br> [sound:4c-k-土木.mp3]
[sound:4c-s-土木工事が進行中です。.mp3]	<b>土木工事が進行中です。</b> <br> どぼくこうじがしんこうちゅうです。 <br><br> (土木) <br> Civil engineering work is in progress.
土木工事が進行中です。 <br><br> (土木)	<b>どぼくこうじがしんこうちゅうです。</b> <br> Civil engineering work is in progress. <br> [sound:4c-s-土木工事が進行中です。.mp3]
Civil engineering work is in progress.	<b>土木工事が進行中です。</b> <br> どぼくこうじがしんこうちゅうです。 <br><br> (土木) <br> [sound:4c-s-土木工事が進行中です。.mp3]
[sound:4c-k-給与.mp3]	<b>給与</b> <br> きゅうよ <br> pay, salary, wages, allowance, grant, supply
給与	<b>きゅうよ</b> <br> pay, salary, wages, allowance, grant, supply <br> [sound:4c-k-給与.mp3]
pay, salary, wages, allowance, grant, supply	<b>給与</b> <br> きゅうよ <br> [sound:4c-k-給与.mp3]
[sound:4c-s-給与が増えました。.mp3]	<b>給与が増えました。</b> <br> きゅうよがふえました。 <br><br> (給与) <br> My salary has increased.
給与が増えました。 <br><br> (給与)	<b>きゅうよがふえました。</b> <br> My salary has increased. <br> [sound:4c-s-給与が増えました。.mp3]
My salary has increased.	<b>給与が増えました。</b> <br> きゅうよがふえました。 <br><br> (給与) <br> [sound:4c-s-給与が増えました。.mp3]
[sound:4c-k-供与.mp3]	<b>供与</b> <br> きょうよ <br> giving, provision, furnishing
供与	<b>きょうよ</b> <br> giving, provision, furnishing <br> [sound:4c-k-供与.mp3]
giving, provision, furnishing	<b>供与</b> <br> きょうよ <br> [sound:4c-k-供与.mp3]
[sound:4c-s-政府は支援を供与した。.mp3]	<b>政府は支援を供与した。</b> <br> せいふはしえんをきょうよした。 <br><br> (供与) <br> The government provided aid.
政府は支援を供与した。 <br><br> (供与)	<b>せいふはしえんをきょうよした。</b> <br> The government provided aid. <br> [sound:4c-s-政府は支援を供与した。.mp3]
The government provided aid.	<b>政府は支援を供与した。</b> <br> せいふはしえんをきょうよした。 <br><br> (供与) <br> [sound:4c-s-政府は支援を供与した。.mp3]
[sound:4c-k-投与.mp3]	<b>投与</b> <br> とうよ <br> prescribing medicine, administering (medicine)
投与	<b>とうよ</b> <br> prescribing medicine, administering (medicine) <br> [sound:4c-k-投与.mp3]
prescribing medicine, administering (medicine)	<b>投与</b> <br> とうよ <br> [sound:4c-k-投与.mp3]
[sound:4c-s-医師は薬を投与した。.mp3]	<b>医師は薬を投与した。</b> <br> いしはくすりをとうよした。 <br><br> (投与) <br> The doctor administered the medicine.
医師は薬を投与した。 <br><br> (投与)	<b>いしはくすりをとうよした。</b> <br> The doctor administered the medicine. <br> [sound:4c-s-医師は薬を投与した。.mp3]
The doctor administered the medicine.	<b>医師は薬を投与した。</b> <br> いしはくすりをとうよした。 <br><br> (投与) <br> [sound:4c-s-医師は薬を投与した。.mp3]
[sound:4c-k-付与.mp3]	<b>付与</b> <br> ふよ <br> grant, allowance, endowment, bestowal, assignment, conferment
付与	<b>ふよ</b> <br> grant, allowance, endowment, bestowal, assignment, conferment <br> [sound:4c-k-付与.mp3]
grant, allowance, endowment, bestowal, assignment, conferment	<b>付与</b> <br> ふよ <br> [sound:4c-k-付与.mp3]
[sound:4c-s-このカードには特典が付与される。.mp3]	<b>このカードには特典が付与される。</b> <br> このかーどにはとくてんがふよされる。 <br><br> (付与) <br> This card comes with benefits.
このカードには特典が付与される。 <br><br> (付与)	<b>このかーどにはとくてんがふよされる。</b> <br> This card comes with benefits. <br> [sound:4c-s-このカードには特典が付与される。.mp3]
This card comes with benefits.	<b>このカードには特典が付与される。</b> <br> このかーどにはとくてんがふよされる。 <br><br> (付与) <br> [sound:4c-s-このカードには特典が付与される。.mp3]
[sound:4c-k-緊急.mp3]	<b>緊急</b> <br> きんきゅう <br> urgent, pressing, emergency
緊急	<b>きんきゅう</b> <br> urgent, pressing, emergency <br> [sound:4c-k-緊急.mp3]
urgent, pressing, emergency	<b>緊急</b> <br> きんきゅう <br> [sound:4c-k-緊急.mp3]
[sound:4c-s-緊急会議が開かれた。.mp3]	<b>緊急会議が開かれた。</b> <br> きんきゅうかいぎがひらかれた。 <br><br> (緊急) <br> An emergency meeting was held.
緊急会議が開かれた。 <br><br> (緊急)	<b>きんきゅうかいぎがひらかれた。</b> <br> An emergency meeting was held. <br> [sound:4c-s-緊急会議が開かれた。.mp3]
An emergency meeting was held.	<b>緊急会議が開かれた。</b> <br> きんきゅうかいぎがひらかれた。 <br><br> (緊急) <br> [sound:4c-s-緊急会議が開かれた。.mp3]
[sound:4c-k-急速.mp3]	<b>急速</b> <br> きゅうそく <br> rapid (e.g. progress)
急速	<b>きゅうそく</b> <br> rapid (e.g. progress) <br> [sound:4c-k-急速.mp3]
rapid (e.g. progress)	<b>急速</b> <br> きゅうそく <br> [sound:4c-k-急速.mp3]
[sound:4c-s-技術は急速に進化している。.mp3]	<b>技術は急速に進化している。</b> <br> ぎじゅつはきゅうそくにしんかしている。 <br><br> (急速) <br> Technology is evolving rapidly.
技術は急速に進化している。 <br><br> (急速)	<b>ぎじゅつはきゅうそくにしんかしている。</b> <br> Technology is evolving rapidly. <br> [sound:4c-s-技術は急速に進化している。.mp3]
Technology is evolving rapidly.	<b>技術は急速に進化している。</b> <br> ぎじゅつはきゅうそくにしんかしている。 <br><br> (急速) <br> [sound:4c-s-技術は急速に進化している。.mp3]
[sound:4c-k-早急.mp3]	<b>早急</b> <br> さっきゅう, そうきゅう <br> urgent
早急	<b>さっきゅう, そうきゅう</b> <br> urgent <br> [sound:4c-k-早急.mp3]
urgent	<b>早急</b> <br> さっきゅう, そうきゅう <br> [sound:4c-k-早急.mp3]
[sound:4c-s-この問題は早急に対応すべきです。.mp3]	<b>この問題は早急に対応すべきです。</b> <br> このもんだいはそうきゅうにたいおうすべきです。 <br><br> (早急) <br> This issue should be addressed immediately.
この問題は早急に対応すべきです。 <br><br> (早急)	<b>このもんだいはそうきゅうにたいおうすべきです。</b> <br> This issue should be addressed immediately. <br> [sound:4c-s-この問題は早急に対応すべきです。.mp3]
This issue should be addressed immediately.	<b>この問題は早急に対応すべきです。</b> <br> このもんだいはそうきゅうにたいおうすべきです。 <br><br> (早急) <br> [sound:4c-s-この問題は早急に対応すべきです。.mp3]
[sound:4c-k-急激.mp3]	<b>急激</b> <br> きゅうげき <br> sudden, precipitous, radical
急激	<b>きゅうげき</b> <br> sudden, precipitous, radical <br> [sound:4c-k-急激.mp3]
sudden, precipitous, radical	<b>急激</b> <br> きゅうげき <br> [sound:4c-k-急激.mp3]
[sound:4c-s-気温が急激に下がった。.mp3]	<b>気温が急激に下がった。</b> <br> きおんがきゅうげきにさがった。 <br><br> (急激) <br> The temperature dropped sharply.
気温が急激に下がった。 <br><br> (急激)	<b>きおんがきゅうげきにさがった。</b> <br> The temperature dropped sharply. <br> [sound:4c-s-気温が急激に下がった。.mp3]
The temperature dropped sharply.	<b>気温が急激に下がった。</b> <br> きおんがきゅうげきにさがった。 <br><br> (急激) <br> [sound:4c-s-気温が急激に下がった。.mp3]
[sound:4c-k-中止.mp3]	<b>中止</b> <br> ちゅうし <br> suspension, stoppage, discontinuance, interruption
中止	<b>ちゅうし</b> <br> suspension, stoppage, discontinuance, interruption <br> [sound:4c-k-中止.mp3]
suspension, stoppage, discontinuance, interruption	<b>中止</b> <br> ちゅうし <br> [sound:4c-k-中止.mp3]
[sound:4c-s-イベントは雨のため中止になった。.mp3]	<b>イベントは雨のため中止になった。</b> <br> いべんとはあめのためちゅうしになった。 <br><br> (中止) <br> The event was canceled due to rain.
イベントは雨のため中止になった。 <br><br> (中止)	<b>いべんとはあめのためちゅうしになった。</b> <br> The event was canceled due to rain. <br> [sound:4c-s-イベントは雨のため中止になった。.mp3]
The event was canceled due to rain.	<b>イベントは雨のため中止になった。</b> <br> いべんとはあめのためちゅうしになった。 <br><br> (中止) <br> [sound:4c-s-イベントは雨のため中止になった。.mp3]
[sound:4c-k-廃止.mp3]	<b>廃止</b> <br> はいし <br> abolition, repeal
廃止	<b>はいし</b> <br> abolition, repeal <br> [sound:4c-k-廃止.mp3]
abolition, repeal	<b>廃止</b> <br> はいし <br> [sound:4c-k-廃止.mp3]
[sound:4c-s-古い制度が廃止された。.mp3]	<b>古い制度が廃止された。</b> <br> ふるいせいどがはいしされた。 <br><br> (廃止) <br> The old system was abolished.
古い制度が廃止された。 <br><br> (廃止)	<b>ふるいせいどがはいしされた。</b> <br> The old system was abolished. <br> [sound:4c-s-古い制度が廃止された。.mp3]
The old system was abolished.	<b>古い制度が廃止された。</b> <br> ふるいせいどがはいしされた。 <br><br> (廃止) <br> [sound:4c-s-古い制度が廃止された。.mp3]
[sound:4c-k-歯止め.mp3]	<b>歯止め</b> <br> はどめ <br> brake, skid, pawl; restraint, curtailment, self-imposed limit, check
歯止め	<b>はどめ</b> <br> brake, skid, pawl; restraint, curtailment, self-imposed limit, check <br> [sound:4c-k-歯止め.mp3]
brake, skid, pawl; restraint, curtailment, self-imposed limit, check	<b>歯止め</b> <br> はどめ <br> [sound:4c-k-歯止め.mp3]
[sound:4c-s-政府はインフレに歯止めをかけた。.mp3]	<b>政府はインフレに歯止めをかけた。</b> <br> せいふはいんふれにはどめをかけた。 <br><br> (歯止め) <br> The government put a brake on inflation.
政府はインフレに歯止めをかけた。 <br><br> (歯止め)	<b>せいふはいんふれにはどめをかけた。</b> <br> The government put a brake on inflation. <br> [sound:4c-s-政府はインフレに歯止めをかけた。.mp3]
The government put a brake on inflation.	<b>政府はインフレに歯止めをかけた。</b> <br> せいふはいんふれにはどめをかけた。 <br><br> (歯止め) <br> [sound:4c-s-政府はインフレに歯止めをかけた。.mp3]
[sound:4c-k-受け止める.mp3]	<b>受け止める</b> <br> うけとめる <br> to catch, to stop the blow, to react to, to take
受け止める	<b>うけとめる</b> <br> to catch, to stop the blow, to react to, to take <br> [sound:4c-k-受け止める.mp3]
to catch, to stop the blow, to react to, to take	<b>受け止める</b> <br> うけとめる <br> [sound:4c-k-受け止める.mp3]
[sound:4c-s-彼はその批判を真剣に受け止めた。.mp3]	<b>彼はその批判を真剣に受け止めた。</b> <br> かれはそのひはんをしんけんにうけとめた。 <br><br> (受け止める) <br> He took the criticism seriously.
彼はその批判を真剣に受け止めた。 <br><br> (受け止める)	<b>かれはそのひはんをしんけんにうけとめた。</b> <br> He took the criticism seriously. <br> [sound:4c-s-彼はその批判を真剣に受け止めた。.mp3]
He took the criticism seriously.	<b>彼はその批判を真剣に受け止めた。</b> <br> かれはそのひはんをしんけんにうけとめた。 <br><br> (受け止める) <br> [sound:4c-s-彼はその批判を真剣に受け止めた。.mp3]
[sound:4c-k-送り.mp3]	<b>送り</b> <br> おくり <br> seeing off, sending off; funeral; escapement
送り	<b>おくり</b> <br> seeing off, sending off; funeral; escapement <br> [sound:4c-k-送り.mp3]
seeing off, sending off; funeral; escapement	<b>送り</b> <br> おくり <br> [sound:4c-k-送り.mp3]
[sound:4c-s-荷物を送りました。.mp3]	<b>荷物を送りました。</b> <br> にもつをおくりました。 <br><br> (送り) <br> I sent the package.
荷物を送りました。 <br><br> (送り)	<b>にもつをおくりました。</b> <br> I sent the package. <br> [sound:4c-s-荷物を送りました。.mp3]
I sent the package.	<b>荷物を送りました。</b> <br> にもつをおくりました。 <br><br> (送り) <br> [sound:4c-s-荷物を送りました。.mp3]
[sound:4c-k-先送り.mp3]	<b>先送り</b> <br> さきおくり <br> postpone
先送り	<b>さきおくり</b> <br> postpone <br> [sound:4c-k-先送り.mp3]
postpone	<b>先送り</b> <br> さきおくり <br> [sound:4c-k-先送り.mp3]
[sound:4c-s-問題の解決が先送りされた。.mp3]	<b>問題の解決が先送りされた。</b> <br> もんだいのかいけつがさきおくりされた。 <br><br> (先送り) <br> The resolution of the issue was postponed.
問題の解決が先送りされた。 <br><br> (先送り)	<b>もんだいのかいけつがさきおくりされた。</b> <br> The resolution of the issue was postponed. <br> [sound:4c-s-問題の解決が先送りされた。.mp3]
The resolution of the issue was postponed.	<b>問題の解決が先送りされた。</b> <br> もんだいのかいけつがさきおくりされた。 <br><br> (先送り) <br> [sound:4c-s-問題の解決が先送りされた。.mp3]
[sound:4c-k-見送り.mp3]	<b>見送り</b> <br> みおくり <br> seeing one off, farewell, escort
見送り	<b>みおくり</b> <br> seeing one off, farewell, escort <br> [sound:4c-k-見送り.mp3]
seeing one off, farewell, escort	<b>見送り</b> <br> みおくり <br> [sound:4c-k-見送り.mp3]
[sound:4c-s-試合の延期が見送りになった。.mp3]	<b>試合の延期が見送りになった。</b> <br> しあいのえんきがみおくりになった。 <br><br> (見送り) <br> The postponement of the match was called off.
試合の延期が見送りになった。 <br><br> (見送り)	<b>しあいのえんきがみおくりになった。</b> <br> The postponement of the match was called off. <br> [sound:4c-s-試合の延期が見送りになった。.mp3]
The postponement of the match was called off.	<b>試合の延期が見送りになった。</b> <br> しあいのえんきがみおくりになった。 <br><br> (見送り) <br> [sound:4c-s-試合の延期が見送りになった。.mp3]
[sound:4c-k-見送る.mp3]	<b>見送る</b> <br> みおくる <br> to see off (e.g. to the station, an airport, etc.), to escort (e.g. home), to farewell; to see out, to send off; to let pass, to wait and see, to continue (e.g. in legal contexts); to let a pitch go by (baseball), to watch a batted ball go into the stands
見送る	<b>みおくる</b> <br> to see off (e.g. to the station, an airport, etc.), to escort (e.g. home), to farewell; to see out, to send off; to let pass, to wait and see, to continue (e.g. in legal contexts); to let a pitch go by (baseball), to watch a batted ball go into the stands <br> [sound:4c-k-見送る.mp3]
to see off (e.g. to the station, an airport, etc.), to escort (e.g. home), to farewell; to see out, to send off; to let pass, to wait and see, to continue (e.g. in legal contexts); to let a pitch go by (baseball), to watch a batted ball go into the stands	<b>見送る</b> <br> みおくる <br> [sound:4c-k-見送る.mp3]
[sound:4c-s-彼を空港で見送った。.mp3]	<b>彼を空港で見送った。</b> <br> かれをくうこうでみおくった。 <br><br> (見送る) <br> I saw him off at the airport.
彼を空港で見送った。 <br><br> (見送る)	<b>かれをくうこうでみおくった。</b> <br> I saw him off at the airport. <br> [sound:4c-s-彼を空港で見送った。.mp3]
I saw him off at the airport.	<b>彼を空港で見送った。</b> <br> かれをくうこうでみおくった。 <br><br> (見送る) <br> [sound:4c-s-彼を空港で見送った。.mp3]
[sound:4c-k-救援.mp3]	<b>救援</b> <br> きゅうえん <br> relief, rescue, reinforcement
救援	<b>きゅうえん</b> <br> relief, rescue, reinforcement <br> [sound:4c-k-救援.mp3]
relief, rescue, reinforcement	<b>救援</b> <br> きゅうえん <br> [sound:4c-k-救援.mp3]
[sound:4c-s-救援物資が被災地に届いた。.mp3]	<b>救援物資が被災地に届いた。</b> <br> きゅうえんぶっしがひさいちにとどいた。 <br><br> (救援) <br> Relief supplies reached the disaster area.
救援物資が被災地に届いた。 <br><br> (救援)	<b>きゅうえんぶっしがひさいちにとどいた。</b> <br> Relief supplies reached the disaster area. <br> [sound:4c-s-救援物資が被災地に届いた。.mp3]
Relief supplies reached the disaster area.	<b>救援物資が被災地に届いた。</b> <br> きゅうえんぶっしがひさいちにとどいた。 <br><br> (救援) <br> [sound:4c-s-救援物資が被災地に届いた。.mp3]
[sound:4c-k-後援.mp3]	<b>後援</b> <br> こうえん <br> support, backing
後援	<b>こうえん</b> <br> support, backing <br> [sound:4c-k-後援.mp3]
support, backing	<b>後援</b> <br> こうえん <br> [sound:4c-k-後援.mp3]
[sound:4c-s-市は文化イベントを後援した。.mp3]	<b>市は文化イベントを後援した。</b> <br> しはぶんかいべんとをこうえんした。 <br><br> (後援) <br> The city supported the cultural event.
市は文化イベントを後援した。 <br><br> (後援)	<b>しはぶんかいべんとをこうえんした。</b> <br> The city supported the cultural event. <br> [sound:4c-s-市は文化イベントを後援した。.mp3]
The city supported the cultural event.	<b>市は文化イベントを後援した。</b> <br> しはぶんかいべんとをこうえんした。 <br><br> (後援) <br> [sound:4c-s-市は文化イベントを後援した。.mp3]
[sound:4c-k-援護.mp3]	<b>援護</b> <br> えんご <br> covering, protection, backing, relief
援護	<b>えんご</b> <br> covering, protection, backing, relief <br> [sound:4c-k-援護.mp3]
covering, protection, backing, relief	<b>援護</b> <br> えんご <br> [sound:4c-k-援護.mp3]
[sound:4c-s-彼は仲間を援護した。.mp3]	<b>彼は仲間を援護した。</b> <br> かれはなかまをえんごした。 <br><br> (援護) <br> He defended his teammates.
彼は仲間を援護した。 <br><br> (援護)	<b>かれはなかまをえんごした。</b> <br> He defended his teammates. <br> [sound:4c-s-彼は仲間を援護した。.mp3]
He defended his teammates.	<b>彼は仲間を援護した。</b> <br> かれはなかまをえんごした。 <br><br> (援護) <br> [sound:4c-s-彼は仲間を援護した。.mp3]
[sound:4c-k-声援.mp3]	<b>声援</b> <br> せいえん <br> encouragement, cheering, support
声援	<b>せいえん</b> <br> encouragement, cheering, support <br> [sound:4c-k-声援.mp3]
encouragement, cheering, support	<b>声援</b> <br> せいえん <br> [sound:4c-k-声援.mp3]
[sound:4c-s-観客の声援が響いた。.mp3]	<b>観客の声援が響いた。</b> <br> かんきゃくのせいえんがひびいた。 <br><br> (声援) <br> The cheers of the audience echoed.
観客の声援が響いた。 <br><br> (声援)	<b>かんきゃくのせいえんがひびいた。</b> <br> The cheers of the audience echoed. <br> [sound:4c-s-観客の声援が響いた。.mp3]
The cheers of the audience echoed.	<b>観客の声援が響いた。</b> <br> かんきゃくのせいえんがひびいた。 <br><br> (声援) <br> [sound:4c-s-観客の声援が響いた。.mp3]
[sound:4c-k-供与.mp3]	<b>供与</b> <br> きょうよ <br> giving, provision, furnishing
供与	<b>きょうよ</b> <br> giving, provision, furnishing <br> [sound:4c-k-供与.mp3]
giving, provision, furnishing	<b>供与</b> <br> きょうよ <br> [sound:4c-k-供与.mp3]
[sound:4c-s-政府は支援を供与した。.mp3]	<b>政府は支援を供与した。</b> <br> せいふはしえんをきょうよした。 <br><br> (供与) <br> The government provided aid.
政府は支援を供与した。 <br><br> (供与)	<b>せいふはしえんをきょうよした。</b> <br> The government provided aid. <br> [sound:4c-s-政府は支援を供与した。.mp3]
The government provided aid.	<b>政府は支援を供与した。</b> <br> せいふはしえんをきょうよした。 <br><br> (供与) <br> [sound:4c-s-政府は支援を供与した。.mp3]
[sound:4c-k-供述.mp3]	<b>供述</b> <br> きょうじゅつ <br> affidavit, deposition, testimony
供述	<b>きょうじゅつ</b> <br> affidavit, deposition, testimony <br> [sound:4c-k-供述.mp3]
affidavit, deposition, testimony	<b>供述</b> <br> きょうじゅつ <br> [sound:4c-k-供述.mp3]
[sound:4c-s-彼は事件について供述した。.mp3]	<b>彼は事件について供述した。</b> <br> かれはじけんについてきょうじゅつした。 <br><br> (供述) <br> He testified about the incident.
彼は事件について供述した。 <br><br> (供述)	<b>かれはじけんについてきょうじゅつした。</b> <br> He testified about the incident. <br> [sound:4c-s-彼は事件について供述した。.mp3]
He testified about the incident.	<b>彼は事件について供述した。</b> <br> かれはじけんについてきょうじゅつした。 <br><br> (供述) <br> [sound:4c-s-彼は事件について供述した。.mp3]
[sound:4c-k-供.mp3]	<b>供</b> <br> とも <br> companion, follower, attendant, retinue
供	<b>とも</b> <br> companion, follower, attendant, retinue <br> [sound:4c-k-供.mp3]
companion, follower, attendant, retinue	<b>供</b> <br> とも <br> [sound:4c-k-供.mp3]
[sound:4c-s-神に供を捧げた。.mp3]	<b>神に供を捧げた。</b> <br> かみにともをささげた。 <br><br> (供) <br> Offerings were made to the gods.
神に供を捧げた。 <br><br> (供)	<b>かみにともをささげた。</b> <br> Offerings were made to the gods. <br> [sound:4c-s-神に供を捧げた。.mp3]
Offerings were made to the gods.	<b>神に供を捧げた。</b> <br> かみにともをささげた。 <br><br> (供) <br> [sound:4c-s-神に供を捧げた。.mp3]
[sound:4c-k-提供者.mp3]	<b>提供者</b> <br> ていきょうしゃ <br> donor, contributer, provider
提供者	<b>ていきょうしゃ</b> <br> donor, contributer, provider <br> [sound:4c-k-提供者.mp3]
donor, contributer, provider	<b>提供者</b> <br> ていきょうしゃ <br> [sound:4c-k-提供者.mp3]
[sound:4c-s-情報の提供者を明かさない。.mp3]	<b>情報の提供者を明かさない。</b> <br> じょうほうのていきょうしゃをあかさない。 <br><br> (提供者) <br> The source of the information will not be revealed.
情報の提供者を明かさない。 <br><br> (提供者)	<b>じょうほうのていきょうしゃをあかさない。</b> <br> The source of the information will not be revealed. <br> [sound:4c-s-情報の提供者を明かさない。.mp3]
The source of the information will not be revealed.	<b>情報の提供者を明かさない。</b> <br> じょうほうのていきょうしゃをあかさない。 <br><br> (提供者) <br> [sound:4c-s-情報の提供者を明かさない。.mp3]
[sound:4c-k-許可.mp3]	<b>許可</b> <br> きょか <br> permission, approval, authorization
許可	<b>きょか</b> <br> permission, approval, authorization <br> [sound:4c-k-許可.mp3]
permission, approval, authorization	<b>許可</b> <br> きょか <br> [sound:4c-k-許可.mp3]
[sound:4c-s-彼は撮影の許可を得た。.mp3]	<b>彼は撮影の許可を得た。</b> <br> かれはさつえいのきょかをえた。 <br><br> (許可) <br> He obtained permission to film.
彼は撮影の許可を得た。 <br><br> (許可)	<b>かれはさつえいのきょかをえた。</b> <br> He obtained permission to film. <br> [sound:4c-s-彼は撮影の許可を得た。.mp3]
He obtained permission to film.	<b>彼は撮影の許可を得た。</b> <br> かれはさつえいのきょかをえた。 <br><br> (許可) <br> [sound:4c-s-彼は撮影の許可を得た。.mp3]
[sound:4c-k-可笑しい.mp3]	<b>可笑しい</b> <br> おかしい <br> strange, funny, amusing, ridiculous
可笑しい	<b>おかしい</b> <br> strange, funny, amusing, ridiculous <br> [sound:4c-k-可笑しい.mp3]
strange, funny, amusing, ridiculous	<b>可笑しい</b> <br> おかしい <br> [sound:4c-k-可笑しい.mp3]
[sound:4c-s-彼の話はとても可笑しかった。.mp3]	<b>彼の話はとても可笑しかった。</b> <br> かれのはなしはとてもおかしかった。 <br><br> (可笑しい) <br> His story was very funny.
彼の話はとても可笑しかった。 <br><br> (可笑しい)	<b>かれのはなしはとてもおかしかった。</b> <br> His story was very funny. <br> [sound:4c-s-彼の話はとても可笑しかった。.mp3]
His story was very funny.	<b>彼の話はとても可笑しかった。</b> <br> かれのはなしはとてもおかしかった。 <br><br> (可笑しい) <br> [sound:4c-s-彼の話はとても可笑しかった。.mp3]
[sound:4c-k-認可.mp3]	<b>認可</b> <br> にんか <br> approval, license, licence, permission
認可	<b>にんか</b> <br> approval, license, licence, permission <br> [sound:4c-k-認可.mp3]
approval, license, licence, permission	<b>認可</b> <br> にんか <br> [sound:4c-k-認可.mp3]
[sound:4c-s-新しい薬が認可された。.mp3]	<b>新しい薬が認可された。</b> <br> あたらしいくすりがにんかされた。 <br><br> (認可) <br> The new drug was approved.
新しい薬が認可された。 <br><br> (認可)	<b>あたらしいくすりがにんかされた。</b> <br> The new drug was approved. <br> [sound:4c-s-新しい薬が認可された。.mp3]
The new drug was approved.	<b>新しい薬が認可された。</b> <br> あたらしいくすりがにんかされた。 <br><br> (認可) <br> [sound:4c-s-新しい薬が認可された。.mp3]
[sound:4c-k-不可欠.mp3]	<b>不可欠</b> <br> ふかけつ <br> indispensable, essential
不可欠	<b>ふかけつ</b> <br> indispensable, essential <br> [sound:4c-k-不可欠.mp3]
indispensable, essential	<b>不可欠</b> <br> ふかけつ <br> [sound:4c-k-不可欠.mp3]
[sound:4c-s-水は生活に不可欠だ。.mp3]	<b>水は生活に不可欠だ。</b> <br> みずはせいかつにふかけつだ。 <br><br> (不可欠) <br> Water is essential for life.
水は生活に不可欠だ。 <br><br> (不可欠)	<b>みずはせいかつにふかけつだ。</b> <br> Water is essential for life. <br> [sound:4c-s-水は生活に不可欠だ。.mp3]
Water is essential for life.	<b>水は生活に不可欠だ。</b> <br> みずはせいかつにふかけつだ。 <br><br> (不可欠) <br> [sound:4c-s-水は生活に不可欠だ。.mp3]
[sound:4c-k-取締役.mp3]	<b>取締役</b> <br> とりしまりやく <br> company director, board member
取締役	<b>とりしまりやく</b> <br> company director, board member <br> [sound:4c-k-取締役.mp3]
company director, board member	<b>取締役</b> <br> とりしまりやく <br> [sound:4c-k-取締役.mp3]
[sound:4c-s-彼は取締役に昇進した。.mp3]	<b>彼は取締役に昇進した。</b> <br> かれはとりしまりやくにしょうしんした。 <br><br> (取締役) <br> He was promoted to director.
彼は取締役に昇進した。 <br><br> (取締役)	<b>かれはとりしまりやくにしょうしんした。</b> <br> He was promoted to director. <br> [sound:4c-s-彼は取締役に昇進した。.mp3]
He was promoted to director.	<b>彼は取締役に昇進した。</b> <br> かれはとりしまりやくにしょうしんした。 <br><br> (取締役) <br> [sound:4c-s-彼は取締役に昇進した。.mp3]
[sound:4c-k-懲役.mp3]	<b>懲役</b> <br> ちょうえき <br> penal servitude, imprisonment with hard labor (hard labour)
懲役	<b>ちょうえき</b> <br> penal servitude, imprisonment with hard labor (hard labour) <br> [sound:4c-k-懲役.mp3]
penal servitude, imprisonment with hard labor (hard labour)	<b>懲役</b> <br> ちょうえき <br> [sound:4c-k-懲役.mp3]
[sound:4c-s-彼は懲役三年の刑を受けた。.mp3]	<b>彼は懲役三年の刑を受けた。</b> <br> かれはちょうえきさんねんのけいをうけた。 <br><br> (懲役) <br> He was sentenced to three years in prison.
彼は懲役三年の刑を受けた。 <br><br> (懲役)	<b>かれはちょうえきさんねんのけいをうけた。</b> <br> He was sentenced to three years in prison. <br> [sound:4c-s-彼は懲役三年の刑を受けた。.mp3]
He was sentenced to three years in prison.	<b>彼は懲役三年の刑を受けた。</b> <br> かれはちょうえきさんねんのけいをうけた。 <br><br> (懲役) <br> [sound:4c-s-彼は懲役三年の刑を受けた。.mp3]
[sound:4c-k-現役.mp3]	<b>現役</b> <br> げんえき <br> active duty, active service
現役	<b>げんえき</b> <br> active duty, active service <br> [sound:4c-k-現役.mp3]
active duty, active service	<b>現役</b> <br> げんえき <br> [sound:4c-k-現役.mp3]
[sound:4c-s-彼はまだ現役の選手だ。.mp3]	<b>彼はまだ現役の選手だ。</b> <br> かれはまだげんえきのせんしゅだ。 <br><br> (現役) <br> He is still an active player.
彼はまだ現役の選手だ。 <br><br> (現役)	<b>かれはまだげんえきのせんしゅだ。</b> <br> He is still an active player. <br> [sound:4c-s-彼はまだ現役の選手だ。.mp3]
He is still an active player.	<b>彼はまだ現役の選手だ。</b> <br> かれはまだげんえきのせんしゅだ。 <br><br> (現役) <br> [sound:4c-s-彼はまだ現役の選手だ。.mp3]
[sound:4c-k-三役.mp3]	<b>三役</b> <br> さんやく <br> three highest ranks (wrestling, unions, etc.)
三役	<b>さんやく</b> <br> three highest ranks (wrestling, unions, etc.) <br> [sound:4c-k-三役.mp3]
three highest ranks (wrestling, unions, etc.)	<b>三役</b> <br> さんやく <br> [sound:4c-k-三役.mp3]
[sound:4c-s-彼は三役を務めた。.mp3]	<b>彼は三役を務めた。</b> <br> かれはさんやくをつとめた。 <br><br> (三役) <br> He held three key positions.
彼は三役を務めた。 <br><br> (三役)	<b>かれはさんやくをつとめた。</b> <br> He held three key positions. <br> [sound:4c-s-彼は三役を務めた。.mp3]
He held three key positions.	<b>彼は三役を務めた。</b> <br> かれはさんやくをつとめた。 <br><br> (三役) <br> [sound:4c-s-彼は三役を務めた。.mp3]
[sound:4c-k-構成.mp3]	<b>構成</b> <br> こうせい <br> organization, organisation, configuration, composition
構成	<b>こうせい</b> <br> organization, organisation, configuration, composition <br> [sound:4c-k-構成.mp3]
organization, organisation, configuration, composition	<b>構成</b> <br> こうせい <br> [sound:4c-k-構成.mp3]
[sound:4c-s-チームは五人で構成されている。.mp3]	<b>チームは五人で構成されている。</b> <br> ちーむはごにんでこうせいされている。 <br><br> (構成) <br> The team consists of five people.
チームは五人で構成されている。 <br><br> (構成)	<b>ちーむはごにんでこうせいされている。</b> <br> The team consists of five people. <br> [sound:4c-s-チームは五人で構成されている。.mp3]
The team consists of five people.	<b>チームは五人で構成されている。</b> <br> ちーむはごにんでこうせいされている。 <br><br> (構成) <br> [sound:4c-s-チームは五人で構成されている。.mp3]
[sound:4c-k-構築.mp3]	<b>構築</b> <br> こうちく <br> construction
構築	<b>こうちく</b> <br> construction <br> [sound:4c-k-構築.mp3]
construction	<b>構築</b> <br> こうちく <br> [sound:4c-k-構築.mp3]
[sound:4c-s-新しいシステムが構築された。.mp3]	<b>新しいシステムが構築された。</b> <br> あたらしいしすてむがこうちくされた。 <br><br> (構築) <br> A new system was built.
新しいシステムが構築された。 <br><br> (構築)	<b>あたらしいしすてむがこうちくされた。</b> <br> A new system was built. <br> [sound:4c-s-新しいシステムが構築された。.mp3]
A new system was built.	<b>新しいシステムが構築された。</b> <br> あたらしいしすてむがこうちくされた。 <br><br> (構築) <br> [sound:4c-s-新しいシステムが構築された。.mp3]
[sound:4c-k-構図.mp3]	<b>構図</b> <br> こうず <br> composition
構図	<b>こうず</b> <br> composition <br> [sound:4c-k-構図.mp3]
composition	<b>構図</b> <br> こうず <br> [sound:4c-k-構図.mp3]
[sound:4c-s-この写真の構図が素晴らしい。.mp3]	<b>この写真の構図が素晴らしい。</b> <br> このしゃしんのこうずがすばらしい。 <br><br> (構図) <br> The composition of this photo is excellent.
この写真の構図が素晴らしい。 <br><br> (構図)	<b>このしゃしんのこうずがすばらしい。</b> <br> The composition of this photo is excellent. <br> [sound:4c-s-この写真の構図が素晴らしい。.mp3]
The composition of this photo is excellent.	<b>この写真の構図が素晴らしい。</b> <br> このしゃしんのこうずがすばらしい。 <br><br> (構図) <br> [sound:4c-s-この写真の構図が素晴らしい。.mp3]
[sound:4c-k-結構.mp3]	<b>結構</b> <br> けっこう <br> splendid, nice, wonderful, delicious, sweet; sufficient, fine (in the sense of "I'm fine"), (by implication) no thank you; well enough, OK, tolerable; reasonably, fairly, tolerably; construction, architecture
結構	<b>けっこう</b> <br> splendid, nice, wonderful, delicious, sweet; sufficient, fine (in the sense of "I'm fine"), (by implication) no thank you; well enough, OK, tolerable; reasonably, fairly, tolerably; construction, architecture <br> [sound:4c-k-結構.mp3]
splendid, nice, wonderful, delicious, sweet; sufficient, fine (in the sense of "I'm fine"), (by implication) no thank you; well enough, OK, tolerable; reasonably, fairly, tolerably; construction, architecture	<b>結構</b> <br> けっこう <br> [sound:4c-k-結構.mp3]
[sound:4c-s-このレストランは結構おいしい。.mp3]	<b>このレストランは結構おいしい。</b> <br> このれすとらんはけっこうおいしい。 <br><br> (結構) <br> This restaurant is quite good.
このレストランは結構おいしい。 <br><br> (結構)	<b>このれすとらんはけっこうおいしい。</b> <br> This restaurant is quite good. <br> [sound:4c-s-このレストランは結構おいしい。.mp3]
This restaurant is quite good.	<b>このレストランは結構おいしい。</b> <br> このれすとらんはけっこうおいしい。 <br><br> (結構) <br> [sound:4c-s-このレストランは結構おいしい。.mp3]
[sound:4c-k-土木.mp3]	<b>土木</b> <br> どぼく <br> public works
土木	<b>どぼく</b> <br> public works <br> [sound:4c-k-土木.mp3]
public works	<b>土木</b> <br> どぼく <br> [sound:4c-k-土木.mp3]
[sound:4c-s-彼は土木工事に従事している。.mp3]	<b>彼は土木工事に従事している。</b> <br> かれはどぼくこうじにじゅうじしている。 <br><br> (土木) <br> He is engaged in civil engineering work.
彼は土木工事に従事している。 <br><br> (土木)	<b>かれはどぼくこうじにじゅうじしている。</b> <br> He is engaged in civil engineering work. <br> [sound:4c-s-彼は土木工事に従事している。.mp3]
He is engaged in civil engineering work.	<b>彼は土木工事に従事している。</b> <br> かれはどぼくこうじにじゅうじしている。 <br><br> (土木) <br> [sound:4c-s-彼は土木工事に従事している。.mp3]
[sound:4c-k-木材.mp3]	<b>木材</b> <br> もくざい <br> lumber, timber, wood
木材	<b>もくざい</b> <br> lumber, timber, wood <br> [sound:4c-k-木材.mp3]
lumber, timber, wood	<b>木材</b> <br> もくざい <br> [sound:4c-k-木材.mp3]
[sound:4c-s-この家具は木材で作られている。.mp3]	<b>この家具は木材で作られている。</b> <br> このかぐはもくざいでつくられている。 <br><br> (木材) <br> This furniture is made of wood.
この家具は木材で作られている。 <br><br> (木材)	<b>このかぐはもくざいでつくられている。</b> <br> This furniture is made of wood. <br> [sound:4c-s-この家具は木材で作られている。.mp3]
This furniture is made of wood.	<b>この家具は木材で作られている。</b> <br> このかぐはもくざいでつくられている。 <br><br> (木材) <br> [sound:4c-s-この家具は木材で作られている。.mp3]
[sound:4c-k-荒木.mp3]	<b>荒木</b> <br> あらき <br> logs in bark, rough wood
荒木	<b>あらき</b> <br> logs in bark, rough wood <br> [sound:4c-k-荒木.mp3]
logs in bark, rough wood	<b>荒木</b> <br> あらき <br> [sound:4c-k-荒木.mp3]
[sound:4c-s-荒木さんは昨日、映画を見に行きました。.mp3]	<b>荒木さんは昨日、映画を見に行きました。</b> <br> あらきさんはきのう、えいがをみにいきました。 <br><br> (荒木) <br> Araki-san went to see a movie yesterday.
荒木さんは昨日、映画を見に行きました。 <br><br> (荒木)	<b>あらきさんはきのう、えいがをみにいきました。</b> <br> Araki-san went to see a movie yesterday. <br> [sound:4c-s-荒木さんは昨日、映画を見に行きました。.mp3]
Araki-san went to see a movie yesterday.	<b>荒木さんは昨日、映画を見に行きました。</b> <br> あらきさんはきのう、えいがをみにいきました。 <br><br> (荒木) <br> [sound:4c-s-荒木さんは昨日、映画を見に行きました。.mp3]
[sound:4c-k-樹木.mp3]	<b>樹木</b> <br> じゅもく <br> trees and shrubs, arbour, arbor
樹木	<b>じゅもく</b> <br> trees and shrubs, arbour, arbor <br> [sound:4c-k-樹木.mp3]
trees and shrubs, arbour, arbor	<b>樹木</b> <br> じゅもく <br> [sound:4c-k-樹木.mp3]
[sound:4c-s-この公園にはたくさんの樹木があります。.mp3]	<b>この公園にはたくさんの樹木があります。</b> <br> このこうえんにはたくさんのじゅもくがあります。 <br><br> (樹木) <br> There are many trees in this park.
この公園にはたくさんの樹木があります。 <br><br> (樹木)	<b>このこうえんにはたくさんのじゅもくがあります。</b> <br> There are many trees in this park. <br> [sound:4c-s-この公園にはたくさんの樹木があります。.mp3]
There are many trees in this park.	<b>この公園にはたくさんの樹木があります。</b> <br> このこうえんにはたくさんのじゅもくがあります。 <br><br> (樹木) <br> [sound:4c-s-この公園にはたくさんの樹木があります。.mp3]
[sound:4c-k-分割.mp3]	<b>分割</b> <br> ぶんかつ <br> partition, division, separation, segmenting, splitting
分割	<b>ぶんかつ</b> <br> partition, division, separation, segmenting, splitting <br> [sound:4c-k-分割.mp3]
partition, division, separation, segmenting, splitting	<b>分割</b> <br> ぶんかつ <br> [sound:4c-k-分割.mp3]
[sound:4c-s-プロジェクトは分割して進められます。.mp3]	<b>プロジェクトは分割して進められます。</b> <br> ぷろじぇくとはぶんかつしてすすめられます。 <br><br> (分割) <br> The project can be divided and carried out.
プロジェクトは分割して進められます。 <br><br> (分割)	<b>ぷろじぇくとはぶんかつしてすすめられます。</b> <br> The project can be divided and carried out. <br> [sound:4c-s-プロジェクトは分割して進められます。.mp3]
The project can be divided and carried out.	<b>プロジェクトは分割して進められます。</b> <br> ぷろじぇくとはぶんかつしてすすめられます。 <br><br> (分割) <br> [sound:4c-s-プロジェクトは分割して進められます。.mp3]
[sound:4c-k-割引.mp3]	<b>割引</b> <br> わりびき <br> discount, reduction, rebate, tenths discounted
割引	<b>わりびき</b> <br> discount, reduction, rebate, tenths discounted <br> [sound:4c-k-割引.mp3]
discount, reduction, rebate, tenths discounted	<b>割引</b> <br> わりびき <br> [sound:4c-k-割引.mp3]
[sound:4c-s-この店では割引セールが行われています。.mp3]	<b>この店では割引セールが行われています。</b> <br> このみせではわりびきせーるがおこなわれています。 <br><br> (割引) <br> This store is having a discount sale.
この店では割引セールが行われています。 <br><br> (割引)	<b>このみせではわりびきせーるがおこなわれています。</b> <br> This store is having a discount sale. <br> [sound:4c-s-この店では割引セールが行われています。.mp3]
This store is having a discount sale.	<b>この店では割引セールが行われています。</b> <br> このみせではわりびきせーるがおこなわれています。 <br><br> (割引) <br> [sound:4c-s-この店では割引セールが行われています。.mp3]
[sound:4c-k-割高.mp3]	<b>割高</b> <br> わりだか <br> comparatively high, fairly expensive
割高	<b>わりだか</b> <br> comparatively high, fairly expensive <br> [sound:4c-k-割高.mp3]
comparatively high, fairly expensive	<b>割高</b> <br> わりだか <br> [sound:4c-k-割高.mp3]
[sound:4c-s-このレストランは少し割高ですが、美味しいです。.mp3]	<b>このレストランは少し割高ですが、美味しいです。</b> <br> このれすとらんはすこしわりだかいですが、おいしいです。 <br><br> (割高) <br> This restaurant is a bit expensive, but it's delicious.
このレストランは少し割高ですが、美味しいです。 <br><br> (割高)	<b>このれすとらんはすこしわりだかいですが、おいしいです。</b> <br> This restaurant is a bit expensive, but it's delicious. <br> [sound:4c-s-このレストランは少し割高ですが、美味しいです。.mp3]
This restaurant is a bit expensive, but it's delicious.	<b>このレストランは少し割高ですが、美味しいです。</b> <br> このれすとらんはすこしわりだかいですが、おいしいです。 <br><br> (割高) <br> [sound:4c-s-このレストランは少し割高ですが、美味しいです。.mp3]
[sound:4c-k-割安.mp3]	<b>割安</b> <br> わりやす <br> economical, comparatively cheap
割安	<b>わりやす</b> <br> economical, comparatively cheap <br> [sound:4c-k-割安.mp3]
economical, comparatively cheap	<b>割安</b> <br> わりやす <br> [sound:4c-k-割安.mp3]
[sound:4c-s-その商品は割安で購入できます。.mp3]	<b>その商品は割安で購入できます。</b> <br> そのしょうひんはわりやすでこうにゅうできます。 <br><br> (割安) <br> That product can be bought at a low price.
その商品は割安で購入できます。 <br><br> (割安)	<b>そのしょうひんはわりやすでこうにゅうできます。</b> <br> That product can be bought at a low price. <br> [sound:4c-s-その商品は割安で購入できます。.mp3]
That product can be bought at a low price.	<b>その商品は割安で購入できます。</b> <br> そのしょうひんはわりやすでこうにゅうできます。 <br><br> (割安) <br> [sound:4c-s-その商品は割安で購入できます。.mp3]
[sound:4c-k-聞き手.mp3]	<b>聞き手</b> <br> ききて <br> hearer, listener, audience; interviewer, questioner
聞き手	<b>ききて</b> <br> hearer, listener, audience; interviewer, questioner <br> [sound:4c-k-聞き手.mp3]
hearer, listener, audience; interviewer, questioner	<b>聞き手</b> <br> ききて <br> [sound:4c-k-聞き手.mp3]
[sound:4c-s-インタビューの聞き手はとても優れています。.mp3]	<b>インタビューの聞き手はとても優れています。</b> <br> いんたびゅーのききてはとてもすぐれています。 <br><br> (聞き手) <br> The interviewer is very skilled.
インタビューの聞き手はとても優れています。 <br><br> (聞き手)	<b>いんたびゅーのききてはとてもすぐれています。</b> <br> The interviewer is very skilled. <br> [sound:4c-s-インタビューの聞き手はとても優れています。.mp3]
The interviewer is very skilled.	<b>インタビューの聞き手はとても優れています。</b> <br> いんたびゅーのききてはとてもすぐれています。 <br><br> (聞き手) <br> [sound:4c-s-インタビューの聞き手はとても優れています。.mp3]
[sound:4c-k-新聞紙.mp3]	<b>新聞紙</b> <br> しんぶんし <br> newsprint, newspaper
新聞紙	<b>しんぶんし</b> <br> newsprint, newspaper <br> [sound:4c-k-新聞紙.mp3]
newsprint, newspaper	<b>新聞紙</b> <br> しんぶんし <br> [sound:4c-k-新聞紙.mp3]
[sound:4c-s-床に新聞紙を広げて掃除をしました。.mp3]	<b>床に新聞紙を広げて掃除をしました。</b> <br> ゆかにしんぶんしをひろげてそうじをしました。 <br><br> (新聞紙) <br> I spread newspaper on the floor and cleaned it.
床に新聞紙を広げて掃除をしました。 <br><br> (新聞紙)	<b>ゆかにしんぶんしをひろげてそうじをしました。</b> <br> I spread newspaper on the floor and cleaned it. <br> [sound:4c-s-床に新聞紙を広げて掃除をしました。.mp3]
I spread newspaper on the floor and cleaned it.	<b>床に新聞紙を広げて掃除をしました。</b> <br> ゆかにしんぶんしをひろげてそうじをしました。 <br><br> (新聞紙) <br> [sound:4c-s-床に新聞紙を広げて掃除をしました。.mp3]
[sound:4c-k-前代未聞.mp3]	<b>前代未聞</b> <br> ぜんだいみもん <br> unheard-of, unprecedented, unparalleled in history (unparallelled), record-breaking
前代未聞	<b>ぜんだいみもん</b> <br> unheard-of, unprecedented, unparalleled in history (unparallelled), record-breaking <br> [sound:4c-k-前代未聞.mp3]
unheard-of, unprecedented, unparalleled in history (unparallelled), record-breaking	<b>前代未聞</b> <br> ぜんだいみもん <br> [sound:4c-k-前代未聞.mp3]
[sound:4c-s-その事件は前代未聞の出来事でした。.mp3]	<b>その事件は前代未聞の出来事でした。</b> <br> そのじけんはぜんだいみもんのできごとでした。 <br><br> (前代未聞) <br> The incident was an unprecedented event.
その事件は前代未聞の出来事でした。 <br><br> (前代未聞)	<b>そのじけんはぜんだいみもんのできごとでした。</b> <br> The incident was an unprecedented event. <br> [sound:4c-s-その事件は前代未聞の出来事でした。.mp3]
The incident was an unprecedented event.	<b>その事件は前代未聞の出来事でした。</b> <br> そのじけんはぜんだいみもんのできごとでした。 <br><br> (前代未聞) <br> [sound:4c-s-その事件は前代未聞の出来事でした。.mp3]
[sound:4c-k-新聞記事.mp3]	<b>新聞記事</b> <br> しんぶんきじ <br> newspaper story (article, account)
新聞記事	<b>しんぶんきじ</b> <br> newspaper story (article, account) <br> [sound:4c-k-新聞記事.mp3]
newspaper story (article, account)	<b>新聞記事</b> <br> しんぶんきじ <br> [sound:4c-k-新聞記事.mp3]
[sound:4c-s-昨日、新聞記事でその話を読みました。.mp3]	<b>昨日、新聞記事でその話を読みました。</b> <br> きのう、しんぶんきじでそのはなしをよみました。 <br><br> (新聞記事) <br> I read the story in a newspaper article yesterday.
昨日、新聞記事でその話を読みました。 <br><br> (新聞記事)	<b>きのう、しんぶんきじでそのはなしをよみました。</b> <br> I read the story in a newspaper article yesterday. <br> [sound:4c-s-昨日、新聞記事でその話を読みました。.mp3]
I read the story in a newspaper article yesterday.	<b>昨日、新聞記事でその話を読みました。</b> <br> きのう、しんぶんきじでそのはなしをよみました。 <br><br> (新聞記事) <br> [sound:4c-s-昨日、新聞記事でその話を読みました。.mp3]
[sound:4c-k-中身.mp3]	<b>中身</b> <br> なかみ <br> contents, interior, substance, filling, (sword) blade
中身	<b>なかみ</b> <br> contents, interior, substance, filling, (sword) blade <br> [sound:4c-k-中身.mp3]
contents, interior, substance, filling, (sword) blade	<b>中身</b> <br> なかみ <br> [sound:4c-k-中身.mp3]
[sound:4c-s-この箱の中身は何ですか？.mp3]	<b>この箱の中身は何ですか？</b> <br> このはこのなかみはなんですか？ <br><br> (中身) <br> What is inside this box?
この箱の中身は何ですか？ <br><br> (中身)	<b>このはこのなかみはなんですか？</b> <br> What is inside this box? <br> [sound:4c-s-この箱の中身は何ですか？.mp3]
What is inside this box?	<b>この箱の中身は何ですか？</b> <br> このはこのなかみはなんですか？ <br><br> (中身) <br> [sound:4c-s-この箱の中身は何ですか？.mp3]
[sound:4c-k-身長.mp3]	<b>身長</b> <br> しんちょう <br> height (of body), stature
身長	<b>しんちょう</b> <br> height (of body), stature <br> [sound:4c-k-身長.mp3]
height (of body), stature	<b>身長</b> <br> しんちょう <br> [sound:4c-k-身長.mp3]
[sound:4c-s-彼の身長は180センチメートルです。.mp3]	<b>彼の身長は180センチメートルです。</b> <br> かれのしんちょうは180せんちめーとるです。 <br><br> (身長) <br> His height is 180 cm.
彼の身長は180センチメートルです。 <br><br> (身長)	<b>かれのしんちょうは180せんちめーとるです。</b> <br> His height is 180 cm. <br> [sound:4c-s-彼の身長は180センチメートルです。.mp3]
His height is 180 cm.	<b>彼の身長は180センチメートルです。</b> <br> かれのしんちょうは180せんちめーとるです。 <br><br> (身長) <br> [sound:4c-s-彼の身長は180センチメートルです。.mp3]
[sound:4c-k-全身.mp3]	<b>全身</b> <br> ぜんしん <br> whole (body), full-length (e.g. portrait); systemic
全身	<b>ぜんしん</b> <br> whole (body), full-length (e.g. portrait); systemic <br> [sound:4c-k-全身.mp3]
whole (body), full-length (e.g. portrait); systemic	<b>全身</b> <br> ぜんしん <br> [sound:4c-k-全身.mp3]
[sound:4c-s-全身を使って運動することが大切です。.mp3]	<b>全身を使って運動することが大切です。</b> <br> ぜんしんをつかってうんどうすることがたいせつです。 <br><br> (全身) <br> It is important to exercise using your whole body.
全身を使って運動することが大切です。 <br><br> (全身)	<b>ぜんしんをつかってうんどうすることがたいせつです。</b> <br> It is important to exercise using your whole body. <br> [sound:4c-s-全身を使って運動することが大切です。.mp3]
It is important to exercise using your whole body.	<b>全身を使って運動することが大切です。</b> <br> ぜんしんをつかってうんどうすることがたいせつです。 <br><br> (全身) <br> [sound:4c-s-全身を使って運動することが大切です。.mp3]
[sound:4c-k-出身者.mp3]	<b>出身者</b> <br> しゅっしんしゃ <br> alumnus (alumnae), graduate, old boy (girl); former member of an organization; former inhabitant (country, region, etc.)
出身者	<b>しゅっしんしゃ</b> <br> alumnus (alumnae), graduate, old boy (girl); former member of an organization; former inhabitant (country, region, etc.) <br> [sound:4c-k-出身者.mp3]
alumnus (alumnae), graduate, old boy (girl); former member of an organization; former inhabitant (country, region, etc.)	<b>出身者</b> <br> しゅっしんしゃ <br> [sound:4c-k-出身者.mp3]
[sound:4c-s-この町の出身者はとても誇りに思っています。.mp3]	<b>この町の出身者はとても誇りに思っています。</b> <br> このまちのしゅっしんしゃはとてもほこりにおもっています。 <br><br> (出身者) <br> The people from this town are very proud.
この町の出身者はとても誇りに思っています。 <br><br> (出身者)	<b>このまちのしゅっしんしゃはとてもほこりにおもっています。</b> <br> The people from this town are very proud. <br> [sound:4c-s-この町の出身者はとても誇りに思っています。.mp3]
The people from this town are very proud.	<b>この町の出身者はとても誇りに思っています。</b> <br> このまちのしゅっしんしゃはとてもほこりにおもっています。 <br><br> (出身者) <br> [sound:4c-s-この町の出身者はとても誇りに思っています。.mp3]
[sound:4c-k-費用.mp3]	<b>費用</b> <br> ひよう <br> cost, expense
費用	<b>ひよう</b> <br> cost, expense <br> [sound:4c-k-費用.mp3]
cost, expense	<b>費用</b> <br> ひよう <br> [sound:4c-k-費用.mp3]
[sound:4c-s-このプロジェクトの費用は予算を超えています。.mp3]	<b>このプロジェクトの費用は予算を超えています。</b> <br> このぷろじぇくとのひようはよさんをこえています。 <br><br> (費用) <br> The cost of this project exceeds the budget.
このプロジェクトの費用は予算を超えています。 <br><br> (費用)	<b>このぷろじぇくとのひようはよさんをこえています。</b> <br> The cost of this project exceeds the budget. <br> [sound:4c-s-このプロジェクトの費用は予算を超えています。.mp3]
The cost of this project exceeds the budget.	<b>このプロジェクトの費用は予算を超えています。</b> <br> このぷろじぇくとのひようはよさんをこえています。 <br><br> (費用) <br> [sound:4c-s-このプロジェクトの費用は予算を超えています。.mp3]
[sound:4c-k-経費.mp3]	<b>経費</b> <br> けいひ <br> expenses, cost, outlay
経費	<b>けいひ</b> <br> expenses, cost, outlay <br> [sound:4c-k-経費.mp3]
expenses, cost, outlay	<b>経費</b> <br> けいひ <br> [sound:4c-k-経費.mp3]
[sound:4c-s-会議の経費は会社が負担します。.mp3]	<b>会議の経費は会社が負担します。</b> <br> かいぎのけいひはかいしゃがふたんします。 <br><br> (経費) <br> The company will bear the costs of the meeting.
会議の経費は会社が負担します。 <br><br> (経費)	<b>かいぎのけいひはかいしゃがふたんします。</b> <br> The company will bear the costs of the meeting. <br> [sound:4c-s-会議の経費は会社が負担します。.mp3]
The company will bear the costs of the meeting.	<b>会議の経費は会社が負担します。</b> <br> かいぎのけいひはかいしゃがふたんします。 <br><br> (経費) <br> [sound:4c-s-会議の経費は会社が負担します。.mp3]
[sound:4c-k-人件費.mp3]	<b>人件費</b> <br> じんけんひ <br> personnel expenses, labor cost, labour cost; indirect labour costs, indirect labor costs
人件費	<b>じんけんひ</b> <br> personnel expenses, labor cost, labour cost; indirect labour costs, indirect labor costs <br> [sound:4c-k-人件費.mp3]
personnel expenses, labor cost, labour cost; indirect labour costs, indirect labor costs	<b>人件費</b> <br> じんけんひ <br> [sound:4c-k-人件費.mp3]
[sound:4c-s-人件費が高くなってきている問題があります。.mp3]	<b>人件費が高くなってきている問題があります。</b> <br> じんけんひがたかくなってきているもんだいがあります。 <br><br> (人件費) <br> There is a problem with rising labor costs.
人件費が高くなってきている問題があります。 <br><br> (人件費)	<b>じんけんひがたかくなってきているもんだいがあります。</b> <br> There is a problem with rising labor costs. <br> [sound:4c-s-人件費が高くなってきている問題があります。.mp3]
There is a problem with rising labor costs.	<b>人件費が高くなってきている問題があります。</b> <br> じんけんひがたかくなってきているもんだいがあります。 <br><br> (人件費) <br> [sound:4c-s-人件費が高くなってきている問題があります。.mp3]
[sound:4c-k-会費.mp3]	<b>会費</b> <br> かいひ <br> membership fee
会費	<b>かいひ</b> <br> membership fee <br> [sound:4c-k-会費.mp3]
membership fee	<b>会費</b> <br> かいひ <br> [sound:4c-k-会費.mp3]
[sound:4c-s-このクラブの会費は月額1000円です。.mp3]	<b>このクラブの会費は月額1000円です。</b> <br> このくらぶのかいひはげつがく1000えんです。 <br><br> (会費) <br> The club's membership fee is 1000 yen per month.
このクラブの会費は月額1000円です。 <br><br> (会費)	<b>このくらぶのかいひはげつがく1000えんです。</b> <br> The club's membership fee is 1000 yen per month. <br> [sound:4c-s-このクラブの会費は月額1000円です。.mp3]
The club's membership fee is 1000 yen per month.	<b>このクラブの会費は月額1000円です。</b> <br> このくらぶのかいひはげつがく1000えんです。 <br><br> (会費) <br> [sound:4c-s-このクラブの会費は月額1000円です。.mp3]
[sound:4c-k-交付.mp3]	<b>交付</b> <br> こうふ <br> delivering, handing over, furnishing (e.g. with copies), issuance, issuing
交付	<b>こうふ</b> <br> delivering, handing over, furnishing (e.g. with copies), issuance, issuing <br> [sound:4c-k-交付.mp3]
delivering, handing over, furnishing (e.g. with copies), issuance, issuing	<b>交付</b> <br> こうふ <br> [sound:4c-k-交付.mp3]
[sound:4c-s-新しいパスポートが交付されました。.mp3]	<b>新しいパスポートが交付されました。</b> <br> あたらしいぱすぽーとがこうふされました。 <br><br> (交付) <br> A new passport has been issued.
新しいパスポートが交付されました。 <br><br> (交付)	<b>あたらしいぱすぽーとがこうふされました。</b> <br> A new passport has been issued. <br> [sound:4c-s-新しいパスポートが交付されました。.mp3]
A new passport has been issued.	<b>新しいパスポートが交付されました。</b> <br> あたらしいぱすぽーとがこうふされました。 <br><br> (交付) <br> [sound:4c-s-新しいパスポートが交付されました。.mp3]
[sound:4c-k-付き合い.mp3]	<b>付き合い</b> <br> つきあい <br> association, socializing, socialising, fellowship
付き合い	<b>つきあい</b> <br> association, socializing, socialising, fellowship <br> [sound:4c-k-付き合い.mp3]
association, socializing, socialising, fellowship	<b>付き合い</b> <br> つきあい <br> [sound:4c-k-付き合い.mp3]
[sound:4c-s-仕事の付き合いで、今日はお酒を飲みます。.mp3]	<b>仕事の付き合いで、今日はお酒を飲みます。</b> <br> しごとのつきあいで、きょうはおさけをのみます。 <br><br> (付き合い) <br> I will drink alcohol today due to work relations.
仕事の付き合いで、今日はお酒を飲みます。 <br><br> (付き合い)	<b>しごとのつきあいで、きょうはおさけをのみます。</b> <br> I will drink alcohol today due to work relations. <br> [sound:4c-s-仕事の付き合いで、今日はお酒を飲みます。.mp3]
I will drink alcohol today due to work relations.	<b>仕事の付き合いで、今日はお酒を飲みます。</b> <br> しごとのつきあいで、きょうはおさけをのみます。 <br><br> (付き合い) <br> [sound:4c-s-仕事の付き合いで、今日はお酒を飲みます。.mp3]
[sound:4c-k-貸付.mp3]	<b>貸付</b> <br> かしつけ <br> loan
貸付	<b>かしつけ</b> <br> loan <br> [sound:4c-k-貸付.mp3]
loan	<b>貸付</b> <br> かしつけ <br> [sound:4c-k-貸付.mp3]
[sound:4c-s-銀行は低金利で貸付を行っています。.mp3]	<b>銀行は低金利で貸付を行っています。</b> <br> ぎんこうはていきんりでかしつけをおこなっています。 <br><br> (貸付) <br> The bank provides loans at low interest rates.
銀行は低金利で貸付を行っています。 <br><br> (貸付)	<b>ぎんこうはていきんりでかしつけをおこなっています。</b> <br> The bank provides loans at low interest rates. <br> [sound:4c-s-銀行は低金利で貸付を行っています。.mp3]
The bank provides loans at low interest rates.	<b>銀行は低金利で貸付を行っています。</b> <br> ぎんこうはていきんりでかしつけをおこなっています。 <br><br> (貸付) <br> [sound:4c-s-銀行は低金利で貸付を行っています。.mp3]
[sound:4c-k-日付.mp3]	<b>日付</b> <br> ひづけ <br> date, dating
日付	<b>ひづけ</b> <br> date, dating <br> [sound:4c-k-日付.mp3]
date, dating	<b>日付</b> <br> ひづけ <br> [sound:4c-k-日付.mp3]
[sound:4c-s-今日の日付は2025年6月8日です。.mp3]	<b>今日の日付は2025年6月8日です。</b> <br> きょうのひづけは2025ねん6がつ8にちです。 <br><br> (日付) <br> Today's date is June 8, 2025.
今日の日付は2025年6月8日です。 <br><br> (日付)	<b>きょうのひづけは2025ねん6がつ8にちです。</b> <br> Today's date is June 8, 2025. <br> [sound:4c-s-今日の日付は2025年6月8日です。.mp3]
Today's date is June 8, 2025.	<b>今日の日付は2025年6月8日です。</b> <br> きょうのひづけは2025ねん6がつ8にちです。 <br><br> (日付) <br> [sound:4c-s-今日の日付は2025年6月8日です。.mp3]
[sound:4c-k-施策.mp3]	<b>施策</b> <br> しさく <br> policy, measure
施策	<b>しさく</b> <br> policy, measure <br> [sound:4c-k-施策.mp3]
policy, measure	<b>施策</b> <br> しさく <br> [sound:4c-k-施策.mp3]
[sound:4c-s-政府は新しい施策を導入しました。.mp3]	<b>政府は新しい施策を導入しました。</b> <br> せいふはあたらしいしさくをどうにゅうしました。 <br><br> (施策) <br> The government has introduced new policies.
政府は新しい施策を導入しました。 <br><br> (施策)	<b>せいふはあたらしいしさくをどうにゅうしました。</b> <br> The government has introduced new policies. <br> [sound:4c-s-政府は新しい施策を導入しました。.mp3]
The government has introduced new policies.	<b>政府は新しい施策を導入しました。</b> <br> せいふはあたらしいしさくをどうにゅうしました。 <br><br> (施策) <br> [sound:4c-s-政府は新しい施策を導入しました。.mp3]
[sound:4c-k-施行.mp3]	<b>施行</b> <br> しこう, せぎょう, せこう, しぎょう <br> execution, enforcing, carrying out; giving alms, giving food to the poor or monks
施行	<b>しこう, せぎょう, せこう, しぎょう</b> <br> execution, enforcing, carrying out; giving alms, giving food to the poor or monks <br> [sound:4c-k-施行.mp3]
execution, enforcing, carrying out; giving alms, giving food to the poor or monks	<b>施行</b> <br> しこう, せぎょう, せこう, しぎょう <br> [sound:4c-k-施行.mp3]
[sound:4c-s-新しい法律は来月から施行されます。.mp3]	<b>新しい法律は来月から施行されます。</b> <br> あたらしいほうりつはらいげつからしこうされます。 <br><br> (施行) <br> The new law will be enforced starting next month.
新しい法律は来月から施行されます。 <br><br> (施行)	<b>あたらしいほうりつはらいげつからしこうされます。</b> <br> The new law will be enforced starting next month. <br> [sound:4c-s-新しい法律は来月から施行されます。.mp3]
The new law will be enforced starting next month.	<b>新しい法律は来月から施行されます。</b> <br> あたらしいほうりつはらいげつからしこうされます。 <br><br> (施行) <br> [sound:4c-s-新しい法律は来月から施行されます。.mp3]
[sound:4c-k-施政.mp3]	<b>施政</b> <br> しせい <br> government, administration, statesmanship
施政	<b>しせい</b> <br> government, administration, statesmanship <br> [sound:4c-k-施政.mp3]
government, administration, statesmanship	<b>施政</b> <br> しせい <br> [sound:4c-k-施政.mp3]
[sound:4c-s-施政方針を発表するために、会見が開かれました。.mp3]	<b>施政方針を発表するために、会見が開かれました。</b> <br> せいせいほうしんをはっぴょうするために、かいけんがひらかれました。 <br><br> (施政) <br> A press conference was held to announce the policy direction.
施政方針を発表するために、会見が開かれました。 <br><br> (施政)	<b>せいせいほうしんをはっぴょうするために、かいけんがひらかれました。</b> <br> A press conference was held to announce the policy direction. <br> [sound:4c-s-施政方針を発表するために、会見が開かれました。.mp3]
A press conference was held to announce the policy direction.	<b>施政方針を発表するために、会見が開かれました。</b> <br> せいせいほうしんをはっぴょうするために、かいけんがひらかれました。 <br><br> (施政) <br> [sound:4c-s-施政方針を発表するために、会見が開かれました。.mp3]
[sound:4c-k-施工.mp3]	<b>施工</b> <br> せこう, しこう <br> execution (building contract), carrying out
施工	<b>せこう, しこう</b> <br> execution (building contract), carrying out <br> [sound:4c-k-施工.mp3]
execution (building contract), carrying out	<b>施工</b> <br> せこう, しこう <br> [sound:4c-k-施工.mp3]
[sound:4c-s-この建物の施工は来年に開始されます。.mp3]	<b>この建物の施工は来年に開始されます。</b> <br> このたてもののせこうはらいねんにかいしされます。 <br><br> (施工) <br> The construction of this building will start next year.
この建物の施工は来年に開始されます。 <br><br> (施工)	<b>このたてもののせこうはらいねんにかいしされます。</b> <br> The construction of this building will start next year. <br> [sound:4c-s-この建物の施工は来年に開始されます。.mp3]
The construction of this building will start next year.	<b>この建物の施工は来年に開始されます。</b> <br> このたてもののせこうはらいねんにかいしされます。 <br><br> (施工) <br> [sound:4c-s-この建物の施工は来年に開始されます。.mp3]
[sound:4c-k-適切.mp3]	<b>適切</b> <br> てきせつ <br> pertinent, appropriate, adequate, relevance
適切	<b>てきせつ</b> <br> pertinent, appropriate, adequate, relevance <br> [sound:4c-k-適切.mp3]
pertinent, appropriate, adequate, relevance	<b>適切</b> <br> てきせつ <br> [sound:4c-k-適切.mp3]
[sound:4c-s-適切な対応が必要です。.mp3]	<b>適切な対応が必要です。</b> <br> てきせつなたいおうがひつようです。 <br><br> (適切) <br> Appropriate action is required.
適切な対応が必要です。 <br><br> (適切)	<b>てきせつなたいおうがひつようです。</b> <br> Appropriate action is required. <br> [sound:4c-s-適切な対応が必要です。.mp3]
Appropriate action is required.	<b>適切な対応が必要です。</b> <br> てきせつなたいおうがひつようです。 <br><br> (適切) <br> [sound:4c-s-適切な対応が必要です。.mp3]
[sound:4c-k-切り.mp3]	<b>切り</b> <br> きり <br> limits, end, bounds, period, place to leave off, closing sentence, all there is, only, since
切り	<b>きり</b> <br> limits, end, bounds, period, place to leave off, closing sentence, all there is, only, since <br> [sound:4c-k-切り.mp3]
limits, end, bounds, period, place to leave off, closing sentence, all there is, only, since	<b>切り</b> <br> きり <br> [sound:4c-k-切り.mp3]
[sound:4c-s-その仕事を切りのいいところで終わらせました。.mp3]	<b>その仕事を切りのいいところで終わらせました。</b> <br> そのしごとをきりのいいところでおわらせました。 <br><br> (切り) <br> I finished the task at a good stopping point.
その仕事を切りのいいところで終わらせました。 <br><br> (切り)	<b>そのしごとをきりのいいところでおわらせました。</b> <br> I finished the task at a good stopping point. <br> [sound:4c-s-その仕事を切りのいいところで終わらせました。.mp3]
I finished the task at a good stopping point.	<b>その仕事を切りのいいところで終わらせました。</b> <br> そのしごとをきりのいいところでおわらせました。 <br><br> (切り) <br> [sound:4c-s-その仕事を切りのいいところで終わらせました。.mp3]
[sound:4c-k-思い切って.mp3]	<b>思い切って</b> <br> おもいきって <br> resolutely, boldly, daringly
思い切って	<b>おもいきって</b> <br> resolutely, boldly, daringly <br> [sound:4c-k-思い切って.mp3]
resolutely, boldly, daringly	<b>思い切って</b> <br> おもいきって <br> [sound:4c-k-思い切って.mp3]
[sound:4c-s-思い切って新しい仕事に挑戦しました。.mp3]	<b>思い切って新しい仕事に挑戦しました。</b> <br> おもいきってあたらしいしごとにちょうせんしました。 <br><br> (思い切って) <br> I boldly challenged myself to a new job.
思い切って新しい仕事に挑戦しました。 <br><br> (思い切って)	<b>おもいきってあたらしいしごとにちょうせんしました。</b> <br> I boldly challenged myself to a new job. <br> [sound:4c-s-思い切って新しい仕事に挑戦しました。.mp3]
I boldly challenged myself to a new job.	<b>思い切って新しい仕事に挑戦しました。</b> <br> おもいきってあたらしいしごとにちょうせんしました。 <br><br> (思い切って) <br> [sound:4c-s-思い切って新しい仕事に挑戦しました。.mp3]
[sound:4c-k-切らす.mp3]	<b>切らす</b> <br> きらす <br> to be out of, to run out of, to be short of, to be out of stock
切らす	<b>きらす</b> <br> to be out of, to run out of, to be short of, to be out of stock <br> [sound:4c-k-切らす.mp3]
to be out of, to run out of, to be short of, to be out of stock	<b>切らす</b> <br> きらす <br> [sound:4c-k-切らす.mp3]
[sound:4c-s-今日は牛乳を切らしてしまいました。.mp3]	<b>今日は牛乳を切らしてしまいました。</b> <br> きょうはぎゅうにゅうをきらしてしまいました。 <br><br> (切らす) <br> I ran out of milk today.
今日は牛乳を切らしてしまいました。 <br><br> (切らす)	<b>きょうはぎゅうにゅうをきらしてしまいました。</b> <br> I ran out of milk today. <br> [sound:4c-s-今日は牛乳を切らしてしまいました。.mp3]
I ran out of milk today.	<b>今日は牛乳を切らしてしまいました。</b> <br> きょうはぎゅうにゅうをきらしてしまいました。 <br><br> (切らす) <br> [sound:4c-s-今日は牛乳を切らしてしまいました。.mp3]
[sound:4c-k-経由.mp3]	<b>経由</b> <br> けいゆ <br> go by the way, via
経由	<b>けいゆ</b> <br> go by the way, via <br> [sound:4c-k-経由.mp3]
go by the way, via	<b>経由</b> <br> けいゆ <br> [sound:4c-k-経由.mp3]
[sound:4c-s-この便は東京経由で大阪に行きます。.mp3]	<b>この便は東京経由で大阪に行きます。</b> <br> このびんはとうきょうけいゆでおおさかにいきます。 <br><br> (経由) <br> This flight goes through Tokyo on its way to Osaka.
この便は東京経由で大阪に行きます。 <br><br> (経由)	<b>このびんはとうきょうけいゆでおおさかにいきます。</b> <br> This flight goes through Tokyo on its way to Osaka. <br> [sound:4c-s-この便は東京経由で大阪に行きます。.mp3]
This flight goes through Tokyo on its way to Osaka.	<b>この便は東京経由で大阪に行きます。</b> <br> このびんはとうきょうけいゆでおおさかにいきます。 <br><br> (経由) <br> [sound:4c-s-この便は東京経由で大阪に行きます。.mp3]
[sound:4c-k-不自由.mp3]	<b>不自由</b> <br> ふじゆう <br> discomfort, inconvenience; poverty, want, destitution; disability, impairment (physical, mental, etc.)
不自由	<b>ふじゆう</b> <br> discomfort, inconvenience; poverty, want, destitution; disability, impairment (physical, mental, etc.) <br> [sound:4c-k-不自由.mp3]
discomfort, inconvenience; poverty, want, destitution; disability, impairment (physical, mental, etc.)	<b>不自由</b> <br> ふじゆう <br> [sound:4c-k-不自由.mp3]
[sound:4c-s-その町では交通が不自由です。.mp3]	<b>その町では交通が不自由です。</b> <br> そのまちではこうつうがふじゆうです。 <br><br> (不自由) <br> Transportation is inconvenient in that town.
その町では交通が不自由です。 <br><br> (不自由)	<b>そのまちではこうつうがふじゆうです。</b> <br> Transportation is inconvenient in that town. <br> [sound:4c-s-その町では交通が不自由です。.mp3]
Transportation is inconvenient in that town.	<b>その町では交通が不自由です。</b> <br> そのまちではこうつうがふじゆうです。 <br><br> (不自由) <br> [sound:4c-s-その町では交通が不自由です。.mp3]
[sound:4c-k-自由化.mp3]	<b>自由化</b> <br> じゆうか <br> liberalization, liberalisation, freeing
自由化	<b>じゆうか</b> <br> liberalization, liberalisation, freeing <br> [sound:4c-k-自由化.mp3]
liberalization, liberalisation, freeing	<b>自由化</b> <br> じゆうか <br> [sound:4c-k-自由化.mp3]
[sound:4c-s-市場の自由化が進んでいます。.mp3]	<b>市場の自由化が進んでいます。</b> <br> しじょうのじゆうかがすすんでいます。 <br><br> (自由化) <br> Market liberalization is progressing.
市場の自由化が進んでいます。 <br><br> (自由化)	<b>しじょうのじゆうかがすすんでいます。</b> <br> Market liberalization is progressing. <br> [sound:4c-s-市場の自由化が進んでいます。.mp3]
Market liberalization is progressing.	<b>市場の自由化が進んでいます。</b> <br> しじょうのじゆうかがすすんでいます。 <br><br> (自由化) <br> [sound:4c-s-市場の自由化が進んでいます。.mp3]
[sound:4c-k-自由形.mp3]	<b>自由形</b> <br> じゆうがた <br> freestyle (e.g. swimming event)
自由形	<b>じゆうがた</b> <br> freestyle (e.g. swimming event) <br> [sound:4c-k-自由形.mp3]
freestyle (e.g. swimming event)	<b>自由形</b> <br> じゆうがた <br> [sound:4c-k-自由形.mp3]
[sound:4c-s-彼は自由形の泳ぎが得意です。.mp3]	<b>彼は自由形の泳ぎが得意です。</b> <br> かれはじゆうがたのおよぎがとくいです。 <br><br> (自由形) <br> He is good at freestyle swimming.
彼は自由形の泳ぎが得意です。 <br><br> (自由形)	<b>かれはじゆうがたのおよぎがとくいです。</b> <br> He is good at freestyle swimming. <br> [sound:4c-s-彼は自由形の泳ぎが得意です。.mp3]
He is good at freestyle swimming.	<b>彼は自由形の泳ぎが得意です。</b> <br> かれはじゆうがたのおよぎがとくいです。 <br><br> (自由形) <br> [sound:4c-s-彼は自由形の泳ぎが得意です。.mp3]
[sound:4c-k-解説.mp3]	<b>解説</b> <br> かいせつ <br> explanation, commentary, exposition, elucidation
解説	<b>かいせつ</b> <br> explanation, commentary, exposition, elucidation <br> [sound:4c-k-解説.mp3]
explanation, commentary, exposition, elucidation	<b>解説</b> <br> かいせつ <br> [sound:4c-k-解説.mp3]
[sound:4c-s-この本には詳しい解説があります。.mp3]	<b>この本には詳しい解説があります。</b> <br> このほんにはくわしいかいせつがあります。 <br><br> (解説) <br> This book contains detailed explanations.
この本には詳しい解説があります。 <br><br> (解説)	<b>このほんにはくわしいかいせつがあります。</b> <br> This book contains detailed explanations. <br> [sound:4c-s-この本には詳しい解説があります。.mp3]
This book contains detailed explanations.	<b>この本には詳しい解説があります。</b> <br> このほんにはくわしいかいせつがあります。 <br><br> (解説) <br> [sound:4c-s-この本には詳しい解説があります。.mp3]
[sound:4c-k-説得.mp3]	<b>説得</b> <br> せっとく <br> persuasion
説得	<b>せっとく</b> <br> persuasion <br> [sound:4c-k-説得.mp3]
persuasion	<b>説得</b> <br> せっとく <br> [sound:4c-k-説得.mp3]
[sound:4c-s-彼は私を説得して、計画を変更しました。.mp3]	<b>彼は私を説得して、計画を変更しました。</b> <br> かれはわたしをせっとくして、けいかくをへんこうしました。 <br><br> (説得) <br> He persuaded me to change the plan.
彼は私を説得して、計画を変更しました。 <br><br> (説得)	<b>かれはわたしをせっとくして、けいかくをへんこうしました。</b> <br> He persuaded me to change the plan. <br> [sound:4c-s-彼は私を説得して、計画を変更しました。.mp3]
He persuaded me to change the plan.	<b>彼は私を説得して、計画を変更しました。</b> <br> かれはわたしをせっとくして、けいかくをへんこうしました。 <br><br> (説得) <br> [sound:4c-s-彼は私を説得して、計画を変更しました。.mp3]
[sound:4c-k-伝説.mp3]	<b>伝説</b> <br> でんせつ <br> tradition, legend, folklore
伝説	<b>でんせつ</b> <br> tradition, legend, folklore <br> [sound:4c-k-伝説.mp3]
tradition, legend, folklore	<b>伝説</b> <br> でんせつ <br> [sound:4c-k-伝説.mp3]
[sound:4c-s-その山には古くからの伝説があります。.mp3]	<b>その山には古くからの伝説があります。</b> <br> そのやまにはふるくからのでんせつがあります。 <br><br> (伝説) <br> There are ancient legends about that mountain.
その山には古くからの伝説があります。 <br><br> (伝説)	<b>そのやまにはふるくからのでんせつがあります。</b> <br> There are ancient legends about that mountain. <br> [sound:4c-s-その山には古くからの伝説があります。.mp3]
There are ancient legends about that mountain.	<b>その山には古くからの伝説があります。</b> <br> そのやまにはふるくからのでんせつがあります。 <br><br> (伝説) <br> [sound:4c-s-その山には古くからの伝説があります。.mp3]
[sound:4c-k-遊説.mp3]	<b>遊説</b> <br> ゆうぜい <br> election tour, election campaign, stumping
遊説	<b>ゆうぜい</b> <br> election tour, election campaign, stumping <br> [sound:4c-k-遊説.mp3]
election tour, election campaign, stumping	<b>遊説</b> <br> ゆうぜい <br> [sound:4c-k-遊説.mp3]
[sound:4c-s-候補者は遊説で全国を回っています。.mp3]	<b>候補者は遊説で全国を回っています。</b> <br> こうほしゃはゆうぜいでぜんこくをまわっています。 <br><br> (遊説) <br> The candidate is touring the country on a campaign.
候補者は遊説で全国を回っています。 <br><br> (遊説)	<b>こうほしゃはゆうぜいでぜんこくをまわっています。</b> <br> The candidate is touring the country on a campaign. <br> [sound:4c-s-候補者は遊説で全国を回っています。.mp3]
The candidate is touring the country on a campaign.	<b>候補者は遊説で全国を回っています。</b> <br> こうほしゃはゆうぜいでぜんこくをまわっています。 <br><br> (遊説) <br> [sound:4c-s-候補者は遊説で全国を回っています。.mp3]
[sound:4c-k-移転.mp3]	<b>移転</b> <br> いてん <br> moving, transfer, demise
移転	<b>いてん</b> <br> moving, transfer, demise <br> [sound:4c-k-移転.mp3]
moving, transfer, demise	<b>移転</b> <br> いてん <br> [sound:4c-k-移転.mp3]
[sound:4c-s-会社は来月、オフィスを移転します。.mp3]	<b>会社は来月、オフィスを移転します。</b> <br> かいしゃはらいげつ、おふぃすをいてんします。 <br><br> (移転) <br> The company will relocate its office next month.
会社は来月、オフィスを移転します。 <br><br> (移転)	<b>かいしゃはらいげつ、おふぃすをいてんします。</b> <br> The company will relocate its office next month. <br> [sound:4c-s-会社は来月、オフィスを移転します。.mp3]
The company will relocate its office next month.	<b>会社は来月、オフィスを移転します。</b> <br> かいしゃはらいげつ、おふぃすをいてんします。 <br><br> (移転) <br> [sound:4c-s-会社は来月、オフィスを移転します。.mp3]
[sound:4c-k-運転手.mp3]	<b>運転手</b> <br> うんてんしゅ <br> driver, chauffeur
運転手	<b>うんてんしゅ</b> <br> driver, chauffeur <br> [sound:4c-k-運転手.mp3]
driver, chauffeur	<b>運転手</b> <br> うんてんしゅ <br> [sound:4c-k-運転手.mp3]
[sound:4c-s-運転手は私たちを空港まで連れて行きました。.mp3]	<b>運転手は私たちを空港まで連れて行きました。</b> <br> うんてんしゅはわたしたちをくうこうまでつれていきました。 <br><br> (運転手) <br> The driver took us to the airport.
運転手は私たちを空港まで連れて行きました。 <br><br> (運転手)	<b>うんてんしゅはわたしたちをくうこうまでつれていきました。</b> <br> The driver took us to the airport. <br> [sound:4c-s-運転手は私たちを空港まで連れて行きました。.mp3]
The driver took us to the airport.	<b>運転手は私たちを空港まで連れて行きました。</b> <br> うんてんしゅはわたしたちをくうこうまでつれていきました。 <br><br> (運転手) <br> [sound:4c-s-運転手は私たちを空港まで連れて行きました。.mp3]
[sound:4c-k-自転車.mp3]	<b>自転車</b> <br> じてんしゃ, じでんしゃ <br> bicycle
自転車	<b>じてんしゃ, じでんしゃ</b> <br> bicycle <br> [sound:4c-k-自転車.mp3]
bicycle	<b>自転車</b> <br> じてんしゃ, じでんしゃ <br> [sound:4c-k-自転車.mp3]
[sound:4c-s-私は毎日、自転車で通勤しています。.mp3]	<b>私は毎日、自転車で通勤しています。</b> <br> わたしはまいにち、じてんしゃでつうきんしています。 <br><br> (自転車) <br> I commute by bicycle every day.
私は毎日、自転車で通勤しています。 <br><br> (自転車)	<b>わたしはまいにち、じてんしゃでつうきんしています。</b> <br> I commute by bicycle every day. <br> [sound:4c-s-私は毎日、自転車で通勤しています。.mp3]
I commute by bicycle every day.	<b>私は毎日、自転車で通勤しています。</b> <br> わたしはまいにち、じてんしゃでつうきんしています。 <br><br> (自転車) <br> [sound:4c-s-私は毎日、自転車で通勤しています。.mp3]
[sound:4c-k-回転.mp3]	<b>回転</b> <br> かいてん <br> rotation (usu. around something), revolution, turning
回転	<b>かいてん</b> <br> rotation (usu. around something), revolution, turning <br> [sound:4c-k-回転.mp3]
rotation (usu. around something), revolution, turning	<b>回転</b> <br> かいてん <br> [sound:4c-k-回転.mp3]
[sound:4c-s-この工場では、毎日製品が回転しています。.mp3]	<b>この工場では、毎日製品が回転しています。</b> <br> このこうじょうでは、まいにちせいひんがかいてんしています。 <br><br> (回転) <br> In this factory, products are produced every day.
この工場では、毎日製品が回転しています。 <br><br> (回転)	<b>このこうじょうでは、まいにちせいひんがかいてんしています。</b> <br> In this factory, products are produced every day. <br> [sound:4c-s-この工場では、毎日製品が回転しています。.mp3]
In this factory, products are produced every day.	<b>この工場では、毎日製品が回転しています。</b> <br> このこうじょうでは、まいにちせいひんがかいてんしています。 <br><br> (回転) <br> [sound:4c-s-この工場では、毎日製品が回転しています。.mp3]
[sound:4c-k-食料.mp3]	<b>食料</b> <br> しょくりょう <br> food
食料	<b>しょくりょう</b> <br> food <br> [sound:4c-k-食料.mp3]
food	<b>食料</b> <br> しょくりょう <br> [sound:4c-k-食料.mp3]
[sound:4c-s-食料品の買い物をするためにスーパーに行きました。.mp3]	<b>食料品の買い物をするためにスーパーに行きました。</b> <br> しょくりょうひんのかいものをするためにすーぱーにいきました。 <br><br> (食料) <br> I went to the supermarket to buy food.
食料品の買い物をするためにスーパーに行きました。 <br><br> (食料)	<b>しょくりょうひんのかいものをするためにすーぱーにいきました。</b> <br> I went to the supermarket to buy food. <br> [sound:4c-s-食料品の買い物をするためにスーパーに行きました。.mp3]
I went to the supermarket to buy food.	<b>食料品の買い物をするためにスーパーに行きました。</b> <br> しょくりょうひんのかいものをするためにすーぱーにいきました。 <br><br> (食料) <br> [sound:4c-s-食料品の買い物をするためにスーパーに行きました。.mp3]
[sound:4c-k-食糧.mp3]	<b>食糧</b> <br> しょくりょう <br> provisions, rations, food supply
食糧	<b>しょくりょう</b> <br> provisions, rations, food supply <br> [sound:4c-k-食糧.mp3]
provisions, rations, food supply	<b>食糧</b> <br> しょくりょう <br> [sound:4c-k-食糧.mp3]
[sound:4c-s-食糧の供給が安定しています。.mp3]	<b>食糧の供給が安定しています。</b> <br> しょくりょうのきょうきゅうがあんていしています。 <br><br> (食糧) <br> The supply of food is stable.
食糧の供給が安定しています。 <br><br> (食糧)	<b>しょくりょうのきょうきゅうがあんていしています。</b> <br> The supply of food is stable. <br> [sound:4c-s-食糧の供給が安定しています。.mp3]
The supply of food is stable.	<b>食糧の供給が安定しています。</b> <br> しょくりょうのきょうきゅうがあんていしています。 <br><br> (食糧) <br> [sound:4c-s-食糧の供給が安定しています。.mp3]
[sound:4c-k-昼食.mp3]	<b>昼食</b> <br> ちゅうしょく, ちゅうじき, ひるげ <br> lunch, midday meal; food served at a tea party (tea ceremony)
昼食	<b>ちゅうしょく, ちゅうじき, ひるげ</b> <br> lunch, midday meal; food served at a tea party (tea ceremony) <br> [sound:4c-k-昼食.mp3]
lunch, midday meal; food served at a tea party (tea ceremony)	<b>昼食</b> <br> ちゅうしょく, ちゅうじき, ひるげ <br> [sound:4c-k-昼食.mp3]
[sound:4c-s-今日は昼食に寿司を食べました。.mp3]	<b>今日は昼食に寿司を食べました。</b> <br> きょうはちゅうしょくにすしをたべました。 <br><br> (昼食) <br> I had sushi for lunch today.
今日は昼食に寿司を食べました。 <br><br> (昼食)	<b>きょうはちゅうしょくにすしをたべました。</b> <br> I had sushi for lunch today. <br> [sound:4c-s-今日は昼食に寿司を食べました。.mp3]
I had sushi for lunch today.	<b>今日は昼食に寿司を食べました。</b> <br> きょうはちゅうしょくにすしをたべました。 <br><br> (昼食) <br> [sound:4c-s-今日は昼食に寿司を食べました。.mp3]
[sound:4c-k-飲食.mp3]	<b>飲食</b> <br> いんしょく <br> food and drink, eating and drinking
飲食	<b>いんしょく</b> <br> food and drink, eating and drinking <br> [sound:4c-k-飲食.mp3]
food and drink, eating and drinking	<b>飲食</b> <br> いんしょく <br> [sound:4c-k-飲食.mp3]
[sound:4c-s-このレストランは飲食店として人気があります。.mp3]	<b>このレストランは飲食店として人気があります。</b> <br> このれすとらんはいんしょくてんとしてにんきがあります。 <br><br> (飲食) <br> This restaurant is popular as a dining establishment.
このレストランは飲食店として人気があります。 <br><br> (飲食)	<b>このれすとらんはいんしょくてんとしてにんきがあります。</b> <br> This restaurant is popular as a dining establishment. <br> [sound:4c-s-このレストランは飲食店として人気があります。.mp3]
This restaurant is popular as a dining establishment.	<b>このレストランは飲食店として人気があります。</b> <br> このれすとらんはいんしょくてんとしてにんきがあります。 <br><br> (飲食) <br> [sound:4c-s-このレストランは飲食店として人気があります。.mp3]
[sound:4c-k-比較.mp3]	<b>比較</b> <br> ひかく <br> comparison
比較	<b>ひかく</b> <br> comparison <br> [sound:4c-k-比較.mp3]
comparison	<b>比較</b> <br> ひかく <br> [sound:4c-k-比較.mp3]
[sound:4c-s-この二つの製品を比較してみました。.mp3]	<b>この二つの製品を比較してみました。</b> <br> このふたつのせいひんをひかくしてみました。 <br><br> (比較) <br> I compared these two products.
この二つの製品を比較してみました。 <br><br> (比較)	<b>このふたつのせいひんをひかくしてみました。</b> <br> I compared these two products. <br> [sound:4c-s-この二つの製品を比較してみました。.mp3]
I compared these two products.	<b>この二つの製品を比較してみました。</b> <br> このふたつのせいひんをひかくしてみました。 <br><br> (比較) <br> [sound:4c-s-この二つの製品を比較してみました。.mp3]
[sound:4c-k-比べ.mp3]	<b>比べ</b> <br> くらべ <br> contest, comparison, competition
比べ	<b>くらべ</b> <br> contest, comparison, competition <br> [sound:4c-k-比べ.mp3]
contest, comparison, competition	<b>比べ</b> <br> くらべ <br> [sound:4c-k-比べ.mp3]
[sound:4c-s-この町と他の町を比べると、交通が便利です。.mp3]	<b>この町と他の町を比べると、交通が便利です。</b> <br> このまちとほかのまちをくらべると、こうつうがべんりです。 <br><br> (比べ) <br> Compared to other towns, transportation here is convenient.
この町と他の町を比べると、交通が便利です。 <br><br> (比べ)	<b>このまちとほかのまちをくらべると、こうつうがべんりです。</b> <br> Compared to other towns, transportation here is convenient. <br> [sound:4c-s-この町と他の町を比べると、交通が便利です。.mp3]
Compared to other towns, transportation here is convenient.	<b>この町と他の町を比べると、交通が便利です。</b> <br> このまちとほかのまちをくらべると、こうつうがべんりです。 <br><br> (比べ) <br> [sound:4c-s-この町と他の町を比べると、交通が便利です。.mp3]
[sound:4c-k-比.mp3]	<b>比</b> <br> ひ <br> ratio, proportion; match, equal; explicit comparison (style of the Shi Jing); Philippines
比	<b>ひ</b> <br> ratio, proportion; match, equal; explicit comparison (style of the Shi Jing); Philippines <br> [sound:4c-k-比.mp3]
ratio, proportion; match, equal; explicit comparison (style of the Shi Jing); Philippines	<b>比</b> <br> ひ <br> [sound:4c-k-比.mp3]
[sound:4c-s-この商品の価格は他の商品の半分の比です。.mp3]	<b>この商品の価格は他の商品の半分の比です。</b> <br> このしょうひんのかかくはほかのしょうひんのはんぶんのひです。 <br><br> (比) <br> The price of this product is half of other products.
この商品の価格は他の商品の半分の比です。 <br><br> (比)	<b>このしょうひんのかかくはほかのしょうひんのはんぶんのひです。</b> <br> The price of this product is half of other products. <br> [sound:4c-s-この商品の価格は他の商品の半分の比です。.mp3]
The price of this product is half of other products.	<b>この商品の価格は他の商品の半分の比です。</b> <br> このしょうひんのかかくはほかのしょうひんのはんぶんのひです。 <br><br> (比) <br> [sound:4c-s-この商品の価格は他の商品の半分の比です。.mp3]
[sound:4c-k-比重.mp3]	<b>比重</b> <br> ひじゅう <br> specific gravity, weight, part; relative weight, relative importance
比重	<b>ひじゅう</b> <br> specific gravity, weight, part; relative weight, relative importance <br> [sound:4c-k-比重.mp3]
specific gravity, weight, part; relative weight, relative importance	<b>比重</b> <br> ひじゅう <br> [sound:4c-k-比重.mp3]
[sound:4c-s-この物質の比重は水よりも高いです。.mp3]	<b>この物質の比重は水よりも高いです。</b> <br> このぶっしつのひじゅうはみずよりもたかいです。 <br><br> (比重) <br> The specific gravity of this material is higher than water.
この物質の比重は水よりも高いです。 <br><br> (比重)	<b>このぶっしつのひじゅうはみずよりもたかいです。</b> <br> The specific gravity of this material is higher than water. <br> [sound:4c-s-この物質の比重は水よりも高いです。.mp3]
The specific gravity of this material is higher than water.	<b>この物質の比重は水よりも高いです。</b> <br> このぶっしつのひじゅうはみずよりもたかいです。 <br><br> (比重) <br> [sound:4c-s-この物質の比重は水よりも高いです。.mp3]
[sound:4c-k-困難.mp3]	<b>困難</b> <br> こんなん <br> difficulty, distress
困難	<b>こんなん</b> <br> difficulty, distress <br> [sound:4c-k-困難.mp3]
difficulty, distress	<b>困難</b> <br> こんなん <br> [sound:4c-k-困難.mp3]
[sound:4c-s-その問題を解決するには困難な状況です。.mp3]	<b>その問題を解決するには困難な状況です。</b> <br> そのもんだいをかいけつするにはこんなんなじょうきょうです。 <br><br> (困難) <br> It is a difficult situation to solve the problem.
その問題を解決するには困難な状況です。 <br><br> (困難)	<b>そのもんだいをかいけつするにはこんなんなじょうきょうです。</b> <br> It is a difficult situation to solve the problem. <br> [sound:4c-s-その問題を解決するには困難な状況です。.mp3]
It is a difficult situation to solve the problem.	<b>その問題を解決するには困難な状況です。</b> <br> そのもんだいをかいけつするにはこんなんなじょうきょうです。 <br><br> (困難) <br> [sound:4c-s-その問題を解決するには困難な状況です。.mp3]
[sound:4c-k-避難.mp3]	<b>避難</b> <br> ひなん <br> taking refuge, finding shelter, evacuation, escape
避難	<b>ひなん</b> <br> taking refuge, finding shelter, evacuation, escape <br> [sound:4c-k-避難.mp3]
taking refuge, finding shelter, evacuation, escape	<b>避難</b> <br> ひなん <br> [sound:4c-k-避難.mp3]
[sound:4c-s-避難所は学校に設置されています。.mp3]	<b>避難所は学校に設置されています。</b> <br> ひなんじょはがっこうにせっちされています。 <br><br> (避難) <br> Temporary shelters are set up in schools.
避難所は学校に設置されています。 <br><br> (避難)	<b>ひなんじょはがっこうにせっちされています。</b> <br> Temporary shelters are set up in schools. <br> [sound:4c-s-避難所は学校に設置されています。.mp3]
Temporary shelters are set up in schools.	<b>避難所は学校に設置されています。</b> <br> ひなんじょはがっこうにせっちされています。 <br><br> (避難) <br> [sound:4c-s-避難所は学校に設置されています。.mp3]
[sound:4c-k-非難.mp3]	<b>非難</b> <br> ひなん <br> blame, attack, criticism
非難	<b>ひなん</b> <br> blame, attack, criticism <br> [sound:4c-k-非難.mp3]
blame, attack, criticism	<b>非難</b> <br> ひなん <br> [sound:4c-k-非難.mp3]
[sound:4c-s-彼はその行動を非難されました。.mp3]	<b>彼はその行動を非難されました。</b> <br> かれはそのこうどうをひなんされました。 <br><br> (非難) <br> He was criticized for his actions.
彼はその行動を非難されました。 <br><br> (非難)	<b>かれはそのこうどうをひなんされました。</b> <br> He was criticized for his actions. <br> [sound:4c-s-彼はその行動を非難されました。.mp3]
He was criticized for his actions.	<b>彼はその行動を非難されました。</b> <br> かれはそのこうどうをひなんされました。 <br><br> (非難) <br> [sound:4c-s-彼はその行動を非難されました。.mp3]
[sound:4c-k-難色.mp3]	<b>難色</b> <br> なんしょく <br> disapproval
難色	<b>なんしょく</b> <br> disapproval <br> [sound:4c-k-難色.mp3]
disapproval	<b>難色</b> <br> なんしょく <br> [sound:4c-k-難色.mp3]
[sound:4c-s-彼はその提案に難色を示しました。.mp3]	<b>彼はその提案に難色を示しました。</b> <br> かれはそのていあんになんしょくをしめしました。 <br><br> (難色) <br> He showed hesitation toward the proposal.
彼はその提案に難色を示しました。 <br><br> (難色)	<b>かれはそのていあんになんしょくをしめしました。</b> <br> He showed hesitation toward the proposal. <br> [sound:4c-s-彼はその提案に難色を示しました。.mp3]
He showed hesitation toward the proposal.	<b>彼はその提案に難色を示しました。</b> <br> かれはそのていあんになんしょくをしめしました。 <br><br> (難色) <br> [sound:4c-s-彼はその提案に難色を示しました。.mp3]
[sound:4c-k-防衛庁.mp3]	<b>防衛庁</b> <br> ぼうえいちょう <br> Japan Defense Agency (Defence) (became Japanese Ministry of Defense in Jan. 2007)
防衛庁	<b>ぼうえいちょう</b> <br> Japan Defense Agency (Defence) (became Japanese Ministry of Defense in Jan. 2007) <br> [sound:4c-k-防衛庁.mp3]
Japan Defense Agency (Defence) (became Japanese Ministry of Defense in Jan. 2007)	<b>防衛庁</b> <br> ぼうえいちょう <br> [sound:4c-k-防衛庁.mp3]
[sound:4c-s-防衛庁は新しい政策を発表しました。.mp3]	<b>防衛庁は新しい政策を発表しました。</b> <br> ぼうえいちょうはあたらしいせいさくをはっぴょうしました。 <br><br> (防衛庁) <br> The Ministry of Defense announced a new policy.
防衛庁は新しい政策を発表しました。 <br><br> (防衛庁)	<b>ぼうえいちょうはあたらしいせいさくをはっぴょうしました。</b> <br> The Ministry of Defense announced a new policy. <br> [sound:4c-s-防衛庁は新しい政策を発表しました。.mp3]
The Ministry of Defense announced a new policy.	<b>防衛庁は新しい政策を発表しました。</b> <br> ぼうえいちょうはあたらしいせいさくをはっぴょうしました。 <br><br> (防衛庁) <br> [sound:4c-s-防衛庁は新しい政策を発表しました。.mp3]
[sound:4c-k-予防.mp3]	<b>予防</b> <br> よぼう <br> prevention, precaution, protection against
予防	<b>よぼう</b> <br> prevention, precaution, protection against <br> [sound:4c-k-予防.mp3]
prevention, precaution, protection against	<b>予防</b> <br> よぼう <br> [sound:4c-k-予防.mp3]
[sound:4c-s-予防接種を受けることが重要です。.mp3]	<b>予防接種を受けることが重要です。</b> <br> よぼうせっしゅをうけることがじゅうようです。 <br><br> (予防) <br> It is important to get vaccinations to prevent diseases.
予防接種を受けることが重要です。 <br><br> (予防)	<b>よぼうせっしゅをうけることがじゅうようです。</b> <br> It is important to get vaccinations to prevent diseases. <br> [sound:4c-s-予防接種を受けることが重要です。.mp3]
It is important to get vaccinations to prevent diseases.	<b>予防接種を受けることが重要です。</b> <br> よぼうせっしゅをうけることがじゅうようです。 <br><br> (予防) <br> [sound:4c-s-予防接種を受けることが重要です。.mp3]
[sound:4c-k-攻防.mp3]	<b>攻防</b> <br> こうぼう <br> offense and defense, offence and defence
攻防	<b>こうぼう</b> <br> offense and defense, offence and defence <br> [sound:4c-k-攻防.mp3]
offense and defense, offence and defence	<b>攻防</b> <br> こうぼう <br> [sound:4c-k-攻防.mp3]
[sound:4c-s-攻防戦が激しく行われました。.mp3]	<b>攻防戦が激しく行われました。</b> <br> こうぼうせんがはげしくおこなわれました。 <br><br> (攻防) <br> The battle between offense and defense was intense.
攻防戦が激しく行われました。 <br><br> (攻防)	<b>こうぼうせんがはげしくおこなわれました。</b> <br> The battle between offense and defense was intense. <br> [sound:4c-s-攻防戦が激しく行われました。.mp3]
The battle between offense and defense was intense.	<b>攻防戦が激しく行われました。</b> <br> こうぼうせんがはげしくおこなわれました。 <br><br> (攻防) <br> [sound:4c-s-攻防戦が激しく行われました。.mp3]
[sound:4c-k-消防.mp3]	<b>消防</b> <br> しょうぼう <br> fire fighting, fire department
消防	<b>しょうぼう</b> <br> fire fighting, fire department <br> [sound:4c-k-消防.mp3]
fire fighting, fire department	<b>消防</b> <br> しょうぼう <br> [sound:4c-k-消防.mp3]
[sound:4c-s-消防士は火事の消火活動を行っています。.mp3]	<b>消防士は火事の消火活動を行っています。</b> <br> しょうぼうしはかじのしょうかかつどうをおこなっています。 <br><br> (消防) <br> The firefighters are engaged in firefighting activities.
消防士は火事の消火活動を行っています。 <br><br> (消防)	<b>しょうぼうしはかじのしょうかかつどうをおこなっています。</b> <br> The firefighters are engaged in firefighting activities. <br> [sound:4c-s-消防士は火事の消火活動を行っています。.mp3]
The firefighters are engaged in firefighting activities.	<b>消防士は火事の消火活動を行っています。</b> <br> しょうぼうしはかじのしょうかかつどうをおこなっています。 <br><br> (消防) <br> [sound:4c-s-消防士は火事の消火活動を行っています。.mp3]
[sound:4c-k-立候補.mp3]	<b>立候補</b> <br> りっこうほ <br> announcing candidacy
立候補	<b>りっこうほ</b> <br> announcing candidacy <br> [sound:4c-k-立候補.mp3]
announcing candidacy	<b>立候補</b> <br> りっこうほ <br> [sound:4c-k-立候補.mp3]
[sound:4c-s-彼は次の選挙に立候補する予定です。.mp3]	<b>彼は次の選挙に立候補する予定です。</b> <br> かれはつぎのせんきょにりっこうほするよていです。 <br><br> (立候補) <br> He plans to run for the next election.
彼は次の選挙に立候補する予定です。 <br><br> (立候補)	<b>かれはつぎのせんきょにりっこうほするよていです。</b> <br> He plans to run for the next election. <br> [sound:4c-s-彼は次の選挙に立候補する予定です。.mp3]
He plans to run for the next election.	<b>彼は次の選挙に立候補する予定です。</b> <br> かれはつぎのせんきょにりっこうほするよていです。 <br><br> (立候補) <br> [sound:4c-s-彼は次の選挙に立候補する予定です。.mp3]
[sound:4c-k-補正予算.mp3]	<b>補正予算</b> <br> ほせいよさん <br> revised or supplementary budget
補正予算	<b>ほせいよさん</b> <br> revised or supplementary budget <br> [sound:4c-k-補正予算.mp3]
revised or supplementary budget	<b>補正予算</b> <br> ほせいよさん <br> [sound:4c-k-補正予算.mp3]
[sound:4c-s-政府は補正予算を提出しました。.mp3]	<b>政府は補正予算を提出しました。</b> <br> せいふはほせいよさんをていしゅつしました。 <br><br> (補正予算) <br> The government submitted a supplementary budget.
政府は補正予算を提出しました。 <br><br> (補正予算)	<b>せいふはほせいよさんをていしゅつしました。</b> <br> The government submitted a supplementary budget. <br> [sound:4c-s-政府は補正予算を提出しました。.mp3]
The government submitted a supplementary budget.	<b>政府は補正予算を提出しました。</b> <br> せいふはほせいよさんをていしゅつしました。 <br><br> (補正予算) <br> [sound:4c-s-政府は補正予算を提出しました。.mp3]
[sound:4c-k-補佐.mp3]	<b>補佐</b> <br> ほさ <br> aid, help, assistance, assistant, counselor, counsellor, adviser, advisor
補佐	<b>ほさ</b> <br> aid, help, assistance, assistant, counselor, counsellor, adviser, advisor <br> [sound:4c-k-補佐.mp3]
aid, help, assistance, assistant, counselor, counsellor, adviser, advisor	<b>補佐</b> <br> ほさ <br> [sound:4c-k-補佐.mp3]
[sound:4c-s-彼はプロジェクトの補佐をしています。.mp3]	<b>彼はプロジェクトの補佐をしています。</b> <br> かれはぷろじぇくとのほさをしています。 <br><br> (補佐) <br> He is assisting with the project.
彼はプロジェクトの補佐をしています。 <br><br> (補佐)	<b>かれはぷろじぇくとのほさをしています。</b> <br> He is assisting with the project. <br> [sound:4c-s-彼はプロジェクトの補佐をしています。.mp3]
He is assisting with the project.	<b>彼はプロジェクトの補佐をしています。</b> <br> かれはぷろじぇくとのほさをしています。 <br><br> (補佐) <br> [sound:4c-s-彼はプロジェクトの補佐をしています。.mp3]
[sound:4c-k-補給.mp3]	<b>補給</b> <br> ほきゅう <br> supply, supplying, replenishment
補給	<b>ほきゅう</b> <br> supply, supplying, replenishment <br> [sound:4c-k-補給.mp3]
supply, supplying, replenishment	<b>補給</b> <br> ほきゅう <br> [sound:4c-k-補給.mp3]
[sound:4c-s-物資の補給が必要です。.mp3]	<b>物資の補給が必要です。</b> <br> ぶっしのほきゅうがひつようです。 <br><br> (補給) <br> Supply replenishment is necessary.
物資の補給が必要です。 <br><br> (補給)	<b>ぶっしのほきゅうがひつようです。</b> <br> Supply replenishment is necessary. <br> [sound:4c-s-物資の補給が必要です。.mp3]
Supply replenishment is necessary.	<b>物資の補給が必要です。</b> <br> ぶっしのほきゅうがひつようです。 <br><br> (補給) <br> [sound:4c-s-物資の補給が必要です。.mp3]
[sound:4c-k-乗用車.mp3]	<b>乗用車</b> <br> じょうようしゃ <br> passenger vehicle, automobile
乗用車	<b>じょうようしゃ</b> <br> passenger vehicle, automobile <br> [sound:4c-k-乗用車.mp3]
passenger vehicle, automobile	<b>乗用車</b> <br> じょうようしゃ <br> [sound:4c-k-乗用車.mp3]
[sound:4c-s-その道には乗用車がたくさん走っています。.mp3]	<b>その道には乗用車がたくさん走っています。</b> <br> そのみちはじょうようしゃがたくさんはしっています。 <br><br> (乗用車) <br> There are many cars running on that road.
その道には乗用車がたくさん走っています。 <br><br> (乗用車)	<b>そのみちはじょうようしゃがたくさんはしっています。</b> <br> There are many cars running on that road. <br> [sound:4c-s-その道には乗用車がたくさん走っています。.mp3]
There are many cars running on that road.	<b>その道には乗用車がたくさん走っています。</b> <br> そのみちはじょうようしゃがたくさんはしっています。 <br><br> (乗用車) <br> [sound:4c-s-その道には乗用車がたくさん走っています。.mp3]
[sound:4c-k-自転車.mp3]	<b>自転車</b> <br> じてんしゃ, じでんしゃ <br> bicycle
自転車	<b>じてんしゃ, じでんしゃ</b> <br> bicycle <br> [sound:4c-k-自転車.mp3]
bicycle	<b>自転車</b> <br> じてんしゃ, じでんしゃ <br> [sound:4c-k-自転車.mp3]
[sound:4c-s-自転車で公園に行くのは楽しいです。.mp3]	<b>自転車で公園に行くのは楽しいです。</b> <br> じてんしゃでこうえんにいくのはたのしいです。 <br><br> (自転車) <br> Cycling to the park is fun.
自転車で公園に行くのは楽しいです。 <br><br> (自転車)	<b>じてんしゃでこうえんにいくのはたのしいです。</b> <br> Cycling to the park is fun. <br> [sound:4c-s-自転車で公園に行くのは楽しいです。.mp3]
Cycling to the park is fun.	<b>自転車で公園に行くのは楽しいです。</b> <br> じてんしゃでこうえんにいくのはたのしいです。 <br><br> (自転車) <br> [sound:4c-s-自転車で公園に行くのは楽しいです。.mp3]
[sound:4c-k-車両.mp3]	<b>車両</b> <br> しゃりょう <br> rolling stock, railroad cars, vehicles
車両	<b>しゃりょう</b> <br> rolling stock, railroad cars, vehicles <br> [sound:4c-k-車両.mp3]
rolling stock, railroad cars, vehicles	<b>車両</b> <br> しゃりょう <br> [sound:4c-k-車両.mp3]
[sound:4c-s-新しい車両が駅に到着しました。.mp3]	<b>新しい車両が駅に到着しました。</b> <br> あたらしいしゃりょうがえきにとうちゃくしました。 <br><br> (車両) <br> New vehicles have arrived at the station.
新しい車両が駅に到着しました。 <br><br> (車両)	<b>あたらしいしゃりょうがえきにとうちゃくしました。</b> <br> New vehicles have arrived at the station. <br> [sound:4c-s-新しい車両が駅に到着しました。.mp3]
New vehicles have arrived at the station.	<b>新しい車両が駅に到着しました。</b> <br> あたらしいしゃりょうがえきにとうちゃくしました。 <br><br> (車両) <br> [sound:4c-s-新しい車両が駅に到着しました。.mp3]
[sound:4c-k-電車.mp3]	<b>電車</b> <br> でんしゃ <br> (electric) train
電車	<b>でんしゃ</b> <br> (electric) train <br> [sound:4c-k-電車.mp3]
(electric) train	<b>電車</b> <br> でんしゃ <br> [sound:4c-k-電車.mp3]
[sound:4c-s-電車は定刻通りに到着しました。.mp3]	<b>電車は定刻通りに到着しました。</b> <br> でんしゃはていこくどおりにとうちゃくしました。 <br><br> (電車) <br> The train arrived on time.
電車は定刻通りに到着しました。 <br><br> (電車)	<b>でんしゃはていこくどおりにとうちゃくしました。</b> <br> The train arrived on time. <br> [sound:4c-s-電車は定刻通りに到着しました。.mp3]
The train arrived on time.	<b>電車は定刻通りに到着しました。</b> <br> でんしゃはていこくどおりにとうちゃくしました。 <br><br> (電車) <br> [sound:4c-s-電車は定刻通りに到着しました。.mp3]
[sound:4c-k-女優.mp3]	<b>女優</b> <br> じょゆう <br> actress
女優	<b>じょゆう</b> <br> actress <br> [sound:4c-k-女優.mp3]
actress	<b>女優</b> <br> じょゆう <br> [sound:4c-k-女優.mp3]
[sound:4c-s-彼女は才能ある女優として知られています。.mp3]	<b>彼女は才能ある女優として知られています。</b> <br> かのじょはさいのうあるじょゆうとしてしられています。 <br><br> (女優) <br> She is known as a talented actress.
彼女は才能ある女優として知られています。 <br><br> (女優)	<b>かのじょはさいのうあるじょゆうとしてしられています。</b> <br> She is known as a talented actress. <br> [sound:4c-s-彼女は才能ある女優として知られています。.mp3]
She is known as a talented actress.	<b>彼女は才能ある女優として知られています。</b> <br> かのじょはさいのうあるじょゆうとしてしられています。 <br><br> (女優) <br> [sound:4c-s-彼女は才能ある女優として知られています。.mp3]
[sound:4c-k-優秀.mp3]	<b>優秀</b> <br> ゆうしゅう <br> superiority, excellence
優秀	<b>ゆうしゅう</b> <br> superiority, excellence <br> [sound:4c-k-優秀.mp3]
superiority, excellence	<b>優秀</b> <br> ゆうしゅう <br> [sound:4c-k-優秀.mp3]
[sound:4c-s-彼は優秀なエンジニアです。.mp3]	<b>彼は優秀なエンジニアです。</b> <br> かれはゆうしゅうなえんじにあです。 <br><br> (優秀) <br> He is an excellent engineer.
彼は優秀なエンジニアです。 <br><br> (優秀)	<b>かれはゆうしゅうなえんじにあです。</b> <br> He is an excellent engineer. <br> [sound:4c-s-彼は優秀なエンジニアです。.mp3]
He is an excellent engineer.	<b>彼は優秀なエンジニアです。</b> <br> かれはゆうしゅうなえんじにあです。 <br><br> (優秀) <br> [sound:4c-s-彼は優秀なエンジニアです。.mp3]
[sound:4c-k-優遇.mp3]	<b>優遇</b> <br> ゆうぐう <br> favorable treatment, favourable treatment, hospitality, warm reception, good treatment, hearty welcome
優遇	<b>ゆうぐう</b> <br> favorable treatment, favourable treatment, hospitality, warm reception, good treatment, hearty welcome <br> [sound:4c-k-優遇.mp3]
favorable treatment, favourable treatment, hospitality, warm reception, good treatment, hearty welcome	<b>優遇</b> <br> ゆうぐう <br> [sound:4c-k-優遇.mp3]
[sound:4c-s-このプログラムでは参加者が優遇されます。.mp3]	<b>このプログラムでは参加者が優遇されます。</b> <br> このぷろぐらむではさんかしゃがゆうぐうされます。 <br><br> (優遇) <br> Participants in this program are given preferential treatment.
このプログラムでは参加者が優遇されます。 <br><br> (優遇)	<b>このぷろぐらむではさんかしゃがゆうぐうされます。</b> <br> Participants in this program are given preferential treatment. <br> [sound:4c-s-このプログラムでは参加者が優遇されます。.mp3]
Participants in this program are given preferential treatment.	<b>このプログラムでは参加者が優遇されます。</b> <br> このぷろぐらむではさんかしゃがゆうぐうされます。 <br><br> (優遇) <br> [sound:4c-s-このプログラムでは参加者が優遇されます。.mp3]
[sound:4c-k-優しい.mp3]	<b>優しい</b> <br> やさしい <br> tender, kind, gentle, graceful, affectionate, amiable, suave
優しい	<b>やさしい</b> <br> tender, kind, gentle, graceful, affectionate, amiable, suave <br> [sound:4c-k-優しい.mp3]
