[sound:4c-k-以後.mp3]	<b>以後</b> <br> いご <br> after this, from now on, hereafter; thereafter, since (verb) (after -te form of verb), after (time), since (then)
以後	<b>いご</b> <br> after this, from now on, hereafter; thereafter, since (verb) (after -te form of verb), after (time), since (then) <br> [sound:4c-k-以後.mp3]
after this, from now on, hereafter; thereafter, since (verb) (after -te form of verb), after (time), since (then)	<b>以後</b> <br> いご <br> [sound:4c-k-以後.mp3]
[sound:4c-s-以後、注意してください。.mp3]	<b>以後、注意してください。</b> <br> いご、ちゅういしてください。 <br><br> (以後) <br> Please be careful from now on.
以後、注意してください。 <br><br> (以後)	<b>いご、ちゅういしてください。</b> <br> Please be careful from now on. <br> [sound:4c-s-以後、注意してください。.mp3]
Please be careful from now on.	<b>以後、注意してください。</b> <br> いご、ちゅういしてください。 <br><br> (以後) <br> [sound:4c-s-以後、注意してください。.mp3]
[sound:4c-k-以上.mp3]	<b>以上</b> <br> いじょう <br> not less than, ... and more, ... and upwards; beyond ... (e.g. one's means), further (e.g. nothing further to say), more than ... (e.g. cannot pay more than that); above-mentioned, foregoing; since ..., seeing that ...; this is all, that is the end, the end
以上	<b>いじょう</b> <br> not less than, ... and more, ... and upwards; beyond ... (e.g. one's means), further (e.g. nothing further to say), more than ... (e.g. cannot pay more than that); above-mentioned, foregoing; since ..., seeing that ...; this is all, that is the end, the end <br> [sound:4c-k-以上.mp3]
not less than, ... and more, ... and upwards; beyond ... (e.g. one's means), further (e.g. nothing further to say), more than ... (e.g. cannot pay more than that); above-mentioned, foregoing; since ..., seeing that ...; this is all, that is the end, the end	<b>以上</b> <br> いじょう <br> [sound:4c-k-以上.mp3]
[sound:4c-s-以上のことを理解してください。.mp3]	<b>以上のことを理解してください。</b> <br> いじょうのことをりかいしてください。 <br><br> (以上) <br> Please understand the above points.
以上のことを理解してください。 <br><br> (以上)	<b>いじょうのことをりかいしてください。</b> <br> Please understand the above points. <br> [sound:4c-s-以上のことを理解してください。.mp3]
Please understand the above points.	<b>以上のことを理解してください。</b> <br> いじょうのことをりかいしてください。 <br><br> (以上) <br> [sound:4c-s-以上のことを理解してください。.mp3]
[sound:4c-k-以降.mp3]	<b>以降</b> <br> いこう <br> on and after, as from, hereafter, thereafter, since
以降	<b>いこう</b> <br> on and after, as from, hereafter, thereafter, since <br> [sound:4c-k-以降.mp3]
on and after, as from, hereafter, thereafter, since	<b>以降</b> <br> いこう <br> [sound:4c-k-以降.mp3]
[sound:4c-s-この規則は来月以降適用されます。.mp3]	<b>この規則は来月以降適用されます。</b> <br> このきそくはらいげついこうてきようされます。 <br><br> (以降) <br> This rule will apply from next month onwards.
この規則は来月以降適用されます。 <br><br> (以降)	<b>このきそくはらいげついこうてきようされます。</b> <br> This rule will apply from next month onwards. <br> [sound:4c-s-この規則は来月以降適用されます。.mp3]
This rule will apply from next month onwards.	<b>この規則は来月以降適用されます。</b> <br> このきそくはらいげついこうてきようされます。 <br><br> (以降) <br> [sound:4c-s-この規則は来月以降適用されます。.mp3]
[sound:4c-k-機能.mp3]	<b>機能</b> <br> きのう <br> function, facility, faculty, feature
機能	<b>きのう</b> <br> function, facility, faculty, feature <br> [sound:4c-k-機能.mp3]
function, facility, faculty, feature	<b>機能</b> <br> きのう <br> [sound:4c-k-機能.mp3]
[sound:4c-s-このアプリには便利な機能があります。.mp3]	<b>このアプリには便利な機能があります。</b> <br> このアプリにはべんりなきのうがあります。 <br><br> (機能) <br> This app has useful features.
このアプリには便利な機能があります。 <br><br> (機能)	<b>このアプリにはべんりなきのうがあります。</b> <br> This app has useful features. <br> [sound:4c-s-このアプリには便利な機能があります。.mp3]
This app has useful features.	<b>このアプリには便利な機能があります。</b> <br> このアプリにはべんりなきのうがあります。 <br><br> (機能) <br> [sound:4c-s-このアプリには便利な機能があります。.mp3]
[sound:4c-k-機会.mp3]	<b>機会</b> <br> きかい <br> chance, opportunity
機会	<b>きかい</b> <br> chance, opportunity <br> [sound:4c-k-機会.mp3]
chance, opportunity	<b>機会</b> <br> きかい <br> [sound:4c-k-機会.mp3]
[sound:4c-s-彼と話す機会がありました。.mp3]	<b>彼と話す機会がありました。</b> <br> かれとはなすきかいがありました。 <br><br> (機会) <br> I had the opportunity to talk with him.
彼と話す機会がありました。 <br><br> (機会)	<b>かれとはなすきかいがありました。</b> <br> I had the opportunity to talk with him. <br> [sound:4c-s-彼と話す機会がありました。.mp3]
I had the opportunity to talk with him.	<b>彼と話す機会がありました。</b> <br> かれとはなすきかいがありました。 <br><br> (機会) <br> [sound:4c-s-彼と話す機会がありました。.mp3]
[sound:4c-k-機械.mp3]	<b>機械</b> <br> きかい <br> machine, mechanism; instrument, appliance, apparatus
機械	<b>きかい</b> <br> machine, mechanism; instrument, appliance, apparatus <br> [sound:4c-k-機械.mp3]
machine, mechanism; instrument, appliance, apparatus	<b>機械</b> <br> きかい <br> [sound:4c-k-機械.mp3]
[sound:4c-s-新しい機械が導入されました。.mp3]	<b>新しい機械が導入されました。</b> <br> あたらしいきかいがどうにゅうされました。 <br><br> (機械) <br> A new machine was introduced.
新しい機械が導入されました。 <br><br> (機械)	<b>あたらしいきかいがどうにゅうされました。</b> <br> A new machine was introduced. <br> [sound:4c-s-新しい機械が導入されました。.mp3]
A new machine was introduced.	<b>新しい機械が導入されました。</b> <br> あたらしいきかいがどうにゅうされました。 <br><br> (機械) <br> [sound:4c-s-新しい機械が導入されました。.mp3]
[sound:4c-k-機器.mp3]	<b>機器</b> <br> きき <br> machinery and tools
機器	<b>きき</b> <br> machinery and tools <br> [sound:4c-k-機器.mp3]
machinery and tools	<b>機器</b> <br> きき <br> [sound:4c-k-機器.mp3]
[sound:4c-s-この機器の使い方を教えてください。.mp3]	<b>この機器の使い方を教えてください。</b> <br> このききのつかいかたをおしえてください。 <br><br> (機器) <br> Please explain how to use this equipment.
この機器の使い方を教えてください。 <br><br> (機器)	<b>このききのつかいかたをおしえてください。</b> <br> Please explain how to use this equipment. <br> [sound:4c-s-この機器の使い方を教えてください。.mp3]
Please explain how to use this equipment.	<b>この機器の使い方を教えてください。</b> <br> このききのつかいかたをおしえてください。 <br><br> (機器) <br> [sound:4c-s-この機器の使い方を教えてください。.mp3]
[sound:4c-k-太平洋.mp3]	<b>太平洋</b> <br> たいへいよう <br> Pacific Ocean
太平洋	<b>たいへいよう</b> <br> Pacific Ocean <br> [sound:4c-k-太平洋.mp3]
Pacific Ocean	<b>太平洋</b> <br> たいへいよう <br> [sound:4c-k-太平洋.mp3]
[sound:4c-s-太平洋を航海しました。.mp3]	<b>太平洋を航海しました。</b> <br> たいへいようをこうかいしました。 <br><br> (太平洋) <br> I sailed across the Pacific Ocean.
太平洋を航海しました。 <br><br> (太平洋)	<b>たいへいようをこうかいしました。</b> <br> I sailed across the Pacific Ocean. <br> [sound:4c-s-太平洋を航海しました。.mp3]
I sailed across the Pacific Ocean.	<b>太平洋を航海しました。</b> <br> たいへいようをこうかいしました。 <br><br> (太平洋) <br> [sound:4c-s-太平洋を航海しました。.mp3]
[sound:4c-k-平成.mp3]	<b>平成</b> <br> へいせい <br> Heisei era (1989.1.8- )
平成	<b>へいせい</b> <br> Heisei era (1989.1.8- ) <br> [sound:4c-k-平成.mp3]
Heisei era (1989.1.8- )	<b>平成</b> <br> へいせい <br> [sound:4c-k-平成.mp3]
[sound:4c-s-平成時代に多くの技術が進歩しました。.mp3]	<b>平成時代に多くの技術が進歩しました。</b> <br> へいせいじだいにおおくのぎじゅつがしんぽしました。 <br><br> (平成) <br> Many technologies advanced during the Heisei era.
平成時代に多くの技術が進歩しました。 <br><br> (平成)	<b>へいせいじだいにおおくのぎじゅつがしんぽしました。</b> <br> Many technologies advanced during the Heisei era. <br> [sound:4c-s-平成時代に多くの技術が進歩しました。.mp3]
Many technologies advanced during the Heisei era.	<b>平成時代に多くの技術が進歩しました。</b> <br> へいせいじだいにおおくのぎじゅつがしんぽしました。 <br><br> (平成) <br> [sound:4c-s-平成時代に多くの技術が進歩しました。.mp3]
[sound:4c-k-平壌.mp3]	<b>平壌</b> <br> へいじょう <br> Pyongyang
平壌	<b>へいじょう</b> <br> Pyongyang <br> [sound:4c-k-平壌.mp3]
Pyongyang	<b>平壌</b> <br> へいじょう <br> [sound:4c-k-平壌.mp3]
[sound:4c-s-平壌で国際会議が開催されました。.mp3]	<b>平壌で国際会議が開催されました。</b> <br> ぴょんやんでこくさいかいぎがかいさいされました。 <br><br> (平壌) <br> An international conference was held in Pyongyang.
平壌で国際会議が開催されました。 <br><br> (平壌)	<b>ぴょんやんでこくさいかいぎがかいさいされました。</b> <br> An international conference was held in Pyongyang. <br> [sound:4c-s-平壌で国際会議が開催されました。.mp3]
An international conference was held in Pyongyang.	<b>平壌で国際会議が開催されました。</b> <br> ぴょんやんでこくさいかいぎがかいさいされました。 <br><br> (平壌) <br> [sound:4c-s-平壌で国際会議が開催されました。.mp3]
[sound:4c-k-平等.mp3]	<b>平等</b> <br> びょうどう <br> equality, impartiality, evenness
平等	<b>びょうどう</b> <br> equality, impartiality, evenness <br> [sound:4c-k-平等.mp3]
equality, impartiality, evenness	<b>平等</b> <br> びょうどう <br> [sound:4c-k-平等.mp3]
[sound:4c-s-全ての人に平等な機会が与えられるべきです。.mp3]	<b>全ての人に平等な機会が与えられるべきです。</b> <br> すべてのひとにびょうどうなきかいがあたえられるべきです。 <br><br> (平等) <br> Everyone should be given equal opportunities.
全ての人に平等な機会が与えられるべきです。 <br><br> (平等)	<b>すべてのひとにびょうどうなきかいがあたえられるべきです。</b> <br> Everyone should be given equal opportunities. <br> [sound:4c-s-全ての人に平等な機会が与えられるべきです。.mp3]
Everyone should be given equal opportunities.	<b>全ての人に平等な機会が与えられるべきです。</b> <br> すべてのひとにびょうどうなきかいがあたえられるべきです。 <br><br> (平等) <br> [sound:4c-s-全ての人に平等な機会が与えられるべきです。.mp3]
[sound:4c-k-総合.mp3]	<b>総合</b> <br> そうごう <br> synthesis, coordination, putting together, integration, composite; comprehensive
総合	<b>そうごう</b> <br> synthesis, coordination, putting together, integration, composite; comprehensive <br> [sound:4c-k-総合.mp3]
synthesis, coordination, putting together, integration, composite; comprehensive	<b>総合</b> <br> そうごう <br> [sound:4c-k-総合.mp3]
[sound:4c-s-総合的な計画を策定しました。.mp3]	<b>総合的な計画を策定しました。</b> <br> そうごうてきなけいかくをさくていしました。 <br><br> (総合) <br> I developed a comprehensive plan.
総合的な計画を策定しました。 <br><br> (総合)	<b>そうごうてきなけいかくをさくていしました。</b> <br> I developed a comprehensive plan. <br> [sound:4c-s-総合的な計画を策定しました。.mp3]
I developed a comprehensive plan.	<b>総合的な計画を策定しました。</b> <br> そうごうてきなけいかくをさくていしました。 <br><br> (総合) <br> [sound:4c-s-総合的な計画を策定しました。.mp3]
[sound:4c-k-総額.mp3]	<b>総額</b> <br> そうがく <br> sum total, total amount
総額	<b>そうがく</b> <br> sum total, total amount <br> [sound:4c-k-総額.mp3]
sum total, total amount	<b>総額</b> <br> そうがく <br> [sound:4c-k-総額.mp3]
[sound:4c-s-総額を計算してください。.mp3]	<b>総額を計算してください。</b> <br> そうがくをけいさんしてください。 <br><br> (総額) <br> Please calculate the total amount.
総額を計算してください。 <br><br> (総額)	<b>そうがくをけいさんしてください。</b> <br> Please calculate the total amount. <br> [sound:4c-s-総額を計算してください。.mp3]
Please calculate the total amount.	<b>総額を計算してください。</b> <br> そうがくをけいさんしてください。 <br><br> (総額) <br> [sound:4c-s-総額を計算してください。.mp3]
[sound:4c-k-総長.mp3]	<b>総長</b> <br> そうちょう <br> (college) president, secretary-general
総長	<b>そうちょう</b> <br> (college) president, secretary-general <br> [sound:4c-k-総長.mp3]
(college) president, secretary-general	<b>総長</b> <br> そうちょう <br> [sound:4c-k-総長.mp3]
[sound:4c-s-総長が声明を発表しました。.mp3]	<b>総長が声明を発表しました。</b> <br> そうちょうがせいめいをはっぴょうしました。 <br><br> (総長) <br> The Secretary-General issued a statement.
総長が声明を発表しました。 <br><br> (総長)	<b>そうちょうがせいめいをはっぴょうしました。</b> <br> The Secretary-General issued a statement. <br> [sound:4c-s-総長が声明を発表しました。.mp3]
The Secretary-General issued a statement.	<b>総長が声明を発表しました。</b> <br> そうちょうがせいめいをはっぴょうしました。 <br><br> (総長) <br> [sound:4c-s-総長が声明を発表しました。.mp3]
[sound:4c-k-総務.mp3]	<b>総務</b> <br> そうむ <br> general business (affairs), manager, director, adjutant general (mil)
総務	<b>そうむ</b> <br> general business (affairs), manager, director, adjutant general (mil) <br> [sound:4c-k-総務.mp3]
general business (affairs), manager, director, adjutant general (mil)	<b>総務</b> <br> そうむ <br> [sound:4c-k-総務.mp3]
[sound:4c-s-総務部が新しい規則を発表しました。.mp3]	<b>総務部が新しい規則を発表しました。</b> <br> そうむぶがあたらしいきそくをはっぴょうしました。 <br><br> (総務) <br> The general affairs department announced a new regulation.
総務部が新しい規則を発表しました。 <br><br> (総務)	<b>そうむぶがあたらしいきそくをはっぴょうしました。</b> <br> The general affairs department announced a new regulation. <br> [sound:4c-s-総務部が新しい規則を発表しました。.mp3]
The general affairs department announced a new regulation.	<b>総務部が新しい規則を発表しました。</b> <br> そうむぶがあたらしいきそくをはっぴょうしました。 <br><br> (総務) <br> [sound:4c-s-総務部が新しい規則を発表しました。.mp3]
[sound:4c-k-増加.mp3]	<b>増加</b> <br> ぞうか <br> increase, increment, addition
増加	<b>ぞうか</b> <br> increase, increment, addition <br> [sound:4c-k-増加.mp3]
increase, increment, addition	<b>増加</b> <br> ぞうか <br> [sound:4c-k-増加.mp3]
[sound:4c-s-人口が増加しています。.mp3]	<b>人口が増加しています。</b> <br> じんこうがぞうかしています。 <br><br> (増加) <br> The population is increasing.
人口が増加しています。 <br><br> (増加)	<b>じんこうがぞうかしています。</b> <br> The population is increasing. <br> [sound:4c-s-人口が増加しています。.mp3]
The population is increasing.	<b>人口が増加しています。</b> <br> じんこうがぞうかしています。 <br><br> (増加) <br> [sound:4c-s-人口が増加しています。.mp3]
[sound:4c-k-参加者.mp3]	<b>参加者</b> <br> さんかしゃ <br> participant, entrant
参加者	<b>さんかしゃ</b> <br> participant, entrant <br> [sound:4c-k-参加者.mp3]
participant, entrant	<b>参加者</b> <br> さんかしゃ <br> [sound:4c-k-参加者.mp3]
[sound:4c-s-イベントの参加者は500人です。.mp3]	<b>イベントの参加者は500人です。</b> <br> イベントのさんかしゃはごひゃくにんです。 <br><br> (参加者) <br> The event has 500 participants.
イベントの参加者は500人です。 <br><br> (参加者)	<b>イベントのさんかしゃはごひゃくにんです。</b> <br> The event has 500 participants. <br> [sound:4c-s-イベントの参加者は500人です。.mp3]
The event has 500 participants.	<b>イベントの参加者は500人です。</b> <br> イベントのさんかしゃはごひゃくにんです。 <br><br> (参加者) <br> [sound:4c-s-イベントの参加者は500人です。.mp3]
[sound:4c-k-追加.mp3]	<b>追加</b> <br> ついか <br> addition, supplement, append (e.g. to a file), appendix
追加	<b>ついか</b> <br> addition, supplement, append (e.g. to a file), appendix <br> [sound:4c-k-追加.mp3]
addition, supplement, append (e.g. to a file), appendix	<b>追加</b> <br> ついか <br> [sound:4c-k-追加.mp3]
[sound:4c-s-新しい機能が追加されました。.mp3]	<b>新しい機能が追加されました。</b> <br> あたらしいきのうがついかされました。 <br><br> (追加) <br> A new feature has been added.
新しい機能が追加されました。 <br><br> (追加)	<b>あたらしいきのうがついかされました。</b> <br> A new feature has been added. <br> [sound:4c-s-新しい機能が追加されました。.mp3]
A new feature has been added.	<b>新しい機能が追加されました。</b> <br> あたらしいきのうがついかされました。 <br><br> (追加) <br> [sound:4c-s-新しい機能が追加されました。.mp3]
[sound:4c-k-加入.mp3]	<b>加入</b> <br> かにゅう <br> becoming a member, joining, entry, admission, subscription, affiliation, adherence, signing
加入	<b>かにゅう</b> <br> becoming a member, joining, entry, admission, subscription, affiliation, adherence, signing <br> [sound:4c-k-加入.mp3]
becoming a member, joining, entry, admission, subscription, affiliation, adherence, signing	<b>加入</b> <br> かにゅう <br> [sound:4c-k-加入.mp3]
[sound:4c-s-彼は新しいクラブに加入しました。.mp3]	<b>彼は新しいクラブに加入しました。</b> <br> かれはあたらしいクラブにかにゅうしました。 <br><br> (加入) <br> He joined a new club.
彼は新しいクラブに加入しました。 <br><br> (加入)	<b>かれはあたらしいクラブにかにゅうしました。</b> <br> He joined a new club. <br> [sound:4c-s-彼は新しいクラブに加入しました。.mp3]
He joined a new club.	<b>彼は新しいクラブに加入しました。</b> <br> かれはあたらしいクラブにかにゅうしました。 <br><br> (加入) <br> [sound:4c-s-彼は新しいクラブに加入しました。.mp3]
[sound:4c-k-山形.mp3]	<b>山形</b> <br> やまがた <br> mountain-shaped
山形	<b>やまがた</b> <br> mountain-shaped <br> [sound:4c-k-山形.mp3]
mountain-shaped	<b>山形</b> <br> やまがた <br> [sound:4c-k-山形.mp3]
[sound:4c-s-山形県は美しい自然があります。.mp3]	<b>山形県は美しい自然があります。</b> <br> やまがたけんはうつくしいしぜんがあります。 <br><br> (山形) <br> Yamagata Prefecture has beautiful nature.
山形県は美しい自然があります。 <br><br> (山形)	<b>やまがたけんはうつくしいしぜんがあります。</b> <br> Yamagata Prefecture has beautiful nature. <br> [sound:4c-s-山形県は美しい自然があります。.mp3]
Yamagata Prefecture has beautiful nature.	<b>山形県は美しい自然があります。</b> <br> やまがたけんはうつくしいしぜんがあります。 <br><br> (山形) <br> [sound:4c-s-山形県は美しい自然があります。.mp3]
[sound:4c-k-登山.mp3]	<b>登山</b> <br> とざん <br> mountain climbing
登山	<b>とざん</b> <br> mountain climbing <br> [sound:4c-k-登山.mp3]
mountain climbing	<b>登山</b> <br> とざん <br> [sound:4c-k-登山.mp3]
[sound:4c-s-週末に登山を楽しみました。.mp3]	<b>週末に登山を楽しみました。</b> <br> しゅうまつにとざんをたのしみました。 <br><br> (登山) <br> I enjoyed mountain climbing over the weekend.
週末に登山を楽しみました。 <br><br> (登山)	<b>しゅうまつにとざんをたのしみました。</b> <br> I enjoyed mountain climbing over the weekend. <br> [sound:4c-s-週末に登山を楽しみました。.mp3]
I enjoyed mountain climbing over the weekend.	<b>週末に登山を楽しみました。</b> <br> しゅうまつにとざんをたのしみました。 <br><br> (登山) <br> [sound:4c-s-週末に登山を楽しみました。.mp3]
[sound:4c-k-山岳.mp3]	<b>山岳</b> <br> さんがく <br> mountains
山岳	<b>さんがく</b> <br> mountains <br> [sound:4c-k-山岳.mp3]
mountains	<b>山岳</b> <br> さんがく <br> [sound:4c-k-山岳.mp3]
[sound:4c-s-山岳地帯の天気は変わりやすいです。.mp3]	<b>山岳地帯の天気は変わりやすいです。</b> <br> さんがくちたいのてんきはかわりやすいです。 <br><br> (山岳) <br> The weather in mountainous areas is unpredictable.
山岳地帯の天気は変わりやすいです。 <br><br> (山岳)	<b>さんがくちたいのてんきはかわりやすいです。</b> <br> The weather in mountainous areas is unpredictable. <br> [sound:4c-s-山岳地帯の天気は変わりやすいです。.mp3]
The weather in mountainous areas is unpredictable.	<b>山岳地帯の天気は変わりやすいです。</b> <br> さんがくちたいのてんきはかわりやすいです。 <br><br> (山岳) <br> [sound:4c-s-山岳地帯の天気は変わりやすいです。.mp3]
[sound:4c-k-小山.mp3]	<b>小山</b> <br> こやま <br> hill, knoll
小山	<b>こやま</b> <br> hill, knoll <br> [sound:4c-k-小山.mp3]
hill, knoll	<b>小山</b> <br> こやま <br> [sound:4c-k-小山.mp3]
[sound:4c-s-小山の上から景色を楽しみました。.mp3]	<b>小山の上から景色を楽しみました。</b> <br> こやまのうえからけしきをたのしみました。 <br><br> (小山) <br> I enjoyed the scenery from the top of a small hill.
小山の上から景色を楽しみました。 <br><br> (小山)	<b>こやまのうえからけしきをたのしみました。</b> <br> I enjoyed the scenery from the top of a small hill. <br> [sound:4c-s-小山の上から景色を楽しみました。.mp3]
I enjoyed the scenery from the top of a small hill.	<b>小山の上から景色を楽しみました。</b> <br> こやまのうえからけしきをたのしみました。 <br><br> (小山) <br> [sound:4c-s-小山の上から景色を楽しみました。.mp3]
[sound:4c-k-意思.mp3]	<b>意思</b> <br> いし <br> intention, purpose
意思	<b>いし</b> <br> intention, purpose <br> [sound:4c-k-意思.mp3]
intention, purpose	<b>意思</b> <br> いし <br> [sound:4c-k-意思.mp3]
[sound:4c-s-彼の意思を尊重します。.mp3]	<b>彼の意思を尊重します。</b> <br> かれのいしをそんちょうします。 <br><br> (意思) <br> I respect his wishes.
彼の意思を尊重します。 <br><br> (意思)	<b>かれのいしをそんちょうします。</b> <br> I respect his wishes. <br> [sound:4c-s-彼の意思を尊重します。.mp3]
I respect his wishes.	<b>彼の意思を尊重します。</b> <br> かれのいしをそんちょうします。 <br><br> (意思) <br> [sound:4c-s-彼の意思を尊重します。.mp3]
[sound:4c-k-思想.mp3]	<b>思想</b> <br> しそう <br> thought, idea, ideology
思想	<b>しそう</b> <br> thought, idea, ideology <br> [sound:4c-k-思想.mp3]
thought, idea, ideology	<b>思想</b> <br> しそう <br> [sound:4c-k-思想.mp3]
[sound:4c-s-彼の思想はとても興味深いです。.mp3]	<b>彼の思想はとても興味深いです。</b> <br> かれのしそうはとてもきょうみぶかいです。 <br><br> (思想) <br> His ideology is very interesting.
彼の思想はとても興味深いです。 <br><br> (思想)	<b>かれのしそうはとてもきょうみぶかいです。</b> <br> His ideology is very interesting. <br> [sound:4c-s-彼の思想はとても興味深いです。.mp3]
His ideology is very interesting.	<b>彼の思想はとても興味深いです。</b> <br> かれのしそうはとてもきょうみぶかいです。 <br><br> (思想) <br> [sound:4c-s-彼の思想はとても興味深いです。.mp3]
[sound:4c-k-思惑.mp3]	<b>思惑</b> <br> おもわく <br> expectation, prediction, forecast; anticipation, speculation
思惑	<b>おもわく</b> <br> expectation, prediction, forecast; anticipation, speculation <br> [sound:4c-k-思惑.mp3]
expectation, prediction, forecast; anticipation, speculation	<b>思惑</b> <br> おもわく <br> [sound:4c-k-思惑.mp3]
[sound:4c-s-彼の思惑が明らかになりました。.mp3]	<b>彼の思惑が明らかになりました。</b> <br> かれのおもわくがあきらかになりました。 <br><br> (思惑) <br> His intentions became clear.
彼の思惑が明らかになりました。 <br><br> (思惑)	<b>かれのおもわくがあきらかになりました。</b> <br> His intentions became clear. <br> [sound:4c-s-彼の思惑が明らかになりました。.mp3]
His intentions became clear.	<b>彼の思惑が明らかになりました。</b> <br> かれのおもわくがあきらかになりました。 <br><br> (思惑) <br> [sound:4c-s-彼の思惑が明らかになりました。.mp3]
[sound:4c-k-思い切って.mp3]	<b>思い切って</b> <br> おもいきって <br> resolutely, boldly, daringly
思い切って	<b>おもいきって</b> <br> resolutely, boldly, daringly <br> [sound:4c-k-思い切って.mp3]
resolutely, boldly, daringly	<b>思い切って</b> <br> おもいきって <br> [sound:4c-k-思い切って.mp3]
[sound:4c-s-思い切って新しいことに挑戦しました。.mp3]	<b>思い切って新しいことに挑戦しました。</b> <br> おもいきってあたらしいことにちょうせんしました。 <br><br> (思い切って) <br> I boldly challenged myself with something new.
思い切って新しいことに挑戦しました。 <br><br> (思い切って)	<b>おもいきってあたらしいことにちょうせんしました。</b> <br> I boldly challenged myself with something new. <br> [sound:4c-s-思い切って新しいことに挑戦しました。.mp3]
I boldly challenged myself with something new.	<b>思い切って新しいことに挑戦しました。</b> <br> おもいきってあたらしいことにちょうせんしました。 <br><br> (思い切って) <br> [sound:4c-s-思い切って新しいことに挑戦しました。.mp3]
[sound:4c-k-政治家.mp3]	<b>政治家</b> <br> せいじか <br> politician, statesman
政治家	<b>せいじか</b> <br> politician, statesman <br> [sound:4c-k-政治家.mp3]
politician, statesman	<b>政治家</b> <br> せいじか <br> [sound:4c-k-政治家.mp3]
[sound:4c-s-政治家が演説を行いました。.mp3]	<b>政治家が演説を行いました。</b> <br> せいじかがえんぜつをおこないました。 <br><br> (政治家) <br> The politician gave a speech.
政治家が演説を行いました。 <br><br> (政治家)	<b>せいじかがえんぜつをおこないました。</b> <br> The politician gave a speech. <br> [sound:4c-s-政治家が演説を行いました。.mp3]
The politician gave a speech.	<b>政治家が演説を行いました。</b> <br> せいじかがえんぜつをおこないました。 <br><br> (政治家) <br> [sound:4c-s-政治家が演説を行いました。.mp3]
[sound:4c-k-作家.mp3]	<b>作家</b> <br> さっか <br> author, writer, novelist, artist
作家	<b>さっか</b> <br> author, writer, novelist, artist <br> [sound:4c-k-作家.mp3]
author, writer, novelist, artist	<b>作家</b> <br> さっか <br> [sound:4c-k-作家.mp3]
[sound:4c-s-彼は有名な作家です。.mp3]	<b>彼は有名な作家です。</b> <br> かれはゆうめいなさっかです。 <br><br> (作家) <br> He is a famous writer.
彼は有名な作家です。 <br><br> (作家)	<b>かれはゆうめいなさっかです。</b> <br> He is a famous writer. <br> [sound:4c-s-彼は有名な作家です。.mp3]
He is a famous writer.	<b>彼は有名な作家です。</b> <br> かれはゆうめいなさっかです。 <br><br> (作家) <br> [sound:4c-s-彼は有名な作家です。.mp3]
[sound:4c-k-専門家.mp3]	<b>専門家</b> <br> せんもんか <br> specialist
専門家	<b>せんもんか</b> <br> specialist <br> [sound:4c-k-専門家.mp3]
specialist	<b>専門家</b> <br> せんもんか <br> [sound:4c-k-専門家.mp3]
[sound:4c-s-専門家が意見を述べました。.mp3]	<b>専門家が意見を述べました。</b> <br> せんもんかがいけんをのべました。 <br><br> (専門家) <br> An expert gave their opinion.
専門家が意見を述べました。 <br><br> (専門家)	<b>せんもんかがいけんをのべました。</b> <br> An expert gave their opinion. <br> [sound:4c-s-専門家が意見を述べました。.mp3]
An expert gave their opinion.	<b>専門家が意見を述べました。</b> <br> せんもんかがいけんをのべました。 <br><br> (専門家) <br> [sound:4c-s-専門家が意見を述べました。.mp3]
[sound:4c-k-農家.mp3]	<b>農家</b> <br> のうか <br> farmer, farm family
農家	<b>のうか</b> <br> farmer, farm family <br> [sound:4c-k-農家.mp3]
farmer, farm family	<b>農家</b> <br> のうか <br> [sound:4c-k-農家.mp3]
[sound:4c-s-農家が新しい農法を導入しました。.mp3]	<b>農家が新しい農法を導入しました。</b> <br> のうかがあたらしいのうほうをどうにゅうしました。 <br><br> (農家) <br> A farmer introduced a new farming method.
農家が新しい農法を導入しました。 <br><br> (農家)	<b>のうかがあたらしいのうほうをどうにゅうしました。</b> <br> A farmer introduced a new farming method. <br> [sound:4c-s-農家が新しい農法を導入しました。.mp3]
A farmer introduced a new farming method.	<b>農家が新しい農法を導入しました。</b> <br> のうかがあたらしいのうほうをどうにゅうしました。 <br><br> (農家) <br> [sound:4c-s-農家が新しい農法を導入しました。.mp3]
[sound:4c-k-話題.mp3]	<b>話題</b> <br> わだい <br> topic, subject
話題	<b>わだい</b> <br> topic, subject <br> [sound:4c-k-話題.mp3]
topic, subject	<b>話題</b> <br> わだい <br> [sound:4c-k-話題.mp3]
[sound:4c-s-この映画は話題になっています。.mp3]	<b>この映画は話題になっています。</b> <br> このえいがはわだいになっています。 <br><br> (話題) <br> This movie is trending.
この映画は話題になっています。 <br><br> (話題)	<b>このえいがはわだいになっています。</b> <br> This movie is trending. <br> [sound:4c-s-この映画は話題になっています。.mp3]
This movie is trending.	<b>この映画は話題になっています。</b> <br> このえいがはわだいになっています。 <br><br> (話題) <br> [sound:4c-s-この映画は話題になっています。.mp3]
[sound:4c-k-話し合い.mp3]	<b>話し合い</b> <br> はなしあい <br> discussion, conference
話し合い	<b>はなしあい</b> <br> discussion, conference <br> [sound:4c-k-話し合い.mp3]
discussion, conference	<b>話し合い</b> <br> はなしあい <br> [sound:4c-k-話し合い.mp3]
[sound:4c-s-問題について話し合いをしました。.mp3]	<b>問題について話し合いをしました。</b> <br> もんだいについてはなしあいをしました。 <br><br> (話し合い) <br> We had a discussion about the issue.
問題について話し合いをしました。 <br><br> (話し合い)	<b>もんだいについてはなしあいをしました。</b> <br> We had a discussion about the issue. <br> [sound:4c-s-問題について話し合いをしました。.mp3]
We had a discussion about the issue.	<b>問題について話し合いをしました。</b> <br> もんだいについてはなしあいをしました。 <br><br> (話し合い) <br> [sound:4c-s-問題について話し合いをしました。.mp3]
[sound:4c-k-会話.mp3]	<b>会話</b> <br> かいわ <br> conversation
会話	<b>かいわ</b> <br> conversation <br> [sound:4c-k-会話.mp3]
conversation	<b>会話</b> <br> かいわ <br> [sound:4c-k-会話.mp3]
[sound:4c-s-彼と日本語で会話をしました。.mp3]	<b>彼と日本語で会話をしました。</b> <br> かれとにほんごでかいわをしました。 <br><br> (会話) <br> I had a conversation with him in Japanese.
彼と日本語で会話をしました。 <br><br> (会話)	<b>かれとにほんごでかいわをしました。</b> <br> I had a conversation with him in Japanese. <br> [sound:4c-s-彼と日本語で会話をしました。.mp3]
I had a conversation with him in Japanese.	<b>彼と日本語で会話をしました。</b> <br> かれとにほんごでかいわをしました。 <br><br> (会話) <br> [sound:4c-s-彼と日本語で会話をしました。.mp3]
[sound:4c-k-世話.mp3]	<b>世話</b> <br> せわ <br> looking after, help, aid, assistance
世話	<b>せわ</b> <br> looking after, help, aid, assistance <br> [sound:4c-k-世話.mp3]
looking after, help, aid, assistance	<b>世話</b> <br> せわ <br> [sound:4c-k-世話.mp3]
[sound:4c-s-彼は子供たちの世話をしています。.mp3]	<b>彼は子供たちの世話をしています。</b> <br> かれはこどもたちのせわをしています。 <br><br> (世話) <br> He is taking care of the children.
彼は子供たちの世話をしています。 <br><br> (世話)	<b>かれはこどもたちのせわをしています。</b> <br> He is taking care of the children. <br> [sound:4c-s-彼は子供たちの世話をしています。.mp3]
He is taking care of the children.	<b>彼は子供たちの世話をしています。</b> <br> かれはこどもたちのせわをしています。 <br><br> (世話) <br> [sound:4c-s-彼は子供たちの世話をしています。.mp3]
[sound:4c-k-世論.mp3]	<b>世論</b> <br> せろん, よろん <br> public opinion
世論	<b>せろん, よろん</b> <br> public opinion <br> [sound:4c-k-世論.mp3]
public opinion	<b>世論</b> <br> せろん, よろん <br> [sound:4c-k-世論.mp3]
[sound:4c-s-世論は政府の政策に影響を与えます。.mp3]	<b>世論は政府の政策に影響を与えます。</b> <br> よろんはせいふのせいさくにえいきょうをあたえます。 <br><br> (世論) <br> Public opinion affects government policy.
世論は政府の政策に影響を与えます。 <br><br> (世論)	<b>よろんはせいふのせいさくにえいきょうをあたえます。</b> <br> Public opinion affects government policy. <br> [sound:4c-s-世論は政府の政策に影響を与えます。.mp3]
Public opinion affects government policy.	<b>世論は政府の政策に影響を与えます。</b> <br> よろんはせいふのせいさくにえいきょうをあたえます。 <br><br> (世論) <br> [sound:4c-s-世論は政府の政策に影響を与えます。.mp3]
[sound:4c-k-世界的.mp3]	<b>世界的</b> <br> せかいてき <br> global, international, world-famous
世界的	<b>せかいてき</b> <br> global, international, world-famous <br> [sound:4c-k-世界的.mp3]
global, international, world-famous	<b>世界的</b> <br> せかいてき <br> [sound:4c-k-世界的.mp3]
[sound:4c-s-彼の研究は世界的に評価されています。.mp3]	<b>彼の研究は世界的に評価されています。</b> <br> かれのけんきゅうはせかいてきにひょうかされています。 <br><br> (世界的) <br> His research is recognized worldwide.
彼の研究は世界的に評価されています。 <br><br> (世界的)	<b>かれのけんきゅうはせかいてきにひょうかされています。</b> <br> His research is recognized worldwide. <br> [sound:4c-s-彼の研究は世界的に評価されています。.mp3]
His research is recognized worldwide.	<b>彼の研究は世界的に評価されています。</b> <br> かれのけんきゅうはせかいてきにひょうかされています。 <br><br> (世界的) <br> [sound:4c-s-彼の研究は世界的に評価されています。.mp3]
[sound:4c-k-世紀.mp3]	<b>世紀</b> <br> せいき <br> century, era
世紀	<b>せいき</b> <br> century, era <br> [sound:4c-k-世紀.mp3]
century, era	<b>世紀</b> <br> せいき <br> [sound:4c-k-世紀.mp3]
[sound:4c-s-21世紀の技術は急速に進歩しています。.mp3]	<b>21世紀の技術は急速に進歩しています。</b> <br> にじゅういっせいきのぎじゅつはきゅうそくにしんぽしています。 <br><br> (世紀) <br> The technology of the 21st century is advancing rapidly.
21世紀の技術は急速に進歩しています。 <br><br> (世紀)	<b>にじゅういっせいきのぎじゅつはきゅうそくにしんぽしています。</b> <br> The technology of the 21st century is advancing rapidly. <br> [sound:4c-s-21世紀の技術は急速に進歩しています。.mp3]
The technology of the 21st century is advancing rapidly.	<b>21世紀の技術は急速に進歩しています。</b> <br> にじゅういっせいきのぎじゅつはきゅうそくにしんぽしています。 <br><br> (世紀) <br> [sound:4c-s-21世紀の技術は急速に進歩しています。.mp3]
[sound:4c-k-世帯.mp3]	<b>世帯</b> <br> せたい, しょたい <br> household, home, family, housekeeping
世帯	<b>せたい, しょたい</b> <br> household, home, family, housekeeping <br> [sound:4c-k-世帯.mp3]
household, home, family, housekeeping	<b>世帯</b> <br> せたい, しょたい <br> [sound:4c-k-世帯.mp3]
[sound:4c-s-日本では小さい世帯が増えています。.mp3]	<b>日本では小さい世帯が増えています。</b> <br> にほんではちいさいせたいがふえています。 <br><br> (世帯) <br> Small households are increasing in Japan.
日本では小さい世帯が増えています。 <br><br> (世帯)	<b>にほんではちいさいせたいがふえています。</b> <br> Small households are increasing in Japan. <br> [sound:4c-s-日本では小さい世帯が増えています。.mp3]
Small households are increasing in Japan.	<b>日本では小さい世帯が増えています。</b> <br> にほんではちいさいせたいがふえています。 <br><br> (世帯) <br> [sound:4c-s-日本では小さい世帯が増えています。.mp3]
[sound:4c-k-受賞.mp3]	<b>受賞</b> <br> じゅしょう <br> winning (a prize)
受賞	<b>じゅしょう</b> <br> winning (a prize) <br> [sound:4c-k-受賞.mp3]
winning (a prize)	<b>受賞</b> <br> じゅしょう <br> [sound:4c-k-受賞.mp3]
[sound:4c-s-彼は文学賞を受賞しました。.mp3]	<b>彼は文学賞を受賞しました。</b> <br> かれはぶんがくしょうをじゅしょうしました。 <br><br> (受賞) <br> He received a literary award.
彼は文学賞を受賞しました。 <br><br> (受賞)	<b>かれはぶんがくしょうをじゅしょうしました。</b> <br> He received a literary award. <br> [sound:4c-s-彼は文学賞を受賞しました。.mp3]
He received a literary award.	<b>彼は文学賞を受賞しました。</b> <br> かれはぶんがくしょうをじゅしょうしました。 <br><br> (受賞) <br> [sound:4c-s-彼は文学賞を受賞しました。.mp3]
[sound:4c-k-受注.mp3]	<b>受注</b> <br> じゅちゅう <br> accepting orders
受注	<b>じゅちゅう</b> <br> accepting orders <br> [sound:4c-k-受注.mp3]
accepting orders	<b>受注</b> <br> じゅちゅう <br> [sound:4c-k-受注.mp3]
[sound:4c-s-この会社は多くの注文を受注しています。.mp3]	<b>この会社は多くの注文を受注しています。</b> <br> このかいしゃはおおくのちゅうもんをじゅちゅうしています。 <br><br> (受注) <br> This company receives many orders.
この会社は多くの注文を受注しています。 <br><br> (受注)	<b>このかいしゃはおおくのちゅうもんをじゅちゅうしています。</b> <br> This company receives many orders. <br> [sound:4c-s-この会社は多くの注文を受注しています。.mp3]
This company receives many orders.	<b>この会社は多くの注文を受注しています。</b> <br> このかいしゃはおおくのちゅうもんをじゅちゅうしています。 <br><br> (受注) <br> [sound:4c-s-この会社は多くの注文を受注しています。.mp3]
[sound:4c-k-受け止める.mp3]	<b>受け止める</b> <br> うけとめる <br> to catch, to stop the blow, to react to, to take
受け止める	<b>うけとめる</b> <br> to catch, to stop the blow, to react to, to take <br> [sound:4c-k-受け止める.mp3]
to catch, to stop the blow, to react to, to take	<b>受け止める</b> <br> うけとめる <br> [sound:4c-k-受け止める.mp3]
[sound:4c-s-彼の言葉を真剣に受け止めました。.mp3]	<b>彼の言葉を真剣に受け止めました。</b> <br> かれのことばをしんけんにうけとめました。 <br><br> (受け止める) <br> I took his words seriously.
彼の言葉を真剣に受け止めました。 <br><br> (受け止める)	<b>かれのことばをしんけんにうけとめました。</b> <br> I took his words seriously. <br> [sound:4c-s-彼の言葉を真剣に受け止めました。.mp3]
I took his words seriously.	<b>彼の言葉を真剣に受け止めました。</b> <br> かれのことばをしんけんにうけとめました。 <br><br> (受け止める) <br> [sound:4c-s-彼の言葉を真剣に受け止めました。.mp3]
[sound:4c-k-受け入れる.mp3]	<b>受け入れる</b> <br> うけいれる <br> to accept, to receive
受け入れる	<b>うけいれる</b> <br> to accept, to receive <br> [sound:4c-k-受け入れる.mp3]
to accept, to receive	<b>受け入れる</b> <br> うけいれる <br> [sound:4c-k-受け入れる.mp3]
[sound:4c-s-新しい環境を受け入れました。.mp3]	<b>新しい環境を受け入れました。</b> <br> あたらしいかんきょうをうけいれました。 <br><br> (受け入れる) <br> I accepted the new environment.
新しい環境を受け入れました。 <br><br> (受け入れる)	<b>あたらしいかんきょうをうけいれました。</b> <br> I accepted the new environment. <br> [sound:4c-s-新しい環境を受け入れました。.mp3]
I accepted the new environment.	<b>新しい環境を受け入れました。</b> <br> あたらしいかんきょうをうけいれました。 <br><br> (受け入れる) <br> [sound:4c-s-新しい環境を受け入れました。.mp3]
[sound:4c-k-区内.mp3]	<b>区内</b> <br> くない <br> in the ward or borough
区内	<b>くない</b> <br> in the ward or borough <br> [sound:4c-k-区内.mp3]
in the ward or borough	<b>区内</b> <br> くない <br> [sound:4c-k-区内.mp3]
[sound:4c-s-区内の公園で遊びました。.mp3]	<b>区内の公園で遊びました。</b> <br> くないのこうえんであそびました。 <br><br> (区内) <br> I played in the park within the district.
区内の公園で遊びました。 <br><br> (区内)	<b>くないのこうえんであそびました。</b> <br> I played in the park within the district. <br> [sound:4c-s-区内の公園で遊びました。.mp3]
I played in the park within the district.	<b>区内の公園で遊びました。</b> <br> くないのこうえんであそびました。 <br><br> (区内) <br> [sound:4c-s-区内の公園で遊びました。.mp3]
[sound:4c-k-区域.mp3]	<b>区域</b> <br> くいき <br> limits, boundary, domain, zone, sphere, territory; area (e.g. in programming languages)
区域	<b>くいき</b> <br> limits, boundary, domain, zone, sphere, territory; area (e.g. in programming languages) <br> [sound:4c-k-区域.mp3]
limits, boundary, domain, zone, sphere, territory; area (e.g. in programming languages)	<b>区域</b> <br> くいき <br> [sound:4c-k-区域.mp3]
[sound:4c-s-この区域には入れません。.mp3]	<b>この区域には入れません。</b> <br> このくいきにははいれません。 <br><br> (区域) <br> You cannot enter this area.
この区域には入れません。 <br><br> (区域)	<b>このくいきにははいれません。</b> <br> You cannot enter this area. <br> [sound:4c-s-この区域には入れません。.mp3]
You cannot enter this area.	<b>この区域には入れません。</b> <br> このくいきにははいれません。 <br><br> (区域) <br> [sound:4c-s-この区域には入れません。.mp3]
[sound:4c-k-区間.mp3]	<b>区間</b> <br> くかん <br> section (of track, etc.), segment, dimension
区間	<b>くかん</b> <br> section (of track, etc.), segment, dimension <br> [sound:4c-k-区間.mp3]
section (of track, etc.), segment, dimension	<b>区間</b> <br> くかん <br> [sound:4c-k-区間.mp3]
[sound:4c-s-この区間は工事中です。.mp3]	<b>この区間は工事中です。</b> <br> このくかんはこうじちゅうです。 <br><br> (区間) <br> This section is under construction.
この区間は工事中です。 <br><br> (区間)	<b>このくかんはこうじちゅうです。</b> <br> This section is under construction. <br> [sound:4c-s-この区間は工事中です。.mp3]
This section is under construction.	<b>この区間は工事中です。</b> <br> このくかんはこうじちゅうです。 <br><br> (区間) <br> [sound:4c-s-この区間は工事中です。.mp3]
[sound:4c-k-区長.mp3]	<b>区長</b> <br> くちょう <br> ward headman
区長	<b>くちょう</b> <br> ward headman <br> [sound:4c-k-区長.mp3]
ward headman	<b>区長</b> <br> くちょう <br> [sound:4c-k-区長.mp3]
[sound:4c-s-区長が新しい政策を発表した。.mp3]	<b>区長が新しい政策を発表した。</b> <br> くちょうがあたらしいせいさくをはっぴょうした。 <br><br> (区長) <br> The district mayor announced a new policy.
区長が新しい政策を発表した。 <br><br> (区長)	<b>くちょうがあたらしいせいさくをはっぴょうした。</b> <br> The district mayor announced a new policy. <br> [sound:4c-s-区長が新しい政策を発表した。.mp3]
The district mayor announced a new policy.	<b>区長が新しい政策を発表した。</b> <br> くちょうがあたらしいせいさくをはっぴょうした。 <br><br> (区長) <br> [sound:4c-s-区長が新しい政策を発表した。.mp3]
[sound:4c-k-領域.mp3]	<b>領域</b> <br> りょういき <br> area, domain, territory, field, range, region, regime
領域	<b>りょういき</b> <br> area, domain, territory, field, range, region, regime <br> [sound:4c-k-領域.mp3]
area, domain, territory, field, range, region, regime	<b>領域</b> <br> りょういき <br> [sound:4c-k-領域.mp3]
[sound:4c-s-科学の領域で働きたい。.mp3]	<b>科学の領域で働きたい。</b> <br> かがくのりょういきではたらきたい。 <br><br> (領域) <br> I want to work in the field of science.
科学の領域で働きたい。 <br><br> (領域)	<b>かがくのりょういきではたらきたい。</b> <br> I want to work in the field of science. <br> [sound:4c-s-科学の領域で働きたい。.mp3]
I want to work in the field of science.	<b>科学の領域で働きたい。</b> <br> かがくのりょういきではたらきたい。 <br><br> (領域) <br> [sound:4c-s-科学の領域で働きたい。.mp3]
[sound:4c-k-綱領.mp3]	<b>綱領</b> <br> こうりょう <br> general plan, main points, summary, platform (e.g. for a campaign), mission statement
綱領	<b>こうりょう</b> <br> general plan, main points, summary, platform (e.g. for a campaign), mission statement <br> [sound:4c-k-綱領.mp3]
general plan, main points, summary, platform (e.g. for a campaign), mission statement	<b>綱領</b> <br> こうりょう <br> [sound:4c-k-綱領.mp3]
[sound:4c-s-党の綱領を説明してください。.mp3]	<b>党の綱領を説明してください。</b> <br> とうのこうりょうをせつめいしてください。 <br><br> (綱領) <br> Please explain the party's platform.
党の綱領を説明してください。 <br><br> (綱領)	<b>とうのこうりょうをせつめいしてください。</b> <br> Please explain the party's platform. <br> [sound:4c-s-党の綱領を説明してください。.mp3]
Please explain the party's platform.	<b>党の綱領を説明してください。</b> <br> とうのこうりょうをせつめいしてください。 <br><br> (綱領) <br> [sound:4c-s-党の綱領を説明してください。.mp3]
[sound:4c-k-領内.mp3]	<b>領内</b> <br> りょうない <br> (within a) territory, domains
領内	<b>りょうない</b> <br> (within a) territory, domains <br> [sound:4c-k-領内.mp3]
(within a) territory, domains	<b>領内</b> <br> りょうない <br> [sound:4c-k-領内.mp3]
[sound:4c-s-領内に入るには許可が必要です。.mp3]	<b>領内に入るには許可が必要です。</b> <br> りょうないにはいるにはきょかがひつようです。 <br><br> (領内) <br> You need permission to enter the territory.
領内に入るには許可が必要です。 <br><br> (領内)	<b>りょうないにはいるにはきょかがひつようです。</b> <br> You need permission to enter the territory. <br> [sound:4c-s-領内に入るには許可が必要です。.mp3]
You need permission to enter the territory.	<b>領内に入るには許可が必要です。</b> <br> りょうないにはいるにはきょかがひつようです。 <br><br> (領内) <br> [sound:4c-s-領内に入るには許可が必要です。.mp3]
[sound:4c-k-領有.mp3]	<b>領有</b> <br> りょうゆう <br> possession
領有	<b>りょうゆう</b> <br> possession <br> [sound:4c-k-領有.mp3]
possession	<b>領有</b> <br> りょうゆう <br> [sound:4c-k-領有.mp3]
[sound:4c-s-国はその島の領有を主張している。.mp3]	<b>国はその島の領有を主張している。</b> <br> くにはそのしまのりょうゆうをしゅちょうしている。 <br><br> (領有) <br> The country claims ownership of the island.
国はその島の領有を主張している。 <br><br> (領有)	<b>くにはそのしまのりょうゆうをしゅちょうしている。</b> <br> The country claims ownership of the island. <br> [sound:4c-s-国はその島の領有を主張している。.mp3]
The country claims ownership of the island.	<b>国はその島の領有を主張している。</b> <br> くにはそのしまのりょうゆうをしゅちょうしている。 <br><br> (領有) <br> [sound:4c-s-国はその島の領有を主張している。.mp3]
[sound:4c-k-最多.mp3]	<b>最多</b> <br> さいた <br> the most
最多	<b>さいた</b> <br> the most <br> [sound:4c-k-最多.mp3]
the most	<b>最多</b> <br> さいた <br> [sound:4c-k-最多.mp3]
[sound:4c-s-今年の大会で最多得点を獲得した。.mp3]	<b>今年の大会で最多得点を獲得した。</b> <br> ことしのたいかいでさいたとくてんをかくとくした。 <br><br> (最多) <br> This year's tournament saw the highest score.
今年の大会で最多得点を獲得した。 <br><br> (最多)	<b>ことしのたいかいでさいたとくてんをかくとくした。</b> <br> This year's tournament saw the highest score. <br> [sound:4c-s-今年の大会で最多得点を獲得した。.mp3]
This year's tournament saw the highest score.	<b>今年の大会で最多得点を獲得した。</b> <br> ことしのたいかいでさいたとくてんをかくとくした。 <br><br> (最多) <br> [sound:4c-s-今年の大会で最多得点を獲得した。.mp3]
[sound:4c-k-多額.mp3]	<b>多額</b> <br> たがく <br> large amount of money
多額	<b>たがく</b> <br> large amount of money <br> [sound:4c-k-多額.mp3]
large amount of money	<b>多額</b> <br> たがく <br> [sound:4c-k-多額.mp3]
[sound:4c-s-彼は多額の資金を投資した。.mp3]	<b>彼は多額の資金を投資した。</b> <br> かれはたがくのしきんをとうしした。 <br><br> (多額) <br> He invested a large sum of money.
彼は多額の資金を投資した。 <br><br> (多額)	<b>かれはたがくのしきんをとうしした。</b> <br> He invested a large sum of money. <br> [sound:4c-s-彼は多額の資金を投資した。.mp3]
He invested a large sum of money.	<b>彼は多額の資金を投資した。</b> <br> かれはたがくのしきんをとうしした。 <br><br> (多額) <br> [sound:4c-s-彼は多額の資金を投資した。.mp3]
[sound:4c-k-多彩.mp3]	<b>多彩</b> <br> たさい <br> variegated, varicoloured, multi-colored, diverse
多彩	<b>たさい</b> <br> variegated, varicoloured, multi-colored, diverse <br> [sound:4c-k-多彩.mp3]
variegated, varicoloured, multi-colored, diverse	<b>多彩</b> <br> たさい <br> [sound:4c-k-多彩.mp3]
[sound:4c-s-多彩な文化が共存する都市です。.mp3]	<b>多彩な文化が共存する都市です。</b> <br> たさいなぶんかがきょうそんするとしです。 <br><br> (多彩) <br> It is a city where diverse cultures coexist.
多彩な文化が共存する都市です。 <br><br> (多彩)	<b>たさいなぶんかがきょうそんするとしです。</b> <br> It is a city where diverse cultures coexist. <br> [sound:4c-s-多彩な文化が共存する都市です。.mp3]
It is a city where diverse cultures coexist.	<b>多彩な文化が共存する都市です。</b> <br> たさいなぶんかがきょうそんするとしです。 <br><br> (多彩) <br> [sound:4c-s-多彩な文化が共存する都市です。.mp3]
[sound:4c-k-多少.mp3]	<b>多少</b> <br> たしょう <br> more or less, somewhat, a little, some
多少	<b>たしょう</b> <br> more or less, somewhat, a little, some <br> [sound:4c-k-多少.mp3]
more or less, somewhat, a little, some	<b>多少</b> <br> たしょう <br> [sound:4c-k-多少.mp3]
[sound:4c-s-この商品には多少の傷があります。.mp3]	<b>この商品には多少の傷があります。</b> <br> このしょうひんにはたしょうのきずがあります。 <br><br> (多少) <br> This product has some minor damage.
この商品には多少の傷があります。 <br><br> (多少)	<b>このしょうひんにはたしょうのきずがあります。</b> <br> This product has some minor damage. <br> [sound:4c-s-この商品には多少の傷があります。.mp3]
This product has some minor damage.	<b>この商品には多少の傷があります。</b> <br> このしょうひんにはたしょうのきずがあります。 <br><br> (多少) <br> [sound:4c-s-この商品には多少の傷があります。.mp3]
[sound:4c-k-県内.mp3]	<b>県内</b> <br> けんない <br> within the prefecture
県内	<b>けんない</b> <br> within the prefecture <br> [sound:4c-k-県内.mp3]
within the prefecture	<b>県内</b> <br> けんない <br> [sound:4c-k-県内.mp3]
[sound:4c-s-県内の観光地を訪れました。.mp3]	<b>県内の観光地を訪れました。</b> <br> けんないのかんこうちをおとずれました。 <br><br> (県内) <br> I visited tourist spots within the prefecture.
県内の観光地を訪れました。 <br><br> (県内)	<b>けんないのかんこうちをおとずれました。</b> <br> I visited tourist spots within the prefecture. <br> [sound:4c-s-県内の観光地を訪れました。.mp3]
I visited tourist spots within the prefecture.	<b>県内の観光地を訪れました。</b> <br> けんないのかんこうちをおとずれました。 <br><br> (県内) <br> [sound:4c-s-県内の観光地を訪れました。.mp3]
[sound:4c-k-都道府県.mp3]	<b>都道府県</b> <br> とどうふけん <br> administrative divisions of Japan: Tokyo-to, Hokkai-do, Osaka-fu, Kyoto-fu and remaining prefectures
都道府県	<b>とどうふけん</b> <br> administrative divisions of Japan: Tokyo-to, Hokkai-do, Osaka-fu, Kyoto-fu and remaining prefectures <br> [sound:4c-k-都道府県.mp3]
administrative divisions of Japan: Tokyo-to, Hokkai-do, Osaka-fu, Kyoto-fu and remaining prefectures	<b>都道府県</b> <br> とどうふけん <br> [sound:4c-k-都道府県.mp3]
[sound:4c-s-都道府県ごとに規則が異なります。.mp3]	<b>都道府県ごとに規則が異なります。</b> <br> とどうふけんごとにきそくがことなります。 <br><br> (都道府県) <br> Regulations vary by prefecture.
都道府県ごとに規則が異なります。 <br><br> (都道府県)	<b>とどうふけんごとにきそくがことなります。</b> <br> Regulations vary by prefecture. <br> [sound:4c-s-都道府県ごとに規則が異なります。.mp3]
Regulations vary by prefecture.	<b>都道府県ごとに規則が異なります。</b> <br> とどうふけんごとにきそくがことなります。 <br><br> (都道府県) <br> [sound:4c-s-都道府県ごとに規則が異なります。.mp3]
[sound:4c-k-県議.mp3]	<b>県議</b> <br> けんぎ <br> prefectural assembly
県議	<b>けんぎ</b> <br> prefectural assembly <br> [sound:4c-k-県議.mp3]
prefectural assembly	<b>県議</b> <br> けんぎ <br> [sound:4c-k-県議.mp3]
[sound:4c-s-県議会で新しい条例が決まりました。.mp3]	<b>県議会で新しい条例が決まりました。</b> <br> けんぎかいであたらしいじょうれいがきまりました。 <br><br> (県議) <br> A new ordinance was decided in the prefectural assembly.
県議会で新しい条例が決まりました。 <br><br> (県議)	<b>けんぎかいであたらしいじょうれいがきまりました。</b> <br> A new ordinance was decided in the prefectural assembly. <br> [sound:4c-s-県議会で新しい条例が決まりました。.mp3]
A new ordinance was decided in the prefectural assembly.	<b>県議会で新しい条例が決まりました。</b> <br> けんぎかいであたらしいじょうれいがきまりました。 <br><br> (県議) <br> [sound:4c-s-県議会で新しい条例が決まりました。.mp3]
[sound:4c-k-県立.mp3]	<b>県立</b> <br> けんりつ <br> prefectural (institution)
県立	<b>けんりつ</b> <br> prefectural (institution) <br> [sound:4c-k-県立.mp3]
prefectural (institution)	<b>県立</b> <br> けんりつ <br> [sound:4c-k-県立.mp3]
[sound:4c-s-県立大学に通っています。.mp3]	<b>県立大学に通っています。</b> <br> けんりつだいがくにかよっています。 <br><br> (県立) <br> I attend a prefectural university.
県立大学に通っています。 <br><br> (県立)	<b>けんりつだいがくにかよっています。</b> <br> I attend a prefectural university. <br> [sound:4c-s-県立大学に通っています。.mp3]
I attend a prefectural university.	<b>県立大学に通っています。</b> <br> けんりつだいがくにかよっています。 <br><br> (県立) <br> [sound:4c-s-県立大学に通っています。.mp3]
[sound:4c-k-続き.mp3]	<b>続き</b> <br> つづき <br> sequel, continuation, (also suffix) continuation (in time and space), second series, succession, spell
続き	<b>つづき</b> <br> sequel, continuation, (also suffix) continuation (in time and space), second series, succession, spell <br> [sound:4c-k-続き.mp3]
sequel, continuation, (also suffix) continuation (in time and space), second series, succession, spell	<b>続き</b> <br> つづき <br> [sound:4c-k-続き.mp3]
[sound:4c-s-話の続きを聞きたいです。.mp3]	<b>話の続きを聞きたいです。</b> <br> はなしのつづきをききたいです。 <br><br> (続き) <br> I want to hear the continuation of the story.
話の続きを聞きたいです。 <br><br> (続き)	<b>はなしのつづきをききたいです。</b> <br> I want to hear the continuation of the story. <br> [sound:4c-s-話の続きを聞きたいです。.mp3]
I want to hear the continuation of the story.	<b>話の続きを聞きたいです。</b> <br> はなしのつづきをききたいです。 <br><br> (続き) <br> [sound:4c-s-話の続きを聞きたいです。.mp3]
[sound:4c-k-持続.mp3]	<b>持続</b> <br> じぞく <br> continuation
持続	<b>じぞく</b> <br> continuation <br> [sound:4c-k-持続.mp3]
continuation	<b>持続</b> <br> じぞく <br> [sound:4c-k-持続.mp3]
[sound:4c-s-運動を持続することが重要です。.mp3]	<b>運動を持続することが重要です。</b> <br> うんどうをじぞくすることがじゅうようです。 <br><br> (持続) <br> It is important to sustain exercise.
運動を持続することが重要です。 <br><br> (持続)	<b>うんどうをじぞくすることがじゅうようです。</b> <br> It is important to sustain exercise. <br> [sound:4c-s-運動を持続することが重要です。.mp3]
It is important to sustain exercise.	<b>運動を持続することが重要です。</b> <br> うんどうをじぞくすることがじゅうようです。 <br><br> (持続) <br> [sound:4c-s-運動を持続することが重要です。.mp3]
[sound:4c-k-存続.mp3]	<b>存続</b> <br> そんぞく <br> duration, continuance
存続	<b>そんぞく</b> <br> duration, continuance <br> [sound:4c-k-存続.mp3]
duration, continuance	<b>存続</b> <br> そんぞく <br> [sound:4c-k-存続.mp3]
[sound:4c-s-その会社の存続が危ぶまれている。.mp3]	<b>その会社の存続が危ぶまれている。</b> <br> そのかいしゃのそんぞくがあやぶまれている。 <br><br> (存続) <br> The company's existence is in jeopardy.
その会社の存続が危ぶまれている。 <br><br> (存続)	<b>そのかいしゃのそんぞくがあやぶまれている。</b> <br> The company's existence is in jeopardy. <br> [sound:4c-s-その会社の存続が危ぶまれている。.mp3]
The company's existence is in jeopardy.	<b>その会社の存続が危ぶまれている。</b> <br> そのかいしゃのそんぞくがあやぶまれている。 <br><br> (存続) <br> [sound:4c-s-その会社の存続が危ぶまれている。.mp3]
[sound:4c-k-続々.mp3]	<b>続々</b> <br> ぞくぞく <br> successively, one after another
続々	<b>ぞくぞく</b> <br> successively, one after another <br> [sound:4c-k-続々.mp3]
successively, one after another	<b>続々</b> <br> ぞくぞく <br> [sound:4c-k-続々.mp3]
[sound:4c-s-新製品が続々と発売されています。.mp3]	<b>新製品が続々と発売されています。</b> <br> しんせいひんがぞくぞくとはつばいされています。 <br><br> (続々) <br> New products are being released one after another.
新製品が続々と発売されています。 <br><br> (続々)	<b>しんせいひんがぞくぞくとはつばいされています。</b> <br> New products are being released one after another. <br> [sound:4c-s-新製品が続々と発売されています。.mp3]
New products are being released one after another.	<b>新製品が続々と発売されています。</b> <br> しんせいひんがぞくぞくとはつばいされています。 <br><br> (続々) <br> [sound:4c-s-新製品が続々と発売されています。.mp3]
[sound:4c-k-進展.mp3]	<b>進展</b> <br> しんてん <br> progress, development
進展	<b>しんてん</b> <br> progress, development <br> [sound:4c-k-進展.mp3]
progress, development	<b>進展</b> <br> しんてん <br> [sound:4c-k-進展.mp3]
[sound:4c-s-交渉に進展がありました。.mp3]	<b>交渉に進展がありました。</b> <br> こうしょうにしんてんがありました。 <br><br> (進展) <br> There has been progress in the negotiations.
交渉に進展がありました。 <br><br> (進展)	<b>こうしょうにしんてんがありました。</b> <br> There has been progress in the negotiations. <br> [sound:4c-s-交渉に進展がありました。.mp3]
There has been progress in the negotiations.	<b>交渉に進展がありました。</b> <br> こうしょうにしんてんがありました。 <br><br> (進展) <br> [sound:4c-s-交渉に進展がありました。.mp3]
[sound:4c-k-促進.mp3]	<b>促進</b> <br> そくしん <br> promotion, acceleration, encouragement, facilitation, spurring on
促進	<b>そくしん</b> <br> promotion, acceleration, encouragement, facilitation, spurring on <br> [sound:4c-k-促進.mp3]
promotion, acceleration, encouragement, facilitation, spurring on	<b>促進</b> <br> そくしん <br> [sound:4c-k-促進.mp3]
[sound:4c-s-環境保護活動は地域社会の発展を促進します。.mp3]	<b>環境保護活動は地域社会の発展を促進します。</b> <br> かんきょうほごかつどうはちいきしゃかいのはってんをそくしんします。 <br><br> (促進) <br> Environmental protection activities promote the development of local communities.
環境保護活動は地域社会の発展を促進します。 <br><br> (促進)	<b>かんきょうほごかつどうはちいきしゃかいのはってんをそくしんします。</b> <br> Environmental protection activities promote the development of local communities. <br> [sound:4c-s-環境保護活動は地域社会の発展を促進します。.mp3]
Environmental protection activities promote the development of local communities.	<b>環境保護活動は地域社会の発展を促進します。</b> <br> かんきょうほごかつどうはちいきしゃかいのはってんをそくしんします。 <br><br> (促進) <br> [sound:4c-s-環境保護活動は地域社会の発展を促進します。.mp3]
[sound:4c-k-先進.mp3]	<b>先進</b> <br> せんしん <br> seniority, advance, leadership
先進	<b>せんしん</b> <br> seniority, advance, leadership <br> [sound:4c-k-先進.mp3]
seniority, advance, leadership	<b>先進</b> <br> せんしん <br> [sound:4c-k-先進.mp3]
[sound:4c-s-先進技術を活用して新しい製品を開発しました。.mp3]	<b>先進技術を活用して新しい製品を開発しました。</b> <br> せんしんぎじゅつをかつようしてあたらしいせいひんをかいはつしました。 <br><br> (先進) <br> We developed new products by utilizing advanced technology.
先進技術を活用して新しい製品を開発しました。 <br><br> (先進)	<b>せんしんぎじゅつをかつようしてあたらしいせいひんをかいはつしました。</b> <br> We developed new products by utilizing advanced technology. <br> [sound:4c-s-先進技術を活用して新しい製品を開発しました。.mp3]
We developed new products by utilizing advanced technology.	<b>先進技術を活用して新しい製品を開発しました。</b> <br> せんしんぎじゅつをかつようしてあたらしいせいひんをかいはつしました。 <br><br> (先進) <br> [sound:4c-s-先進技術を活用して新しい製品を開発しました。.mp3]
[sound:4c-k-進学.mp3]	<b>進学</b> <br> しんがく <br> entering a higher-level school, esp. going on to university
進学	<b>しんがく</b> <br> entering a higher-level school, esp. going on to university <br> [sound:4c-k-進学.mp3]
entering a higher-level school, esp. going on to university	<b>進学</b> <br> しんがく <br> [sound:4c-k-進学.mp3]
[sound:4c-s-彼は来年大学に進学する予定です。.mp3]	<b>彼は来年大学に進学する予定です。</b> <br> かれはらいねんだいがくにしんがくするよていです。 <br><br> (進学) <br> He plans to advance to university next year.
彼は来年大学に進学する予定です。 <br><br> (進学)	<b>かれはらいねんだいがくにしんがくするよていです。</b> <br> He plans to advance to university next year. <br> [sound:4c-s-彼は来年大学に進学する予定です。.mp3]
He plans to advance to university next year.	<b>彼は来年大学に進学する予定です。</b> <br> かれはらいねんだいがくにしんがくするよていです。 <br><br> (進学) <br> [sound:4c-s-彼は来年大学に進学する予定です。.mp3]
[sound:4c-k-正式.mp3]	<b>正式</b> <br> せいしき <br> due form, official, formality
正式	<b>せいしき</b> <br> due form, official, formality <br> [sound:4c-k-正式.mp3]
due form, official, formality	<b>正式</b> <br> せいしき <br> [sound:4c-k-正式.mp3]
[sound:4c-s-正式な手続きが必要です。.mp3]	<b>正式な手続きが必要です。</b> <br> せいしきなてつづきがひつようです。 <br><br> (正式) <br> Formal procedures are required.
正式な手続きが必要です。 <br><br> (正式)	<b>せいしきなてつづきがひつようです。</b> <br> Formal procedures are required. <br> [sound:4c-s-正式な手続きが必要です。.mp3]
Formal procedures are required.	<b>正式な手続きが必要です。</b> <br> せいしきなてつづきがひつようです。 <br><br> (正式) <br> [sound:4c-s-正式な手続きが必要です。.mp3]
[sound:4c-k-正常.mp3]	<b>正常</b> <br> せいじょう <br> normalcy, normality, normal
正常	<b>せいじょう</b> <br> normalcy, normality, normal <br> [sound:4c-k-正常.mp3]
normalcy, normality, normal	<b>正常</b> <br> せいじょう <br> [sound:4c-k-正常.mp3]
[sound:4c-s-機械の動作は正常です。.mp3]	<b>機械の動作は正常です。</b> <br> きかいのどうさはせいじょうです。 <br><br> (正常) <br> The machine's operation is normal.
機械の動作は正常です。 <br><br> (正常)	<b>きかいのどうさはせいじょうです。</b> <br> The machine's operation is normal. <br> [sound:4c-s-機械の動作は正常です。.mp3]
The machine's operation is normal.	<b>機械の動作は正常です。</b> <br> きかいのどうさはせいじょうです。 <br><br> (正常) <br> [sound:4c-s-機械の動作は正常です。.mp3]
[sound:4c-k-是正.mp3]	<b>是正</b> <br> ぜせい <br> correction, revision
是正	<b>ぜせい</b> <br> correction, revision <br> [sound:4c-k-是正.mp3]
correction, revision	<b>是正</b> <br> ぜせい <br> [sound:4c-k-是正.mp3]
[sound:4c-s-不正行為を是正する必要があります。.mp3]	<b>不正行為を是正する必要があります。</b> <br> ふせいこういをぜせいするひつようがあります。 <br><br> (是正) <br> It is necessary to correct misconduct.
不正行為を是正する必要があります。 <br><br> (是正)	<b>ふせいこういをぜせいするひつようがあります。</b> <br> It is necessary to correct misconduct. <br> [sound:4c-s-不正行為を是正する必要があります。.mp3]
It is necessary to correct misconduct.	<b>不正行為を是正する必要があります。</b> <br> ふせいこういをぜせいするひつようがあります。 <br><br> (是正) <br> [sound:4c-s-不正行為を是正する必要があります。.mp3]
[sound:4c-k-正義.mp3]	<b>正義</b> <br> せいぎ <br> justice, right, righteousness, correct meaning
正義	<b>せいぎ</b> <br> justice, right, righteousness, correct meaning <br> [sound:4c-k-正義.mp3]
justice, right, righteousness, correct meaning	<b>正義</b> <br> せいぎ <br> [sound:4c-k-正義.mp3]
[sound:4c-s-正義は勝つと信じています。.mp3]	<b>正義は勝つと信じています。</b> <br> せいぎはかつとしんじています。 <br><br> (正義) <br> I believe that justice will prevail.
正義は勝つと信じています。 <br><br> (正義)	<b>せいぎはかつとしんじています。</b> <br> I believe that justice will prevail. <br> [sound:4c-s-正義は勝つと信じています。.mp3]
I believe that justice will prevail.	<b>正義は勝つと信じています。</b> <br> せいぎはかつとしんじています。 <br><br> (正義) <br> [sound:4c-s-正義は勝つと信じています。.mp3]
[sound:4c-k-安定.mp3]	<b>安定</b> <br> あんてい <br> stability, equilibrium
安定	<b>あんてい</b> <br> stability, equilibrium <br> [sound:4c-k-安定.mp3]
stability, equilibrium	<b>安定</b> <br> あんてい <br> [sound:4c-k-安定.mp3]
[sound:4c-s-経済の安定が重要です。.mp3]	<b>経済の安定が重要です。</b> <br> けいざいのあんていがじゅうようです。 <br><br> (安定) <br> Economic stability is important.
経済の安定が重要です。 <br><br> (安定)	<b>けいざいのあんていがじゅうようです。</b> <br> Economic stability is important. <br> [sound:4c-s-経済の安定が重要です。.mp3]
Economic stability is important.	<b>経済の安定が重要です。</b> <br> けいざいのあんていがじゅうようです。 <br><br> (安定) <br> [sound:4c-s-経済の安定が重要です。.mp3]
[sound:4c-k-不安.mp3]	<b>不安</b> <br> ふあん <br> anxiety, uneasiness, insecurity, suspense
不安	<b>ふあん</b> <br> anxiety, uneasiness, insecurity, suspense <br> [sound:4c-k-不安.mp3]
anxiety, uneasiness, insecurity, suspense	<b>不安</b> <br> ふあん <br> [sound:4c-k-不安.mp3]
[sound:4c-s-試験前は不安になります。.mp3]	<b>試験前は不安になります。</b> <br> しけんまえはふあんになります。 <br><br> (不安) <br> I become anxious before exams.
試験前は不安になります。 <br><br> (不安)	<b>しけんまえはふあんになります。</b> <br> I become anxious before exams. <br> [sound:4c-s-試験前は不安になります。.mp3]
I become anxious before exams.	<b>試験前は不安になります。</b> <br> しけんまえはふあんになります。 <br><br> (不安) <br> [sound:4c-s-試験前は不安になります。.mp3]
[sound:4c-k-慰安.mp3]	<b>慰安</b> <br> いあん <br> solace, relaxation
慰安	<b>いあん</b> <br> solace, relaxation <br> [sound:4c-k-慰安.mp3]
solace, relaxation	<b>慰安</b> <br> いあん <br> [sound:4c-k-慰安.mp3]
[sound:4c-s-慰安旅行が企画されています。.mp3]	<b>慰安旅行が企画されています。</b> <br> いあんりょこうがきかくされています。 <br><br> (慰安) <br> A leisure trip is being planned.
慰安旅行が企画されています。 <br><br> (慰安)	<b>いあんりょこうがきかくされています。</b> <br> A leisure trip is being planned. <br> [sound:4c-s-慰安旅行が企画されています。.mp3]
A leisure trip is being planned.	<b>慰安旅行が企画されています。</b> <br> いあんりょこうがきかくされています。 <br><br> (慰安) <br> [sound:4c-s-慰安旅行が企画されています。.mp3]
[sound:4c-k-安打.mp3]	<b>安打</b> <br> あんだ <br> safe hit (baseball)
安打	<b>あんだ</b> <br> safe hit (baseball) <br> [sound:4c-k-安打.mp3]
safe hit (baseball)	<b>安打</b> <br> あんだ <br> [sound:4c-k-安打.mp3]
[sound:4c-s-彼は昨日、三本の安打を打ちました。.mp3]	<b>彼は昨日、三本の安打を打ちました。</b> <br> かれはきのう、さんぼんのあんだをうちました。 <br><br> (安打) <br> He hit three singles yesterday.
彼は昨日、三本の安打を打ちました。 <br><br> (安打)	<b>かれはきのう、さんぼんのあんだをうちました。</b> <br> He hit three singles yesterday. <br> [sound:4c-s-彼は昨日、三本の安打を打ちました。.mp3]
He hit three singles yesterday.	<b>彼は昨日、三本の安打を打ちました。</b> <br> かれはきのう、さんぼんのあんだをうちました。 <br><br> (安打) <br> [sound:4c-s-彼は昨日、三本の安打を打ちました。.mp3]
[sound:4c-k-設備.mp3]	<b>設備</b> <br> せつび <br> equipment, device, facilities, installation
設備	<b>せつび</b> <br> equipment, device, facilities, installation <br> [sound:4c-k-設備.mp3]
equipment, device, facilities, installation	<b>設備</b> <br> せつび <br> [sound:4c-k-設備.mp3]
[sound:4c-s-新しい設備が導入されました。.mp3]	<b>新しい設備が導入されました。</b> <br> あたらしいせつびがどうにゅうされました。 <br><br> (設備) <br> New equipment has been introduced.
新しい設備が導入されました。 <br><br> (設備)	<b>あたらしいせつびがどうにゅうされました。</b> <br> New equipment has been introduced. <br> [sound:4c-s-新しい設備が導入されました。.mp3]
New equipment has been introduced.	<b>新しい設備が導入されました。</b> <br> あたらしいせつびがどうにゅうされました。 <br><br> (設備) <br> [sound:4c-s-新しい設備が導入されました。.mp3]
[sound:4c-k-設計.mp3]	<b>設計</b> <br> せっけい <br> plan, design, layout
設計	<b>せっけい</b> <br> plan, design, layout <br> [sound:4c-k-設計.mp3]
plan, design, layout	<b>設計</b> <br> せっけい <br> [sound:4c-k-設計.mp3]
[sound:4c-s-建物の設計は完了しました。.mp3]	<b>建物の設計は完了しました。</b> <br> たてもののせっけいはかんりょうしました。 <br><br> (設計) <br> The building design has been completed.
建物の設計は完了しました。 <br><br> (設計)	<b>たてもののせっけいはかんりょうしました。</b> <br> The building design has been completed. <br> [sound:4c-s-建物の設計は完了しました。.mp3]
The building design has been completed.	<b>建物の設計は完了しました。</b> <br> たてもののせっけいはかんりょうしました。 <br><br> (設計) <br> [sound:4c-s-建物の設計は完了しました。.mp3]
[sound:4c-k-設立.mp3]	<b>設立</b> <br> せつりつ <br> establishment, foundation, incorporation (of a business)
設立	<b>せつりつ</b> <br> establishment, foundation, incorporation (of a business) <br> [sound:4c-k-設立.mp3]
establishment, foundation, incorporation (of a business)	<b>設立</b> <br> せつりつ <br> [sound:4c-k-設立.mp3]
[sound:4c-s-新しい会社が設立されました。.mp3]	<b>新しい会社が設立されました。</b> <br> あたらしいかいしゃがせつりつされました。 <br><br> (設立) <br> A new company has been established.
新しい会社が設立されました。 <br><br> (設立)	<b>あたらしいかいしゃがせつりつされました。</b> <br> A new company has been established. <br> [sound:4c-s-新しい会社が設立されました。.mp3]
A new company has been established.	<b>新しい会社が設立されました。</b> <br> あたらしいかいしゃがせつりつされました。 <br><br> (設立) <br> [sound:4c-s-新しい会社が設立されました。.mp3]
[sound:4c-k-設定.mp3]	<b>設定</b> <br> せってい <br> establishment, creation; options or preference settings (in computer software), configuration, assignment, setup
設定	<b>せってい</b> <br> establishment, creation; options or preference settings (in computer software), configuration, assignment, setup <br> [sound:4c-k-設定.mp3]
establishment, creation; options or preference settings (in computer software), configuration, assignment, setup	<b>設定</b> <br> せってい <br> [sound:4c-k-設定.mp3]
[sound:4c-s-目標を設定することが重要です。.mp3]	<b>目標を設定することが重要です。</b> <br> もくひょうをせっていすることがじゅうようです。 <br><br> (設定) <br> Setting goals is important.
目標を設定することが重要です。 <br><br> (設定)	<b>もくひょうをせっていすることがじゅうようです。</b> <br> Setting goals is important. <br> [sound:4c-s-目標を設定することが重要です。.mp3]
Setting goals is important.	<b>目標を設定することが重要です。</b> <br> もくひょうをせっていすることがじゅうようです。 <br><br> (設定) <br> [sound:4c-s-目標を設定することが重要です。.mp3]
[sound:4c-k-安全保障.mp3]	<b>安全保障</b> <br> あんぜんほしょう <br> security guarantee (e.g. military security, network security, etc.)
安全保障	<b>あんぜんほしょう</b> <br> security guarantee (e.g. military security, network security, etc.) <br> [sound:4c-k-安全保障.mp3]
security guarantee (e.g. military security, network security, etc.)	<b>安全保障</b> <br> あんぜんほしょう <br> [sound:4c-k-安全保障.mp3]
[sound:4c-s-国の安全保障が最優先です。.mp3]	<b>国の安全保障が最優先です。</b> <br> くにのあんぜんほしょうがさいゆうせんです。 <br><br> (安全保障) <br> The country's security is the top priority.
国の安全保障が最優先です。 <br><br> (安全保障)	<b>くにのあんぜんほしょうがさいゆうせんです。</b> <br> The country's security is the top priority. <br> [sound:4c-s-国の安全保障が最優先です。.mp3]
The country's security is the top priority.	<b>国の安全保障が最優先です。</b> <br> くにのあんぜんほしょうがさいゆうせんです。 <br><br> (安全保障) <br> [sound:4c-s-国の安全保障が最優先です。.mp3]
[sound:4c-k-確保.mp3]	<b>確保</b> <br> かくほ <br> guarantee, maintain, ensure, insure, secure, reservation
確保	<b>かくほ</b> <br> guarantee, maintain, ensure, insure, secure, reservation <br> [sound:4c-k-確保.mp3]
guarantee, maintain, ensure, insure, secure, reservation	<b>確保</b> <br> かくほ <br> [sound:4c-k-確保.mp3]
[sound:4c-s-資源の確保が課題です。.mp3]	<b>資源の確保が課題です。</b> <br> しげんのかくほがかだいです。 <br><br> (確保) <br> Securing resources is a challenge.
資源の確保が課題です。 <br><br> (確保)	<b>しげんのかくほがかだいです。</b> <br> Securing resources is a challenge. <br> [sound:4c-s-資源の確保が課題です。.mp3]
Securing resources is a challenge.	<b>資源の確保が課題です。</b> <br> しげんのかくほがかだいです。 <br><br> (確保) <br> [sound:4c-s-資源の確保が課題です。.mp3]
[sound:4c-k-保険.mp3]	<b>保険</b> <br> ほけん <br> insurance, guarantee
保険	<b>ほけん</b> <br> insurance, guarantee <br> [sound:4c-k-保険.mp3]
insurance, guarantee	<b>保険</b> <br> ほけん <br> [sound:4c-k-保険.mp3]
[sound:4c-s-健康保険に加入しています。.mp3]	<b>健康保険に加入しています。</b> <br> けんこうほけんにかにゅうしています。 <br><br> (保険) <br> I am enrolled in health insurance.
健康保険に加入しています。 <br><br> (保険)	<b>けんこうほけんにかにゅうしています。</b> <br> I am enrolled in health insurance. <br> [sound:4c-s-健康保険に加入しています。.mp3]
I am enrolled in health insurance.	<b>健康保険に加入しています。</b> <br> けんこうほけんにかにゅうしています。 <br><br> (保険) <br> [sound:4c-s-健康保険に加入しています。.mp3]
[sound:4c-k-保守.mp3]	<b>保守</b> <br> ほしゅ <br> maintenance, conservation
保守	<b>ほしゅ</b> <br> maintenance, conservation <br> [sound:4c-k-保守.mp3]
maintenance, conservation	<b>保守</b> <br> ほしゅ <br> [sound:4c-k-保守.mp3]
[sound:4c-s-システムの保守が必要です。.mp3]	<b>システムの保守が必要です。</b> <br> しすてむのほしゅがひつようです。 <br><br> (保守) <br> System maintenance is necessary.
システムの保守が必要です。 <br><br> (保守)	<b>しすてむのほしゅがひつようです。</b> <br> System maintenance is necessary. <br> [sound:4c-s-システムの保守が必要です。.mp3]
System maintenance is necessary.	<b>システムの保守が必要です。</b> <br> しすてむのほしゅがひつようです。 <br><br> (保守) <br> [sound:4c-s-システムの保守が必要です。.mp3]
[sound:4c-k-改造.mp3]	<b>改造</b> <br> かいぞう <br> remodeling, remodelling, restructuring; modding
改造	<b>かいぞう</b> <br> remodeling, remodelling, restructuring; modding <br> [sound:4c-k-改造.mp3]
remodeling, remodelling, restructuring; modding	<b>改造</b> <br> かいぞう <br> [sound:4c-k-改造.mp3]
[sound:4c-s-車の改造が趣味です。.mp3]	<b>車の改造が趣味です。</b> <br> くるまのかいぞうがしゅみです。 <br><br> (改造) <br> Car modification is my hobby.
車の改造が趣味です。 <br><br> (改造)	<b>くるまのかいぞうがしゅみです。</b> <br> Car modification is my hobby. <br> [sound:4c-s-車の改造が趣味です。.mp3]
Car modification is my hobby.	<b>車の改造が趣味です。</b> <br> くるまのかいぞうがしゅみです。 <br><br> (改造) <br> [sound:4c-s-車の改造が趣味です。.mp3]
[sound:4c-k-改める.mp3]	<b>改める</b> <br> あらためる <br> to change, to alter, to revise, to replace; to reform, to correct, to mend, to improve; to examine, to check, to inspect; to do properly, to do formally
改める	<b>あらためる</b> <br> to change, to alter, to revise, to replace; to reform, to correct, to mend, to improve; to examine, to check, to inspect; to do properly, to do formally <br> [sound:4c-k-改める.mp3]
to change, to alter, to revise, to replace; to reform, to correct, to mend, to improve; to examine, to check, to inspect; to do properly, to do formally	<b>改める</b> <br> あらためる <br> [sound:4c-k-改める.mp3]
[sound:4c-s-考えを改めることが大切です。.mp3]	<b>考えを改めることが大切です。</b> <br> かんがえをあらためることがたいせつです。 <br><br> (改める) <br> It is important to change one's thinking.
考えを改めることが大切です。 <br><br> (改める)	<b>かんがえをあらためることがたいせつです。</b> <br> It is important to change one's thinking. <br> [sound:4c-s-考えを改めることが大切です。.mp3]
It is important to change one's thinking.	<b>考えを改めることが大切です。</b> <br> かんがえをあらためることがたいせつです。 <br><br> (改める) <br> [sound:4c-s-考えを改めることが大切です。.mp3]
[sound:4c-k-改定.mp3]	<b>改定</b> <br> かいてい <br> reform
改定	<b>かいてい</b> <br> reform <br> [sound:4c-k-改定.mp3]
reform	<b>改定</b> <br> かいてい <br> [sound:4c-k-改定.mp3]
[sound:4c-s-料金が改定されました。.mp3]	<b>料金が改定されました。</b> <br> りょうきんがかいていされました。 <br><br> (改定) <br> The charges have been revised.
料金が改定されました。 <br><br> (改定)	<b>りょうきんがかいていされました。</b> <br> The charges have been revised. <br> [sound:4c-s-料金が改定されました。.mp3]
The charges have been revised.	<b>料金が改定されました。</b> <br> りょうきんがかいていされました。 <br><br> (改定) <br> [sound:4c-s-料金が改定されました。.mp3]
[sound:4c-k-改憲.mp3]	<b>改憲</b> <br> かいけん <br> constitutional change
改憲	<b>かいけん</b> <br> constitutional change <br> [sound:4c-k-改憲.mp3]
constitutional change	<b>改憲</b> <br> かいけん <br> [sound:4c-k-改憲.mp3]
[sound:4c-s-憲法改正が議論されています。.mp3]	<b>憲法改正が議論されています。</b> <br> けんぽうかいせいがぎろんされています。 <br><br> (改憲) <br> Constitutional amendment is being discussed.
憲法改正が議論されています。 <br><br> (改憲)	<b>けんぽうかいせいがぎろんされています。</b> <br> Constitutional amendment is being discussed. <br> [sound:4c-s-憲法改正が議論されています。.mp3]
Constitutional amendment is being discussed.	<b>憲法改正が議論されています。</b> <br> けんぽうかいせいがぎろんされています。 <br><br> (改憲) <br> [sound:4c-s-憲法改正が議論されています。.mp3]
[sound:4c-k-定数.mp3]	<b>定数</b> <br> ていすう <br> constant; literal
定数	<b>ていすう</b> <br> constant; literal <br> [sound:4c-k-定数.mp3]
constant; literal	<b>定数</b> <br> ていすう <br> [sound:4c-k-定数.mp3]
[sound:4c-s-定数の変更はありません。.mp3]	<b>定数の変更はありません。</b> <br> ていすうのへんこうはありません。 <br><br> (定数) <br> There is no change in the constants.
定数の変更はありません。 <br><br> (定数)	<b>ていすうのへんこうはありません。</b> <br> There is no change in the constants. <br> [sound:4c-s-定数の変更はありません。.mp3]
There is no change in the constants.	<b>定数の変更はありません。</b> <br> ていすうのへんこうはありません。 <br><br> (定数) <br> [sound:4c-s-定数の変更はありません。.mp3]
[sound:4c-k-少数.mp3]	<b>少数</b> <br> しょうすう <br> minority, few
少数	<b>しょうすう</b> <br> minority, few <br> [sound:4c-k-少数.mp3]
minority, few	<b>少数</b> <br> しょうすう <br> [sound:4c-k-少数.mp3]
[sound:4c-s-少数派の意見も尊重すべきです。.mp3]	<b>少数派の意見も尊重すべきです。</b> <br> しょうすうはのいけんもそんちょうすべきです。 <br><br> (少数) <br> The opinions of the minority should also be respected.
少数派の意見も尊重すべきです。 <br><br> (少数)	<b>しょうすうはのいけんもそんちょうすべきです。</b> <br> The opinions of the minority should also be respected. <br> [sound:4c-s-少数派の意見も尊重すべきです。.mp3]
The opinions of the minority should also be respected.	<b>少数派の意見も尊重すべきです。</b> <br> しょうすうはのいけんもそんちょうすべきです。 <br><br> (少数) <br> [sound:4c-s-少数派の意見も尊重すべきです。.mp3]
[sound:4c-k-複数.mp3]	<b>複数</b> <br> ふくすう <br> several, plural, plurality, multiple
複数	<b>ふくすう</b> <br> several, plural, plurality, multiple <br> [sound:4c-k-複数.mp3]
several, plural, plurality, multiple	<b>複数</b> <br> ふくすう <br> [sound:4c-k-複数.mp3]
[sound:4c-s-複数の選択肢があります。.mp3]	<b>複数の選択肢があります。</b> <br> ふくすうのせんたくしがあります。 <br><br> (複数) <br> There are multiple options.
複数の選択肢があります。 <br><br> (複数)	<b>ふくすうのせんたくしがあります。</b> <br> There are multiple options. <br> [sound:4c-s-複数の選択肢があります。.mp3]
There are multiple options.	<b>複数の選択肢があります。</b> <br> ふくすうのせんたくしがあります。 <br><br> (複数) <br> [sound:4c-s-複数の選択肢があります。.mp3]
[sound:4c-k-過半数.mp3]	<b>過半数</b> <br> かはんすう <br> majority
過半数	<b>かはんすう</b> <br> majority <br> [sound:4c-k-過半数.mp3]
majority	<b>過半数</b> <br> かはんすう <br> [sound:4c-k-過半数.mp3]
[sound:4c-s-過半数の賛成を得ました。.mp3]	<b>過半数の賛成を得ました。</b> <br> かはんすうのさんせいをえました。 <br><br> (過半数) <br> We obtained the majority's approval.
過半数の賛成を得ました。 <br><br> (過半数)	<b>かはんすうのさんせいをえました。</b> <br> We obtained the majority's approval. <br> [sound:4c-s-過半数の賛成を得ました。.mp3]
We obtained the majority's approval.	<b>過半数の賛成を得ました。</b> <br> かはんすうのさんせいをえました。 <br><br> (過半数) <br> [sound:4c-s-過半数の賛成を得ました。.mp3]
[sound:4c-k-書記.mp3]	<b>書記</b> <br> しょき <br> clerk, secretary
書記	<b>しょき</b> <br> clerk, secretary <br> [sound:4c-k-書記.mp3]
clerk, secretary	<b>書記</b> <br> しょき <br> [sound:4c-k-書記.mp3]
[sound:4c-s-会議の書記を担当しました。.mp3]	<b>会議の書記を担当しました。</b> <br> かいぎのしょきをたんとうしました。 <br><br> (書記) <br> I served as the secretary for the meeting.
会議の書記を担当しました。 <br><br> (書記)	<b>かいぎのしょきをたんとうしました。</b> <br> I served as the secretary for the meeting. <br> [sound:4c-s-会議の書記を担当しました。.mp3]
I served as the secretary for the meeting.	<b>会議の書記を担当しました。</b> <br> かいぎのしょきをたんとうしました。 <br><br> (書記) <br> [sound:4c-s-会議の書記を担当しました。.mp3]
[sound:4c-k-記念.mp3]	<b>記念</b> <br> きねん <br> commemoration, memory
記念	<b>きねん</b> <br> commemoration, memory <br> [sound:4c-k-記念.mp3]
commemoration, memory	<b>記念</b> <br> きねん <br> [sound:4c-k-記念.mp3]
[sound:4c-s-結婚記念日を祝いました。.mp3]	<b>結婚記念日を祝いました。</b> <br> けっこんきねんびをいわいました。 <br><br> (記念) <br> We celebrated our wedding anniversary.
結婚記念日を祝いました。 <br><br> (記念)	<b>けっこんきねんびをいわいました。</b> <br> We celebrated our wedding anniversary. <br> [sound:4c-s-結婚記念日を祝いました。.mp3]
We celebrated our wedding anniversary.	<b>結婚記念日を祝いました。</b> <br> けっこんきねんびをいわいました。 <br><br> (記念) <br> [sound:4c-s-結婚記念日を祝いました。.mp3]
[sound:4c-k-記憶.mp3]	<b>記憶</b> <br> きおく <br> memory, recollection, remembrance; storage
記憶	<b>きおく</b> <br> memory, recollection, remembrance; storage <br> [sound:4c-k-記憶.mp3]
memory, recollection, remembrance; storage	<b>記憶</b> <br> きおく <br> [sound:4c-k-記憶.mp3]
[sound:4c-s-その出来事を記憶しています。.mp3]	<b>その出来事を記憶しています。</b> <br> そのできごとをきおくしています。 <br><br> (記憶) <br> I remember that event.
その出来事を記憶しています。 <br><br> (記憶)	<b>そのできごとをきおくしています。</b> <br> I remember that event. <br> [sound:4c-s-その出来事を記憶しています。.mp3]
I remember that event.	<b>その出来事を記憶しています。</b> <br> そのできごとをきおくしています。 <br><br> (記憶) <br> [sound:4c-s-その出来事を記憶しています。.mp3]
[sound:4c-k-記す.mp3]	<b>記す</b> <br> しるす, きす <br> to write down, to note; to remember
記す	<b>しるす, きす</b> <br> to write down, to note; to remember <br> [sound:4c-k-記す.mp3]
to write down, to note; to remember	<b>記す</b> <br> しるす, きす <br> [sound:4c-k-記す.mp3]
[sound:4c-s-名前を記してください。.mp3]	<b>名前を記してください。</b> <br> なまえをしるしてください。 <br><br> (記す) <br> Please write your name.
名前を記してください。 <br><br> (記す)	<b>なまえをしるしてください。</b> <br> Please write your name. <br> [sound:4c-s-名前を記してください。.mp3]
Please write your name.	<b>名前を記してください。</b> <br> なまえをしるしてください。 <br><br> (記す) <br> [sound:4c-s-名前を記してください。.mp3]
[sound:4c-k-下院.mp3]	<b>下院</b> <br> かいん <br> lower house, lower (legislative) body
下院	<b>かいん</b> <br> lower house, lower (legislative) body <br> [sound:4c-k-下院.mp3]
lower house, lower (legislative) body	<b>下院</b> <br> かいん <br> [sound:4c-k-下院.mp3]
[sound:4c-s-下院で法案が可決されました。.mp3]	<b>下院で法案が可決されました。</b> <br> かいんでほうあんがかけつされました。 <br><br> (下院) <br> The bill was passed in the lower house.
下院で法案が可決されました。 <br><br> (下院)	<b>かいんでほうあんがかけつされました。</b> <br> The bill was passed in the lower house. <br> [sound:4c-s-下院で法案が可決されました。.mp3]
The bill was passed in the lower house.	<b>下院で法案が可決されました。</b> <br> かいんでほうあんがかけつされました。 <br><br> (下院) <br> [sound:4c-s-下院で法案が可決されました。.mp3]
[sound:4c-k-上院.mp3]	<b>上院</b> <br> じょういん <br> Upper House, Senate, Lords
上院	<b>じょういん</b> <br> Upper House, Senate, Lords <br> [sound:4c-k-上院.mp3]
Upper House, Senate, Lords	<b>上院</b> <br> じょういん <br> [sound:4c-k-上院.mp3]
[sound:4c-s-上院の承認を得る必要があります。.mp3]	<b>上院の承認を得る必要があります。</b> <br> じょういんのしょうにんをえるひつようがあります。 <br><br> (上院) <br> It is necessary to obtain approval from the upper house.
上院の承認を得る必要があります。 <br><br> (上院)	<b>じょういんのしょうにんをえるひつようがあります。</b> <br> It is necessary to obtain approval from the upper house. <br> [sound:4c-s-上院の承認を得る必要があります。.mp3]
It is necessary to obtain approval from the upper house.	<b>上院の承認を得る必要があります。</b> <br> じょういんのしょうにんをえるひつようがあります。 <br><br> (上院) <br> [sound:4c-s-上院の承認を得る必要があります。.mp3]
[sound:4c-k-学院.mp3]	<b>学院</b> <br> がくいん <br> institute, academy
学院	<b>がくいん</b> <br> institute, academy <br> [sound:4c-k-学院.mp3]
institute, academy	<b>学院</b> <br> がくいん <br> [sound:4c-k-学院.mp3]
[sound:4c-s-音楽学院に通っています。.mp3]	<b>音楽学院に通っています。</b> <br> おんがくがくいんにかよっています。 <br><br> (学院) <br> I attend a music academy.
音楽学院に通っています。 <br><br> (学院)	<b>おんがくがくいんにかよっています。</b> <br> I attend a music academy. <br> [sound:4c-s-音楽学院に通っています。.mp3]
I attend a music academy.	<b>音楽学院に通っています。</b> <br> おんがくがくいんにかよっています。 <br><br> (学院) <br> [sound:4c-s-音楽学院に通っています。.mp3]
[sound:4c-k-大学院.mp3]	<b>大学院</b> <br> だいがくいん <br> graduate school
大学院	<b>だいがくいん</b> <br> graduate school <br> [sound:4c-k-大学院.mp3]
graduate school	<b>大学院</b> <br> だいがくいん <br> [sound:4c-k-大学院.mp3]
[sound:4c-s-大学院で研究しています。.mp3]	<b>大学院で研究しています。</b> <br> だいがくいんでけんきゅうしています。 <br><br> (大学院) <br> I am conducting research in graduate school.
大学院で研究しています。 <br><br> (大学院)	<b>だいがくいんでけんきゅうしています。</b> <br> I am conducting research in graduate school. <br> [sound:4c-s-大学院で研究しています。.mp3]
I am conducting research in graduate school.	<b>大学院で研究しています。</b> <br> だいがくいんでけんきゅうしています。 <br><br> (大学院) <br> [sound:4c-s-大学院で研究しています。.mp3]
[sound:4c-k-男女.mp3]	<b>男女</b> <br> だんじょ <br> man and woman, men and women
男女	<b>だんじょ</b> <br> man and woman, men and women <br> [sound:4c-k-男女.mp3]
man and woman, men and women	<b>男女</b> <br> だんじょ <br> [sound:4c-k-男女.mp3]
[sound:4c-s-男女平等が重要です。.mp3]	<b>男女平等が重要です。</b> <br> だんじょびょうどうがじゅうようです。 <br><br> (男女) <br> Gender equality is important.
男女平等が重要です。 <br><br> (男女)	<b>だんじょびょうどうがじゅうようです。</b> <br> Gender equality is important. <br> [sound:4c-s-男女平等が重要です。.mp3]
Gender equality is important.	<b>男女平等が重要です。</b> <br> だんじょびょうどうがじゅうようです。 <br><br> (男女) <br> [sound:4c-s-男女平等が重要です。.mp3]
[sound:4c-k-彼女.mp3]	<b>彼女</b> <br> かのじょ <br> she, her; girl friend, girlfriend, sweetheart
彼女	<b>かのじょ</b> <br> she, her; girl friend, girlfriend, sweetheart <br> [sound:4c-k-彼女.mp3]
she, her; girl friend, girlfriend, sweetheart	<b>彼女</b> <br> かのじょ <br> [sound:4c-k-彼女.mp3]
[sound:4c-s-彼女は医者です。.mp3]	<b>彼女は医者です。</b> <br> かのじょはいしゃです。 <br><br> (彼女) <br> She is a doctor.
彼女は医者です。 <br><br> (彼女)	<b>かのじょはいしゃです。</b> <br> She is a doctor. <br> [sound:4c-s-彼女は医者です。.mp3]
She is a doctor.	<b>彼女は医者です。</b> <br> かのじょはいしゃです。 <br><br> (彼女) <br> [sound:4c-s-彼女は医者です。.mp3]
[sound:4c-k-女優.mp3]	<b>女優</b> <br> じょゆう <br> actress
女優	<b>じょゆう</b> <br> actress <br> [sound:4c-k-女優.mp3]
actress	<b>女優</b> <br> じょゆう <br> [sound:4c-k-女優.mp3]
[sound:4c-s-彼女は有名な女優です。.mp3]	<b>彼女は有名な女優です。</b> <br> かのじょはゆうめいなじょゆうです。 <br><br> (女優) <br> She is a famous actress.
彼女は有名な女優です。 <br><br> (女優)	<b>かのじょはゆうめいなじょゆうです。</b> <br> She is a famous actress. <br> [sound:4c-s-彼女は有名な女優です。.mp3]
She is a famous actress.	<b>彼女は有名な女優です。</b> <br> かのじょはゆうめいなじょゆうです。 <br><br> (女優) <br> [sound:4c-s-彼女は有名な女優です。.mp3]
[sound:4c-k-長女.mp3]	<b>長女</b> <br> ちょうじょ <br> eldest daughter
長女	<b>ちょうじょ</b> <br> eldest daughter <br> [sound:4c-k-長女.mp3]
eldest daughter	<b>長女</b> <br> ちょうじょ <br> [sound:4c-k-長女.mp3]
[sound:4c-s-長女は大学生です。.mp3]	<b>長女は大学生です。</b> <br> ちょうじょはだいがくせいです。 <br><br> (長女) <br> The eldest daughter is a university student.
長女は大学生です。 <br><br> (長女)	<b>ちょうじょはだいがくせいです。</b> <br> The eldest daughter is a university student. <br> [sound:4c-s-長女は大学生です。.mp3]
The eldest daughter is a university student.	<b>長女は大学生です。</b> <br> ちょうじょはだいがくせいです。 <br><br> (長女) <br> [sound:4c-s-長女は大学生です。.mp3]
[sound:4c-k-初日.mp3]	<b>初日</b> <br> しょにち <br> first or opening day
初日	<b>しょにち</b> <br> first or opening day <br> [sound:4c-k-初日.mp3]
first or opening day	<b>初日</b> <br> しょにち <br> [sound:4c-k-初日.mp3]
[sound:4c-s-初日に到着しました。.mp3]	<b>初日に到着しました。</b> <br> しょにちにとうちゃくしました。 <br><br> (初日) <br> I arrived on the first day.
初日に到着しました。 <br><br> (初日)	<b>しょにちにとうちゃくしました。</b> <br> I arrived on the first day. <br> [sound:4c-s-初日に到着しました。.mp3]
I arrived on the first day.	<b>初日に到着しました。</b> <br> しょにちにとうちゃくしました。 <br><br> (初日) <br> [sound:4c-s-初日に到着しました。.mp3]
[sound:4c-k-初期.mp3]	<b>初期</b> <br> しょき <br> early (days), initial stage; initial
初期	<b>しょき</b> <br> early (days), initial stage; initial <br> [sound:4c-k-初期.mp3]
early (days), initial stage; initial	<b>初期</b> <br> しょき <br> [sound:4c-k-初期.mp3]
[sound:4c-s-初期の段階では問題ありません。.mp3]	<b>初期の段階では問題ありません。</b> <br> しょきのだんかいではもんだいありません。 <br><br> (初期) <br> There are no problems in the initial stage.
初期の段階では問題ありません。 <br><br> (初期)	<b>しょきのだんかいではもんだいありません。</b> <br> There are no problems in the initial stage. <br> [sound:4c-s-初期の段階では問題ありません。.mp3]
There are no problems in the initial stage.	<b>初期の段階では問題ありません。</b> <br> しょきのだんかいではもんだいありません。 <br><br> (初期) <br> [sound:4c-s-初期の段階では問題ありません。.mp3]
[sound:4c-k-初代.mp3]	<b>初代</b> <br> しょだい <br> first generation, founder
初代	<b>しょだい</b> <br> first generation, founder <br> [sound:4c-k-初代.mp3]
first generation, founder	<b>初代</b> <br> しょだい <br> [sound:4c-k-初代.mp3]
[sound:4c-s-初代社長は厳格でした。.mp3]	<b>初代社長は厳格でした。</b> <br> しょだいしゃちょうはげんかくでした。 <br><br> (初代) <br> The first president was strict.
初代社長は厳格でした。 <br><br> (初代)	<b>しょだいしゃちょうはげんかくでした。</b> <br> The first president was strict. <br> [sound:4c-s-初代社長は厳格でした。.mp3]
The first president was strict.	<b>初代社長は厳格でした。</b> <br> しょだいしゃちょうはげんかくでした。 <br><br> (初代) <br> [sound:4c-s-初代社長は厳格でした。.mp3]
[sound:4c-k-初戦.mp3]	<b>初戦</b> <br> しょせん <br> first match (in a series)
初戦	<b>しょせん</b> <br> first match (in a series) <br> [sound:4c-k-初戦.mp3]
first match (in a series)	<b>初戦</b> <br> しょせん <br> [sound:4c-k-初戦.mp3]
[sound:4c-s-初戦で勝利を収めました。.mp3]	<b>初戦で勝利を収めました。</b> <br> しょせんでしょうりをおさめました。 <br><br> (初戦) <br> We achieved victory in the first match.
初戦で勝利を収めました。 <br><br> (初戦)	<b>しょせんでしょうりをおさめました。</b> <br> We achieved victory in the first match. <br> [sound:4c-s-初戦で勝利を収めました。.mp3]
We achieved victory in the first match.	<b>初戦で勝利を収めました。</b> <br> しょせんでしょうりをおさめました。 <br><br> (初戦) <br> [sound:4c-s-初戦で勝利を収めました。.mp3]
[sound:4c-k-北朝鮮.mp3]	<b>北朝鮮</b> <br> きたちょうせん <br> North Korea
北朝鮮	<b>きたちょうせん</b> <br> North Korea <br> [sound:4c-k-北朝鮮.mp3]
North Korea	<b>北朝鮮</b> <br> きたちょうせん <br> [sound:4c-k-北朝鮮.mp3]
[sound:4c-s-北朝鮮との関係は複雑です。.mp3]	<b>北朝鮮との関係は複雑です。</b> <br> きたちょうせんとのかんけいはふくざつです。 <br><br> (北朝鮮) <br> Relations with North Korea are complex.
北朝鮮との関係は複雑です。 <br><br> (北朝鮮)	<b>きたちょうせんとのかんけいはふくざつです。</b> <br> Relations with North Korea are complex. <br> [sound:4c-s-北朝鮮との関係は複雑です。.mp3]
Relations with North Korea are complex.	<b>北朝鮮との関係は複雑です。</b> <br> きたちょうせんとのかんけいはふくざつです。 <br><br> (北朝鮮) <br> [sound:4c-s-北朝鮮との関係は複雑です。.mp3]
[sound:4c-k-東北.mp3]	<b>東北</b> <br> とうほく, ひがしきた <br> north-east; Northern most six prefectures of Honshu
東北	<b>とうほく, ひがしきた</b> <br> north-east; Northern most six prefectures of Honshu <br> [sound:4c-k-東北.mp3]
north-east; Northern most six prefectures of Honshu	<b>東北</b> <br> とうほく, ひがしきた <br> [sound:4c-k-東北.mp3]
[sound:4c-s-東北地方は雪が多いです。.mp3]	<b>東北地方は雪が多いです。</b> <br> とうほくちほうはゆきがおおいです。 <br><br> (東北) <br> The Tohoku region has a lot of snow.
東北地方は雪が多いです。 <br><br> (東北)	<b>とうほくちほうはゆきがおおいです。</b> <br> The Tohoku region has a lot of snow. <br> [sound:4c-s-東北地方は雪が多いです。.mp3]
The Tohoku region has a lot of snow.	<b>東北地方は雪が多いです。</b> <br> とうほくちほうはゆきがおおいです。 <br><br> (東北) <br> [sound:4c-s-東北地方は雪が多いです。.mp3]
[sound:4c-k-南北.mp3]	<b>南北</b> <br> なんぼく <br> south and north
南北	<b>なんぼく</b> <br> south and north <br> [sound:4c-k-南北.mp3]
south and north	<b>南北</b> <br> なんぼく <br> [sound:4c-k-南北.mp3]
[sound:4c-s-南北戦争はアメリカの歴史の一部です。.mp3]	<b>南北戦争はアメリカの歴史の一部です。</b> <br> なんぼくせんそうはあめりかのれきしのいちぶです。 <br><br> (南北) <br> The Civil War is part of American history.
南北戦争はアメリカの歴史の一部です。 <br><br> (南北)	<b>なんぼくせんそうはあめりかのれきしのいちぶです。</b> <br> The Civil War is part of American history. <br> [sound:4c-s-南北戦争はアメリカの歴史の一部です。.mp3]
The Civil War is part of American history.	<b>南北戦争はアメリカの歴史の一部です。</b> <br> なんぼくせんそうはあめりかのれきしのいちぶです。 <br><br> (南北) <br> [sound:4c-s-南北戦争はアメリカの歴史の一部です。.mp3]
[sound:4c-k-北方.mp3]	<b>北方</b> <br> ほっぽう <br> northern (district), northward
北方	<b>ほっぽう</b> <br> northern (district), northward <br> [sound:4c-k-北方.mp3]
northern (district), northward	<b>北方</b> <br> ほっぽう <br> [sound:4c-k-北方.mp3]
[sound:4c-s-北方の国々との貿易が増加しています。.mp3]	<b>北方の国々との貿易が増加しています。</b> <br> ほっぽうのくにぐにとのぼうえきがぞうかしています。 <br><br> (北方) <br> Trade with northern countries is increasing.
北方の国々との貿易が増加しています。 <br><br> (北方)	<b>ほっぽうのくにぐにとのぼうえきがぞうかしています。</b> <br> Trade with northern countries is increasing. <br> [sound:4c-s-北方の国々との貿易が増加しています。.mp3]
Trade with northern countries is increasing.	<b>北方の国々との貿易が増加しています。</b> <br> ほっぽうのくにぐにとのぼうえきがぞうかしています。 <br><br> (北方) <br> [sound:4c-s-北方の国々との貿易が増加しています。.mp3]
[sound:4c-k-午.mp3]	<b>午</b> <br> うま <br> seventh sign of Chinese zodiac (The Horse, 11am-1pm, south, May)
午	<b>うま</b> <br> seventh sign of Chinese zodiac (The Horse, 11am-1pm, south, May) <br> [sound:4c-k-午.mp3]
seventh sign of Chinese zodiac (The Horse, 11am-1pm, south, May)	<b>午</b> <br> うま <br> [sound:4c-k-午.mp3]
[sound:4c-s-午後の会議はキャンセルされました。.mp3]	<b>午後の会議はキャンセルされました。</b> <br> ごごのかいぎはきゃんせるされました。 <br><br> (午) <br> The afternoon meeting was canceled.
午後の会議はキャンセルされました。 <br><br> (午)	<b>ごごのかいぎはきゃんせるされました。</b> <br> The afternoon meeting was canceled. <br> [sound:4c-s-午後の会議はキャンセルされました。.mp3]
The afternoon meeting was canceled.	<b>午後の会議はキャンセルされました。</b> <br> ごごのかいぎはきゃんせるされました。 <br><br> (午) <br> [sound:4c-s-午後の会議はキャンセルされました。.mp3]
[sound:4c-k-午.mp3]	<b>午</b> <br> ひる <br> noon, midday; daytime; lunch
午	<b>ひる</b> <br> noon, midday; daytime; lunch <br> [sound:4c-k-午.mp3]
noon, midday; daytime; lunch	<b>午</b> <br> ひる <br> [sound:4c-k-午.mp3]
[sound:4c-s-子午線を越えると時間が変わります。.mp3]	<b>子午線を越えると時間が変わります。</b> <br> しごせんをこえるとじかんがかわります。 <br><br> (子午線) <br> Crossing the meridian changes the time.
子午線を越えると時間が変わります。 <br><br> (子午線)	<b>しごせんをこえるとじかんがかわります。</b> <br> Crossing the meridian changes the time. <br> [sound:4c-s-子午線を越えると時間が変わります。.mp3]
Crossing the meridian changes the time.	<b>子午線を越えると時間が変わります。</b> <br> しごせんをこえるとじかんがかわります。 <br><br> (子午線) <br> [sound:4c-s-子午線を越えると時間が変わります。.mp3]
[sound:4c-k-子午線.mp3]	<b>子午線</b> <br> しごせん <br> the meridian
子午線	<b>しごせん</b> <br> the meridian <br> [sound:4c-k-子午線.mp3]
the meridian	<b>子午線</b> <br> しごせん <br> [sound:4c-k-子午線.mp3]
[sound:4c-s-端午の節句は子供の日です。.mp3]	<b>端午の節句は子供の日です。</b> <br> たんごのせっくはこどものひです。 <br><br> (端午) <br> The Tango Festival is Children's Day.
端午の節句は子供の日です。 <br><br> (端午)	<b>たんごのせっくはこどものひです。</b> <br> The Tango Festival is Children's Day. <br> [sound:4c-s-端午の節句は子供の日です。.mp3]
The Tango Festival is Children's Day.	<b>端午の節句は子供の日です。</b> <br> たんごのせっくはこどものひです。 <br><br> (端午) <br> [sound:4c-s-端午の節句は子供の日です。.mp3]
[sound:4c-k-端午.mp3]	<b>端午</b> <br> たんご <br> Boy's Day celebration (May 5th)
端午	<b>たんご</b> <br> Boy's Day celebration (May 5th) <br> [sound:4c-k-端午.mp3]
Boy's Day celebration (May 5th)	<b>端午</b> <br> たんご <br> [sound:4c-k-端午.mp3]
[sound:4c-s-指定された場所で待機してください。.mp3]	<b>指定された場所で待機してください。</b> <br> していされたばしょでたいきしてください。 <br><br> (指定) <br> Please wait at the designated location.
指定された場所で待機してください。 <br><br> (指定)	<b>していされたばしょでたいきしてください。</b> <br> Please wait at the designated location. <br> [sound:4c-s-指定された場所で待機してください。.mp3]
Please wait at the designated location.	<b>指定された場所で待機してください。</b> <br> していされたばしょでたいきしてください。 <br><br> (指定) <br> [sound:4c-s-指定された場所で待機してください。.mp3]
[sound:4c-k-指定.mp3]	<b>指定</b> <br> してい <br> designation, specification, assignment, appointment, pointing at
指定	<b>してい</b> <br> designation, specification, assignment, appointment, pointing at <br> [sound:4c-k-指定.mp3]
designation, specification, assignment, appointment, pointing at	<b>指定</b> <br> してい <br> [sound:4c-k-指定.mp3]
[sound:4c-s-彼をプロジェクトリーダーに指名しました。.mp3]	<b>彼をプロジェクトリーダーに指名しました。</b> <br> かれをぷろじぇくとりーだーにしめいしました。 <br><br> (指名) <br> I appointed him as the project leader.
彼をプロジェクトリーダーに指名しました。 <br><br> (指名)	<b>かれをぷろじぇくとりーだーにしめいしました。</b> <br> I appointed him as the project leader. <br> [sound:4c-s-彼をプロジェクトリーダーに指名しました。.mp3]
I appointed him as the project leader.	<b>彼をプロジェクトリーダーに指名しました。</b> <br> かれをぷろじぇくとりーだーにしめいしました。 <br><br> (指名) <br> [sound:4c-s-彼をプロジェクトリーダーに指名しました。.mp3]
[sound:4c-k-指名.mp3]	<b>指名</b> <br> しめい <br> name, nominate, designate
指名	<b>しめい</b> <br> name, nominate, designate <br> [sound:4c-k-指名.mp3]
name, nominate, designate	<b>指名</b> <br> しめい <br> [sound:4c-k-指名.mp3]
[sound:4c-s-上司からの指示に従ってください。.mp3]	<b>上司からの指示に従ってください。</b> <br> じょうしからのしじにしたがってください。 <br><br> (指示) <br> Please follow the instructions from your supervisor.
上司からの指示に従ってください。 <br><br> (指示)	<b>じょうしからのしじにしたがってください。</b> <br> Please follow the instructions from your supervisor. <br> [sound:4c-s-上司からの指示に従ってください。.mp3]
Please follow the instructions from your supervisor.	<b>上司からの指示に従ってください。</b> <br> じょうしからのしじにしたがってください。 <br><br> (指示) <br> [sound:4c-s-上司からの指示に従ってください。.mp3]
[sound:4c-k-指示.mp3]	<b>指示</b> <br> しじ <br> indication, instruction, designation, directions
指示	<b>しじ</b> <br> indication, instruction, designation, directions <br> [sound:4c-k-指示.mp3]
indication, instruction, designation, directions	<b>指示</b> <br> しじ <br> [sound:4c-k-指示.mp3]
[sound:4c-s-問題点を指摘してください。.mp3]	<b>問題点を指摘してください。</b> <br> もんだいてんをしてきしてください。 <br><br> (指摘) <br> Please point out the issues.
問題点を指摘してください。 <br><br> (指摘)	<b>もんだいてんをしてきしてください。</b> <br> Please point out the issues. <br> [sound:4c-s-問題点を指摘してください。.mp3]
Please point out the issues.	<b>問題点を指摘してください。</b> <br> もんだいてんをしてきしてください。 <br><br> (指摘) <br> [sound:4c-s-問題点を指摘してください。.mp3]
[sound:4c-k-指摘.mp3]	<b>指摘</b> <br> してき <br> pointing out, identification
指摘	<b>してき</b> <br> pointing out, identification <br> [sound:4c-k-指摘.mp3]
pointing out, identification	<b>指摘</b> <br> してき <br> [sound:4c-k-指摘.mp3]
[sound:4c-s-権力の乱用は許されません。.mp3]	<b>権力の乱用は許されません。</b> <br> けんりょくのらんようはゆるされません。 <br><br> (権力) <br> Abuse of power is not permitted.
権力の乱用は許されません。 <br><br> (権力)	<b>けんりょくのらんようはゆるされません。</b> <br> Abuse of power is not permitted. <br> [sound:4c-s-権力の乱用は許されません。.mp3]
Abuse of power is not permitted.	<b>権力の乱用は許されません。</b> <br> けんりょくのらんようはゆるされません。 <br><br> (権力) <br> [sound:4c-s-権力の乱用は許されません。.mp3]
[sound:4c-k-権力.mp3]	<b>権力</b> <br> けんりょく <br> (political) power, authority, influence
権力	<b>けんりょく</b> <br> (political) power, authority, influence <br> [sound:4c-k-権力.mp3]
(political) power, authority, influence	<b>権力</b> <br> けんりょく <br> [sound:4c-k-権力.mp3]
[sound:4c-s-人権を尊重することが大切です。.mp3]	<b>人権を尊重することが大切です。</b> <br> じんけんをそんちょうすることがたいせつです。 <br><br> (人権) <br> Respecting human rights is important.
人権を尊重することが大切です。 <br><br> (人権)	<b>じんけんをそんちょうすることがたいせつです。</b> <br> Respecting human rights is important. <br> [sound:4c-s-人権を尊重することが大切です。.mp3]
Respecting human rights is important.	<b>人権を尊重することが大切です。</b> <br> じんけんをそんちょうすることがたいせつです。 <br><br> (人権) <br> [sound:4c-s-人権を尊重することが大切です。.mp3]
[sound:4c-k-人権.mp3]	<b>人権</b> <br> じんけん <br> human rights, civil liberties
人権	<b>じんけん</b> <br> human rights, civil liberties <br> [sound:4c-k-人権.mp3]
human rights, civil liberties	<b>人権</b> <br> じんけん <br> [sound:4c-k-人権.mp3]
[sound:4c-s-その決定には権限が必要です。.mp3]	<b>その決定には権限が必要です。</b> <br> そのけっていにはけんげんがひつようです。 <br><br> (権限) <br> Authority is required for that decision.
その決定には権限が必要です。 <br><br> (権限)	<b>そのけっていにはけんげんがひつようです。</b> <br> Authority is required for that decision. <br> [sound:4c-s-その決定には権限が必要です。.mp3]
Authority is required for that decision.	<b>その決定には権限が必要です。</b> <br> そのけっていにはけんげんがひつようです。 <br><br> (権限) <br> [sound:4c-s-その決定には権限が必要です。.mp3]
[sound:4c-k-権限.mp3]	<b>権限</b> <br> けんげん <br> power, authority, jurisdiction
権限	<b>けんげん</b> <br> power, authority, jurisdiction <br> [sound:4c-k-権限.mp3]
power, authority, jurisdiction	<b>権限</b> <br> けんげん <br> [sound:4c-k-権限.mp3]
[sound:4c-s-債権者は返済を要求しています。.mp3]	<b>債権者は返済を要求しています。</b> <br> さいけんしゃはへんさいをようきゅうしています。 <br><br> (債権) <br> Creditors are demanding repayment.
債権者は返済を要求しています。 <br><br> (債権)	<b>さいけんしゃはへんさいをようきゅうしています。</b> <br> Creditors are demanding repayment. <br> [sound:4c-s-債権者は返済を要求しています。.mp3]
Creditors are demanding repayment.	<b>債権者は返済を要求しています。</b> <br> さいけんしゃはへんさいをようきゅうしています。 <br><br> (債権) <br> [sound:4c-s-債権者は返済を要求しています。.mp3]
[sound:4c-k-債権.mp3]	<b>債権</b> <br> さいけん <br> credit, claim
債権	<b>さいけん</b> <br> credit, claim <br> [sound:4c-k-債権.mp3]
credit, claim	<b>債権</b> <br> さいけん <br> [sound:4c-k-債権.mp3]
[sound:4c-s-心からお詫び申し上げます。.mp3]	<b>心からお詫び申し上げます。</b> <br> こころからおわびもうしあげます。 <br><br> (心から) <br> I sincerely apologize.
心からお詫び申し上げます。 <br><br> (心から)	<b>こころからおわびもうしあげます。</b> <br> I sincerely apologize. <br> [sound:4c-s-心からお詫び申し上げます。.mp3]
I sincerely apologize.	<b>心からお詫び申し上げます。</b> <br> こころからおわびもうしあげます。 <br><br> (心から) <br> [sound:4c-s-心からお詫び申し上げます。.mp3]
[sound:4c-k-心から.mp3]	<b>心から</b> <br> しんから, こころから <br> from the bottom of one's heart, heart and soul, by nature
心から	<b>しんから, こころから</b> <br> from the bottom of one's heart, heart and soul, by nature <br> [sound:4c-k-心から.mp3]
from the bottom of one's heart, heart and soul, by nature	<b>心から</b> <br> しんから, こころから <br> [sound:4c-k-心から.mp3]
[sound:4c-s-心臓の健康が重要です。.mp3]	<b>心臓の健康が重要です。</b> <br> しんぞうのけんこうがじゅうようです。 <br><br> (心臓) <br> Heart health is important.
心臓の健康が重要です。 <br><br> (心臓)	<b>しんぞうのけんこうがじゅうようです。</b> <br> Heart health is important. <br> [sound:4c-s-心臓の健康が重要です。.mp3]
Heart health is important.	<b>心臓の健康が重要です。</b> <br> しんぞうのけんこうがじゅうようです。 <br><br> (心臓) <br> [sound:4c-s-心臓の健康が重要です。.mp3]
[sound:4c-k-心臓.mp3]	<b>心臓</b> <br> しんぞう <br> heart
心臓	<b>しんぞう</b> <br> heart <br> [sound:4c-k-心臓.mp3]
heart	<b>心臓</b> <br> しんぞう <br> [sound:4c-k-心臓.mp3]
[sound:4c-s-試験の結果が心配です。.mp3]	<b>試験の結果が心配です。</b> <br> しけんのけっかがしんぱいです。 <br><br> (心配) <br> I am worried about the exam results.
試験の結果が心配です。 <br><br> (心配)	<b>しけんのけっかがしんぱいです。</b> <br> I am worried about the exam results. <br> [sound:4c-s-試験の結果が心配です。.mp3]
I am worried about the exam results.	<b>試験の結果が心配です。</b> <br> しけんのけっかがしんぱいです。 <br><br> (心配) <br> [sound:4c-s-試験の結果が心配です。.mp3]
[sound:4c-k-心配.mp3]	<b>心配</b> <br> しんぱい <br> worry, concern, anxiety; care, help, aid, assistance
心配	<b>しんぱい</b> <br> worry, concern, anxiety; care, help, aid, assistance <br> [sound:4c-k-心配.mp3]
worry, concern, anxiety; care, help, aid, assistance	<b>心配</b> <br> しんぱい <br> [sound:4c-k-心配.mp3]
[sound:4c-s-心理学を学んでいます。.mp3]	<b>心理学を学んでいます。</b> <br> しんりがくをまなんでいます。 <br><br> (心理) <br> I am studying psychology.
心理学を学んでいます。 <br><br> (心理)	<b>しんりがくをまなんでいます。</b> <br> I am studying psychology. <br> [sound:4c-s-心理学を学んでいます。.mp3]
I am studying psychology.	<b>心理学を学んでいます。</b> <br> しんりがくをまなんでいます。 <br><br> (心理) <br> [sound:4c-s-心理学を学んでいます。.mp3]
[sound:4c-k-心理.mp3]	<b>心理</b> <br> しんり <br> mentality
心理	<b>しんり</b> <br> mentality <br> [sound:4c-k-心理.mp3]
mentality	<b>心理</b> <br> しんり <br> [sound:4c-k-心理.mp3]
[sound:4c-s-財界のリーダーと会談しました。.mp3]	<b>財界のリーダーと会談しました。</b> <br> ざいかいのりーだーとかいだんしました。 <br><br> (財界) <br> I had a meeting with business leaders.
財界のリーダーと会談しました。 <br><br> (財界)	<b>ざいかいのりーだーとかいだんしました。</b> <br> I had a meeting with business leaders. <br> [sound:4c-s-財界のリーダーと会談しました。.mp3]
I had a meeting with business leaders.	<b>財界のリーダーと会談しました。</b> <br> ざいかいのりーだーとかいだんしました。 <br><br> (財界) <br> [sound:4c-s-財界のリーダーと会談しました。.mp3]
[sound:4c-k-財界.mp3]	<b>財界</b> <br> ざいかい <br> financial world
財界	<b>ざいかい</b> <br> financial world <br> [sound:4c-k-財界.mp3]
financial world	<b>財界</b> <br> ざいかい <br> [sound:4c-k-財界.mp3]
[sound:4c-s-この方法には限界があります。.mp3]	<b>この方法には限界があります。</b> <br> このほうほうにはげんかいがあります。 <br><br> (限界) <br> This method has its limits.
この方法には限界があります。 <br><br> (限界)	<b>このほうほうにはげんかいがあります。</b> <br> This method has its limits. <br> [sound:4c-s-この方法には限界があります。.mp3]
This method has its limits.	<b>この方法には限界があります。</b> <br> このほうほうにはげんかいがあります。 <br><br> (限界) <br> [sound:4c-s-この方法には限界があります。.mp3]
[sound:4c-k-限界.mp3]	<b>限界</b> <br> げんかい <br> limit, bound
限界	<b>げんかい</b> <br> limit, bound <br> [sound:4c-k-限界.mp3]
limit, bound	<b>限界</b> <br> げんかい <br> [sound:4c-k-限界.mp3]
[sound:4c-s-彼は世界的に有名な音楽家です。.mp3]	<b>彼は世界的に有名な音楽家です。</b> <br> かれはせかいてきにゆうめいなおんがくかです。 <br><br> (世界的) <br> He is a world-famous musician.
彼は世界的に有名な音楽家です。 <br><br> (世界的)	<b>かれはせかいてきにゆうめいなおんがくかです。</b> <br> He is a world-famous musician. <br> [sound:4c-s-彼は世界的に有名な音楽家です。.mp3]
He is a world-famous musician.	<b>彼は世界的に有名な音楽家です。</b> <br> かれはせかいてきにゆうめいなおんがくかです。 <br><br> (世界的) <br> [sound:4c-s-彼は世界的に有名な音楽家です。.mp3]
[sound:4c-k-世界的.mp3]	<b>世界的</b> <br> せかいてき <br> global, international, world-famous
世界的	<b>せかいてき</b> <br> global, international, world-famous <br> [sound:4c-k-世界的.mp3]
global, international, world-famous	<b>世界的</b> <br> せかいてき <br> [sound:4c-k-世界的.mp3]
[sound:4c-s-経済界は新しい政策に注目しています。.mp3]	<b>経済界は新しい政策に注目しています。</b> <br> けいざいかいはあたらしいせいさくにちゅうもくしています。 <br><br> (経済界) <br> The business world is paying attention to the new policy.
経済界は新しい政策に注目しています。 <br><br> (経済界)	<b>けいざいかいはあたらしいせいさくにちゅうもくしています。</b> <br> The business world is paying attention to the new policy. <br> [sound:4c-s-経済界は新しい政策に注目しています。.mp3]
The business world is paying attention to the new policy.	<b>経済界は新しい政策に注目しています。</b> <br> けいざいかいはあたらしいせいさくにちゅうもくしています。 <br><br> (経済界) <br> [sound:4c-s-経済界は新しい政策に注目しています。.mp3]
[sound:4c-k-経済界.mp3]	<b>経済界</b> <br> けいざいかい <br> economic world, financial circles
経済界	<b>けいざいかい</b> <br> economic world, financial circles <br> [sound:4c-k-経済界.mp3]
economic world, financial circles	<b>経済界</b> <br> けいざいかい <br> [sound:4c-k-経済界.mp3]
[sound:4c-s-新しい支店がオープンしました。.mp3]	<b>新しい支店がオープンしました。</b> <br> あたらしいしてんがオープンしました。 <br><br> (支店) <br> A new branch has opened.
新しい支店がオープンしました。 <br><br> (支店)	<b>あたらしいしてんがオープンしました。</b> <br> A new branch has opened. <br> [sound:4c-s-新しい支店がオープンしました。.mp3]
A new branch has opened.	<b>新しい支店がオープンしました。</b> <br> あたらしいしてんがオープンしました。 <br><br> (支店) <br> [sound:4c-s-新しい支店がオープンしました。.mp3]
[sound:4c-k-支店.mp3]	<b>支店</b> <br> してん <br> branch store (office)
支店	<b>してん</b> <br> branch store (office) <br> [sound:4c-k-支店.mp3]
branch store (office)	<b>支店</b> <br> してん <br> [sound:4c-k-支店.mp3]
[sound:4c-s-その国は長い間他国に支配されていました。.mp3]	<b>その国は長い間他国に支配されていました。</b> <br> そのくにはながいあいだたこくにしはいされていました。 <br><br> (支配) <br> The country was ruled by another for a long time.
その国は長い間他国に支配されていました。 <br><br> (支配)	<b>そのくにはながいあいだたこくにしはいされていました。</b> <br> The country was ruled by another for a long time. <br> [sound:4c-s-その国は長い間他国に支配されていました。.mp3]
The country was ruled by another for a long time.	<b>その国は長い間他国に支配されていました。</b> <br> そのくにはながいあいだたこくにしはいされていました。 <br><br> (支配) <br> [sound:4c-s-その国は長い間他国に支配されていました。.mp3]
[sound:4c-k-支配.mp3]	<b>支配</b> <br> しはい <br> rule, control, direction
支配	<b>しはい</b> <br> rule, control, direction <br> [sound:4c-k-支配.mp3]
rule, control, direction	<b>支配</b> <br> しはい <br> [sound:4c-k-支配.mp3]
[sound:4c-s-東京に新しい支部を設置しました。.mp3]	<b>東京に新しい支部を設置しました。</b> <br> とうきょうにあたらしいしぶをせっちしました。 <br><br> (支部) <br> We established a new branch office in Tokyo.
東京に新しい支部を設置しました。 <br><br> (支部)	<b>とうきょうにあたらしいしぶをせっちしました。</b> <br> We established a new branch office in Tokyo. <br> [sound:4c-s-東京に新しい支部を設置しました。.mp3]
We established a new branch office in Tokyo.	<b>東京に新しい支部を設置しました。</b> <br> とうきょうにあたらしいしぶをせっちしました。 <br><br> (支部) <br> [sound:4c-s-東京に新しい支部を設置しました。.mp3]
[sound:4c-k-支部.mp3]	<b>支部</b> <br> しぶ <br> branch, subdivision
支部	<b>しぶ</b> <br> branch, subdivision <br> [sound:4c-k-支部.mp3]
branch, subdivision	<b>支部</b> <br> しぶ <br> [sound:4c-k-支部.mp3]
[sound:4c-s-会社の収支は黒字です。.mp3]	<b>会社の収支は黒字です。</b> <br> かいしゃのしゅうしはくろじです。 <br><br> (収支) <br> The company's balance is in the black.
会社の収支は黒字です。 <br><br> (収支)	<b>かいしゃのしゅうしはくろじです。</b> <br> The company's balance is in the black. <br> [sound:4c-s-会社の収支は黒字です。.mp3]
The company's balance is in the black.	<b>会社の収支は黒字です。</b> <br> かいしゃのしゅうしはくろじです。 <br><br> (収支) <br> [sound:4c-s-会社の収支は黒字です。.mp3]
[sound:4c-k-収支.mp3]	<b>収支</b> <br> しゅうし <br> income and expenditure
収支	<b>しゅうし</b> <br> income and expenditure <br> [sound:4c-k-収支.mp3]
income and expenditure	<b>収支</b> <br> しゅうし <br> [sound:4c-k-収支.mp3]
[sound:4c-s-彼はその分野の第一人者です。.mp3]	<b>彼はその分野の第一人者です。</b> <br> かれはそのぶんやのだいいちにんしゃです。 <br><br> (第一人者) <br> He is the leading expert in that field.
彼はその分野の第一人者です。 <br><br> (第一人者)	<b>かれはそのぶんやのだいいちにんしゃです。</b> <br> He is the leading expert in that field. <br> [sound:4c-s-彼はその分野の第一人者です。.mp3]
He is the leading expert in that field.	<b>彼はその分野の第一人者です。</b> <br> かれはそのぶんやのだいいちにんしゃです。 <br><br> (第一人者) <br> [sound:4c-s-彼はその分野の第一人者です。.mp3]
[sound:4c-k-第一人者.mp3]	<b>第一人者</b> <br> だいいちにんしゃ <br> leading person
第一人者	<b>だいいちにんしゃ</b> <br> leading person <br> [sound:4c-k-第一人者.mp3]
leading person	<b>第一人者</b> <br> だいいちにんしゃ <br> [sound:4c-k-第一人者.mp3]
[sound:4c-s-第二次世界大戦は多くの国を巻き込みました。.mp3]	<b>第二次世界大戦は多くの国を巻き込みました。</b> <br> だいにじせかいたいせんはおおくのくにをまきこみました。 <br><br> (第二次世界大戦) <br> World War II involved many countries.
第二次世界大戦は多くの国を巻き込みました。 <br><br> (第二次世界大戦)	<b>だいにじせかいたいせんはおおくのくにをまきこみました。</b> <br> World War II involved many countries. <br> [sound:4c-s-第二次世界大戦は多くの国を巻き込みました。.mp3]
World War II involved many countries.	<b>第二次世界大戦は多くの国を巻き込みました。</b> <br> だいにじせかいたいせんはおおくのくにをまきこみました。 <br><br> (第二次世界大戦) <br> [sound:4c-s-第二次世界大戦は多くの国を巻き込みました。.mp3]
[sound:4c-k-第二次世界大戦.mp3]	<b>第二次世界大戦</b> <br> だいにじせかいたいせん <br> World War II
第二次世界大戦	<b>だいにじせかいたいせん</b> <br> World War II <br> [sound:4c-k-第二次世界大戦.mp3]
World War II	<b>第二次世界大戦</b> <br> だいにじせかいたいせん <br> [sound:4c-k-第二次世界大戦.mp3]
[sound:4c-s-彼は今も第一線で活躍しています。.mp3]	<b>彼は今も第一線で活躍しています。</b> <br> かれはいまもだいいっせんでかつやくしています。 <br><br> (第一線) <br> He is still active on the front lines.
彼は今も第一線で活躍しています。 <br><br> (第一線)	<b>かれはいまもだいいっせんでかつやくしています。</b> <br> He is still active on the front lines. <br> [sound:4c-s-彼は今も第一線で活躍しています。.mp3]
He is still active on the front lines.	<b>彼は今も第一線で活躍しています。</b> <br> かれはいまもだいいっせんでかつやくしています。 <br><br> (第一線) <br> [sound:4c-s-彼は今も第一線で活躍しています。.mp3]
[sound:4c-k-第一線.mp3]	<b>第一線</b> <br> だいいっせん <br> the front (of a battlefield), forefront
第一線	<b>だいいっせん</b> <br> the front (of a battlefield), forefront <br> [sound:4c-k-第一線.mp3]
the front (of a battlefield), forefront	<b>第一線</b> <br> だいいっせん <br> [sound:4c-k-第一線.mp3]
[sound:4c-s-彼の第一声に皆が注目しました。.mp3]	<b>彼の第一声に皆が注目しました。</b> <br> かれのだいいっせいにみながちゅうもくしました。 <br><br> (第一声) <br> Everyone paid attention to his first words.
彼の第一声に皆が注目しました。 <br><br> (第一声)	<b>かれのだいいっせいにみながちゅうもくしました。</b> <br> Everyone paid attention to his first words. <br> [sound:4c-s-彼の第一声に皆が注目しました。.mp3]
Everyone paid attention to his first words.	<b>彼の第一声に皆が注目しました。</b> <br> かれのだいいっせいにみながちゅうもくしました。 <br><br> (第一声) <br> [sound:4c-s-彼の第一声に皆が注目しました。.mp3]
[sound:4c-k-第一声.mp3]	<b>第一声</b> <br> だいいっせい <br> first tone, first speech
第一声	<b>だいいっせい</b> <br> first tone, first speech <br> [sound:4c-k-第一声.mp3]
first tone, first speech	<b>第一声</b> <br> だいいっせい <br> [sound:4c-k-第一声.mp3]
[sound:4c-s-彼は多くの資産を持っています。.mp3]	<b>彼は多くの資産を持っています。</b> <br> かれはおおくのしさんをもっています。 <br><br> (資産) <br> He owns a lot of assets.
彼は多くの資産を持っています。 <br><br> (資産)	<b>かれはおおくのしさんをもっています。</b> <br> He owns a lot of assets. <br> [sound:4c-s-彼は多くの資産を持っています。.mp3]
He owns a lot of assets.	<b>彼は多くの資産を持っています。</b> <br> かれはおおくのしさんをもっています。 <br><br> (資産) <br> [sound:4c-s-彼は多くの資産を持っています。.mp3]
[sound:4c-k-資産.mp3]	<b>資産</b> <br> しさん <br> property, fortune, means, assets
資産	<b>しさん</b> <br> property, fortune, means, assets <br> [sound:4c-k-資産.mp3]
property, fortune, means, assets	<b>資産</b> <br> しさん <br> [sound:4c-k-資産.mp3]
[sound:4c-s-不動産業界が成長しています。.mp3]	<b>不動産業界が成長しています。</b> <br> ふどうさんぎょうかいがせいちょうしています。 <br><br> (不動産) <br> The real estate industry is growing.
不動産業界が成長しています。 <br><br> (不動産)	<b>ふどうさんぎょうかいがせいちょうしています。</b> <br> The real estate industry is growing. <br> [sound:4c-s-不動産業界が成長しています。.mp3]
The real estate industry is growing.	<b>不動産業界が成長しています。</b> <br> ふどうさんぎょうかいがせいちょうしています。 <br><br> (不動産) <br> [sound:4c-s-不動産業界が成長しています。.mp3]
[sound:4c-k-不動産.mp3]	<b>不動産</b> <br> ふどうさん <br> real estate
不動産	<b>ふどうさん</b> <br> real estate <br> [sound:4c-k-不動産.mp3]
real estate	<b>不動産</b> <br> ふどうさん <br> [sound:4c-k-不動産.mp3]
[sound:4c-s-通産省は産業政策を担当しています。.mp3]	<b>通産省は産業政策を担当しています。</b> <br> つうさんしょうはさんぎょうせいさくをたんとうしています。 <br><br> (通産省) <br> The Ministry of International Trade and Industry handles industrial policy.
通産省は産業政策を担当しています。 <br><br> (通産省)	<b>つうさんしょうはさんぎょうせいさくをたんとうしています。</b> <br> The Ministry of International Trade and Industry handles industrial policy. <br> [sound:4c-s-通産省は産業政策を担当しています。.mp3]
The Ministry of International Trade and Industry handles industrial policy.	<b>通産省は産業政策を担当しています。</b> <br> つうさんしょうはさんぎょうせいさくをたんとうしています。 <br><br> (通産省) <br> [sound:4c-s-通産省は産業政策を担当しています。.mp3]
[sound:4c-k-通産省.mp3]	<b>通産省</b> <br> つうさんしょう <br> (former) Ministry of International Trade and Industry (now Ministry of Economy, Trade and Industry), MITI
通産省	<b>つうさんしょう</b> <br> (former) Ministry of International Trade and Industry (now Ministry of Economy, Trade and Industry), MITI <br> [sound:4c-k-通産省.mp3]
(former) Ministry of International Trade and Industry (now Ministry of Economy, Trade and Industry), MITI	<b>通産省</b> <br> つうさんしょう <br> [sound:4c-k-通産省.mp3]
[sound:4c-s-彼は共産主義を支持しています。.mp3]	<b>彼は共産主義を支持しています。</b> <br> かれはきょうさんしゅぎをしじしています。 <br><br> (共産) <br> He supports communism.
彼は共産主義を支持しています。 <br><br> (共産)	<b>かれはきょうさんしゅぎをしじしています。</b> <br> He supports communism. <br> [sound:4c-s-彼は共産主義を支持しています。.mp3]
He supports communism.	<b>彼は共産主義を支持しています。</b> <br> かれはきょうさんしゅぎをしじしています。 <br><br> (共産) <br> [sound:4c-s-彼は共産主義を支持しています。.mp3]
[sound:4c-k-共産.mp3]	<b>共産</b> <br> きょうさん <br> communism; Communist Party
共産	<b>きょうさん</b> <br> communism; Communist Party <br> [sound:4c-k-共産.mp3]
communism; Communist Party	<b>共産</b> <br> きょうさん <br> [sound:4c-k-共産.mp3]
[sound:4c-s-結論を出すのはまだ早いです。.mp3]	<b>結論を出すのはまだ早いです。</b> <br> けつろんをだすのはまだはやいです。 <br><br> (結論) <br> It is too early to draw a conclusion.
結論を出すのはまだ早いです。 <br><br> (結論)	<b>けつろんをだすのはまだはやいです。</b> <br> It is too early to draw a conclusion. <br> [sound:4c-s-結論を出すのはまだ早いです。.mp3]
It is too early to draw a conclusion.	<b>結論を出すのはまだ早いです。</b> <br> けつろんをだすのはまだはやいです。 <br><br> (結論) <br> [sound:4c-s-結論を出すのはまだ早いです。.mp3]
[sound:4c-k-結論.mp3]	<b>結論</b> <br> けつろん <br> conclusion
結論	<b>けつろん</b> <br> conclusion <br> [sound:4c-k-結論.mp3]
conclusion	<b>結論</b> <br> けつろん <br> [sound:4c-k-結論.mp3]
[sound:4c-s-二国間で平和条約を結びました。.mp3]	<b>二国間で平和条約を結びました。</b> <br> にこくかんでへいわじょうやくをむすびました。 <br><br> (結ぶ) <br> The two countries signed a peace treaty.
二国間で平和条約を結びました。 <br><br> (結ぶ)	<b>にこくかんでへいわじょうやくをむすびました。</b> <br> The two countries signed a peace treaty. <br> [sound:4c-s-二国間で平和条約を結びました。.mp3]
The two countries signed a peace treaty.	<b>二国間で平和条約を結びました。</b> <br> にこくかんでへいわじょうやくをむすびました。 <br><br> (結ぶ) <br> [sound:4c-s-二国間で平和条約を結びました。.mp3]
[sound:4c-k-結ぶ.mp3]	<b>結ぶ</b> <br> むすぶ <br> to tie, to bind, to link; to bear (fruit)
結ぶ	<b>むすぶ</b> <br> to tie, to bind, to link; to bear (fruit) <br> [sound:4c-k-結ぶ.mp3]
to tie, to bind, to link; to bear (fruit)	<b>結ぶ</b> <br> むすぶ <br> [sound:4c-k-結ぶ.mp3]
[sound:4c-s-新しい政党が結成されました。.mp3]	<b>新しい政党が結成されました。</b> <br> あたらしいせいとうがけっせいされました。 <br><br> (結成) <br> A new political party has been formed.
新しい政党が結成されました。 <br><br> (結成)	<b>あたらしいせいとうがけっせいされました。</b> <br> A new political party has been formed. <br> [sound:4c-s-新しい政党が結成されました。.mp3]
A new political party has been formed.	<b>新しい政党が結成されました。</b> <br> あたらしいせいとうがけっせいされました。 <br><br> (結成) <br> [sound:4c-s-新しい政党が結成されました。.mp3]
[sound:4c-k-結成.mp3]	<b>結成</b> <br> けっせい <br> formation
結成	<b>けっせい</b> <br> formation <br> [sound:4c-k-結成.mp3]
formation	<b>結成</b> <br> けっせい <br> [sound:4c-k-結成.mp3]
[sound:4c-s-戦争が終結しました。.mp3]	<b>戦争が終結しました。</b> <br> せんそうがしゅうけつしました。 <br><br> (終結) <br> The war has ended.
戦争が終結しました。 <br><br> (終結)	<b>せんそうがしゅうけつしました。</b> <br> The war has ended. <br> [sound:4c-s-戦争が終結しました。.mp3]
The war has ended.	<b>戦争が終結しました。</b> <br> せんそうがしゅうけつしました。 <br><br> (終結) <br> [sound:4c-s-戦争が終結しました。.mp3]
[sound:4c-k-終結.mp3]	<b>終結</b> <br> しゅうけつ <br> end, close
終結	<b>しゅうけつ</b> <br> end, close <br> [sound:4c-k-終結.mp3]
end, close	<b>終結</b> <br> しゅうけつ <br> [sound:4c-k-終結.mp3]
[sound:4c-s-その百貨店は歴史が長いです。.mp3]	<b>その百貨店は歴史が長いです。</b> <br> そのひゃっかてんはれきしがながいです。 <br><br> (百貨店) <br> That department store has a long history.
その百貨店は歴史が長いです。 <br><br> (百貨店)	<b>そのひゃっかてんはれきしがながいです。</b> <br> That department store has a long history. <br> [sound:4c-s-その百貨店は歴史が長いです。.mp3]
That department store has a long history.	<b>その百貨店は歴史が長いです。</b> <br> そのひゃっかてんはれきしがながいです。 <br><br> (百貨店) <br> [sound:4c-s-その百貨店は歴史が長いです。.mp3]
[sound:4c-k-百貨店.mp3]	<b>百貨店</b> <br> ひゃっかてん <br> (department) store(s)
百貨店	<b>ひゃっかてん</b> <br> (department) store(s) <br> [sound:4c-k-百貨店.mp3]
(department) store(s)	<b>百貨店</b> <br> ひゃっかてん <br> [sound:4c-k-百貨店.mp3]
[sound:4c-s-百万の人々が参加しました。.mp3]	<b>百万の人々が参加しました。</b> <br> ひゃくまんのひとびとがさんかしました。 <br><br> (百万) <br> A million people participated.
百万の人々が参加しました。 <br><br> (百万)	<b>ひゃくまんのひとびとがさんかしました。</b> <br> A million people participated. <br> [sound:4c-s-百万の人々が参加しました。.mp3]
A million people participated.	<b>百万の人々が参加しました。</b> <br> ひゃくまんのひとびとがさんかしました。 <br><br> (百万) <br> [sound:4c-s-百万の人々が参加しました。.mp3]
[sound:4c-k-百万.mp3]	<b>百万</b> <br> ひゃくまん <br> 1,000,000, one million; many
百万	<b>ひゃくまん</b> <br> 1,000,000, one million; many <br> [sound:4c-k-百万.mp3]
1,000,000, one million; many	<b>百万</b> <br> ひゃくまん <br> [sound:4c-k-百万.mp3]
[sound:4c-s-四百人が集まりました。.mp3]	<b>四百人が集まりました。</b> <br> よんひゃくにんがあつまりました。 <br><br> (四百) <br> Four hundred people gathered.
四百人が集まりました。 <br><br> (四百)	<b>よんひゃくにんがあつまりました。</b> <br> Four hundred people gathered. <br> [sound:4c-s-四百人が集まりました。.mp3]
Four hundred people gathered.	<b>四百人が集まりました。</b> <br> よんひゃくにんがあつまりました。 <br><br> (四百) <br> [sound:4c-s-四百人が集まりました。.mp3]
[sound:4c-k-四百.mp3]	<b>四百</b> <br> よんひゃく <br> four hundred
四百	<b>よんひゃく</b> <br> four hundred <br> [sound:4c-k-四百.mp3]
four hundred	<b>四百</b> <br> よんひゃく <br> [sound:4c-k-四百.mp3]
[sound:4c-s-そのプロジェクトは百億円かかりました。.mp3]	<b>そのプロジェクトは百億円かかりました。</b> <br> そのぷろじぇくとはひゃくおくえんかかりました。 <br><br> (百億) <br> The project cost ten billion yen.
そのプロジェクトは百億円かかりました。 <br><br> (百億)	<b>そのぷろじぇくとはひゃくおくえんかかりました。</b> <br> The project cost ten billion yen. <br> [sound:4c-s-そのプロジェクトは百億円かかりました。.mp3]
The project cost ten billion yen.	<b>そのプロジェクトは百億円かかりました。</b> <br> そのぷろじぇくとはひゃくおくえんかかりました。 <br><br> (百億) <br> [sound:4c-s-そのプロジェクトは百億円かかりました。.mp3]
[sound:4c-k-百億.mp3]	<b>百億</b> <br> ひゃくおく <br> 10,000,000,000, ten billion (American), (obs) ten milliard (British)
百億	<b>ひゃくおく</b> <br> 10,000,000,000, ten billion (American), (obs) ten milliard (British) <br> [sound:4c-k-百億.mp3]
10,000,000,000, ten billion (American), (obs) ten milliard (British)	<b>百億</b> <br> ひゃくおく <br> [sound:4c-k-百億.mp3]
[sound:4c-s-右派の意見が議論されました。.mp3]	<b>右派の意見が議論されました。</b> <br> うはのいけんがぎろんされました。 <br><br> (右派) <br> The opinions of the right wing were discussed.
右派の意見が議論されました。 <br><br> (右派)	<b>うはのいけんがぎろんされました。</b> <br> The opinions of the right wing were discussed. <br> [sound:4c-s-右派の意見が議論されました。.mp3]
The opinions of the right wing were discussed.	<b>右派の意見が議論されました。</b> <br> うはのいけんがぎろんされました。 <br><br> (右派) <br> [sound:4c-s-右派の意見が議論されました。.mp3]
[sound:4c-k-右派.mp3]	<b>右派</b> <br> うは <br> right wing
右派	<b>うは</b> <br> right wing <br> [sound:4c-k-右派.mp3]
right wing	<b>右派</b> <br> うは <br> [sound:4c-k-右派.mp3]
[sound:4c-s-左派の支持が増えています。.mp3]	<b>左派の支持が増えています。</b> <br> さはのしじがふえています。 <br><br> (左派) <br> Support for the left wing is increasing.
左派の支持が増えています。 <br><br> (左派)	<b>さはのしじがふえています。</b> <br> Support for the left wing is increasing. <br> [sound:4c-s-左派の支持が増えています。.mp3]
Support for the left wing is increasing.	<b>左派の支持が増えています。</b> <br> さはのしじがふえています。 <br><br> (左派) <br> [sound:4c-s-左派の支持が増えています。.mp3]
[sound:4c-k-左派.mp3]	<b>左派</b> <br> さは <br> left wing
左派	<b>さは</b> <br> left wing <br> [sound:4c-k-左派.mp3]
left wing	<b>左派</b> <br> さは <br> [sound:4c-k-左派.mp3]
[sound:4c-s-新聞社の特派員が現地に到着しました。.mp3]	<b>新聞社の特派員が現地に到着しました。</b> <br> しんぶんしゃのとくはいんがげんちにとうちゃくしました。 <br><br> (特派員) <br> The newspaper's correspondent arrived on site.
新聞社の特派員が現地に到着しました。 <br><br> (特派員)	<b>しんぶんしゃのとくはいんがげんちにとうちゃくしました。</b> <br> The newspaper's correspondent arrived on site. <br> [sound:4c-s-新聞社の特派員が現地に到着しました。.mp3]
The newspaper's correspondent arrived on site.	<b>新聞社の特派員が現地に到着しました。</b> <br> しんぶんしゃのとくはいんがげんちにとうちゃくしました。 <br><br> (特派員) <br> [sound:4c-s-新聞社の特派員が現地に到着しました。.mp3]
[sound:4c-k-特派員.mp3]	<b>特派員</b> <br> とくはいん <br> correspondent
特派員	<b>とくはいん</b> <br> correspondent <br> [sound:4c-k-特派員.mp3]
correspondent	<b>特派員</b> <br> とくはいん <br> [sound:4c-k-特派員.mp3]
[sound:4c-s-彼は硬派な政治家として知られています。.mp3]	<b>彼は硬派な政治家として知られています。</b> <br> かれはこうはなせいじかとしてしられています。 <br><br> (硬派) <br> He is known as a hardline politician.
彼は硬派な政治家として知られています。 <br><br> (硬派)	<b>かれはこうはなせいじかとしてしられています。</b> <br> He is known as a hardline politician. <br> [sound:4c-s-彼は硬派な政治家として知られています。.mp3]
He is known as a hardline politician.	<b>彼は硬派な政治家として知られています。</b> <br> かれはこうはなせいじかとしてしられています。 <br><br> (硬派) <br> [sound:4c-s-彼は硬派な政治家として知られています。.mp3]
[sound:4c-k-硬派.mp3]	<b>硬派</b> <br> こうは <br> tough elements, hard-liners, stalwart(s)
硬派	<b>こうは</b> <br> tough elements, hard-liners, stalwart(s) <br> [sound:4c-k-硬派.mp3]
tough elements, hard-liners, stalwart(s)	<b>硬派</b> <br> こうは <br> [sound:4c-k-硬派.mp3]
[sound:4c-s-その時点ではまだ何も分かりませんでした。.mp3]	<b>その時点ではまだ何も分かりませんでした。</b> <br> そのじてんではまだなにもわかりませんでした。 <br><br> (時点) <br> At that point in time, nothing was known.
その時点ではまだ何も分かりませんでした。 <br><br> (時点)	<b>そのじてんではまだなにもわかりませんでした。</b> <br> At that point in time, nothing was known. <br> [sound:4c-s-その時点ではまだ何も分かりませんでした。.mp3]
At that point in time, nothing was known.	<b>その時点ではまだ何も分かりませんでした。</b> <br> そのじてんではまだなにもわかりませんでした。 <br><br> (時点) <br> [sound:4c-s-その時点ではまだ何も分かりませんでした。.mp3]
[sound:4c-k-時点.mp3]	<b>時点</b> <br> じてん <br> point in time, occasion
時点	<b>じてん</b> <br> point in time, occasion <br> [sound:4c-k-時点.mp3]
point in time, occasion	<b>時点</b> <br> じてん <br> [sound:4c-k-時点.mp3]
[sound:4c-s-彼は試合で最高得点を取りました。.mp3]	<b>彼は試合で最高得点を取りました。</b> <br> かれはしあいでさいこうとくてんをとりました。 <br><br> (得点) <br> He scored the highest points in the game.
彼は試合で最高得点を取りました。 <br><br> (得点)	<b>かれはしあいでさいこうとくてんをとりました。</b> <br> He scored the highest points in the game. <br> [sound:4c-s-彼は試合で最高得点を取りました。.mp3]
He scored the highest points in the game.	<b>彼は試合で最高得点を取りました。</b> <br> かれはしあいでさいこうとくてんをとりました。 <br><br> (得点) <br> [sound:4c-s-彼は試合で最高得点を取りました。.mp3]
[sound:4c-k-得点.mp3]	<b>得点</b> <br> とくてん <br> score, points made, marks obtained, runs
得点	<b>とくてん</b> <br> score, points made, marks obtained, runs <br> [sound:4c-k-得点.mp3]
score, points made, marks obtained, runs	<b>得点</b> <br> とくてん <br> [sound:4c-k-得点.mp3]
[sound:4c-s-新しい視点から問題を考えてみましょう。.mp3]	<b>新しい視点から問題を考えてみましょう。</b> <br> あたらしいしてんからもんだいをかんがえてみましょう。 <br><br> (視点) <br> Let’s look at the problem from a new perspective.
新しい視点から問題を考えてみましょう。 <br><br> (視点)	<b>あたらしいしてんからもんだいをかんがえてみましょう。</b> <br> Let’s look at the problem from a new perspective. <br> [sound:4c-s-新しい視点から問題を考えてみましょう。.mp3]
Let’s look at the problem from a new perspective.	<b>新しい視点から問題を考えてみましょう。</b> <br> あたらしいしてんからもんだいをかんがえてみましょう。 <br><br> (視点) <br> [sound:4c-s-新しい視点から問題を考えてみましょう。.mp3]
[sound:4c-k-視点.mp3]	<b>視点</b> <br> してん <br> opinion, point of view, visual point
視点	<b>してん</b> <br> opinion, point of view, visual point <br> [sound:4c-k-視点.mp3]
opinion, point of view, visual point	<b>視点</b> <br> してん <br> [sound:4c-k-視点.mp3]
[sound:4c-s-後半に二失点しました。.mp3]	<b>後半に二失点しました。</b> <br> こうはんににしってんしました。 <br><br> (失点) <br> We conceded two points in the second half.
後半に二失点しました。 <br><br> (失点)	<b>こうはんににしってんしました。</b> <br> We conceded two points in the second half. <br> [sound:4c-s-後半に二失点しました。.mp3]
We conceded two points in the second half.	<b>後半に二失点しました。</b> <br> こうはんににしってんしました。 <br><br> (失点) <br> [sound:4c-s-後半に二失点しました。.mp3]
[sound:4c-k-失点.mp3]	<b>失点</b> <br> しってん <br> run charged to the pitcher
失点	<b>しってん</b> <br> run charged to the pitcher <br> [sound:4c-k-失点.mp3]
run charged to the pitcher	<b>失点</b> <br> しってん <br> [sound:4c-k-失点.mp3]
[sound:4c-s-宗教の自由は大切です。.mp3]	<b>宗教の自由は大切です。</b> <br> しゅうきょうのじゆうはたいせつです。 <br><br> (宗教) <br> Freedom of religion is important.
宗教の自由は大切です。 <br><br> (宗教)	<b>しゅうきょうのじゆうはたいせつです。</b> <br> Freedom of religion is important. <br> [sound:4c-s-宗教の自由は大切です。.mp3]
Freedom of religion is important.	<b>宗教の自由は大切です。</b> <br> しゅうきょうのじゆうはたいせつです。 <br><br> (宗教) <br> [sound:4c-s-宗教の自由は大切です。.mp3]
[sound:4c-k-宗教.mp3]	<b>宗教</b> <br> しゅうきょう <br> religion
宗教	<b>しゅうきょう</b> <br> religion <br> [sound:4c-k-宗教.mp3]
religion	<b>宗教</b> <br> しゅうきょう <br> [sound:4c-k-宗教.mp3]
[sound:4c-s-教室で授業が始まりました。.mp3]	<b>教室で授業が始まりました。</b> <br> きょうしつでじゅぎょうがはじまりました。 <br><br> (教室) <br> Class has started in the classroom.
教室で授業が始まりました。 <br><br> (教室)	<b>きょうしつでじゅぎょうがはじまりました。</b> <br> Class has started in the classroom. <br> [sound:4c-s-教室で授業が始まりました。.mp3]
Class has started in the classroom.	<b>教室で授業が始まりました。</b> <br> きょうしつでじゅぎょうがはじまりました。 <br><br> (教室) <br> [sound:4c-s-教室で授業が始まりました。.mp3]
[sound:4c-k-教室.mp3]	<b>教室</b> <br> きょうしつ <br> classroom
教室	<b>きょうしつ</b> <br> classroom <br> [sound:4c-k-教室.mp3]
classroom	<b>教室</b> <br> きょうしつ <br> [sound:4c-k-教室.mp3]
[sound:4c-s-イスラム教徒が集まって祈りを捧げました。.mp3]	<b>イスラム教徒が集まって祈りを捧げました。</b> <br> いすらむきょうとがあつまっていのりをささげました。 <br><br> (教徒) <br> Muslims gathered to pray.
イスラム教徒が集まって祈りを捧げました。 <br><br> (教徒)	<b>いすらむきょうとがあつまっていのりをささげました。</b> <br> Muslims gathered to pray. <br> [sound:4c-s-イスラム教徒が集まって祈りを捧げました。.mp3]
Muslims gathered to pray.	<b>イスラム教徒が集まって祈りを捧げました。</b> <br> いすらむきょうとがあつまっていのりをささげました。 <br><br> (教徒) <br> [sound:4c-s-イスラム教徒が集まって祈りを捧げました。.mp3]
[sound:4c-k-教徒.mp3]	<b>教徒</b> <br> きょうと <br> believer, adherent
教徒	<b>きょうと</b> <br> believer, adherent <br> [sound:4c-k-教徒.mp3]
believer, adherent	<b>教徒</b> <br> きょうと <br> [sound:4c-k-教徒.mp3]
[sound:4c-s-教科書を忘れないでください。.mp3]	<b>教科書を忘れないでください。</b> <br> きょうかしょをわすれないでください。 <br><br> (教科書) <br> Please don’t forget your textbook.
教科書を忘れないでください。 <br><br> (教科書)	<b>きょうかしょをわすれないでください。</b> <br> Please don’t forget your textbook. <br> [sound:4c-s-教科書を忘れないでください。.mp3]
Please don’t forget your textbook.	<b>教科書を忘れないでください。</b> <br> きょうかしょをわすれないでください。 <br><br> (教科書) <br> [sound:4c-s-教科書を忘れないでください。.mp3]
[sound:4c-k-教科書.mp3]	<b>教科書</b> <br> きょうかしょ <br> textbook, text book
教科書	<b>きょうかしょ</b> <br> textbook, text book <br> [sound:4c-k-教科書.mp3]
textbook, text book	<b>教科書</b> <br> きょうかしょ <br> [sound:4c-k-教科書.mp3]
[sound:4c-s-報告書を提出しました。.mp3]	<b>報告書を提出しました。</b> <br> ほうこくしょをていしゅつしました。 <br><br> (報告書) <br> I submitted the report.
報告書を提出しました。 <br><br> (報告書)	<b>ほうこくしょをていしゅつしました。</b> <br> I submitted the report. <br> [sound:4c-s-報告書を提出しました。.mp3]
I submitted the report.	<b>報告書を提出しました。</b> <br> ほうこくしょをていしゅつしました。 <br><br> (報告書) <br> [sound:4c-s-報告書を提出しました。.mp3]
[sound:4c-k-報告書.mp3]	<b>報告書</b> <br> ほうこくしょ <br> (written) report
報告書	<b>ほうこくしょ</b> <br> (written) report <br> [sound:4c-k-報告書.mp3]
(written) report	<b>報告書</b> <br> ほうこくしょ <br> [sound:4c-k-報告書.mp3]
[sound:4c-s-広報部が新しいキャンペーンを発表しました。.mp3]	<b>広報部が新しいキャンペーンを発表しました。</b> <br> こうほうぶがあたらしいきゃんぺーんをはっぴょうしました。 <br><br> (広報) <br> The public relations department announced a new campaign.
広報部が新しいキャンペーンを発表しました。 <br><br> (広報)	<b>こうほうぶがあたらしいきゃんぺーんをはっぴょうしました。</b> <br> The public relations department announced a new campaign. <br> [sound:4c-s-広報部が新しいキャンペーンを発表しました。.mp3]
The public relations department announced a new campaign.	<b>広報部が新しいキャンペーンを発表しました。</b> <br> こうほうぶがあたらしいきゃんぺーんをはっぴょうしました。 <br><br> (広報) <br> [sound:4c-s-広報部が新しいキャンペーンを発表しました。.mp3]
[sound:4c-k-広報.mp3]	<b>広報</b> <br> こうほう <br> PR, public relations, publicity, information
広報	<b>こうほう</b> <br> PR, public relations, publicity, information <br> [sound:4c-k-広報.mp3]
PR, public relations, publicity, information	<b>広報</b> <br> こうほう <br> [sound:4c-k-広報.mp3]
[sound:4c-s-報酬は月末に支払われます。.mp3]	<b>報酬は月末に支払われます。</b> <br> ほうしゅうはげつまつにしはらわれます。 <br><br> (報酬) <br> The reward will be paid at the end of the month.
報酬は月末に支払われます。 <br><br> (報酬)	<b>ほうしゅうはげつまつにしはらわれます。</b> <br> The reward will be paid at the end of the month. <br> [sound:4c-s-報酬は月末に支払われます。.mp3]
The reward will be paid at the end of the month.	<b>報酬は月末に支払われます。</b> <br> ほうしゅうはげつまつにしはらわれます。 <br><br> (報酬) <br> [sound:4c-s-報酬は月末に支払われます。.mp3]
[sound:4c-k-報酬.mp3]	<b>報酬</b> <br> ほうしゅう <br> remuneration, recompense, reward, toll
報酬	<b>ほうしゅう</b> <br> remuneration, recompense, reward, toll <br> [sound:4c-k-報酬.mp3]
remuneration, recompense, reward, toll	<b>報酬</b> <br> ほうしゅう <br> [sound:4c-k-報酬.mp3]
[sound:4c-s-報道陣が現場に集まりました。.mp3]	<b>報道陣が現場に集まりました。</b> <br> ほうどうじんがげんばにあつまりました。 <br><br> (報道陣) <br> Reporters gathered at the scene.
報道陣が現場に集まりました。 <br><br> (報道陣)	<b>ほうどうじんがげんばにあつまりました。</b> <br> Reporters gathered at the scene. <br> [sound:4c-s-報道陣が現場に集まりました。.mp3]
Reporters gathered at the scene.	<b>報道陣が現場に集まりました。</b> <br> ほうどうじんがげんばにあつまりました。 <br><br> (報道陣) <br> [sound:4c-s-報道陣が現場に集まりました。.mp3]
[sound:4c-k-報道陣.mp3]	<b>報道陣</b> <br> ほうどうじん <br> press corps
報道陣	<b>ほうどうじん</b> <br> press corps <br> [sound:4c-k-報道陣.mp3]
press corps	<b>報道陣</b> <br> ほうどうじん <br> [sound:4c-k-報道陣.mp3]
[sound:4c-s-経済的な理由で留学を断念しました。.mp3]	<b>経済的な理由で留学を断念しました。</b> <br> けいざいてきなりゆうでりゅうがくをだんねんしました。 <br><br> (経済的) <br> I gave up studying abroad for financial reasons.
