national policy	<b>国策</b> <br> こくさく <br> [sound:4c-k-国策.mp3]
[sound:4c-s-国策として、新しいエネルギー政策が導入されました。.mp3]	<b>国策として、新しいエネルギー政策が導入されました。</b> <br> こくさくとして、あたらしいえねるぎーせいさくがどうにゅうされました。 <br><br> (国策) <br> A new energy policy was introduced as a national strategy.
国策として、新しいエネルギー政策が導入されました。 <br><br> (国策)	<b>こくさくとして、あたらしいえねるぎーせいさくがどうにゅうされました。</b> <br> A new energy policy was introduced as a national strategy. <br> [sound:4c-s-国策として、新しいエネルギー政策が導入されました。.mp3]
A new energy policy was introduced as a national strategy.	<b>国策として、新しいエネルギー政策が導入されました。</b> <br> こくさくとして、あたらしいえねるぎーせいさくがどうにゅうされました。 <br><br> (国策) <br> [sound:4c-s-国策として、新しいエネルギー政策が導入されました。.mp3]
[sound:4c-k-集める.mp3]	<b>集める</b> <br> あつめる <br> to collect, to assemble, to gather
集める	<b>あつめる</b> <br> to collect, to assemble, to gather <br> [sound:4c-k-集める.mp3]
to collect, to assemble, to gather	<b>集める</b> <br> あつめる <br> [sound:4c-k-集める.mp3]
[sound:4c-s-彼は古い切手を集めています。.mp3]	<b>彼は古い切手を集めています。</b> <br> かれはふるいきってをあつめています。 <br><br> (集める) <br> He is collecting old stamps.
彼は古い切手を集めています。 <br><br> (集める)	<b>かれはふるいきってをあつめています。</b> <br> He is collecting old stamps. <br> [sound:4c-s-彼は古い切手を集めています。.mp3]
He is collecting old stamps.	<b>彼は古い切手を集めています。</b> <br> かれはふるいきってをあつめています。 <br><br> (集める) <br> [sound:4c-s-彼は古い切手を集めています。.mp3]
[sound:4c-k-集会.mp3]	<b>集会</b> <br> しゅうかい <br> meeting, assembly
集会	<b>しゅうかい</b> <br> meeting, assembly <br> [sound:4c-k-集会.mp3]
meeting, assembly	<b>集会</b> <br> しゅうかい <br> [sound:4c-k-集会.mp3]
[sound:4c-s-明日、学校で集会があります。.mp3]	<b>明日、学校で集会があります。</b> <br> あした、がっこうでしゅうかいがあります。 <br><br> (集会) <br> There is a meeting at school tomorrow.
明日、学校で集会があります。 <br><br> (集会)	<b>あした、がっこうでしゅうかいがあります。</b> <br> There is a meeting at school tomorrow. <br> [sound:4c-s-明日、学校で集会があります。.mp3]
There is a meeting at school tomorrow.	<b>明日、学校で集会があります。</b> <br> あした、がっこうでしゅうかいがあります。 <br><br> (集会) <br> [sound:4c-s-明日、学校で集会があります。.mp3]
[sound:4c-k-集.mp3]	<b>集</b> <br> しゅう <br> collection, compilation
集	<b>しゅう</b> <br> collection, compilation <br> [sound:4c-k-集.mp3]
collection, compilation	<b>集</b> <br> しゅう <br> [sound:4c-k-集.mp3]
[sound:4c-s-みんなが集まって会議が始まりました。.mp3]	<b>みんなが集まって会議が始まりました。</b> <br> みんながあつまってかいぎがはじまりました。 <br><br> (集) <br> Everyone gathered and the meeting started.
みんなが集まって会議が始まりました。 <br><br> (集)	<b>みんながあつまってかいぎがはじまりました。</b> <br> Everyone gathered and the meeting started. <br> [sound:4c-s-みんなが集まって会議が始まりました。.mp3]
Everyone gathered and the meeting started.	<b>みんなが集まって会議が始まりました。</b> <br> みんながあつまってかいぎがはじまりました。 <br><br> (集) <br> [sound:4c-s-みんなが集まって会議が始まりました。.mp3]
[sound:4c-k-特集.mp3]	<b>特集</b> <br> とくしゅう <br> feature (e.g. newspaper), special edition, report
特集	<b>とくしゅう</b> <br> feature (e.g. newspaper), special edition, report <br> [sound:4c-k-特集.mp3]
feature (e.g. newspaper), special edition, report	<b>特集</b> <br> とくしゅう <br> [sound:4c-k-特集.mp3]
[sound:4c-s-この雑誌はスポーツの特集があります。.mp3]	<b>この雑誌はスポーツの特集があります。</b> <br> このざっきはすぽーつのとくしゅうがあります。 <br><br> (特集) <br> This magazine has a special feature on sports.
この雑誌はスポーツの特集があります。 <br><br> (特集)	<b>このざっきはすぽーつのとくしゅうがあります。</b> <br> This magazine has a special feature on sports. <br> [sound:4c-s-この雑誌はスポーツの特集があります。.mp3]
This magazine has a special feature on sports.	<b>この雑誌はスポーツの特集があります。</b> <br> このざっきはすぽーつのとくしゅうがあります。 <br><br> (特集) <br> [sound:4c-s-この雑誌はスポーツの特集があります。.mp3]
[sound:4c-k-在る.mp3]	<b>在る</b> <br> ある <br> to be (usu. of inanimate objects), to exist, to live; to have; to be located; to be equipped with; to happen, to come about
在る	<b>ある</b> <br> to be (usu. of inanimate objects), to exist, to live; to have; to be located; to be equipped with; to happen, to come about <br> [sound:4c-k-在る.mp3]
to be (usu. of inanimate objects), to exist, to live; to have; to be located; to be equipped with; to happen, to come about	<b>在る</b> <br> ある <br> [sound:4c-k-在る.mp3]
[sound:4c-s-あそこに大きな公園が在ります。.mp3]	<b>あそこに大きな公園が在ります。</b> <br> あそこにおおきなこうえんがあります。 <br><br> (在る) <br> There is a large park over there.
あそこに大きな公園が在ります。 <br><br> (在る)	<b>あそこにおおきなこうえんがあります。</b> <br> There is a large park over there. <br> [sound:4c-s-あそこに大きな公園が在ります。.mp3]
There is a large park over there.	<b>あそこに大きな公園が在ります。</b> <br> あそこにおおきなこうえんがあります。 <br><br> (在る) <br> [sound:4c-s-あそこに大きな公園が在ります。.mp3]
[sound:4c-k-現在.mp3]	<b>現在</b> <br> げんざい <br> now, current, present, present time, as of
現在	<b>げんざい</b> <br> now, current, present, present time, as of <br> [sound:4c-k-現在.mp3]
now, current, present, present time, as of	<b>現在</b> <br> げんざい <br> [sound:4c-k-現在.mp3]
[sound:4c-s-現在、プロジェクトは進行中です。.mp3]	<b>現在、プロジェクトは進行中です。</b> <br> げんざい、ぷろじぇくとはしんこうちゅうです。 <br><br> (現在) <br> Currently, the project is in progress.
現在、プロジェクトは進行中です。 <br><br> (現在)	<b>げんざい、ぷろじぇくとはしんこうちゅうです。</b> <br> Currently, the project is in progress. <br> [sound:4c-s-現在、プロジェクトは進行中です。.mp3]
Currently, the project is in progress.	<b>現在、プロジェクトは進行中です。</b> <br> げんざい、ぷろじぇくとはしんこうちゅうです。 <br><br> (現在) <br> [sound:4c-s-現在、プロジェクトは進行中です。.mp3]
[sound:4c-k-在宅.mp3]	<b>在宅</b> <br> ざいたく <br> being in, being at home
在宅	<b>ざいたく</b> <br> being in, being at home <br> [sound:4c-k-在宅.mp3]
being in, being at home	<b>在宅</b> <br> ざいたく <br> [sound:4c-k-在宅.mp3]
[sound:4c-s-在宅勤務をしています。.mp3]	<b>在宅勤務をしています。</b> <br> ざいたくきんむをしています。 <br><br> (在宅) <br> I am working from home.
在宅勤務をしています。 <br><br> (在宅)	<b>ざいたくきんむをしています。</b> <br> I am working from home. <br> [sound:4c-s-在宅勤務をしています。.mp3]
I am working from home.	<b>在宅勤務をしています。</b> <br> ざいたくきんむをしています。 <br><br> (在宅) <br> [sound:4c-s-在宅勤務をしています。.mp3]
[sound:4c-k-不在.mp3]	<b>不在</b> <br> ふざい <br> absence
不在	<b>ふざい</b> <br> absence <br> [sound:4c-k-不在.mp3]
absence	<b>不在</b> <br> ふざい <br> [sound:4c-k-不在.mp3]
[sound:4c-s-彼は今不在です。.mp3]	<b>彼は今不在です。</b> <br> かれはいまふざいです。 <br><br> (不在) <br> He is absent right now.
彼は今不在です。 <br><br> (不在)	<b>かれはいまふざいです。</b> <br> He is absent right now. <br> [sound:4c-s-彼は今不在です。.mp3]
He is absent right now.	<b>彼は今不在です。</b> <br> かれはいまふざいです。 <br><br> (不在) <br> [sound:4c-s-彼は今不在です。.mp3]
[sound:4c-k-件.mp3]	<b>件</b> <br> けん <br> matter, case, item
件	<b>けん</b> <br> matter, case, item <br> [sound:4c-k-件.mp3]
matter, case, item	<b>件</b> <br> けん <br> [sound:4c-k-件.mp3]
[sound:4c-s-その件についてお話ししましょう。.mp3]	<b>その件についてお話ししましょう。</b> <br> そのけんについておはなししましょう。 <br><br> (件) <br> Let’s talk about that matter.
その件についてお話ししましょう。 <br><br> (件)	<b>そのけんについておはなししましょう。</b> <br> Let’s talk about that matter. <br> [sound:4c-s-その件についてお話ししましょう。.mp3]
Let’s talk about that matter.	<b>その件についてお話ししましょう。</b> <br> そのけんについておはなししましょう。 <br><br> (件) <br> [sound:4c-s-その件についてお話ししましょう。.mp3]
[sound:4c-k-事件.mp3]	<b>事件</b> <br> じけん <br> event, affair, incident, case, plot, trouble, scandal
事件	<b>じけん</b> <br> event, affair, incident, case, plot, trouble, scandal <br> [sound:4c-k-事件.mp3]
event, affair, incident, case, plot, trouble, scandal	<b>事件</b> <br> じけん <br> [sound:4c-k-事件.mp3]
[sound:4c-s-昨日、大きな事件が起こりました。.mp3]	<b>昨日、大きな事件が起こりました。</b> <br> きのう、おおきなじけんがおこりました。 <br><br> (事件) <br> A major incident occurred yesterday.
昨日、大きな事件が起こりました。 <br><br> (事件)	<b>きのう、おおきなじけんがおこりました。</b> <br> A major incident occurred yesterday. <br> [sound:4c-s-昨日、大きな事件が起こりました。.mp3]
A major incident occurred yesterday.	<b>昨日、大きな事件が起こりました。</b> <br> きのう、おおきなじけんがおこりました。 <br><br> (事件) <br> [sound:4c-s-昨日、大きな事件が起こりました。.mp3]
[sound:4c-k-要件.mp3]	<b>要件</b> <br> ようけん <br> requirement, important matter
要件	<b>ようけん</b> <br> requirement, important matter <br> [sound:4c-k-要件.mp3]
requirement, important matter	<b>要件</b> <br> ようけん <br> [sound:4c-k-要件.mp3]
[sound:4c-s-このプロジェクトにはいくつかの要件があります。.mp3]	<b>このプロジェクトにはいくつかの要件があります。</b> <br> このぷろじぇくとにはいくつかのようけんがあります。 <br><br> (要件) <br> This project has several requirements.
このプロジェクトにはいくつかの要件があります。 <br><br> (要件)	<b>このぷろじぇくとにはいくつかのようけんがあります。</b> <br> This project has several requirements. <br> [sound:4c-s-このプロジェクトにはいくつかの要件があります。.mp3]
This project has several requirements.	<b>このプロジェクトにはいくつかの要件があります。</b> <br> このぷろじぇくとにはいくつかのようけんがあります。 <br><br> (要件) <br> [sound:4c-s-このプロジェクトにはいくつかの要件があります。.mp3]
[sound:4c-k-案件.mp3]	<b>案件</b> <br> あんけん <br> matter in question, subject
案件	<b>あんけん</b> <br> matter in question, subject <br> [sound:4c-k-案件.mp3]
matter in question, subject	<b>案件</b> <br> あんけん <br> [sound:4c-k-案件.mp3]
[sound:4c-s-新しい案件が処理中です。.mp3]	<b>新しい案件が処理中です。</b> <br> あたらしいあんけんがしょりちゅうです。 <br><br> (案件) <br> A new case is being processed.
新しい案件が処理中です。 <br><br> (案件)	<b>あたらしいあんけんがしょりちゅうです。</b> <br> A new case is being processed. <br> [sound:4c-s-新しい案件が処理中です。.mp3]
A new case is being processed.	<b>新しい案件が処理中です。</b> <br> あたらしいあんけんがしょりちゅうです。 <br><br> (案件) <br> [sound:4c-s-新しい案件が処理中です。.mp3]
[sound:4c-k-団体.mp3]	<b>団体</b> <br> だんたい <br> organization, organisation, association
団体	<b>だんたい</b> <br> organization, organisation, association <br> [sound:4c-k-団体.mp3]
organization, organisation, association	<b>団体</b> <br> だんたい <br> [sound:4c-k-団体.mp3]
[sound:4c-s-その団体は多くの活動をしています。.mp3]	<b>その団体は多くの活動をしています。</b> <br> そのだんたいはおおくのかつどうをしています。 <br><br> (団体) <br> The organization is engaged in many activities.
その団体は多くの活動をしています。 <br><br> (団体)	<b>そのだんたいはおおくのかつどうをしています。</b> <br> The organization is engaged in many activities. <br> [sound:4c-s-その団体は多くの活動をしています。.mp3]
The organization is engaged in many activities.	<b>その団体は多くの活動をしています。</b> <br> そのだんたいはおおくのかつどうをしています。 <br><br> (団体) <br> [sound:4c-s-その団体は多くの活動をしています。.mp3]
[sound:4c-k-集団.mp3]	<b>集団</b> <br> しゅうだん <br> group, mass
集団	<b>しゅうだん</b> <br> group, mass <br> [sound:4c-k-集団.mp3]
group, mass	<b>集団</b> <br> しゅうだん <br> [sound:4c-k-集団.mp3]
[sound:4c-s-集団での活動が重要です。.mp3]	<b>集団での活動が重要です。</b> <br> しゅうだんでのかつどうがじゅうようです。 <br><br> (集団) <br> Group activities are important.
集団での活動が重要です。 <br><br> (集団)	<b>しゅうだんでのかつどうがじゅうようです。</b> <br> Group activities are important. <br> [sound:4c-s-集団での活動が重要です。.mp3]
Group activities are important.	<b>集団での活動が重要です。</b> <br> しゅうだんでのかつどうがじゅうようです。 <br><br> (集団) <br> [sound:4c-s-集団での活動が重要です。.mp3]
[sound:4c-k-財団法人.mp3]	<b>財団法人</b> <br> ざいだんほうじん <br> incorporated foundation, juridical foundation
財団法人	<b>ざいだんほうじん</b> <br> incorporated foundation, juridical foundation <br> [sound:4c-k-財団法人.mp3]
incorporated foundation, juridical foundation	<b>財団法人</b> <br> ざいだんほうじん <br> [sound:4c-k-財団法人.mp3]
[sound:4c-s-その財団法人は教育に関する支援を行っています。.mp3]	<b>その財団法人は教育に関する支援を行っています。</b> <br> そのざいだんほうじんはきょういくにかんするしえんをおこなっています。 <br><br> (財団法人) <br> The foundation is providing support for education.
その財団法人は教育に関する支援を行っています。 <br><br> (財団法人)	<b>そのざいだんほうじんはきょういくにかんするしえんをおこなっています。</b> <br> The foundation is providing support for education. <br> [sound:4c-s-その財団法人は教育に関する支援を行っています。.mp3]
The foundation is providing support for education.	<b>その財団法人は教育に関する支援を行っています。</b> <br> そのざいだんほうじんはきょういくにかんするしえんをおこなっています。 <br><br> (財団法人) <br> [sound:4c-s-その財団法人は教育に関する支援を行っています。.mp3]
[sound:4c-k-公団.mp3]	<b>公団</b> <br> こうだん <br> public corporation
公団	<b>こうだん</b> <br> public corporation <br> [sound:4c-k-公団.mp3]
public corporation	<b>公団</b> <br> こうだん <br> [sound:4c-k-公団.mp3]
[sound:4c-s-公団は住宅の建設を行っています。.mp3]	<b>公団は住宅の建設を行っています。</b> <br> こうだんはじゅうたくのけんせつをおこなっています。 <br><br> (公団) <br> The public corporation is constructing housing.
公団は住宅の建設を行っています。 <br><br> (公団)	<b>こうだんはじゅうたくのけんせつをおこなっています。</b> <br> The public corporation is constructing housing. <br> [sound:4c-s-公団は住宅の建設を行っています。.mp3]
The public corporation is constructing housing.	<b>公団は住宅の建設を行っています。</b> <br> こうだんはじゅうたくのけんせつをおこなっています。 <br><br> (公団) <br> [sound:4c-s-公団は住宅の建設を行っています。.mp3]
[sound:4c-k-別に.mp3]	<b>別に</b> <br> べつに <br> (not) particularly, nothing; separately, apart
別に	<b>べつに</b> <br> (not) particularly, nothing; separately, apart <br> [sound:4c-k-別に.mp3]
(not) particularly, nothing; separately, apart	<b>別に</b> <br> べつに <br> [sound:4c-k-別に.mp3]
[sound:4c-s-別に気にしていません。.mp3]	<b>別に気にしていません。</b> <br> べつにきにしていません。 <br><br> (別に) <br> I’m not particularly concerned about it.
別に気にしていません。 <br><br> (別に)	<b>べつにきにしていません。</b> <br> I’m not particularly concerned about it. <br> [sound:4c-s-別に気にしていません。.mp3]
I’m not particularly concerned about it.	<b>別に気にしていません。</b> <br> べつにきにしていません。 <br><br> (別に) <br> [sound:4c-s-別に気にしていません。.mp3]
[sound:4c-k-告別.mp3]	<b>告別</b> <br> こくべつ <br> farewell, leave-taking
告別	<b>こくべつ</b> <br> farewell, leave-taking <br> [sound:4c-k-告別.mp3]
farewell, leave-taking	<b>告別</b> <br> こくべつ <br> [sound:4c-k-告別.mp3]
[sound:4c-s-彼は告別の言葉を述べました。.mp3]	<b>彼は告別の言葉を述べました。</b> <br> かれはこくべつのことばをのべました。 <br><br> (告別) <br> He gave a farewell speech.
彼は告別の言葉を述べました。 <br><br> (告別)	<b>かれはこくべつのことばをのべました。</b> <br> He gave a farewell speech. <br> [sound:4c-s-彼は告別の言葉を述べました。.mp3]
He gave a farewell speech.	<b>彼は告別の言葉を述べました。</b> <br> かれはこくべつのことばをのべました。 <br><br> (告別) <br> [sound:4c-s-彼は告別の言葉を述べました。.mp3]
[sound:4c-k-性別.mp3]	<b>性別</b> <br> せいべつ <br> distinction by sex, sex, gender
性別	<b>せいべつ</b> <br> distinction by sex, sex, gender <br> [sound:4c-k-性別.mp3]
distinction by sex, sex, gender	<b>性別</b> <br> せいべつ <br> [sound:4c-k-性別.mp3]
[sound:4c-s-性別に関係なく、全ての人が平等です。.mp3]	<b>性別に関係なく、全ての人が平等です。</b> <br> せいべつにかんけいなく、すべてのひとがびょうどうです。 <br><br> (性別) <br> Regardless of gender, all people are equal.
性別に関係なく、全ての人が平等です。 <br><br> (性別)	<b>せいべつにかんけいなく、すべてのひとがびょうどうです。</b> <br> Regardless of gender, all people are equal. <br> [sound:4c-s-性別に関係なく、全ての人が平等です。.mp3]
Regardless of gender, all people are equal.	<b>性別に関係なく、全ての人が平等です。</b> <br> せいべつにかんけいなく、すべてのひとがびょうどうです。 <br><br> (性別) <br> [sound:4c-s-性別に関係なく、全ての人が平等です。.mp3]
[sound:4c-k-区別.mp3]	<b>区別</b> <br> くべつ <br> distinction, differentiation, classification
区別	<b>くべつ</b> <br> distinction, differentiation, classification <br> [sound:4c-k-区別.mp3]
distinction, differentiation, classification	<b>区別</b> <br> くべつ <br> [sound:4c-k-区別.mp3]
[sound:4c-s-人々は年齢で区別されるべきではありません。.mp3]	<b>人々は年齢で区別されるべきではありません。</b> <br> ひとびとはねんれいでくべつされるべきではありません。 <br><br> (区別) <br> People should not be distinguished by age.
人々は年齢で区別されるべきではありません。 <br><br> (区別)	<b>ひとびとはねんれいでくべつされるべきではありません。</b> <br> People should not be distinguished by age. <br> [sound:4c-s-人々は年齢で区別されるべきではありません。.mp3]
People should not be distinguished by age.	<b>人々は年齢で区別されるべきではありません。</b> <br> ひとびとはねんれいでくべつされるべきではありません。 <br><br> (区別) <br> [sound:4c-s-人々は年齢で区別されるべきではありません。.mp3]
[sound:4c-k-人物.mp3]	<b>人物</b> <br> じんぶつ <br> character, personality, person, man, personage, talented man
人物	<b>じんぶつ</b> <br> character, personality, person, man, personage, talented man <br> [sound:4c-k-人物.mp3]
character, personality, person, man, personage, talented man	<b>人物</b> <br> じんぶつ <br> [sound:4c-k-人物.mp3]
[sound:4c-s-その人物は非常に有名です。.mp3]	<b>その人物は非常に有名です。</b> <br> そのじんぶつはひじょうにゆうめいです。 <br><br> (人物) <br> That person is very famous.
その人物は非常に有名です。 <br><br> (人物)	<b>そのじんぶつはひじょうにゆうめいです。</b> <br> That person is very famous. <br> [sound:4c-s-その人物は非常に有名です。.mp3]
That person is very famous.	<b>その人物は非常に有名です。</b> <br> そのじんぶつはひじょうにゆうめいです。 <br><br> (人物) <br> [sound:4c-s-その人物は非常に有名です。.mp3]
[sound:4c-k-動物.mp3]	<b>動物</b> <br> どうぶつ <br> animal
動物	<b>どうぶつ</b> <br> animal <br> [sound:4c-k-動物.mp3]
animal	<b>動物</b> <br> どうぶつ <br> [sound:4c-k-動物.mp3]
[sound:4c-s-動物園には多くの種類の動物がいます。.mp3]	<b>動物園には多くの種類の動物がいます。</b> <br> どうぶつえんにはおおくのしゅるいのどうぶつがいます。 <br><br> (動物) <br> There are many types of animals in the zoo.
動物園には多くの種類の動物がいます。 <br><br> (動物)	<b>どうぶつえんにはおおくのしゅるいのどうぶつがいます。</b> <br> There are many types of animals in the zoo. <br> [sound:4c-s-動物園には多くの種類の動物がいます。.mp3]
There are many types of animals in the zoo.	<b>動物園には多くの種類の動物がいます。</b> <br> どうぶつえんにはおおくのしゅるいのどうぶつがいます。 <br><br> (動物) <br> [sound:4c-s-動物園には多くの種類の動物がいます。.mp3]
[sound:4c-k-博物館.mp3]	<b>博物館</b> <br> はくぶつかん <br> museum
博物館	<b>はくぶつかん</b> <br> museum <br> [sound:4c-k-博物館.mp3]
museum	<b>博物館</b> <br> はくぶつかん <br> [sound:4c-k-博物館.mp3]
[sound:4c-s-博物館で古代の遺物を見ました。.mp3]	<b>博物館で古代の遺物を見ました。</b> <br> はくぶつかんでこだいのいぶつをみました。 <br><br> (博物館) <br> I saw ancient artifacts at the museum.
博物館で古代の遺物を見ました。 <br><br> (博物館)	<b>はくぶつかんでこだいのいぶつをみました。</b> <br> I saw ancient artifacts at the museum. <br> [sound:4c-s-博物館で古代の遺物を見ました。.mp3]
I saw ancient artifacts at the museum.	<b>博物館で古代の遺物を見ました。</b> <br> はくぶつかんでこだいのいぶつをみました。 <br><br> (博物館) <br> [sound:4c-s-博物館で古代の遺物を見ました。.mp3]
[sound:4c-k-物資.mp3]	<b>物資</b> <br> ぶっし <br> goods, materials
物資	<b>ぶっし</b> <br> goods, materials <br> [sound:4c-k-物資.mp3]
goods, materials	<b>物資</b> <br> ぶっし <br> [sound:4c-k-物資.mp3]
[sound:4c-s-戦争の影響で物資が不足しています。.mp3]	<b>戦争の影響で物資が不足しています。</b> <br> せんそうのえいきょうでぶっしがふそくしています。 <br><br> (物資) <br> There is a shortage of supplies due to the war.
戦争の影響で物資が不足しています。 <br><br> (物資)	<b>せんそうのえいきょうでぶっしがふそくしています。</b> <br> There is a shortage of supplies due to the war. <br> [sound:4c-s-戦争の影響で物資が不足しています。.mp3]
There is a shortage of supplies due to the war.	<b>戦争の影響で物資が不足しています。</b> <br> せんそうのえいきょうでぶっしがふそくしています。 <br><br> (物資) <br> [sound:4c-s-戦争の影響で物資が不足しています。.mp3]
[sound:4c-k-側.mp3]	<b>側</b> <br> そば, そく, はた <br> near, close, beside, vicinity, proximity, besides, while; third person
側	<b>そば, そく, はた</b> <br> near, close, beside, vicinity, proximity, besides, while; third person <br> [sound:4c-k-側.mp3]
near, close, beside, vicinity, proximity, besides, while; third person	<b>側</b> <br> そば, そく, はた <br> [sound:4c-k-側.mp3]
[sound:4c-s-彼は私の側に座っています。.mp3]	<b>彼は私の側に座っています。</b> <br> かれはわたしのそばにすわっています。 <br><br> (側) <br> He is sitting next to me.
彼は私の側に座っています。 <br><br> (側)	<b>かれはわたしのそばにすわっています。</b> <br> He is sitting next to me. <br> [sound:4c-s-彼は私の側に座っています。.mp3]
He is sitting next to me.	<b>彼は私の側に座っています。</b> <br> かれはわたしのそばにすわっています。 <br><br> (側) <br> [sound:4c-s-彼は私の側に座っています。.mp3]
[sound:4c-k-西側.mp3]	<b>西側</b> <br> にしがわ <br> west side, west bank
西側	<b>にしがわ</b> <br> west side, west bank <br> [sound:4c-k-西側.mp3]
west side, west bank	<b>西側</b> <br> にしがわ <br> [sound:4c-k-西側.mp3]
[sound:4c-s-西側の都市には多くの観光地があります。.mp3]	<b>西側の都市には多くの観光地があります。</b> <br> にしかわのとしにはおおくのかんこうちがあります。 <br><br> (西側) <br> The western cities have many tourist attractions.
西側の都市には多くの観光地があります。 <br><br> (西側)	<b>にしかわのとしにはおおくのかんこうちがあります。</b> <br> The western cities have many tourist attractions. <br> [sound:4c-s-西側の都市には多くの観光地があります。.mp3]
The western cities have many tourist attractions.	<b>西側の都市には多くの観光地があります。</b> <br> にしかわのとしにはおおくのかんこうちがあります。 <br><br> (西側) <br> [sound:4c-s-西側の都市には多くの観光地があります。.mp3]
[sound:4c-k-裏側.mp3]	<b>裏側</b> <br> うらがわ <br> the reverse, other side, lining
裏側	<b>うらがわ</b> <br> the reverse, other side, lining <br> [sound:4c-k-裏側.mp3]
the reverse, other side, lining	<b>裏側</b> <br> うらがわ <br> [sound:4c-k-裏側.mp3]
[sound:4c-s-ビルの裏側に駐車場があります。.mp3]	<b>ビルの裏側に駐車場があります。</b> <br> びるのうらがわにちゅうしゃじょうがあります。 <br><br> (裏側) <br> There is a parking lot on the back side of the building.
ビルの裏側に駐車場があります。 <br><br> (裏側)	<b>びるのうらがわにちゅうしゃじょうがあります。</b> <br> There is a parking lot on the back side of the building. <br> [sound:4c-s-ビルの裏側に駐車場があります。.mp3]
There is a parking lot on the back side of the building.	<b>ビルの裏側に駐車場があります。</b> <br> びるのうらがわにちゅうしゃじょうがあります。 <br><br> (裏側) <br> [sound:4c-s-ビルの裏側に駐車場があります。.mp3]
[sound:4c-k-外側.mp3]	<b>外側</b> <br> そとがわ, がいそく <br> exterior, outside
外側	<b>そとがわ, がいそく</b> <br> exterior, outside <br> [sound:4c-k-外側.mp3]
exterior, outside	<b>外側</b> <br> そとがわ, がいそく <br> [sound:4c-k-外側.mp3]
[sound:4c-s-窓の外側に花が咲いています。.mp3]	<b>窓の外側に花が咲いています。</b> <br> まどのそとがわにはながさいています。 <br><br> (外側) <br> Flowers are blooming on the outside of the window.
窓の外側に花が咲いています。 <br><br> (外側)	<b>まどのそとがわにはながさいています。</b> <br> Flowers are blooming on the outside of the window. <br> [sound:4c-s-窓の外側に花が咲いています。.mp3]
Flowers are blooming on the outside of the window.	<b>窓の外側に花が咲いています。</b> <br> まどのそとがわにはながさいています。 <br><br> (外側) <br> [sound:4c-s-窓の外側に花が咲いています。.mp3]
[sound:4c-k-責任.mp3]	<b>責任</b> <br> せきにん <br> duty, responsibility; liability, onus
責任	<b>せきにん</b> <br> duty, responsibility; liability, onus <br> [sound:4c-k-責任.mp3]
duty, responsibility; liability, onus	<b>責任</b> <br> せきにん <br> [sound:4c-k-責任.mp3]
[sound:4c-s-私はそのプロジェクトに責任を持っています。.mp3]	<b>私はそのプロジェクトに責任を持っています。</b> <br> わたしはそのぷろじぇくとにせきにんをもっています。 <br><br> (責任) <br> I am responsible for the project.
私はそのプロジェクトに責任を持っています。 <br><br> (責任)	<b>わたしはそのぷろじぇくとにせきにんをもっています。</b> <br> I am responsible for the project. <br> [sound:4c-s-私はそのプロジェクトに責任を持っています。.mp3]
I am responsible for the project.	<b>私はそのプロジェクトに責任を持っています。</b> <br> わたしはそのぷろじぇくとにせきにんをもっています。 <br><br> (責任) <br> [sound:4c-s-私はそのプロジェクトに責任を持っています。.mp3]
[sound:4c-k-辞任.mp3]	<b>辞任</b> <br> じにん <br> to resign; resignation
辞任	<b>じにん</b> <br> to resign; resignation <br> [sound:4c-k-辞任.mp3]
to resign; resignation	<b>辞任</b> <br> じにん <br> [sound:4c-k-辞任.mp3]
[sound:4c-s-彼は最近辞任しました。.mp3]	<b>彼は最近辞任しました。</b> <br> かれはさいきんじにんしました。 <br><br> (辞任) <br> He resigned recently.
彼は最近辞任しました。 <br><br> (辞任)	<b>かれはさいきんじにんしました。</b> <br> He resigned recently. <br> [sound:4c-s-彼は最近辞任しました。.mp3]
He resigned recently.	<b>彼は最近辞任しました。</b> <br> かれはさいきんじにんしました。 <br><br> (辞任) <br> [sound:4c-s-彼は最近辞任しました。.mp3]
[sound:4c-k-主任.mp3]	<b>主任</b> <br> しゅにん <br> person in charge, responsible official
主任	<b>しゅにん</b> <br> person in charge, responsible official <br> [sound:4c-k-主任.mp3]
person in charge, responsible official	<b>主任</b> <br> しゅにん <br> [sound:4c-k-主任.mp3]
[sound:4c-s-主任としての責任が増えました。.mp3]	<b>主任としての責任が増えました。</b> <br> しゅにんとしてのせきにんがふえました。 <br><br> (主任) <br> My responsibilities as the manager have increased.
主任としての責任が増えました。 <br><br> (主任)	<b>しゅにんとしてのせきにんがふえました。</b> <br> My responsibilities as the manager have increased. <br> [sound:4c-s-主任としての責任が増えました。.mp3]
My responsibilities as the manager have increased.	<b>主任としての責任が増えました。</b> <br> しゅにんとしてのせきにんがふえました。 <br><br> (主任) <br> [sound:4c-s-主任としての責任が増えました。.mp3]
[sound:4c-k-任務.mp3]	<b>任務</b> <br> にんむ <br> duty, function, office, mission, task
任務	<b>にんむ</b> <br> duty, function, office, mission, task <br> [sound:4c-k-任務.mp3]
duty, function, office, mission, task	<b>任務</b> <br> にんむ <br> [sound:4c-k-任務.mp3]
[sound:4c-s-この任務は非常に重要です。.mp3]	<b>この任務は非常に重要です。</b> <br> このにんむはひじょうにじゅうようです。 <br><br> (任務) <br> This mission is very important.
この任務は非常に重要です。 <br><br> (任務)	<b>このにんむはひじょうにじゅうようです。</b> <br> This mission is very important. <br> [sound:4c-s-この任務は非常に重要です。.mp3]
This mission is very important.	<b>この任務は非常に重要です。</b> <br> このにんむはひじょうにじゅうようです。 <br><br> (任務) <br> [sound:4c-s-この任務は非常に重要です。.mp3]
[sound:4c-k-取引.mp3]	<b>取引</b> <br> とりひき <br> transactions, dealings, business
取引	<b>とりひき</b> <br> transactions, dealings, business <br> [sound:4c-k-取引.mp3]
transactions, dealings, business	<b>取引</b> <br> とりひき <br> [sound:4c-k-取引.mp3]
[sound:4c-s-新しい取引を結びました。.mp3]	<b>新しい取引を結びました。</b> <br> あたらしいとりひきをむすびました。 <br><br> (取引) <br> I made a new deal.
新しい取引を結びました。 <br><br> (取引)	<b>あたらしいとりひきをむすびました。</b> <br> I made a new deal. <br> [sound:4c-s-新しい取引を結びました。.mp3]
I made a new deal.	<b>新しい取引を結びました。</b> <br> あたらしいとりひきをむすびました。 <br><br> (取引) <br> [sound:4c-s-新しい取引を結びました。.mp3]
[sound:4c-k-引き下げ.mp3]	<b>引き下げ</b> <br> ひきさげ <br> reduction, cut
引き下げ	<b>ひきさげ</b> <br> reduction, cut <br> [sound:4c-k-引き下げ.mp3]
reduction, cut	<b>引き下げ</b> <br> ひきさげ <br> [sound:4c-k-引き下げ.mp3]
[sound:4c-s-料金の引き下げが発表されました。.mp3]	<b>料金の引き下げが発表されました。</b> <br> りょうきんのひきさげがはっぴょうされました。 <br><br> (引き下げ) <br> A reduction in fees was announced.
料金の引き下げが発表されました。 <br><br> (引き下げ)	<b>りょうきんのひきさげがはっぴょうされました。</b> <br> A reduction in fees was announced. <br> [sound:4c-s-料金の引き下げが発表されました。.mp3]
A reduction in fees was announced.	<b>料金の引き下げが発表されました。</b> <br> りょうきんのひきさげがはっぴょうされました。 <br><br> (引き下げ) <br> [sound:4c-s-料金の引き下げが発表されました。.mp3]
[sound:4c-k-引き続き.mp3]	<b>引き続き</b> <br> ひきつづき <br> continuing for a long time, in succession, without a break
引き続き	<b>ひきつづき</b> <br> continuing for a long time, in succession, without a break <br> [sound:4c-k-引き続き.mp3]
continuing for a long time, in succession, without a break	<b>引き続き</b> <br> ひきつづき <br> [sound:4c-k-引き続き.mp3]
[sound:4c-s-引き続きお待ちください。.mp3]	<b>引き続きお待ちください。</b> <br> ひきつづきおまちください。 <br><br> (引き続き) <br> Please wait a moment longer.
引き続きお待ちください。 <br><br> (引き続き)	<b>ひきつづきおまちください。</b> <br> Please wait a moment longer. <br> [sound:4c-s-引き続きお待ちください。.mp3]
Please wait a moment longer.	<b>引き続きお待ちください。</b> <br> ひきつづきおまちください。 <br><br> (引き続き) <br> [sound:4c-s-引き続きお待ちください。.mp3]
[sound:4c-k-割引.mp3]	<b>割引</b> <br> わりびき <br> discount, reduction, rebate, tenths discounted
割引	<b>わりびき</b> <br> discount, reduction, rebate, tenths discounted <br> [sound:4c-k-割引.mp3]
discount, reduction, rebate, tenths discounted	<b>割引</b> <br> わりびき <br> [sound:4c-k-割引.mp3]
[sound:4c-s-割引セールが開催されています。.mp3]	<b>割引セールが開催されています。</b> <br> わりびきせーるがかいさいされています。 <br><br> (割引) <br> A discount sale is being held.
割引セールが開催されています。 <br><br> (割引)	<b>わりびきせーるがかいさいされています。</b> <br> A discount sale is being held. <br> [sound:4c-s-割引セールが開催されています。.mp3]
A discount sale is being held.	<b>割引セールが開催されています。</b> <br> わりびきせーるがかいさいされています。 <br><br> (割引) <br> [sound:4c-s-割引セールが開催されています。.mp3]
[sound:4c-k-使わす.mp3]	<b>使わす</b> <br> つかわす <br> to send, to dispatch, to despatch
使わす	<b>つかわす</b> <br> to send, to dispatch, to despatch <br> [sound:4c-k-使わす.mp3]
to send, to dispatch, to despatch	<b>使わす</b> <br> つかわす <br> [sound:4c-k-使わす.mp3]
[sound:4c-s-彼は私にお金を使わせました。.mp3]	<b>彼は私にお金を使わせました。</b> <br> かれはわたしにおかねをつかわせました。 <br><br> (使わす) <br> He made me spend money.
彼は私にお金を使わせました。 <br><br> (使わす)	<b>かれはわたしにおかねをつかわせました。</b> <br> He made me spend money. <br> [sound:4c-s-彼は私にお金を使わせました。.mp3]
He made me spend money.	<b>彼は私にお金を使わせました。</b> <br> かれはわたしにおかねをつかわせました。 <br><br> (使わす) <br> [sound:4c-s-彼は私にお金を使わせました。.mp3]
[sound:4c-k-使う.mp3]	<b>使う</b> <br> つかう <br> to use (a thing, method, etc.), to make use of, to put to use; to use (a person, animal, puppet, etc.), to employ, to handle, to manage, to manipulate; to use (time, money, etc.), to spend, to consume; to use (language), to speak; to take (one's lunch), to circulate (bad money)
使う	<b>つかう</b> <br> to use (a thing, method, etc.), to make use of, to put to use; to use (a person, animal, puppet, etc.), to employ, to handle, to manage, to manipulate; to use (time, money, etc.), to spend, to consume; to use (language), to speak; to take (one's lunch), to circulate (bad money) <br> [sound:4c-k-使う.mp3]
to use (a thing, method, etc.), to make use of, to put to use; to use (a person, animal, puppet, etc.), to employ, to handle, to manage, to manipulate; to use (time, money, etc.), to spend, to consume; to use (language), to speak; to take (one's lunch), to circulate (bad money)	<b>使う</b> <br> つかう <br> [sound:4c-k-使う.mp3]
[sound:4c-s-この道具を使うのは初めてです。.mp3]	<b>この道具を使うのは初めてです。</b> <br> このどうぐをつかうのははじめてです。 <br><br> (使う) <br> This is my first time using this tool.
この道具を使うのは初めてです。 <br><br> (使う)	<b>このどうぐをつかうのははじめてです。</b> <br> This is my first time using this tool. <br> [sound:4c-s-この道具を使うのは初めてです。.mp3]
This is my first time using this tool.	<b>この道具を使うのは初めてです。</b> <br> このどうぐをつかうのははじめてです。 <br><br> (使う) <br> [sound:4c-s-この道具を使うのは初めてです。.mp3]
[sound:4c-k-特使.mp3]	<b>特使</b> <br> とくし <br> special envoy
特使	<b>とくし</b> <br> special envoy <br> [sound:4c-k-特使.mp3]
special envoy	<b>特使</b> <br> とくし <br> [sound:4c-k-特使.mp3]
[sound:4c-s-彼は特使として海外に派遣されました。.mp3]	<b>彼は特使として海外に派遣されました。</b> <br> かれはとくしとしてかいがいにはけんされました。 <br><br> (特使) <br> He was sent abroad as a special envoy.
彼は特使として海外に派遣されました。 <br><br> (特使)	<b>かれはとくしとしてかいがいにはけんされました。</b> <br> He was sent abroad as a special envoy. <br> [sound:4c-s-彼は特使として海外に派遣されました。.mp3]
He was sent abroad as a special envoy.	<b>彼は特使として海外に派遣されました。</b> <br> かれはとくしとしてかいがいにはけんされました。 <br><br> (特使) <br> [sound:4c-s-彼は特使として海外に派遣されました。.mp3]
[sound:4c-k-労使.mp3]	<b>労使</b> <br> ろうし <br> labour and management, labor and management
労使	<b>ろうし</b> <br> labour and management, labor and management <br> [sound:4c-k-労使.mp3]
labour and management, labor and management	<b>労使</b> <br> ろうし <br> [sound:4c-k-労使.mp3]
[sound:4c-s-労使交渉が始まりました。.mp3]	<b>労使交渉が始まりました。</b> <br> ろうしこうしょうがはじまりました。 <br><br> (労使) <br> Labor-management negotiations have started.
労使交渉が始まりました。 <br><br> (労使)	<b>ろうしこうしょうがはじまりました。</b> <br> Labor-management negotiations have started. <br> [sound:4c-s-労使交渉が始まりました。.mp3]
Labor-management negotiations have started.	<b>労使交渉が始まりました。</b> <br> ろうしこうしょうがはじまりました。 <br><br> (労使) <br> [sound:4c-s-労使交渉が始まりました。.mp3]
[sound:4c-k-要求.mp3]	<b>要求</b> <br> ようきゅう <br> demand, firm request, requisition, requirement, desire
要求	<b>ようきゅう</b> <br> demand, firm request, requisition, requirement, desire <br> [sound:4c-k-要求.mp3]
demand, firm request, requisition, requirement, desire	<b>要求</b> <br> ようきゅう <br> [sound:4c-k-要求.mp3]
[sound:4c-s-彼は給料の増額を要求しました。.mp3]	<b>彼は給料の増額を要求しました。</b> <br> かれはきゅうりょうのぞうがくをようきゅうしました。 <br><br> (要求) <br> He demanded a salary increase.
彼は給料の増額を要求しました。 <br><br> (要求)	<b>かれはきゅうりょうのぞうがくをようきゅうしました。</b> <br> He demanded a salary increase. <br> [sound:4c-s-彼は給料の増額を要求しました。.mp3]
He demanded a salary increase.	<b>彼は給料の増額を要求しました。</b> <br> かれはきゅうりょうのぞうがくをようきゅうしました。 <br><br> (要求) <br> [sound:4c-s-彼は給料の増額を要求しました。.mp3]
[sound:4c-k-請求.mp3]	<b>請求</b> <br> せいきゅう <br> claim, demand, charge, application, request, billing (for a service)
請求	<b>せいきゅう</b> <br> claim, demand, charge, application, request, billing (for a service) <br> [sound:4c-k-請求.mp3]
claim, demand, charge, application, request, billing (for a service)	<b>請求</b> <br> せいきゅう <br> [sound:4c-k-請求.mp3]
[sound:4c-s-電気代の請求が届きました。.mp3]	<b>電気代の請求が届きました。</b> <br> でんきだいのせいきゅうがとどきました。 <br><br> (請求) <br> I received the electricity bill.
電気代の請求が届きました。 <br><br> (請求)	<b>でんきだいのせいきゅうがとどきました。</b> <br> I received the electricity bill. <br> [sound:4c-s-電気代の請求が届きました。.mp3]
I received the electricity bill.	<b>電気代の請求が届きました。</b> <br> でんきだいのせいきゅうがとどきました。 <br><br> (請求) <br> [sound:4c-s-電気代の請求が届きました。.mp3]
[sound:4c-k-追求.mp3]	<b>追求</b> <br> ついきゅう <br> pursuing (goal), pursuit, seeking, search; to pursue (e.g. goal), to seek
追求	<b>ついきゅう</b> <br> pursuing (goal), pursuit, seeking, search; to pursue (e.g. goal), to seek <br> [sound:4c-k-追求.mp3]
pursuing (goal), pursuit, seeking, search; to pursue (e.g. goal), to seek	<b>追求</b> <br> ついきゅう <br> [sound:4c-k-追求.mp3]
[sound:4c-s-彼は真実を追求しています。.mp3]	<b>彼は真実を追求しています。</b> <br> かれはしんじつをついきゅうしています。 <br><br> (追求) <br> He is pursuing the truth.
彼は真実を追求しています。 <br><br> (追求)	<b>かれはしんじつをついきゅうしています。</b> <br> He is pursuing the truth. <br> [sound:4c-s-彼は真実を追求しています。.mp3]
He is pursuing the truth.	<b>彼は真実を追求しています。</b> <br> かれはしんじつをついきゅうしています。 <br><br> (追求) <br> [sound:4c-s-彼は真実を追求しています。.mp3]
[sound:4c-k-求職.mp3]	<b>求職</b> <br> きゅうしょく <br> job hunting, seeking employment
求職	<b>きゅうしょく</b> <br> job hunting, seeking employment <br> [sound:4c-k-求職.mp3]
job hunting, seeking employment	<b>求職</b> <br> きゅうしょく <br> [sound:4c-k-求職.mp3]
[sound:4c-s-彼は現在、求職中です。.mp3]	<b>彼は現在、求職中です。</b> <br> かれはげんざい、きゅうしょくちゅうです。 <br><br> (求職) <br> He is currently looking for a job.
彼は現在、求職中です。 <br><br> (求職)	<b>かれはげんざい、きゅうしょくちゅうです。</b> <br> He is currently looking for a job. <br> [sound:4c-s-彼は現在、求職中です。.mp3]
He is currently looking for a job.	<b>彼は現在、求職中です。</b> <br> かれはげんざい、きゅうしょくちゅうです。 <br><br> (求職) <br> [sound:4c-s-彼は現在、求職中です。.mp3]
[sound:4c-k-事務所.mp3]	<b>事務所</b> <br> じむしょ <br> office
事務所	<b>じむしょ</b> <br> office <br> [sound:4c-k-事務所.mp3]
office	<b>事務所</b> <br> じむしょ <br> [sound:4c-k-事務所.mp3]
[sound:4c-s-このビルの事務所に行きました。.mp3]	<b>このビルの事務所に行きました。</b> <br> このびるのじむしょにいきました。 <br><br> (事務所) <br> I went to the office in this building.
このビルの事務所に行きました。 <br><br> (事務所)	<b>このびるのじむしょにいきました。</b> <br> I went to the office in this building. <br> [sound:4c-s-このビルの事務所に行きました。.mp3]
I went to the office in this building.	<b>このビルの事務所に行きました。</b> <br> このびるのじむしょにいきました。 <br><br> (事務所) <br> [sound:4c-s-このビルの事務所に行きました。.mp3]
[sound:4c-k-場所.mp3]	<b>場所</b> <br> ばしょ <br> place, location
場所	<b>ばしょ</b> <br> place, location <br> [sound:4c-k-場所.mp3]
place, location	<b>場所</b> <br> ばしょ <br> [sound:4c-k-場所.mp3]
[sound:4c-s-会議の場所はまだ決まっていません。.mp3]	<b>会議の場所はまだ決まっていません。</b> <br> かいぎのばしょはまだきまっていません。 <br><br> (場所) <br> The location for the meeting has not been decided yet.
会議の場所はまだ決まっていません。 <br><br> (場所)	<b>かいぎのばしょはまだきまっていません。</b> <br> The location for the meeting has not been decided yet. <br> [sound:4c-s-会議の場所はまだ決まっていません。.mp3]
The location for the meeting has not been decided yet.	<b>会議の場所はまだ決まっていません。</b> <br> かいぎのばしょはまだきまっていません。 <br><br> (場所) <br> [sound:4c-s-会議の場所はまだ決まっていません。.mp3]
[sound:4c-k-所属.mp3]	<b>所属</b> <br> しょぞく <br> attached to, belong to, member
所属	<b>しょぞく</b> <br> attached to, belong to, member <br> [sound:4c-k-所属.mp3]
attached to, belong to, member	<b>所属</b> <br> しょぞく <br> [sound:4c-k-所属.mp3]
[sound:4c-s-私はマーケティング部に所属しています。.mp3]	<b>私はマーケティング部に所属しています。</b> <br> わたしはまーけてぃんぐぶにしょぞくしています。 <br><br> (所属) <br> I belong to the marketing department.
私はマーケティング部に所属しています。 <br><br> (所属)	<b>わたしはまーけてぃんぐぶにしょぞくしています。</b> <br> I belong to the marketing department. <br> [sound:4c-s-私はマーケティング部に所属しています。.mp3]
I belong to the marketing department.	<b>私はマーケティング部に所属しています。</b> <br> わたしはまーけてぃんぐぶにしょぞくしています。 <br><br> (所属) <br> [sound:4c-s-私はマーケティング部に所属しています。.mp3]
[sound:4c-k-無所属.mp3]	<b>無所属</b> <br> むしょぞく <br> independent
無所属	<b>むしょぞく</b> <br> independent <br> [sound:4c-k-無所属.mp3]
independent	<b>無所属</b> <br> むしょぞく <br> [sound:4c-k-無所属.mp3]
[sound:4c-s-彼は無所属の議員です。.mp3]	<b>彼は無所属の議員です。</b> <br> かれはむしょぞくのぎいんです。 <br><br> (無所属) <br> He is an independent member of parliament.
彼は無所属の議員です。 <br><br> (無所属)	<b>かれはむしょぞくのぎいんです。</b> <br> He is an independent member of parliament. <br> [sound:4c-s-彼は無所属の議員です。.mp3]
He is an independent member of parliament.	<b>彼は無所属の議員です。</b> <br> かれはむしょぞくのぎいんです。 <br><br> (無所属) <br> [sound:4c-s-彼は無所属の議員です。.mp3]
[sound:4c-k-次官.mp3]	<b>次官</b> <br> じかん <br> vice-minister, undersecretary
次官	<b>じかん</b> <br> vice-minister, undersecretary <br> [sound:4c-k-次官.mp3]
vice-minister, undersecretary	<b>次官</b> <br> じかん <br> [sound:4c-k-次官.mp3]
[sound:4c-s-次官が会議に出席しました。.mp3]	<b>次官が会議に出席しました。</b> <br> じかんがかいぎにしゅっせきしました。 <br><br> (次官) <br> The vice minister attended the meeting.
次官が会議に出席しました。 <br><br> (次官)	<b>じかんがかいぎにしゅっせきしました。</b> <br> The vice minister attended the meeting. <br> [sound:4c-s-次官が会議に出席しました。.mp3]
The vice minister attended the meeting.	<b>次官が会議に出席しました。</b> <br> じかんがかいぎにしゅっせきしました。 <br><br> (次官) <br> [sound:4c-s-次官が会議に出席しました。.mp3]
[sound:4c-k-事務次官.mp3]	<b>事務次官</b> <br> じむじかん <br> permanent vice-president, undersecretary, vice-minister
事務次官	<b>じむじかん</b> <br> permanent vice-president, undersecretary, vice-minister <br> [sound:4c-k-事務次官.mp3]
permanent vice-president, undersecretary, vice-minister	<b>事務次官</b> <br> じむじかん <br> [sound:4c-k-事務次官.mp3]
[sound:4c-s-事務次官は重要な役割を担っています。.mp3]	<b>事務次官は重要な役割を担っています。</b> <br> じむじかんはじゅうようなやくわりをになっています。 <br><br> (事務次官) <br> The permanent secretary plays an important role.
事務次官は重要な役割を担っています。 <br><br> (事務次官)	<b>じむじかんはじゅうようなやくわりをになっています。</b> <br> The permanent secretary plays an important role. <br> [sound:4c-s-事務次官は重要な役割を担っています。.mp3]
The permanent secretary plays an important role.	<b>事務次官は重要な役割を担っています。</b> <br> じむじかんはじゅうようなやくわりをになっています。 <br><br> (事務次官) <br> [sound:4c-s-事務次官は重要な役割を担っています。.mp3]
[sound:4c-k-政務次官.mp3]	<b>政務次官</b> <br> せいむじかん <br> parliamentary vice-minister
政務次官	<b>せいむじかん</b> <br> parliamentary vice-minister <br> [sound:4c-k-政務次官.mp3]
parliamentary vice-minister	<b>政務次官</b> <br> せいむじかん <br> [sound:4c-k-政務次官.mp3]
[sound:4c-s-政務次官が政府の方針を発表しました。.mp3]	<b>政務次官が政府の方針を発表しました。</b> <br> せいむじかんがせいふのほうしんをはっぴょうしました。 <br><br> (政務次官) <br> The parliamentary secretary announced the government’s policy.
政務次官が政府の方針を発表しました。 <br><br> (政務次官)	<b>せいむじかんがせいふのほうしんをはっぴょうしました。</b> <br> The parliamentary secretary announced the government’s policy. <br> [sound:4c-s-政務次官が政府の方針を発表しました。.mp3]
The parliamentary secretary announced the government’s policy.	<b>政務次官が政府の方針を発表しました。</b> <br> せいむじかんがせいふのほうしんをはっぴょうしました。 <br><br> (政務次官) <br> [sound:4c-s-政務次官が政府の方針を発表しました。.mp3]
[sound:4c-k-五十三次.mp3]	<b>五十三次</b> <br> ごじゅうさんつぎ <br> the 53 Toukaidou stages
五十三次	<b>ごじゅうさんつぎ</b> <br> the 53 Toukaidou stages <br> [sound:4c-k-五十三次.mp3]
the 53 Toukaidou stages	<b>五十三次</b> <br> ごじゅうさんつぎ <br> [sound:4c-k-五十三次.mp3]
[sound:4c-s-五十三次を歩いて旅をしました。.mp3]	<b>五十三次を歩いて旅をしました。</b> <br> ごじゅうさんじをあるいてたびをしました。 <br><br> (五十三次) <br> I traveled by walking along the fifty-three stations.
五十三次を歩いて旅をしました。 <br><br> (五十三次)	<b>ごじゅうさんじをあるいてたびをしました。</b> <br> I traveled by walking along the fifty-three stations. <br> [sound:4c-s-五十三次を歩いて旅をしました。.mp3]
I traveled by walking along the fifty-three stations.	<b>五十三次を歩いて旅をしました。</b> <br> ごじゅうさんじをあるいてたびをしました。 <br><br> (五十三次) <br> [sound:4c-s-五十三次を歩いて旅をしました。.mp3]
[sound:4c-k-水.mp3]	<b>水</b> <br> みず <br> water (cold, fresh)
水	<b>みず</b> <br> water (cold, fresh) <br> [sound:4c-k-水.mp3]
water (cold, fresh)	<b>水</b> <br> みず <br> [sound:4c-k-水.mp3]
[sound:4c-s-水は生きるために必要です。.mp3]	<b>水は生きるために必要です。</b> <br> みずはいきるためにひつようです。 <br><br> (水) <br> Water is essential for life.
水は生きるために必要です。 <br><br> (水)	<b>みずはいきるためにひつようです。</b> <br> Water is essential for life. <br> [sound:4c-s-水は生きるために必要です。.mp3]
Water is essential for life.	<b>水は生きるために必要です。</b> <br> みずはいきるためにひつようです。 <br><br> (水) <br> [sound:4c-s-水は生きるために必要です。.mp3]
[sound:4c-k-水準.mp3]	<b>水準</b> <br> すいじゅん <br> level, standard; water level
水準	<b>すいじゅん</b> <br> level, standard; water level <br> [sound:4c-k-水準.mp3]
level, standard; water level	<b>水準</b> <br> すいじゅん <br> [sound:4c-k-水準.mp3]
[sound:4c-s-その商品の品質は高い水準にあります。.mp3]	<b>その商品の品質は高い水準にあります。</b> <br> そのしょうひんのひんしつはたかいすいじゅんにあります。 <br><br> (水準) <br> The quality of that product is at a high level.
その商品の品質は高い水準にあります。 <br><br> (水準)	<b>そのしょうひんのひんしつはたかいすいじゅんにあります。</b> <br> The quality of that product is at a high level. <br> [sound:4c-s-その商品の品質は高い水準にあります。.mp3]
The quality of that product is at a high level.	<b>その商品の品質は高い水準にあります。</b> <br> そのしょうひんのひんしつはたかいすいじゅんにあります。 <br><br> (水準) <br> [sound:4c-s-その商品の品質は高い水準にあります。.mp3]
[sound:4c-k-水質.mp3]	<b>水質</b> <br> すいしつ <br> water quality
水質	<b>すいしつ</b> <br> water quality <br> [sound:4c-k-水質.mp3]
water quality	<b>水質</b> <br> すいしつ <br> [sound:4c-k-水質.mp3]
[sound:4c-s-湖の水質は改善されました。.mp3]	<b>湖の水質は改善されました。</b> <br> みずうみのすいしつはかいぜんされました。 <br><br> (水質) <br> The water quality of the lake has improved.
湖の水質は改善されました。 <br><br> (水質)	<b>みずうみのすいしつはかいぜんされました。</b> <br> The water quality of the lake has improved. <br> [sound:4c-s-湖の水質は改善されました。.mp3]
The water quality of the lake has improved.	<b>湖の水質は改善されました。</b> <br> みずうみのすいしつはかいぜんされました。 <br><br> (水質) <br> [sound:4c-s-湖の水質は改善されました。.mp3]
[sound:4c-k-下水道.mp3]	<b>下水道</b> <br> げすいどう <br> drain, sewer, drainage system
下水道	<b>げすいどう</b> <br> drain, sewer, drainage system <br> [sound:4c-k-下水道.mp3]
drain, sewer, drainage system	<b>下水道</b> <br> げすいどう <br> [sound:4c-k-下水道.mp3]
[sound:4c-s-下水道の工事が行われています。.mp3]	<b>下水道の工事が行われています。</b> <br> げすいどうのこうじがおこなわれています。 <br><br> (下水道) <br> Sewer work is being conducted.
下水道の工事が行われています。 <br><br> (下水道)	<b>げすいどうのこうじがおこなわれています。</b> <br> Sewer work is being conducted. <br> [sound:4c-s-下水道の工事が行われています。.mp3]
Sewer work is being conducted.	<b>下水道の工事が行われています。</b> <br> げすいどうのこうじがおこなわれています。 <br><br> (下水道) <br> [sound:4c-s-下水道の工事が行われています。.mp3]
[sound:4c-k-半.mp3]	<b>半</b> <br> はん <br> half
半	<b>はん</b> <br> half <br> [sound:4c-k-半.mp3]
half	<b>半</b> <br> はん <br> [sound:4c-k-半.mp3]
[sound:4c-s-試合は半分が終了しました。.mp3]	<b>試合は半分が終了しました。</b> <br> しあいははんぶんがしゅうりょうしました。 <br><br> (半) <br> The game has completed half of its duration.
試合は半分が終了しました。 <br><br> (半)	<b>しあいははんぶんがしゅうりょうしました。</b> <br> The game has completed half of its duration. <br> [sound:4c-s-試合は半分が終了しました。.mp3]
The game has completed half of its duration.	<b>試合は半分が終了しました。</b> <br> しあいははんぶんがしゅうりょうしました。 <br><br> (半) <br> [sound:4c-s-試合は半分が終了しました。.mp3]
[sound:4c-k-時半.mp3]	<b>時半</b> <br> じはん <br> about an hour, short time; half past (the hour)
時半	<b>じはん</b> <br> about an hour, short time; half past (the hour) <br> [sound:4c-k-時半.mp3]
about an hour, short time; half past (the hour)	<b>時半</b> <br> じはん <br> [sound:4c-k-時半.mp3]
[sound:4c-s-会議は三時半に始まります。.mp3]	<b>会議は三時半に始まります。</b> <br> かいぎはさんじはんにはじまります。 <br><br> (時半) <br> The meeting starts at 3:30.
会議は三時半に始まります。 <br><br> (時半)	<b>かいぎはさんじはんにはじまります。</b> <br> The meeting starts at 3:30. <br> [sound:4c-s-会議は三時半に始まります。.mp3]
The meeting starts at 3:30.	<b>会議は三時半に始まります。</b> <br> かいぎはさんじはんにはじまります。 <br><br> (時半) <br> [sound:4c-s-会議は三時半に始まります。.mp3]
[sound:4c-k-朝鮮半島.mp3]	<b>朝鮮半島</b> <br> ちょうせんはんとう <br> Korean peninsula
朝鮮半島	<b>ちょうせんはんとう</b> <br> Korean peninsula <br> [sound:4c-k-朝鮮半島.mp3]
Korean peninsula	<b>朝鮮半島</b> <br> ちょうせんはんとう <br> [sound:4c-k-朝鮮半島.mp3]
[sound:4c-s-朝鮮半島は歴史的に重要な地域です。.mp3]	<b>朝鮮半島は歴史的に重要な地域です。</b> <br> ちょうせんはんとうはれきしてきにじゅうようなちいきです。 <br><br> (朝鮮半島) <br> The Korean Peninsula is a historically significant region.
朝鮮半島は歴史的に重要な地域です。 <br><br> (朝鮮半島)	<b>ちょうせんはんとうはれきしてきにじゅうようなちいきです。</b> <br> The Korean Peninsula is a historically significant region. <br> [sound:4c-s-朝鮮半島は歴史的に重要な地域です。.mp3]
The Korean Peninsula is a historically significant region.	<b>朝鮮半島は歴史的に重要な地域です。</b> <br> ちょうせんはんとうはれきしてきにじゅうようなちいきです。 <br><br> (朝鮮半島) <br> [sound:4c-s-朝鮮半島は歴史的に重要な地域です。.mp3]
[sound:4c-k-半数.mp3]	<b>半数</b> <br> はんすう <br> half the number; haploid
半数	<b>はんすう</b> <br> half the number; haploid <br> [sound:4c-k-半数.mp3]
half the number; haploid	<b>半数</b> <br> はんすう <br> [sound:4c-k-半数.mp3]
[sound:4c-s-投票の半数が賛成しました。.mp3]	<b>投票の半数が賛成しました。</b> <br> とうひょうのはんすうがさんせいしました。 <br><br> (半数) <br> Half of the votes were in favor.
投票の半数が賛成しました。 <br><br> (半数)	<b>とうひょうのはんすうがさんせいしました。</b> <br> Half of the votes were in favor. <br> [sound:4c-s-投票の半数が賛成しました。.mp3]
Half of the votes were in favor.	<b>投票の半数が賛成しました。</b> <br> とうひょうのはんすうがさんせいしました。 <br><br> (半数) <br> [sound:4c-s-投票の半数が賛成しました。.mp3]
[sound:4c-k-作品.mp3]	<b>作品</b> <br> さくひん <br> work (e.g. book, film, composition, etc.), opus, performance, production
作品	<b>さくひん</b> <br> work (e.g. book, film, composition, etc.), opus, performance, production <br> [sound:4c-k-作品.mp3]
work (e.g. book, film, composition, etc.), opus, performance, production	<b>作品</b> <br> さくひん <br> [sound:4c-k-作品.mp3]
[sound:4c-s-彼の最新の作品は非常に評価されています。.mp3]	<b>彼の最新の作品は非常に評価されています。</b> <br> かれのさいしんのさくひんはひじょうにひょうかされています。 <br><br> (作品) <br> His latest work is highly praised.
彼の最新の作品は非常に評価されています。 <br><br> (作品)	<b>かれのさいしんのさくひんはひじょうにひょうかされています。</b> <br> His latest work is highly praised. <br> [sound:4c-s-彼の最新の作品は非常に評価されています。.mp3]
His latest work is highly praised.	<b>彼の最新の作品は非常に評価されています。</b> <br> かれのさいしんのさくひんはひじょうにひょうかされています。 <br><br> (作品) <br> [sound:4c-s-彼の最新の作品は非常に評価されています。.mp3]
[sound:4c-k-商品.mp3]	<b>商品</b> <br> しょうひん <br> commodity, article of commerce, goods, stock, merchandise
商品	<b>しょうひん</b> <br> commodity, article of commerce, goods, stock, merchandise <br> [sound:4c-k-商品.mp3]
commodity, article of commerce, goods, stock, merchandise	<b>商品</b> <br> しょうひん <br> [sound:4c-k-商品.mp3]
[sound:4c-s-新しい商品が店に並びました。.mp3]	<b>新しい商品が店に並びました。</b> <br> あたらしいしょうひんがみせにならびました。 <br><br> (商品) <br> New products have been displayed in the store.
新しい商品が店に並びました。 <br><br> (商品)	<b>あたらしいしょうひんがみせにならびました。</b> <br> New products have been displayed in the store. <br> [sound:4c-s-新しい商品が店に並びました。.mp3]
New products have been displayed in the store.	<b>新しい商品が店に並びました。</b> <br> あたらしいしょうひんがみせにならびました。 <br><br> (商品) <br> [sound:4c-s-新しい商品が店に並びました。.mp3]
[sound:4c-k-品種.mp3]	<b>品種</b> <br> ひんしゅ <br> kind (of goods), brand; (taxonomical) form; breed, cultivar
品種	<b>ひんしゅ</b> <br> kind (of goods), brand; (taxonomical) form; breed, cultivar <br> [sound:4c-k-品種.mp3]
kind (of goods), brand; (taxonomical) form; breed, cultivar	<b>品種</b> <br> ひんしゅ <br> [sound:4c-k-品種.mp3]
[sound:4c-s-この花の品種は非常に珍しいです。.mp3]	<b>この花の品種は非常に珍しいです。</b> <br> このはなのひんしゅはひじょうにめずらしいです。 <br><br> (品種) <br> This type of flower is very rare.
この花の品種は非常に珍しいです。 <br><br> (品種)	<b>このはなのひんしゅはひじょうにめずらしいです。</b> <br> This type of flower is very rare. <br> [sound:4c-s-この花の品種は非常に珍しいです。.mp3]
This type of flower is very rare.	<b>この花の品種は非常に珍しいです。</b> <br> このはなのひんしゅはひじょうにめずらしいです。 <br><br> (品種) <br> [sound:4c-s-この花の品種は非常に珍しいです。.mp3]
[sound:4c-k-品目.mp3]	<b>品目</b> <br> ひんもく <br> list of articles
品目	<b>ひんもく</b> <br> list of articles <br> [sound:4c-k-品目.mp3]
list of articles	<b>品目</b> <br> ひんもく <br> [sound:4c-k-品目.mp3]
[sound:4c-s-メニューには多くの品目があります。.mp3]	<b>メニューには多くの品目があります。</b> <br> めにゅーにはおおくのひんもくがあります。 <br><br> (品目) <br> There are many items on the menu.
メニューには多くの品目があります。 <br><br> (品目)	<b>めにゅーにはおおくのひんもくがあります。</b> <br> There are many items on the menu. <br> [sound:4c-s-メニューには多くの品目があります。.mp3]
There are many items on the menu.	<b>メニューには多くの品目があります。</b> <br> めにゅーにはおおくのひんもくがあります。 <br><br> (品目) <br> [sound:4c-s-メニューには多くの品目があります。.mp3]
[sound:4c-k-昨年.mp3]	<b>昨年</b> <br> さくねん <br> last year
昨年	<b>さくねん</b> <br> last year <br> [sound:4c-k-昨年.mp3]
last year	<b>昨年</b> <br> さくねん <br> [sound:4c-k-昨年.mp3]
[sound:4c-s-昨年はとても忙しい年でした。.mp3]	<b>昨年はとても忙しい年でした。</b> <br> さくねんはとてもいそがしいとしでした。 <br><br> (昨年) <br> Last year was a very busy year.
昨年はとても忙しい年でした。 <br><br> (昨年)	<b>さくねんはとてもいそがしいとしでした。</b> <br> Last year was a very busy year. <br> [sound:4c-s-昨年はとても忙しい年でした。.mp3]
Last year was a very busy year.	<b>昨年はとても忙しい年でした。</b> <br> さくねんはとてもいそがしいとしでした。 <br><br> (昨年) <br> [sound:4c-s-昨年はとても忙しい年でした。.mp3]
[sound:4c-k-一昨年.mp3]	<b>一昨年</b> <br> いっさくねん, おととし <br> year before last
一昨年	<b>いっさくねん, おととし</b> <br> year before last <br> [sound:4c-k-一昨年.mp3]
year before last	<b>一昨年</b> <br> いっさくねん, おととし <br> [sound:4c-k-一昨年.mp3]
[sound:4c-s-一昨年、私は海外に行きました。.mp3]	<b>一昨年、私は海外に行きました。</b> <br> おととし、わたしはかいがいにいきました。 <br><br> (一昨年) <br> I went abroad the year before last.
一昨年、私は海外に行きました。 <br><br> (一昨年)	<b>おととし、わたしはかいがいにいきました。</b> <br> I went abroad the year before last. <br> [sound:4c-s-一昨年、私は海外に行きました。.mp3]
I went abroad the year before last.	<b>一昨年、私は海外に行きました。</b> <br> おととし、わたしはかいがいにいきました。 <br><br> (一昨年) <br> [sound:4c-s-一昨年、私は海外に行きました。.mp3]
[sound:4c-k-昨夜.mp3]	<b>昨夜</b> <br> ゆう, ゆうべ, さくや <br> evening; last night
昨夜	<b>ゆう, ゆうべ, さくや</b> <br> evening; last night <br> [sound:4c-k-昨夜.mp3]
evening; last night	<b>昨夜</b> <br> ゆう, ゆうべ, さくや <br> [sound:4c-k-昨夜.mp3]
[sound:4c-s-昨夜はとても寒かったです。.mp3]	<b>昨夜はとても寒かったです。</b> <br> ゆうべはとてもさむかったです。 <br><br> (昨夜) <br> It was very cold last night.
昨夜はとても寒かったです。 <br><br> (昨夜)	<b>ゆうべはとてもさむかったです。</b> <br> It was very cold last night. <br> [sound:4c-s-昨夜はとても寒かったです。.mp3]
It was very cold last night.	<b>昨夜はとても寒かったです。</b> <br> ゆうべはとてもさむかったです。 <br><br> (昨夜) <br> [sound:4c-s-昨夜はとても寒かったです。.mp3]
[sound:4c-k-昨冬.mp3]	<b>昨冬</b> <br> さくとう <br> last winter
昨冬	<b>さくとう</b> <br> last winter <br> [sound:4c-k-昨冬.mp3]
last winter	<b>昨冬</b> <br> さくとう <br> [sound:4c-k-昨冬.mp3]
[sound:4c-s-昨冬、雪がたくさん降りました。.mp3]	<b>昨冬、雪がたくさん降りました。</b> <br> さくふゆ、ゆきがたくさんふりました。 <br><br> (昨冬) <br> Last winter, a lot of snow fell.
昨冬、雪がたくさん降りました。 <br><br> (昨冬)	<b>さくふゆ、ゆきがたくさんふりました。</b> <br> Last winter, a lot of snow fell. <br> [sound:4c-s-昨冬、雪がたくさん降りました。.mp3]
Last winter, a lot of snow fell.	<b>昨冬、雪がたくさん降りました。</b> <br> さくふゆ、ゆきがたくさんふりました。 <br><br> (昨冬) <br> [sound:4c-s-昨冬、雪がたくさん降りました。.mp3]
[sound:4c-k-論議.mp3]	<b>論議</b> <br> ろんぎ <br> discussion, argument, debate
論議	<b>ろんぎ</b> <br> discussion, argument, debate <br> [sound:4c-k-論議.mp3]
discussion, argument, debate	<b>論議</b> <br> ろんぎ <br> [sound:4c-k-論議.mp3]
[sound:4c-s-論議の結果、意見が一致しました。.mp3]	<b>論議の結果、意見が一致しました。</b> <br> ろんぎのけっか、いけんがいっちしました。 <br><br> (論議) <br> As a result of the debate, opinions were unified.
論議の結果、意見が一致しました。 <br><br> (論議)	<b>ろんぎのけっか、いけんがいっちしました。</b> <br> As a result of the debate, opinions were unified. <br> [sound:4c-s-論議の結果、意見が一致しました。.mp3]
As a result of the debate, opinions were unified.	<b>論議の結果、意見が一致しました。</b> <br> ろんぎのけっか、いけんがいっちしました。 <br><br> (論議) <br> [sound:4c-s-論議の結果、意見が一致しました。.mp3]
[sound:4c-k-議論.mp3]	<b>議論</b> <br> ぎろん <br> argument, discussion, dispute, controversy
議論	<b>ぎろん</b> <br> argument, discussion, dispute, controversy <br> [sound:4c-k-議論.mp3]
argument, discussion, dispute, controversy	<b>議論</b> <br> ぎろん <br> [sound:4c-k-議論.mp3]
[sound:4c-s-議論の後、結論が出ました。.mp3]	<b>議論の後、結論が出ました。</b> <br> ぎろんのあと、けつろんがでました。 <br><br> (議論) <br> After the discussion, a conclusion was reached.
議論の後、結論が出ました。 <br><br> (議論)	<b>ぎろんのあと、けつろんがでました。</b> <br> After the discussion, a conclusion was reached. <br> [sound:4c-s-議論の後、結論が出ました。.mp3]
After the discussion, a conclusion was reached.	<b>議論の後、結論が出ました。</b> <br> ぎろんのあと、けつろんがでました。 <br><br> (議論) <br> [sound:4c-s-議論の後、結論が出ました。.mp3]
[sound:4c-k-論争.mp3]	<b>論争</b> <br> ろんそう <br> controversy, dispute
論争	<b>ろんそう</b> <br> controversy, dispute <br> [sound:4c-k-論争.mp3]
controversy, dispute	<b>論争</b> <br> ろんそう <br> [sound:4c-k-論争.mp3]
[sound:4c-s-彼らの間で論争が起こりました。.mp3]	<b>彼らの間で論争が起こりました。</b> <br> かれらのあいだでろんそうがおこりました。 <br><br> (論争) <br> A dispute arose between them.
彼らの間で論争が起こりました。 <br><br> (論争)	<b>かれらのあいだでろんそうがおこりました。</b> <br> A dispute arose between them. <br> [sound:4c-s-彼らの間で論争が起こりました。.mp3]
A dispute arose between them.	<b>彼らの間で論争が起こりました。</b> <br> かれらのあいだでろんそうがおこりました。 <br><br> (論争) <br> [sound:4c-s-彼らの間で論争が起こりました。.mp3]
[sound:4c-k-論理.mp3]	<b>論理</b> <br> ろんり <br> logic; logical
論理	<b>ろんり</b> <br> logic; logical <br> [sound:4c-k-論理.mp3]
logic; logical	<b>論理</b> <br> ろんり <br> [sound:4c-k-論理.mp3]
[sound:4c-s-論理的に考えることは重要です。.mp3]	<b>論理的に考えることは重要です。</b> <br> ろんりてきにかんがえることはじゅうようです。 <br><br> (論理) <br> Thinking logically is important.
論理的に考えることは重要です。 <br><br> (論理)	<b>ろんりてきにかんがえることはじゅうようです。</b> <br> Thinking logically is important. <br> [sound:4c-s-論理的に考えることは重要です。.mp3]
Thinking logically is important.	<b>論理的に考えることは重要です。</b> <br> ろんりてきにかんがえることはじゅうようです。 <br><br> (論理) <br> [sound:4c-s-論理的に考えることは重要です。.mp3]
[sound:4c-k-計.mp3]	<b>計</b> <br> けい <br> plan; meter, measuring device; (in) total, total (of)
計	<b>けい</b> <br> plan; meter, measuring device; (in) total, total (of) <br> [sound:4c-k-計.mp3]
plan; meter, measuring device; (in) total, total (of)	<b>計</b> <br> けい <br> [sound:4c-k-計.mp3]
[sound:4c-s-計画を立てる前に、予算を確認してください。.mp3]	<b>計画を立てる前に、予算を確認してください。</b> <br> けいかくをたてるまえに、よさんをかくにんしてください。 <br><br> (計) <br> Please check the budget before making a plan.
計画を立てる前に、予算を確認してください。 <br><br> (計)	<b>けいかくをたてるまえに、よさんをかくにんしてください。</b> <br> Please check the budget before making a plan. <br> [sound:4c-s-計画を立てる前に、予算を確認してください。.mp3]
Please check the budget before making a plan.	<b>計画を立てる前に、予算を確認してください。</b> <br> けいかくをたてるまえに、よさんをかくにんしてください。 <br><br> (計) <br> [sound:4c-s-計画を立てる前に、予算を確認してください。.mp3]
[sound:4c-k-計画.mp3]	<b>計画</b> <br> けいかく <br> plan, project, schedule, scheme, program, programme
計画	<b>けいかく</b> <br> plan, project, schedule, scheme, program, programme <br> [sound:4c-k-計画.mp3]
plan, project, schedule, scheme, program, programme	<b>計画</b> <br> けいかく <br> [sound:4c-k-計画.mp3]
[sound:4c-s-私は新しい計画を提案しました。.mp3]	<b>私は新しい計画を提案しました。</b> <br> わたしはあたらしいけいかくをていあんしました。 <br><br> (計画) <br> I proposed a new plan.
私は新しい計画を提案しました。 <br><br> (計画)	<b>わたしはあたらしいけいかくをていあんしました。</b> <br> I proposed a new plan. <br> [sound:4c-s-私は新しい計画を提案しました。.mp3]
I proposed a new plan.	<b>私は新しい計画を提案しました。</b> <br> わたしはあたらしいけいかくをていあんしました。 <br><br> (計画) <br> [sound:4c-s-私は新しい計画を提案しました。.mp3]
[sound:4c-k-集計.mp3]	<b>集計</b> <br> しゅうけい <br> totalization, totalisation, aggregate
集計	<b>しゅうけい</b> <br> totalization, totalisation, aggregate <br> [sound:4c-k-集計.mp3]
totalization, totalisation, aggregate	<b>集計</b> <br> しゅうけい <br> [sound:4c-k-集計.mp3]
[sound:4c-s-集計結果が発表されました。.mp3]	<b>集計結果が発表されました。</b> <br> しゅうけいけっかがはっぴょうされました。 <br><br> (集計) <br> The results of the tally were announced.
集計結果が発表されました。 <br><br> (集計)	<b>しゅうけいけっかがはっぴょうされました。</b> <br> The results of the tally were announced. <br> [sound:4c-s-集計結果が発表されました。.mp3]
The results of the tally were announced.	<b>集計結果が発表されました。</b> <br> しゅうけいけっかがはっぴょうされました。 <br><br> (集計) <br> [sound:4c-s-集計結果が発表されました。.mp3]
[sound:4c-k-家計.mp3]	<b>家計</b> <br> かけい <br> household economy, family finances
家計	<b>かけい</b> <br> household economy, family finances <br> [sound:4c-k-家計.mp3]
household economy, family finances	<b>家計</b> <br> かけい <br> [sound:4c-k-家計.mp3]
[sound:4c-s-家計の管理が重要です。.mp3]	<b>家計の管理が重要です。</b> <br> かけいのかんりがじゅうようです。 <br><br> (家計) <br> Managing household finances is important.
家計の管理が重要です。 <br><br> (家計)	<b>かけいのかんりがじゅうようです。</b> <br> Managing household finances is important. <br> [sound:4c-s-家計の管理が重要です。.mp3]
Managing household finances is important.	<b>家計の管理が重要です。</b> <br> かけいのかんりがじゅうようです。 <br><br> (家計) <br> [sound:4c-s-家計の管理が重要です。.mp3]
[sound:4c-k-死.mp3]	<b>死</b> <br> し <br> death, decease; death penalty (by strangulation or decapitation)
死	<b>し</b> <br> death, decease; death penalty (by strangulation or decapitation) <br> [sound:4c-k-死.mp3]
death, decease; death penalty (by strangulation or decapitation)	<b>死</b> <br> し <br> [sound:4c-k-死.mp3]
[sound:4c-s-彼は戦争で死にました。.mp3]	<b>彼は戦争で死にました。</b> <br> かれはせんそうでしにました。 <br><br> (死) <br> He died in the war.
彼は戦争で死にました。 <br><br> (死)	<b>かれはせんそうでしにました。</b> <br> He died in the war. <br> [sound:4c-s-彼は戦争で死にました。.mp3]
He died in the war.	<b>彼は戦争で死にました。</b> <br> かれはせんそうでしにました。 <br><br> (死) <br> [sound:4c-s-彼は戦争で死にました。.mp3]
[sound:4c-k-死者.mp3]	<b>死者</b> <br> ししゃ <br> casualty, deceased
死者	<b>ししゃ</b> <br> casualty, deceased <br> [sound:4c-k-死者.mp3]
casualty, deceased	<b>死者</b> <br> ししゃ <br> [sound:4c-k-死者.mp3]
[sound:4c-s-事故で多くの死者が出ました。.mp3]	<b>事故で多くの死者が出ました。</b> <br> じこでおおくのししゃがでました。 <br><br> (死者) <br> Many casualties occurred in the accident.
事故で多くの死者が出ました。 <br><br> (死者)	<b>じこでおおくのししゃがでました。</b> <br> Many casualties occurred in the accident. <br> [sound:4c-s-事故で多くの死者が出ました。.mp3]
Many casualties occurred in the accident.	<b>事故で多くの死者が出ました。</b> <br> じこでおおくのししゃがでました。 <br><br> (死者) <br> [sound:4c-s-事故で多くの死者が出ました。.mp3]
[sound:4c-k-死後.mp3]	<b>死後</b> <br> しご <br> after death
死後	<b>しご</b> <br> after death <br> [sound:4c-k-死後.mp3]
after death	<b>死後</b> <br> しご <br> [sound:4c-k-死後.mp3]
[sound:4c-s-死後、彼の名声は広まりました。.mp3]	<b>死後、彼の名声は広まりました。</b> <br> しご、かれのめいせいはひろまりました。 <br><br> (死後) <br> After his death, his fame spread.
死後、彼の名声は広まりました。 <br><br> (死後)	<b>しご、かれのめいせいはひろまりました。</b> <br> After his death, his fame spread. <br> [sound:4c-s-死後、彼の名声は広まりました。.mp3]
After his death, his fame spread.	<b>死後、彼の名声は広まりました。</b> <br> しご、かれのめいせいはひろまりました。 <br><br> (死後) <br> [sound:4c-s-死後、彼の名声は広まりました。.mp3]
[sound:4c-k-死体.mp3]	<b>死体</b> <br> したい <br> dead body, corpse, cadaver
死体	<b>したい</b> <br> dead body, corpse, cadaver <br> [sound:4c-k-死体.mp3]
dead body, corpse, cadaver	<b>死体</b> <br> したい <br> [sound:4c-k-死体.mp3]
[sound:4c-s-警察は死体を発見しました。.mp3]	<b>警察は死体を発見しました。</b> <br> けいさつはしたいをはっけんしました。 <br><br> (死体) <br> The police discovered the body.
警察は死体を発見しました。 <br><br> (死体)	<b>けいさつはしたいをはっけんしました。</b> <br> The police discovered the body. <br> [sound:4c-s-警察は死体を発見しました。.mp3]
The police discovered the body.	<b>警察は死体を発見しました。</b> <br> けいさつはしたいをはっけんしました。 <br><br> (死体) <br> [sound:4c-s-警察は死体を発見しました。.mp3]
[sound:4c-k-長官.mp3]	<b>長官</b> <br> ちょうかん <br> secretary (government), director, chief
長官	<b>ちょうかん</b> <br> secretary (government), director, chief <br> [sound:4c-k-長官.mp3]
secretary (government), director, chief	<b>長官</b> <br> ちょうかん <br> [sound:4c-k-長官.mp3]
[sound:4c-s-長官は会議で重要な発言をしました。.mp3]	<b>長官は会議で重要な発言をしました。</b> <br> ちょうかんはかいぎでじゅうようなはつげんをしました。 <br><br> (長官) <br> The director made an important statement at the meeting.
長官は会議で重要な発言をしました。 <br><br> (長官)	<b>ちょうかんはかいぎでじゅうようなはつげんをしました。</b> <br> The director made an important statement at the meeting. <br> [sound:4c-s-長官は会議で重要な発言をしました。.mp3]
The director made an important statement at the meeting.	<b>長官は会議で重要な発言をしました。</b> <br> ちょうかんはかいぎでじゅうようなはつげんをしました。 <br><br> (長官) <br> [sound:4c-s-長官は会議で重要な発言をしました。.mp3]
[sound:4c-k-官邸.mp3]	<b>官邸</b> <br> かんてい <br> official residence
官邸	<b>かんてい</b> <br> official residence <br> [sound:4c-k-官邸.mp3]
official residence	<b>官邸</b> <br> かんてい <br> [sound:4c-k-官邸.mp3]
[sound:4c-s-総理大臣は官邸にいます。.mp3]	<b>総理大臣は官邸にいます。</b> <br> そうりだいじんはかんていにいます。 <br><br> (官邸) <br> The Prime Minister is at the official residence.
総理大臣は官邸にいます。 <br><br> (官邸)	<b>そうりだいじんはかんていにいます。</b> <br> The Prime Minister is at the official residence. <br> [sound:4c-s-総理大臣は官邸にいます。.mp3]
The Prime Minister is at the official residence.	<b>総理大臣は官邸にいます。</b> <br> そうりだいじんはかんていにいます。 <br><br> (官邸) <br> [sound:4c-s-総理大臣は官邸にいます。.mp3]
[sound:4c-k-官房.mp3]	<b>官房</b> <br> かんぼう <br> government secretariat
官房	<b>かんぼう</b> <br> government secretariat <br> [sound:4c-k-官房.mp3]
government secretariat	<b>官房</b> <br> かんぼう <br> [sound:4c-k-官房.mp3]
[sound:4c-s-官房長官が記者会見を行いました。.mp3]	<b>官房長官が記者会見を行いました。</b> <br> かんぼうちょうかんがきしゃかいけんをおこないました。 <br><br> (官房) <br> The Chief Cabinet Secretary held a press conference.
官房長官が記者会見を行いました。 <br><br> (官房)	<b>かんぼうちょうかんがきしゃかいけんをおこないました。</b> <br> The Chief Cabinet Secretary held a press conference. <br> [sound:4c-s-官房長官が記者会見を行いました。.mp3]
The Chief Cabinet Secretary held a press conference.	<b>官房長官が記者会見を行いました。</b> <br> かんぼうちょうかんがきしゃかいけんをおこないました。 <br><br> (官房) <br> [sound:4c-s-官房長官が記者会見を行いました。.mp3]
[sound:4c-k-国務長官.mp3]	<b>国務長官</b> <br> こくむちょうかん <br> Secretary of State
国務長官	<b>こくむちょうかん</b> <br> Secretary of State <br> [sound:4c-k-国務長官.mp3]
Secretary of State	<b>国務長官</b> <br> こくむちょうかん <br> [sound:4c-k-国務長官.mp3]
[sound:4c-s-国務長官は外国を訪問しました。.mp3]	<b>国務長官は外国を訪問しました。</b> <br> こくむちょうかんはがいこくをほうもんしました。 <br><br> (国務長官) <br> The Secretary of State visited a foreign country.
国務長官は外国を訪問しました。 <br><br> (国務長官)	<b>こくむちょうかんはがいこくをほうもんしました。</b> <br> The Secretary of State visited a foreign country. <br> [sound:4c-s-国務長官は外国を訪問しました。.mp3]
The Secretary of State visited a foreign country.	<b>国務長官は外国を訪問しました。</b> <br> こくむちょうかんはがいこくをほうもんしました。 <br><br> (国務長官) <br> [sound:4c-s-国務長官は外国を訪問しました。.mp3]
[sound:4c-k-増加.mp3]	<b>増加</b> <br> ぞうか <br> increase, increment, addition
増加	<b>ぞうか</b> <br> increase, increment, addition <br> [sound:4c-k-増加.mp3]
increase, increment, addition	<b>増加</b> <br> ぞうか <br> [sound:4c-k-増加.mp3]
[sound:4c-s-人口が増加しています。.mp3]	<b>人口が増加しています。</b> <br> じんこうがぞうかしています。 <br><br> (増加) <br> The population is increasing.
人口が増加しています。 <br><br> (増加)	<b>じんこうがぞうかしています。</b> <br> The population is increasing. <br> [sound:4c-s-人口が増加しています。.mp3]
The population is increasing.	<b>人口が増加しています。</b> <br> じんこうがぞうかしています。 <br><br> (増加) <br> [sound:4c-s-人口が増加しています。.mp3]
[sound:4c-k-増税.mp3]	<b>増税</b> <br> ぞうぜい <br> tax increase
増税	<b>ぞうぜい</b> <br> tax increase <br> [sound:4c-k-増税.mp3]
tax increase	<b>増税</b> <br> ぞうぜい <br> [sound:4c-k-増税.mp3]
[sound:4c-s-政府は増税を決定しました。.mp3]	<b>政府は増税を決定しました。</b> <br> せいふはぞうぜいをけっていしました。 <br><br> (増税) <br> The government decided on a tax increase.
政府は増税を決定しました。 <br><br> (増税)	<b>せいふはぞうぜいをけっていしました。</b> <br> The government decided on a tax increase. <br> [sound:4c-s-政府は増税を決定しました。.mp3]
The government decided on a tax increase.	<b>政府は増税を決定しました。</b> <br> せいふはぞうぜいをけっていしました。 <br><br> (増税) <br> [sound:4c-s-政府は増税を決定しました。.mp3]
[sound:4c-k-増益.mp3]	<b>増益</b> <br> ぞうえき <br> increased (profit)
増益	<b>ぞうえき</b> <br> increased (profit) <br> [sound:4c-k-増益.mp3]
increased (profit)	<b>増益</b> <br> ぞうえき <br> [sound:4c-k-増益.mp3]
[sound:4c-s-今年は企業の増益が見込まれています。.mp3]	<b>今年は企業の増益が見込まれています。</b> <br> ことしはきぎょうのぞうえきがみこまれています。 <br><br> (増益) <br> Companies are expected to see increased profits this year.
今年は企業の増益が見込まれています。 <br><br> (増益)	<b>ことしはきぎょうのぞうえきがみこまれています。</b> <br> Companies are expected to see increased profits this year. <br> [sound:4c-s-今年は企業の増益が見込まれています。.mp3]
Companies are expected to see increased profits this year.	<b>今年は企業の増益が見込まれています。</b> <br> ことしはきぎょうのぞうえきがみこまれています。 <br><br> (増益) <br> [sound:4c-s-今年は企業の増益が見込まれています。.mp3]
[sound:4c-k-増額.mp3]	<b>増額</b> <br> ぞうがく <br> increased amount
増額	<b>ぞうがく</b> <br> increased amount <br> [sound:4c-k-増額.mp3]
increased amount	<b>増額</b> <br> ぞうがく <br> [sound:4c-k-増額.mp3]
[sound:4c-s-予算の増額が承認されました。.mp3]	<b>予算の増額が承認されました。</b> <br> よさんのぞうがくがしょうにんされました。 <br><br> (増額) <br> A budget increase was approved.
予算の増額が承認されました。 <br><br> (増額)	<b>よさんのぞうがくがしょうにんされました。</b> <br> A budget increase was approved. <br> [sound:4c-s-予算の増額が承認されました。.mp3]
A budget increase was approved.	<b>予算の増額が承認されました。</b> <br> よさんのぞうがくがしょうにんされました。 <br><br> (増額) <br> [sound:4c-s-予算の増額が承認されました。.mp3]
[sound:4c-k-係.mp3]	<b>係</b> <br> かかり <br> official, duty, person in charge
係	<b>かかり</b> <br> official, duty, person in charge <br> [sound:4c-k-係.mp3]
official, duty, person in charge	<b>係</b> <br> かかり <br> [sound:4c-k-係.mp3]
[sound:4c-s-彼はプロジェクトの係です。.mp3]	<b>彼はプロジェクトの係です。</b> <br> かれはぷろじぇくとのかかりです。 <br><br> (係) <br> He is in charge of the project.
彼はプロジェクトの係です。 <br><br> (係)	<b>かれはぷろじぇくとのかかりです。</b> <br> He is in charge of the project. <br> [sound:4c-s-彼はプロジェクトの係です。.mp3]
He is in charge of the project.	<b>彼はプロジェクトの係です。</b> <br> かれはぷろじぇくとのかかりです。 <br><br> (係) <br> [sound:4c-s-彼はプロジェクトの係です。.mp3]
[sound:4c-k-関係.mp3]	<b>関係</b> <br> かんけい <br> relation, connection
関係	<b>かんけい</b> <br> relation, connection <br> [sound:4c-k-関係.mp3]
relation, connection	<b>関係</b> <br> かんけい <br> [sound:4c-k-関係.mp3]
[sound:4c-s-私たちは長い関係を築いてきました。.mp3]	<b>私たちは長い関係を築いてきました。</b> <br> わたしたちはながいかんけいをきずいてきました。 <br><br> (関係) <br> We have built a long relationship.
私たちは長い関係を築いてきました。 <br><br> (関係)	<b>わたしたちはながいかんけいをきずいてきました。</b> <br> We have built a long relationship. <br> [sound:4c-s-私たちは長い関係を築いてきました。.mp3]
We have built a long relationship.	<b>私たちは長い関係を築いてきました。</b> <br> わたしたちはながいかんけいをきずいてきました。 <br><br> (関係) <br> [sound:4c-s-私たちは長い関係を築いてきました。.mp3]
[sound:4c-k-係争.mp3]	<b>係争</b> <br> けいそう <br> contention, dispute
係争	<b>けいそう</b> <br> contention, dispute <br> [sound:4c-k-係争.mp3]
contention, dispute	<b>係争</b> <br> けいそう <br> [sound:4c-k-係争.mp3]
[sound:4c-s-この件はまだ係争中です。.mp3]	<b>この件はまだ係争中です。</b> <br> このけんはまだけいそうちゅうです。 <br><br> (係争) <br> This issue is still under dispute.
この件はまだ係争中です。 <br><br> (係争)	<b>このけんはまだけいそうちゅうです。</b> <br> This issue is still under dispute. <br> [sound:4c-s-この件はまだ係争中です。.mp3]
This issue is still under dispute.	<b>この件はまだ係争中です。</b> <br> このけんはまだけいそうちゅうです。 <br><br> (係争) <br> [sound:4c-s-この件はまだ係争中です。.mp3]
[sound:4c-k-連係プレー.mp3]	<b>連係プレー</b> <br> れんけいプレー <br> good teamwork play (baseball)
連係プレー	<b>れんけいプレー</b> <br> good teamwork play (baseball) <br> [sound:4c-k-連係プレー.mp3]
good teamwork play (baseball)	<b>連係プレー</b> <br> れんけいプレー <br> [sound:4c-k-連係プレー.mp3]
[sound:4c-s-サッカーの連係プレーが素晴らしかった。.mp3]	<b>サッカーの連係プレーが素晴らしかった。</b> <br> さっかーのれんけいぷれーがすばらしかった。 <br><br> (連係プレー) <br> The teamwork in the soccer game was fantastic.
サッカーの連係プレーが素晴らしかった。 <br><br> (連係プレー)	<b>さっかーのれんけいぷれーがすばらしかった。</b> <br> The teamwork in the soccer game was fantastic. <br> [sound:4c-s-サッカーの連係プレーが素晴らしかった。.mp3]
The teamwork in the soccer game was fantastic.	<b>サッカーの連係プレーが素晴らしかった。</b> <br> さっかーのれんけいぷれーがすばらしかった。 <br><br> (連係プレー) <br> [sound:4c-s-サッカーの連係プレーが素晴らしかった。.mp3]
[sound:4c-k-感じ.mp3]	<b>感じ</b> <br> かんじ <br> feeling, sense, impression
感じ	<b>かんじ</b> <br> feeling, sense, impression <br> [sound:4c-k-感じ.mp3]
feeling, sense, impression	<b>感じ</b> <br> かんじ <br> [sound:4c-k-感じ.mp3]
[sound:4c-s-この場所はとても落ち着いた感じです。.mp3]	<b>この場所はとても落ち着いた感じです。</b> <br> このばしょはとてもおちついたかんじです。 <br><br> (感じ) <br> This place has a very calm feeling.
この場所はとても落ち着いた感じです。 <br><br> (感じ)	<b>このばしょはとてもおちついたかんじです。</b> <br> This place has a very calm feeling. <br> [sound:4c-s-この場所はとても落ち着いた感じです。.mp3]
This place has a very calm feeling.	<b>この場所はとても落ち着いた感じです。</b> <br> このばしょはとてもおちついたかんじです。 <br><br> (感じ) <br> [sound:4c-s-この場所はとても落ち着いた感じです。.mp3]
[sound:4c-k-感覚.mp3]	<b>感覚</b> <br> かんかく <br> sense, sensation, feeling
感覚	<b>かんかく</b> <br> sense, sensation, feeling <br> [sound:4c-k-感覚.mp3]
sense, sensation, feeling	<b>感覚</b> <br> かんかく <br> [sound:4c-k-感覚.mp3]
[sound:4c-s-彼は色に敏感な感覚を持っています。.mp3]	<b>彼は色に敏感な感覚を持っています。</b> <br> かれはいろにびんかんなかんかくをもっています。 <br><br> (感覚) <br> He has a keen sense of color.
彼は色に敏感な感覚を持っています。 <br><br> (感覚)	<b>かれはいろにびんかんなかんかくをもっています。</b> <br> He has a keen sense of color. <br> [sound:4c-s-彼は色に敏感な感覚を持っています。.mp3]
He has a keen sense of color.	<b>彼は色に敏感な感覚を持っています。</b> <br> かれはいろにびんかんなかんかくをもっています。 <br><br> (感覚) <br> [sound:4c-s-彼は色に敏感な感覚を持っています。.mp3]
[sound:4c-k-感性.mp3]	<b>感性</b> <br> かんせい <br> sensitivity, sensitiveness, sense
感性	<b>かんせい</b> <br> sensitivity, sensitiveness, sense <br> [sound:4c-k-感性.mp3]
sensitivity, sensitiveness, sense	<b>感性</b> <br> かんせい <br> [sound:4c-k-感性.mp3]
[sound:4c-s-彼女の感性は非常に鋭いです。.mp3]	<b>彼女の感性は非常に鋭いです。</b> <br> かのじょのかんせいはひじょうにするどいです。 <br><br> (感性) <br> Her sensitivity is extremely sharp.
彼女の感性は非常に鋭いです。 <br><br> (感性)	<b>かのじょのかんせいはひじょうにするどいです。</b> <br> Her sensitivity is extremely sharp. <br> [sound:4c-s-彼女の感性は非常に鋭いです。.mp3]
Her sensitivity is extremely sharp.	<b>彼女の感性は非常に鋭いです。</b> <br> かのじょのかんせいはひじょうにするどいです。 <br><br> (感性) <br> [sound:4c-s-彼女の感性は非常に鋭いです。.mp3]
[sound:4c-k-実感.mp3]	<b>実感</b> <br> じっかん <br> feelings (actual, true)
実感	<b>じっかん</b> <br> feelings (actual, true) <br> [sound:4c-k-実感.mp3]
feelings (actual, true)	<b>実感</b> <br> じっかん <br> [sound:4c-k-実感.mp3]
[sound:4c-s-私はその状況を実感しています。.mp3]	<b>私はその状況を実感しています。</b> <br> わたしはそのじょうきょうをじっかんしています。 <br><br> (実感) <br> I truly feel the situation.
私はその状況を実感しています。 <br><br> (実感)	<b>わたしはそのじょうきょうをじっかんしています。</b> <br> I truly feel the situation. <br> [sound:4c-s-私はその状況を実感しています。.mp3]
I truly feel the situation.	<b>私はその状況を実感しています。</b> <br> わたしはそのじょうきょうをじっかんしています。 <br><br> (実感) <br> [sound:4c-s-私はその状況を実感しています。.mp3]
[sound:4c-k-特に.mp3]	<b>特に</b> <br> とくに <br> particularly, especially
特に	<b>とくに</b> <br> particularly, especially <br> [sound:4c-k-特に.mp3]
particularly, especially	<b>特に</b> <br> とくに <br> [sound:4c-k-特に.mp3]
[sound:4c-s-特に重要な問題があります。.mp3]	<b>特に重要な問題があります。</b> <br> とくにじゅうようなもんだいがあります。 <br><br> (特に) <br> There is an especially important issue.
特に重要な問題があります。 <br><br> (特に)	<b>とくにじゅうようなもんだいがあります。</b> <br> There is an especially important issue. <br> [sound:4c-s-特に重要な問題があります。.mp3]
There is an especially important issue.	<b>特に重要な問題があります。</b> <br> とくにじゅうようなもんだいがあります。 <br><br> (特に) <br> [sound:4c-s-特に重要な問題があります。.mp3]
[sound:4c-k-特別.mp3]	<b>特別</b> <br> とくべつ <br> special
特別	<b>とくべつ</b> <br> special <br> [sound:4c-k-特別.mp3]
special	<b>特別</b> <br> とくべつ <br> [sound:4c-k-特別.mp3]
[sound:4c-s-今日は特別な日です。.mp3]	<b>今日は特別な日です。</b> <br> きょうはとくべつなひです。 <br><br> (特別) <br> Today is a special day.
今日は特別な日です。 <br><br> (特別)	<b>きょうはとくべつなひです。</b> <br> Today is a special day. <br> [sound:4c-s-今日は特別な日です。.mp3]
Today is a special day.	<b>今日は特別な日です。</b> <br> きょうはとくべつなひです。 <br><br> (特別) <br> [sound:4c-s-今日は特別な日です。.mp3]
[sound:4c-k-特使.mp3]	<b>特使</b> <br> とくし <br> special envoy
特使	<b>とくし</b> <br> special envoy <br> [sound:4c-k-特使.mp3]
special envoy	<b>特使</b> <br> とくし <br> [sound:4c-k-特使.mp3]
[sound:4c-s-特使として彼は海外に派遣されました。.mp3]	<b>特使として彼は海外に派遣されました。</b> <br> とくしとしてかれはかいがいにはけんされました。 <br><br> (特使) <br> He was sent abroad as a special envoy.
特使として彼は海外に派遣されました。 <br><br> (特使)	<b>とくしとしてかれはかいがいにはけんされました。</b> <br> He was sent abroad as a special envoy. <br> [sound:4c-s-特使として彼は海外に派遣されました。.mp3]
He was sent abroad as a special envoy.	<b>特使として彼は海外に派遣されました。</b> <br> とくしとしてかれはかいがいにはけんされました。 <br><br> (特使) <br> [sound:4c-s-特使として彼は海外に派遣されました。.mp3]
[sound:4c-k-特集.mp3]	<b>特集</b> <br> とくしゅう <br> feature (e.g. newspaper), special edition, report
特集	<b>とくしゅう</b> <br> feature (e.g. newspaper), special edition, report <br> [sound:4c-k-特集.mp3]
feature (e.g. newspaper), special edition, report	<b>特集</b> <br> とくしゅう <br> [sound:4c-k-特集.mp3]
[sound:4c-s-この雑誌には環境問題に関する特集があります。.mp3]	<b>この雑誌には環境問題に関する特集があります。</b> <br> このざっきにはかんきょうもんだいにかんするとくしゅうがあります。 <br><br> (特集) <br> This magazine has a special feature on environmental issues.
この雑誌には環境問題に関する特集があります。 <br><br> (特集)	<b>このざっきにはかんきょうもんだいにかんするとくしゅうがあります。</b> <br> This magazine has a special feature on environmental issues. <br> [sound:4c-s-この雑誌には環境問題に関する特集があります。.mp3]
This magazine has a special feature on environmental issues.	<b>この雑誌には環境問題に関する特集があります。</b> <br> このざっきにはかんきょうもんだいにかんするとくしゅうがあります。 <br><br> (特集) <br> [sound:4c-s-この雑誌には環境問題に関する特集があります。.mp3]
[sound:4c-k-情.mp3]	<b>情</b> <br> じょう <br> feelings, emotion, passion
情	<b>じょう</b> <br> feelings, emotion, passion <br> [sound:4c-k-情.mp3]
feelings, emotion, passion	<b>情</b> <br> じょう <br> [sound:4c-k-情.mp3]
[sound:4c-s-彼の情熱は素晴らしいです。.mp3]	<b>彼の情熱は素晴らしいです。</b> <br> かれのじょうねつはすばらしいです。 <br><br> (情) <br> His passion is amazing.
彼の情熱は素晴らしいです。 <br><br> (情)	<b>かれのじょうねつはすばらしいです。</b> <br> His passion is amazing. <br> [sound:4c-s-彼の情熱は素晴らしいです。.mp3]
His passion is amazing.	<b>彼の情熱は素晴らしいです。</b> <br> かれのじょうねつはすばらしいです。 <br><br> (情) <br> [sound:4c-s-彼の情熱は素晴らしいです。.mp3]
[sound:4c-k-事情.mp3]	<b>事情</b> <br> じじょう <br> circumstances, consideration, conditions, situation, reasons
事情	<b>じじょう</b> <br> circumstances, consideration, conditions, situation, reasons <br> [sound:4c-k-事情.mp3]
circumstances, consideration, conditions, situation, reasons	<b>事情</b> <br> じじょう <br> [sound:4c-k-事情.mp3]
[sound:4c-s-事情が変わったので、予定を変更しました。.mp3]	<b>事情が変わったので、予定を変更しました。</b> <br> じじょうがかわったので、よていをへんこうしました。 <br><br> (事情) <br> The circumstances changed, so I modified the plan.
事情が変わったので、予定を変更しました。 <br><br> (事情)	<b>じじょうがかわったので、よていをへんこうしました。</b> <br> The circumstances changed, so I modified the plan. <br> [sound:4c-s-事情が変わったので、予定を変更しました。.mp3]
The circumstances changed, so I modified the plan.	<b>事情が変わったので、予定を変更しました。</b> <br> じじょうがかわったので、よていをへんこうしました。 <br><br> (事情) <br> [sound:4c-s-事情が変わったので、予定を変更しました。.mp3]
[sound:4c-k-情熱.mp3]	<b>情熱</b> <br> じょうねつ <br> passion, enthusiasm, zeal
情熱	<b>じょうねつ</b> <br> passion, enthusiasm, zeal <br> [sound:4c-k-情熱.mp3]
passion, enthusiasm, zeal	<b>情熱</b> <br> じょうねつ <br> [sound:4c-k-情熱.mp3]
[sound:4c-s-彼女は情熱的に歌っています。.mp3]	<b>彼女は情熱的に歌っています。</b> <br> かのじょはじょうねつてきにうたっています。 <br><br> (情熱) <br> She is singing passionately.
彼女は情熱的に歌っています。 <br><br> (情熱)	<b>かのじょはじょうねつてきにうたっています。</b> <br> She is singing passionately. <br> [sound:4c-s-彼女は情熱的に歌っています。.mp3]
She is singing passionately.	<b>彼女は情熱的に歌っています。</b> <br> かのじょはじょうねつてきにうたっています。 <br><br> (情熱) <br> [sound:4c-s-彼女は情熱的に歌っています。.mp3]
[sound:4c-k-愛情.mp3]	<b>愛情</b> <br> あいじょう <br> love, affection
愛情	<b>あいじょう</b> <br> love, affection <br> [sound:4c-k-愛情.mp3]
love, affection	<b>愛情</b> <br> あいじょう <br> [sound:4c-k-愛情.mp3]
[sound:4c-s-彼は家族に対して深い愛情を持っています。.mp3]	<b>彼は家族に対して深い愛情を持っています。</b> <br> かれはかぞくにたいしてふかいあいじょうをもっています。 <br><br> (愛情) <br> He has deep affection for his family.
彼は家族に対して深い愛情を持っています。 <br><br> (愛情)	<b>かれはかぞくにたいしてふかいあいじょうをもっています。</b> <br> He has deep affection for his family. <br> [sound:4c-s-彼は家族に対して深い愛情を持っています。.mp3]
He has deep affection for his family.	<b>彼は家族に対して深い愛情を持っています。</b> <br> かれはかぞくにたいしてふかいあいじょうをもっています。 <br><br> (愛情) <br> [sound:4c-s-彼は家族に対して深い愛情を持っています。.mp3]
[sound:4c-k-投資.mp3]	<b>投資</b> <br> とうし <br> investment
投資	<b>とうし</b> <br> investment <br> [sound:4c-k-投資.mp3]
investment	<b>投資</b> <br> とうし <br> [sound:4c-k-投資.mp3]
[sound:4c-s-彼は株に投資しています。.mp3]	<b>彼は株に投資しています。</b> <br> かれはかぶにとうししています。 <br><br> (投資) <br> He is investing in stocks.
彼は株に投資しています。 <br><br> (投資)	<b>かれはかぶにとうししています。</b> <br> He is investing in stocks. <br> [sound:4c-s-彼は株に投資しています。.mp3]
He is investing in stocks.	<b>彼は株に投資しています。</b> <br> かれはかぶにとうししています。 <br><br> (投資) <br> [sound:4c-s-彼は株に投資しています。.mp3]
[sound:4c-k-投手.mp3]	<b>投手</b> <br> とうしゅ <br> (baseball) pitcher
投手	<b>とうしゅ</b> <br> (baseball) pitcher <br> [sound:4c-k-投手.mp3]
(baseball) pitcher	<b>投手</b> <br> とうしゅ <br> [sound:4c-k-投手.mp3]
[sound:4c-s-投手は試合の最初のピッチャーです。.mp3]	<b>投手は試合の最初のピッチャーです。</b> <br> とうしゅはしあいのさいしょのぴっちゃーです。 <br><br> (投手) <br> The pitcher is the first one in the game.
投手は試合の最初のピッチャーです。 <br><br> (投手)	<b>とうしゅはしあいのさいしょのぴっちゃーです。</b> <br> The pitcher is the first one in the game. <br> [sound:4c-s-投手は試合の最初のピッチャーです。.mp3]
The pitcher is the first one in the game.	<b>投手は試合の最初のピッチャーです。</b> <br> とうしゅはしあいのさいしょのぴっちゃーです。 <br><br> (投手) <br> [sound:4c-s-投手は試合の最初のピッチャーです。.mp3]
[sound:4c-k-投機.mp3]	<b>投機</b> <br> とうき <br> speculation, venture, stockjobbing, gambling (on stocks)
投機	<b>とうき</b> <br> speculation, venture, stockjobbing, gambling (on stocks) <br> [sound:4c-k-投機.mp3]
speculation, venture, stockjobbing, gambling (on stocks)	<b>投機</b> <br> とうき <br> [sound:4c-k-投機.mp3]
[sound:4c-s-投機は非常にリスクが高いです。.mp3]	<b>投機は非常にリスクが高いです。</b> <br> とうきはひじょうにりすくがたかいです。 <br><br> (投機) <br> Speculation is very risky.
投機は非常にリスクが高いです。 <br><br> (投機)	<b>とうきはひじょうにりすくがたかいです。</b> <br> Speculation is very risky. <br> [sound:4c-s-投機は非常にリスクが高いです。.mp3]
Speculation is very risky.	<b>投機は非常にリスクが高いです。</b> <br> とうきはひじょうにりすくがたかいです。 <br><br> (投機) <br> [sound:4c-s-投機は非常にリスクが高いです。.mp3]
[sound:4c-k-投棄.mp3]	<b>投棄</b> <br> とうき <br> abandonment, giving up, throwing away
投棄	<b>とうき</b> <br> abandonment, giving up, throwing away <br> [sound:4c-k-投棄.mp3]
abandonment, giving up, throwing away	<b>投棄</b> <br> とうき <br> [sound:4c-k-投棄.mp3]
[sound:4c-s-その地域では不法投棄が問題になっています。.mp3]	<b>その地域では不法投棄が問題になっています。</b> <br> そのちいきではふほうとうきがもんだいになっています。 <br><br> (投棄) <br> Illegal dumping is a problem in that area.
その地域では不法投棄が問題になっています。 <br><br> (投棄)	<b>そのちいきではふほうとうきがもんだいになっています。</b> <br> Illegal dumping is a problem in that area. <br> [sound:4c-s-その地域では不法投棄が問題になっています。.mp3]
Illegal dumping is a problem in that area.	<b>その地域では不法投棄が問題になっています。</b> <br> そのちいきではふほうとうきがもんだいになっています。 <br><br> (投棄) <br> [sound:4c-s-その地域では不法投棄が問題になっています。.mp3]
[sound:4c-k-示す.mp3]	<b>示す</b> <br> しめす <br> to denote, to show, to point out, to indicate, to exemplify
示す	<b>しめす</b> <br> to denote, to show, to point out, to indicate, to exemplify <br> [sound:4c-k-示す.mp3]
to denote, to show, to point out, to indicate, to exemplify	<b>示す</b> <br> しめす <br> [sound:4c-k-示す.mp3]
[sound:4c-s-彼は明確に意見を示しました。.mp3]	<b>彼は明確に意見を示しました。</b> <br> かれはめいかくにいけんをしめしました。 <br><br> (示す) <br> He clearly expressed his opinion.
彼は明確に意見を示しました。 <br><br> (示す)	<b>かれはめいかくにいけんをしめしました。</b> <br> He clearly expressed his opinion. <br> [sound:4c-s-彼は明確に意見を示しました。.mp3]
He clearly expressed his opinion.	<b>彼は明確に意見を示しました。</b> <br> かれはめいかくにいけんをしめしました。 <br><br> (示す) <br> [sound:4c-s-彼は明確に意見を示しました。.mp3]
[sound:4c-k-指示.mp3]	<b>指示</b> <br> しじ <br> indication, instruction, designation, directions
指示	<b>しじ</b> <br> indication, instruction, designation, directions <br> [sound:4c-k-指示.mp3]
indication, instruction, designation, directions	<b>指示</b> <br> しじ <br> [sound:4c-k-指示.mp3]
[sound:4c-s-上司から指示がありました。.mp3]	<b>上司から指示がありました。</b> <br> じょうしからしじがありました。 <br><br> (指示) <br> I received instructions from my boss.
上司から指示がありました。 <br><br> (指示)	<b>じょうしからしじがありました。</b> <br> I received instructions from my boss. <br> [sound:4c-s-上司から指示がありました。.mp3]
I received instructions from my boss.	<b>上司から指示がありました。</b> <br> じょうしからしじがありました。 <br><br> (指示) <br> [sound:4c-s-上司から指示がありました。.mp3]
[sound:4c-k-提示.mp3]	<b>提示</b> <br> ていじ <br> presentation, exhibit, suggest, citation
提示	<b>ていじ</b> <br> presentation, exhibit, suggest, citation <br> [sound:4c-k-提示.mp3]
presentation, exhibit, suggest, citation	<b>提示</b> <br> ていじ <br> [sound:4c-k-提示.mp3]
[sound:4c-s-彼は解決策を提示しました。.mp3]	<b>彼は解決策を提示しました。</b> <br> かれはかいけつさくをていじしました。 <br><br> (提示) <br> He proposed a solution.
彼は解決策を提示しました。 <br><br> (提示)	<b>かれはかいけつさくをていじしました。</b> <br> He proposed a solution. <br> [sound:4c-s-彼は解決策を提示しました。.mp3]
He proposed a solution.	<b>彼は解決策を提示しました。</b> <br> かれはかいけつさくをていじしました。 <br><br> (提示) <br> [sound:4c-s-彼は解決策を提示しました。.mp3]
[sound:4c-k-意思表示.mp3]	<b>意思表示</b> <br> いしひょうじ <br> declaration of intention
意思表示	<b>いしひょうじ</b> <br> declaration of intention <br> [sound:4c-k-意思表示.mp3]
declaration of intention	<b>意思表示</b> <br> いしひょうじ <br> [sound:4c-k-意思表示.mp3]
[sound:4c-s-彼女は意思表示をはっきりしました。.mp3]	<b>彼女は意思表示をはっきりしました。</b> <br> かのじょはいしひょうじをはっきりしました。 <br><br> (意思表示) <br> She clearly showed her intentions.
彼女は意思表示をはっきりしました。 <br><br> (意思表示)	<b>かのじょはいしひょうじをはっきりしました。</b> <br> She clearly showed her intentions. <br> [sound:4c-s-彼女は意思表示をはっきりしました。.mp3]
She clearly showed her intentions.	<b>彼女は意思表示をはっきりしました。</b> <br> かのじょはいしひょうじをはっきりしました。 <br><br> (意思表示) <br> [sound:4c-s-彼女は意思表示をはっきりしました。.mp3]
[sound:4c-k-変わった.mp3]	<b>変わった</b> <br> かわった <br> another, different, various, particular, unusual, novel, peculiar
変わった	<b>かわった</b> <br> another, different, various, particular, unusual, novel, peculiar <br> [sound:4c-k-変わった.mp3]
another, different, various, particular, unusual, novel, peculiar	<b>変わった</b> <br> かわった <br> [sound:4c-k-変わった.mp3]
[sound:4c-s-彼の考え方は少し変わった。.mp3]	<b>彼の考え方は少し変わった。</b> <br> かれのかんがえかたはすこしかわった。 <br><br> (変わった) <br> His way of thinking changed a little.
彼の考え方は少し変わった。 <br><br> (変わった)	<b>かれのかんがえかたはすこしかわった。</b> <br> His way of thinking changed a little. <br> [sound:4c-s-彼の考え方は少し変わった。.mp3]
His way of thinking changed a little.	<b>彼の考え方は少し変わった。</b> <br> かれのかんがえかたはすこしかわった。 <br><br> (変わった) <br> [sound:4c-s-彼の考え方は少し変わった。.mp3]
[sound:4c-k-変わらない.mp3]	<b>変わらない</b> <br> かわらない <br> constant, invariant
変わらない	<b>かわらない</b> <br> constant, invariant <br> [sound:4c-k-変わらない.mp3]
constant, invariant	<b>変わらない</b> <br> かわらない <br> [sound:4c-k-変わらない.mp3]
[sound:4c-s-このルールは変わらない。.mp3]	<b>このルールは変わらない。</b> <br> このるーるはかわらない。 <br><br> (変わらない) <br> This rule does not change.
このルールは変わらない。 <br><br> (変わらない)	<b>このるーるはかわらない。</b> <br> This rule does not change. <br> [sound:4c-s-このルールは変わらない。.mp3]
This rule does not change.	<b>このルールは変わらない。</b> <br> このるーるはかわらない。 <br><br> (変わらない) <br> [sound:4c-s-このルールは変わらない。.mp3]
[sound:4c-k-変.mp3]	<b>変</b> <br> へん <br> strange, odd, peculiar, weird, curious, queer, eccentric, funny, suspicious, fishy; unexpected; change; incident, disturbance, disaster, accident; flat (music)
変	<b>へん</b> <br> strange, odd, peculiar, weird, curious, queer, eccentric, funny, suspicious, fishy; unexpected; change; incident, disturbance, disaster, accident; flat (music) <br> [sound:4c-k-変.mp3]
strange, odd, peculiar, weird, curious, queer, eccentric, funny, suspicious, fishy; unexpected; change; incident, disturbance, disaster, accident; flat (music)	<b>変</b> <br> へん <br> [sound:4c-k-変.mp3]
[sound:4c-s-彼は変な行動をしました。.mp3]	<b>彼は変な行動をしました。</b> <br> かれはへんなこうどうをしました。 <br><br> (変) <br> He behaved strangely.
彼は変な行動をしました。 <br><br> (変)	<b>かれはへんなこうどうをしました。</b> <br> He behaved strangely. <br> [sound:4c-s-彼は変な行動をしました。.mp3]
He behaved strangely.	<b>彼は変な行動をしました。</b> <br> かれはへんなこうどうをしました。 <br><br> (変) <br> [sound:4c-s-彼は変な行動をしました。.mp3]
[sound:4c-k-変革.mp3]	<b>変革</b> <br> へんかく <br> change, reform, revolution, upheaval; Reformation
変革	<b>へんかく</b> <br> change, reform, revolution, upheaval; Reformation <br> [sound:4c-k-変革.mp3]
change, reform, revolution, upheaval; Reformation	<b>変革</b> <br> へんかく <br> [sound:4c-k-変革.mp3]
[sound:4c-s-社会は急速に変革しています。.mp3]	<b>社会は急速に変革しています。</b> <br> しゃかいはきゅうそくにへんかくしています。 <br><br> (変革) <br> Society is undergoing rapid transformation.
社会は急速に変革しています。 <br><br> (変革)	<b>しゃかいはきゅうそくにへんかくしています。</b> <br> Society is undergoing rapid transformation. <br> [sound:4c-s-社会は急速に変革しています。.mp3]
Society is undergoing rapid transformation.	<b>社会は急速に変革しています。</b> <br> しゃかいはきゅうそくにへんかくしています。 <br><br> (変革) <br> [sound:4c-s-社会は急速に変革しています。.mp3]
[sound:4c-k-打つ.mp3]	<b>打つ</b> <br> うつ <br> to hit (something inanimate), to strike, to beat (on something); to type, to tap (e.g. a key); to inject; to indulge in gambling; to visit (on a pilgrimage)
打つ	<b>うつ</b> <br> to hit (something inanimate), to strike, to beat (on something); to type, to tap (e.g. a key); to inject; to indulge in gambling; to visit (on a pilgrimage) <br> [sound:4c-k-打つ.mp3]
to hit (something inanimate), to strike, to beat (on something); to type, to tap (e.g. a key); to inject; to indulge in gambling; to visit (on a pilgrimage)	<b>打つ</b> <br> うつ <br> [sound:4c-k-打つ.mp3]
[sound:4c-s-彼はボールを打ちました。.mp3]	<b>彼はボールを打ちました。</b> <br> かれはぼーるをうちました。 <br><br> (打つ) <br> He hit the ball.
彼はボールを打ちました。 <br><br> (打つ)	<b>かれはぼーるをうちました。</b> <br> He hit the ball. <br> [sound:4c-s-彼はボールを打ちました。.mp3]
He hit the ball.	<b>彼はボールを打ちました。</b> <br> かれはぼーるをうちました。 <br><br> (打つ) <br> [sound:4c-s-彼はボールを打ちました。.mp3]
[sound:4c-k-本塁打.mp3]	<b>本塁打</b> <br> ほんるいだ <br> home run (baseball)
本塁打	<b>ほんるいだ</b> <br> home run (baseball) <br> [sound:4c-k-本塁打.mp3]
home run (baseball)	<b>本塁打</b> <br> ほんるいだ <br> [sound:4c-k-本塁打.mp3]
[sound:4c-s-その選手は本塁打を打ちました。.mp3]	<b>その選手は本塁打を打ちました。</b> <br> そのせんしゅはほんるいだをうちました。 <br><br> (本塁打) <br> The player hit a home run.
その選手は本塁打を打ちました。 <br><br> (本塁打)	<b>そのせんしゅはほんるいだをうちました。</b> <br> The player hit a home run. <br> [sound:4c-s-その選手は本塁打を打ちました。.mp3]
The player hit a home run.	<b>その選手は本塁打を打ちました。</b> <br> そのせんしゅはほんるいだをうちました。 <br><br> (本塁打) <br> [sound:4c-s-その選手は本塁打を打ちました。.mp3]
[sound:4c-k-打ち上げ.mp3]	<b>打ち上げ</b> <br> うちあげ <br> launch
打ち上げ	<b>うちあげ</b> <br> launch <br> [sound:4c-k-打ち上げ.mp3]
launch	<b>打ち上げ</b> <br> うちあげ <br> [sound:4c-k-打ち上げ.mp3]
[sound:4c-s-ロケットは打ち上げに成功しました。.mp3]	<b>ロケットは打ち上げに成功しました。</b> <br> ろけっとはうちあげにせいこうしました。 <br><br> (打ち上げ) <br> The rocket successfully launched.
ロケットは打ち上げに成功しました。 <br><br> (打ち上げ)	<b>ろけっとはうちあげにせいこうしました。</b> <br> The rocket successfully launched. <br> [sound:4c-s-ロケットは打ち上げに成功しました。.mp3]
The rocket successfully launched.	<b>ロケットは打ち上げに成功しました。</b> <br> ろけっとはうちあげにせいこうしました。 <br><br> (打ち上げ) <br> [sound:4c-s-ロケットは打ち上げに成功しました。.mp3]
[sound:4c-k-打開.mp3]	<b>打開</b> <br> だかい <br> break in the deadlock
打開	<b>だかい</b> <br> break in the deadlock <br> [sound:4c-k-打開.mp3]
break in the deadlock	<b>打開</b> <br> だかい <br> [sound:4c-k-打開.mp3]
[sound:4c-s-状況を打開する方法を考えています。.mp3]	<b>状況を打開する方法を考えています。</b> <br> じょうきょうをだかいするほうほうをかんがえています。 <br><br> (打開) <br> I am thinking of a way to overcome the situation.
状況を打開する方法を考えています。 <br><br> (打開)	<b>じょうきょうをだかいするほうほうをかんがえています。</b> <br> I am thinking of a way to overcome the situation. <br> [sound:4c-s-状況を打開する方法を考えています。.mp3]
I am thinking of a way to overcome the situation.	<b>状況を打開する方法を考えています。</b> <br> じょうきょうをだかいするほうほうをかんがえています。 <br><br> (打開) <br> [sound:4c-s-状況を打開する方法を考えています。.mp3]
[sound:4c-k-男.mp3]	<b>男</b> <br> おとこ <br> man
男	<b>おとこ</b> <br> man <br> [sound:4c-k-男.mp3]
man	<b>男</b> <br> おとこ <br> [sound:4c-k-男.mp3]
[sound:4c-s-男は強い意志を持っています。.mp3]	<b>男は強い意志を持っています。</b> <br> おとこはつよいいしをもっています。 <br><br> (男) <br> The man has a strong will.
男は強い意志を持っています。 <br><br> (男)	<b>おとこはつよいいしをもっています。</b> <br> The man has a strong will. <br> [sound:4c-s-男は強い意志を持っています。.mp3]
The man has a strong will.	<b>男は強い意志を持っています。</b> <br> おとこはつよいいしをもっています。 <br><br> (男) <br> [sound:4c-s-男は強い意志を持っています。.mp3]
[sound:4c-k-男子.mp3]	<b>男子</b> <br> だんし <br> youth, young man
男子	<b>だんし</b> <br> youth, young man <br> [sound:4c-k-男子.mp3]
youth, young man	<b>男子</b> <br> だんし <br> [sound:4c-k-男子.mp3]
[sound:4c-s-男子チームが勝利しました。.mp3]	<b>男子チームが勝利しました。</b> <br> だんしてぃーむがしょうりしました。 <br><br> (男子) <br> The men's team won.
男子チームが勝利しました。 <br><br> (男子)	<b>だんしてぃーむがしょうりしました。</b> <br> The men's team won. <br> [sound:4c-s-男子チームが勝利しました。.mp3]
The men's team won.	<b>男子チームが勝利しました。</b> <br> だんしてぃーむがしょうりしました。 <br><br> (男子) <br> [sound:4c-s-男子チームが勝利しました。.mp3]
[sound:4c-k-一男.mp3]	<b>一男</b> <br> いちなん <br> boy, eldest son
一男	<b>いちなん</b> <br> boy, eldest son <br> [sound:4c-k-一男.mp3]
boy, eldest son	<b>一男</b> <br> いちなん <br> [sound:4c-k-一男.mp3]
[sound:4c-s-一男が家に帰ってきました。.mp3]	<b>一男が家に帰ってきました。</b> <br> いちなんがいえにかえってきました。 <br><br> (一男) <br> One boy came home.
一男が家に帰ってきました。 <br><br> (一男)	<b>いちなんがいえにかえってきました。</b> <br> One boy came home. <br> [sound:4c-s-一男が家に帰ってきました。.mp3]
One boy came home.	<b>一男が家に帰ってきました。</b> <br> いちなんがいえにかえってきました。 <br><br> (一男) <br> [sound:4c-s-一男が家に帰ってきました。.mp3]
[sound:4c-k-男優.mp3]	<b>男優</b> <br> だんゆう <br> actor
男優	<b>だんゆう</b> <br> actor <br> [sound:4c-k-男優.mp3]
actor	<b>男優</b> <br> だんゆう <br> [sound:4c-k-男優.mp3]
[sound:4c-s-彼は有名な男優です。.mp3]	<b>彼は有名な男優です。</b> <br> かれはゆうめいなおとこゆうです。 <br><br> (男優) <br> He is a famous actor.
彼は有名な男優です。 <br><br> (男優)	<b>かれはゆうめいなおとこゆうです。</b> <br> He is a famous actor. <br> [sound:4c-s-彼は有名な男優です。.mp3]
He is a famous actor.	<b>彼は有名な男優です。</b> <br> かれはゆうめいなおとこゆうです。 <br><br> (男優) <br> [sound:4c-s-彼は有名な男優です。.mp3]
[sound:4c-k-基本.mp3]	<b>基本</b> <br> きほん <br> foundation, basis, standard
基本	<b>きほん</b> <br> foundation, basis, standard <br> [sound:4c-k-基本.mp3]
foundation, basis, standard	<b>基本</b> <br> きほん <br> [sound:4c-k-基本.mp3]
[sound:4c-s-基本的なルールを守りましょう。.mp3]	<b>基本的なルールを守りましょう。</b> <br> きほんてきなるーるをまもりましょう。 <br><br> (基本) <br> Let’s follow the basic rules.
基本的なルールを守りましょう。 <br><br> (基本)	<b>きほんてきなるーるをまもりましょう。</b> <br> Let’s follow the basic rules. <br> [sound:4c-s-基本的なルールを守りましょう。.mp3]
Let’s follow the basic rules.	<b>基本的なルールを守りましょう。</b> <br> きほんてきなるーるをまもりましょう。 <br><br> (基本) <br> [sound:4c-s-基本的なルールを守りましょう。.mp3]
[sound:4c-k-基準.mp3]	<b>基準</b> <br> きじゅん <br> standard, basis, criterion, norm, reference, datum
基準	<b>きじゅん</b> <br> standard, basis, criterion, norm, reference, datum <br> [sound:4c-k-基準.mp3]
standard, basis, criterion, norm, reference, datum	<b>基準</b> <br> きじゅん <br> [sound:4c-k-基準.mp3]
[sound:4c-s-この試験の基準は非常に高いです。.mp3]	<b>この試験の基準は非常に高いです。</b> <br> このしけんのきじゅんはひじょうにたかいです。 <br><br> (基準) <br> The standard for this exam is very high.
この試験の基準は非常に高いです。 <br><br> (基準)	<b>このしけんのきじゅんはひじょうにたかいです。</b> <br> The standard for this exam is very high. <br> [sound:4c-s-この試験の基準は非常に高いです。.mp3]
The standard for this exam is very high.	<b>この試験の基準は非常に高いです。</b> <br> このしけんのきじゅんはひじょうにたかいです。 <br><br> (基準) <br> [sound:4c-s-この試験の基準は非常に高いです。.mp3]
[sound:4c-k-基幹.mp3]	<b>基幹</b> <br> きかん <br> mainstay, nucleus, key
基幹	<b>きかん</b> <br> mainstay, nucleus, key <br> [sound:4c-k-基幹.mp3]
mainstay, nucleus, key	<b>基幹</b> <br> きかん <br> [sound:4c-k-基幹.mp3]
[sound:4c-s-基幹産業の発展が経済を支えています。.mp3]	<b>基幹産業の発展が経済を支えています。</b> <br> きかんさんぎょうのはってんがけいざいをささえています。 <br><br> (基幹) <br> The development of core industries supports the economy.
基幹産業の発展が経済を支えています。 <br><br> (基幹)	<b>きかんさんぎょうのはってんがけいざいをささえています。</b> <br> The development of core industries supports the economy. <br> [sound:4c-s-基幹産業の発展が経済を支えています。.mp3]
The development of core industries supports the economy.	<b>基幹産業の発展が経済を支えています。</b> <br> きかんさんぎょうのはってんがけいざいをささえています。 <br><br> (基幹) <br> [sound:4c-s-基幹産業の発展が経済を支えています。.mp3]
[sound:4c-k-基軸.mp3]	<b>基軸</b> <br> きじく <br> key, yardstick, criterion, standard
基軸	<b>きじく</b> <br> key, yardstick, criterion, standard <br> [sound:4c-k-基軸.mp3]
key, yardstick, criterion, standard	<b>基軸</b> <br> きじく <br> [sound:4c-k-基軸.mp3]
[sound:4c-s-基軸通貨はアメリカドルです。.mp3]	<b>基軸通貨はアメリカドルです。</b> <br> きじくつうかはあめりかどるです。 <br><br> (基軸) <br> The key currency is the U.S. dollar.
基軸通貨はアメリカドルです。 <br><br> (基軸)	<b>きじくつうかはあめりかどるです。</b> <br> The key currency is the U.S. dollar. <br> [sound:4c-s-基軸通貨はアメリカドルです。.mp3]
The key currency is the U.S. dollar.	<b>基軸通貨はアメリカドルです。</b> <br> きじくつうかはあめりかどるです。 <br><br> (基軸) <br> [sound:4c-s-基軸通貨はアメリカドルです。.mp3]
[sound:4c-k-私.mp3]	<b>私</b> <br> わたし, わたくし <br> I, me; private affairs, personal matter, secrecy; selfishness
私	<b>わたし, わたくし</b> <br> I, me; private affairs, personal matter, secrecy; selfishness <br> [sound:4c-k-私.mp3]
I, me; private affairs, personal matter, secrecy; selfishness	<b>私</b> <br> わたし, わたくし <br> [sound:4c-k-私.mp3]
[sound:4c-s-私は日本に住んでいます。.mp3]	<b>私は日本に住んでいます。</b> <br> わたしはにほんにすんでいます。 <br><br> (私) <br> I live in Japan.
私は日本に住んでいます。 <br><br> (私)	<b>わたしはにほんにすんでいます。</b> <br> I live in Japan. <br> [sound:4c-s-私は日本に住んでいます。.mp3]
I live in Japan.	<b>私は日本に住んでいます。</b> <br> わたしはにほんにすんでいます。 <br><br> (私) <br> [sound:4c-s-私は日本に住んでいます。.mp3]
[sound:4c-k-私立.mp3]	<b>私立</b> <br> しりつ, わたくしりつ <br> private (establishment)
私立	<b>しりつ, わたくしりつ</b> <br> private (establishment) <br> [sound:4c-k-私立.mp3]
private (establishment)	<b>私立</b> <br> しりつ, わたくしりつ <br> [sound:4c-k-私立.mp3]
[sound:4c-s-私立の学校に通っています。.mp3]	<b>私立の学校に通っています。</b> <br> しりつのがっこうにかよっています。 <br><br> (私立) <br> I attend a private school.
私立の学校に通っています。 <br><br> (私立)	<b>しりつのがっこうにかよっています。</b> <br> I attend a private school. <br> [sound:4c-s-私立の学校に通っています。.mp3]
I attend a private school.	<b>私立の学校に通っています。</b> <br> しりつのがっこうにかよっています。 <br><br> (私立) <br> [sound:4c-s-私立の学校に通っています。.mp3]
[sound:4c-k-私文書.mp3]	<b>私文書</b> <br> しぶんしょ <br> private document
私文書	<b>しぶんしょ</b> <br> private document <br> [sound:4c-k-私文書.mp3]
private document	<b>私文書</b> <br> しぶんしょ <br> [sound:4c-k-私文書.mp3]
[sound:4c-s-彼は私文書を紛失しました。.mp3]	<b>彼は私文書を紛失しました。</b> <br> かれはしぶんしょをふんしつしました。 <br><br> (私文書) <br> He lost his private document.
彼は私文書を紛失しました。 <br><br> (私文書)	<b>かれはしぶんしょをふんしつしました。</b> <br> He lost his private document. <br> [sound:4c-s-彼は私文書を紛失しました。.mp3]
He lost his private document.	<b>彼は私文書を紛失しました。</b> <br> かれはしぶんしょをふんしつしました。 <br><br> (私文書) <br> [sound:4c-s-彼は私文書を紛失しました。.mp3]
[sound:4c-k-私設.mp3]	<b>私設</b> <br> しせつ <br> private
私設	<b>しせつ</b> <br> private <br> [sound:4c-k-私設.mp3]
private	<b>私設</b> <br> しせつ <br> [sound:4c-k-私設.mp3]
[sound:4c-s-私設の図書館は静かで快適です。.mp3]	<b>私設の図書館は静かで快適です。</b> <br> しせつのとしょかんはしずかでかいてきです。 <br><br> (私設) <br> The private library is quiet and comfortable.
私設の図書館は静かで快適です。 <br><br> (私設)	<b>しせつのとしょかんはしずかでかいてきです。</b> <br> The private library is quiet and comfortable. <br> [sound:4c-s-私設の図書館は静かで快適です。.mp3]
The private library is quiet and comfortable.	<b>私設の図書館は静かで快適です。</b> <br> しせつのとしょかんはしずかでかいてきです。 <br><br> (私設) <br> [sound:4c-s-私設の図書館は静かで快適です。.mp3]
[sound:4c-k-各自.mp3]	<b>各自</b> <br> かくじ <br> individual, each
各自	<b>かくじ</b> <br> individual, each <br> [sound:4c-k-各自.mp3]
individual, each	<b>各自</b> <br> かくじ <br> [sound:4c-k-各自.mp3]
[sound:4c-s-各自の役割をしっかり果たしてください。.mp3]	<b>各自の役割をしっかり果たしてください。</b> <br> かくじのやくわりをしっかりはたしてください。 <br><br> (各自) <br> Please fulfill each person's role properly.
各自の役割をしっかり果たしてください。 <br><br> (各自)	<b>かくじのやくわりをしっかりはたしてください。</b> <br> Please fulfill each person's role properly. <br> [sound:4c-s-各自の役割をしっかり果たしてください。.mp3]
Please fulfill each person's role properly.	<b>各自の役割をしっかり果たしてください。</b> <br> かくじのやくわりをしっかりはたしてください。 <br><br> (各自) <br> [sound:4c-s-各自の役割をしっかり果たしてください。.mp3]
[sound:4c-k-各種学校.mp3]	<b>各種学校</b> <br> かくしゅがっこう <br> vocational school
各種学校	<b>かくしゅがっこう</b> <br> vocational school <br> [sound:4c-k-各種学校.mp3]
vocational school	<b>各種学校</b> <br> かくしゅがっこう <br> [sound:4c-k-各種学校.mp3]
[sound:4c-s-日本には多くの各種学校があります。.mp3]	<b>日本には多くの各種学校があります。</b> <br> にほんにはおおくのかくしゅがっこうがあります。 <br><br> (各種学校) <br> There are many types of schools in Japan.
日本には多くの各種学校があります。 <br><br> (各種学校)	<b>にほんにはおおくのかくしゅがっこうがあります。</b> <br> There are many types of schools in Japan. <br> [sound:4c-s-日本には多くの各種学校があります。.mp3]
There are many types of schools in Japan.	<b>日本には多くの各種学校があります。</b> <br> にほんにはおおくのかくしゅがっこうがあります。 <br><br> (各種学校) <br> [sound:4c-s-日本には多くの各種学校があります。.mp3]
[sound:4c-k-各員.mp3]	<b>各員</b> <br> かくいん <br> each one
各員	<b>かくいん</b> <br> each one <br> [sound:4c-k-各員.mp3]
each one	<b>各員</b> <br> かくいん <br> [sound:4c-k-各員.mp3]
[sound:4c-s-各員が自分の仕事を終えました。.mp3]	<b>各員が自分の仕事を終えました。</b> <br> かくいんがじぶんのしごとをおえました。 <br><br> (各員) <br> Each member has finished their work.
各員が自分の仕事を終えました。 <br><br> (各員)	<b>かくいんがじぶんのしごとをおえました。</b> <br> Each member has finished their work. <br> [sound:4c-s-各員が自分の仕事を終えました。.mp3]
Each member has finished their work.	<b>各員が自分の仕事を終えました。</b> <br> かくいんがじぶんのしごとをおえました。 <br><br> (各員) <br> [sound:4c-s-各員が自分の仕事を終えました。.mp3]
[sound:4c-k-各駅.mp3]	<b>各駅</b> <br> かくえき <br> every station
各駅	<b>かくえき</b> <br> every station <br> [sound:4c-k-各駅.mp3]
every station	<b>各駅</b> <br> かくえき <br> [sound:4c-k-各駅.mp3]
[sound:4c-s-各駅停車の電車が遅れています。.mp3]	<b>各駅停車の電車が遅れています。</b> <br> かくえきていしゃのでんしゃがおくれています。 <br><br> (各駅) <br> The local train is delayed at every station.
各駅停車の電車が遅れています。 <br><br> (各駅)	<b>かくえきていしゃのでんしゃがおくれています。</b> <br> The local train is delayed at every station. <br> [sound:4c-s-各駅停車の電車が遅れています。.mp3]
The local train is delayed at every station.	<b>各駅停車の電車が遅れています。</b> <br> かくえきていしゃのでんしゃがおくれています。 <br><br> (各駅) <br> [sound:4c-s-各駅停車の電車が遅れています。.mp3]
[sound:4c-k-開始.mp3]	<b>開始</b> <br> かいし <br> start, commencement, beginning, initiation
開始	<b>かいし</b> <br> start, commencement, beginning, initiation <br> [sound:4c-k-開始.mp3]
start, commencement, beginning, initiation	<b>開始</b> <br> かいし <br> [sound:4c-k-開始.mp3]
[sound:4c-s-会議は10時に開始されます。.mp3]	<b>会議は10時に開始されます。</b> <br> かいぎはじゅうじにかいしされます。 <br><br> (開始) <br> The meeting will start at 10 o'clock.
会議は10時に開始されます。 <br><br> (開始)	<b>かいぎはじゅうじにかいしされます。</b> <br> The meeting will start at 10 o'clock. <br> [sound:4c-s-会議は10時に開始されます。.mp3]
The meeting will start at 10 o'clock.	<b>会議は10時に開始されます。</b> <br> かいぎはじゅうじにかいしされます。 <br><br> (開始) <br> [sound:4c-s-会議は10時に開始されます。.mp3]
[sound:4c-k-始まり.mp3]	<b>始まり</b> <br> はじまり <br> origin, beginning
始まり	<b>はじまり</b> <br> origin, beginning <br> [sound:4c-k-始まり.mp3]
origin, beginning	<b>始まり</b> <br> はじまり <br> [sound:4c-k-始まり.mp3]
[sound:4c-s-新しい冒険の始まりです。.mp3]	<b>新しい冒険の始まりです。</b> <br> あたらしいぼうけんのはじまりです。 <br><br> (始まり) <br> This is the beginning of a new adventure.
新しい冒険の始まりです。 <br><br> (始まり)	<b>あたらしいぼうけんのはじまりです。</b> <br> This is the beginning of a new adventure. <br> [sound:4c-s-新しい冒険の始まりです。.mp3]
This is the beginning of a new adventure.	<b>新しい冒険の始まりです。</b> <br> あたらしいぼうけんのはじまりです。 <br><br> (始まり) <br> [sound:4c-s-新しい冒険の始まりです。.mp3]
[sound:4c-k-始発.mp3]	<b>始発</b> <br> しはつ <br> first train
始発	<b>しはつ</b> <br> first train <br> [sound:4c-k-始発.mp3]
first train	<b>始発</b> <br> しはつ <br> [sound:4c-k-始発.mp3]
[sound:4c-s-始発の電車は6時に出発します。.mp3]	<b>始発の電車は6時に出発します。</b> <br> しはつのでんしゃはろくじにしゅっぱつします。 <br><br> (始発) <br> The first train departs at 6 AM.
始発の電車は6時に出発します。 <br><br> (始発)	<b>しはつのでんしゃはろくじにしゅっぱつします。</b> <br> The first train departs at 6 AM. <br> [sound:4c-s-始発の電車は6時に出発します。.mp3]
The first train departs at 6 AM.	<b>始発の電車は6時に出発します。</b> <br> しはつのでんしゃはろくじにしゅっぱつします。 <br><br> (始発) <br> [sound:4c-s-始発の電車は6時に出発します。.mp3]
[sound:4c-k-手始め.mp3]	<b>手始め</b> <br> てはじめ <br> outset
手始め	<b>てはじめ</b> <br> outset <br> [sound:4c-k-手始め.mp3]
outset	<b>手始め</b> <br> てはじめ <br> [sound:4c-k-手始め.mp3]
[sound:4c-s-手始めに簡単な問題を解いてみましょう。.mp3]	<b>手始めに簡単な問題を解いてみましょう。</b> <br> てはじめにかんたんなもんだいをといてみましょう。 <br><br> (手始め) <br> Let’s start by solving some simple problems.
手始めに簡単な問題を解いてみましょう。 <br><br> (手始め)	<b>てはじめにかんたんなもんだいをといてみましょう。</b> <br> Let’s start by solving some simple problems. <br> [sound:4c-s-手始めに簡単な問題を解いてみましょう。.mp3]
Let’s start by solving some simple problems.	<b>手始めに簡単な問題を解いてみましょう。</b> <br> てはじめにかんたんなもんだいをといてみましょう。 <br><br> (手始め) <br> [sound:4c-s-手始めに簡単な問題を解いてみましょう。.mp3]
[sound:4c-k-島.mp3]	<b>島</b> <br> しま <br> island; territory (of a prostitute, organized crime gang, etc.), turf
島	<b>しま</b> <br> island; territory (of a prostitute, organized crime gang, etc.), turf <br> [sound:4c-k-島.mp3]
island; territory (of a prostitute, organized crime gang, etc.), turf	<b>島</b> <br> しま <br> [sound:4c-k-島.mp3]
[sound:4c-s-この島はとても美しいです。.mp3]	<b>この島はとても美しいです。</b> <br> このしまはとても美しいです。 <br><br> (島) <br> This island is very beautiful.
この島はとても美しいです。 <br><br> (島)	<b>このしまはとても美しいです。</b> <br> This island is very beautiful. <br> [sound:4c-s-この島はとても美しいです。.mp3]
This island is very beautiful.	<b>この島はとても美しいです。</b> <br> このしまはとても美しいです。 <br><br> (島) <br> [sound:4c-s-この島はとても美しいです。.mp3]
[sound:4c-k-朝鮮半島.mp3]	<b>朝鮮半島</b> <br> ちょうせんはんとう <br> Korean peninsula
朝鮮半島	<b>ちょうせんはんとう</b> <br> Korean peninsula <br> [sound:4c-k-朝鮮半島.mp3]
Korean peninsula	<b>朝鮮半島</b> <br> ちょうせんはんとう <br> [sound:4c-k-朝鮮半島.mp3]
[sound:4c-s-朝鮮半島は東アジアに位置しています。.mp3]	<b>朝鮮半島は東アジアに位置しています。</b> <br> ちょうせんはんとうはひがしあじあにいちしています。 <br><br> (朝鮮半島) <br> The Korean Peninsula is located in East Asia.
朝鮮半島は東アジアに位置しています。 <br><br> (朝鮮半島)	<b>ちょうせんはんとうはひがしあじあにいちしています。</b> <br> The Korean Peninsula is located in East Asia. <br> [sound:4c-s-朝鮮半島は東アジアに位置しています。.mp3]
The Korean Peninsula is located in East Asia.	<b>朝鮮半島は東アジアに位置しています。</b> <br> ちょうせんはんとうはひがしあじあにいちしています。 <br><br> (朝鮮半島) <br> [sound:4c-s-朝鮮半島は東アジアに位置しています。.mp3]
[sound:4c-k-島国.mp3]	<b>島国</b> <br> しまぐに, とうごく <br> island country (sometimes used as a metaphor for Japan)
島国	<b>しまぐに, とうごく</b> <br> island country (sometimes used as a metaphor for Japan) <br> [sound:4c-k-島国.mp3]
island country (sometimes used as a metaphor for Japan)	<b>島国</b> <br> しまぐに, とうごく <br> [sound:4c-k-島国.mp3]
[sound:4c-s-日本は島国です。.mp3]	<b>日本は島国です。</b> <br> にほんはしまぐにです。 <br><br> (島国) <br> Japan is an island nation.
日本は島国です。 <br><br> (島国)	<b>にほんはしまぐにです。</b> <br> Japan is an island nation. <br> [sound:4c-s-日本は島国です。.mp3]
Japan is an island nation.	<b>日本は島国です。</b> <br> にほんはしまぐにです。 <br><br> (島国) <br> [sound:4c-s-日本は島国です。.mp3]
[sound:4c-k-離島.mp3]	<b>離島</b> <br> りとう <br> isolated (outlying) island, departure from an island
離島	<b>りとう</b> <br> isolated (outlying) island, departure from an island <br> [sound:4c-k-離島.mp3]
isolated (outlying) island, departure from an island	<b>離島</b> <br> りとう <br> [sound:4c-k-離島.mp3]
[sound:4c-s-離島へ行くには船を使う必要があります。.mp3]	<b>離島へ行くには船を使う必要があります。</b> <br> りとうへいくにはふねをつかうひつようがあります。 <br><br> (離島) <br> You need to take a ferry to go to the remote island.
離島へ行くには船を使う必要があります。 <br><br> (離島)	<b>りとうへいくにはふねをつかうひつようがあります。</b> <br> You need to take a ferry to go to the remote island. <br> [sound:4c-s-離島へ行くには船を使う必要があります。.mp3]
You need to take a ferry to go to the remote island.	<b>離島へ行くには船を使う必要があります。</b> <br> りとうへいくにはふねをつかうひつようがあります。 <br><br> (離島) <br> [sound:4c-s-離島へ行くには船を使う必要があります。.mp3]
[sound:4c-k-直.mp3]	<b>直</b> <br> じき <br> soon, in a moment, before long, shortly; nearby, close; direct; spot transaction, cash transaction
直	<b>じき</b> <br> soon, in a moment, before long, shortly; nearby, close; direct; spot transaction, cash transaction <br> [sound:4c-k-直.mp3]
soon, in a moment, before long, shortly; nearby, close; direct; spot transaction, cash transaction	<b>直</b> <br> じき <br> [sound:4c-k-直.mp3]
[sound:4c-s-直に彼に会う予定です。.mp3]	<b>直に彼に会う予定です。</b> <br> なおにかれにあうよていです。 <br><br> (直) <br> I plan to meet him directly.
直に彼に会う予定です。 <br><br> (直)	<b>なおにかれにあうよていです。</b> <br> I plan to meet him directly. <br> [sound:4c-s-直に彼に会う予定です。.mp3]
I plan to meet him directly.	<b>直に彼に会う予定です。</b> <br> なおにかれにあうよていです。 <br><br> (直) <br> [sound:4c-s-直に彼に会う予定です。.mp3]
[sound:4c-k-直ちに.mp3]	<b>直ちに</b> <br> ただちに <br> at once, immediately, directly, in person
直ちに	<b>ただちに</b> <br> at once, immediately, directly, in person <br> [sound:4c-k-直ちに.mp3]
at once, immediately, directly, in person	<b>直ちに</b> <br> ただちに <br> [sound:4c-k-直ちに.mp3]
[sound:4c-s-直ちに行動を起こしてください。.mp3]	<b>直ちに行動を起こしてください。</b> <br> ただちにこうどうをおこしてください。 <br><br> (直ちに) <br> Please take action immediately.
直ちに行動を起こしてください。 <br><br> (直ちに)	<b>ただちにこうどうをおこしてください。</b> <br> Please take action immediately. <br> [sound:4c-s-直ちに行動を起こしてください。.mp3]
Please take action immediately.	<b>直ちに行動を起こしてください。</b> <br> ただちにこうどうをおこしてください。 <br><br> (直ちに) <br> [sound:4c-s-直ちに行動を起こしてください。.mp3]
[sound:4c-k-正直.mp3]	<b>正直</b> <br> しょうじき <br> honesty, integrity, frankness; honestly, frankly
正直	<b>しょうじき</b> <br> honesty, integrity, frankness; honestly, frankly <br> [sound:4c-k-正直.mp3]
honesty, integrity, frankness; honestly, frankly	<b>正直</b> <br> しょうじき <br> [sound:4c-k-正直.mp3]
[sound:4c-s-正直に言うと、それは無理です。.mp3]	<b>正直に言うと、それは無理です。</b> <br> しょうじきにいうと、それはむりです。 <br><br> (正直) <br> Honestly speaking, it’s impossible.
正直に言うと、それは無理です。 <br><br> (正直)	<b>しょうじきにいうと、それはむりです。</b> <br> Honestly speaking, it’s impossible. <br> [sound:4c-s-正直に言うと、それは無理です。.mp3]
Honestly speaking, it’s impossible.	<b>正直に言うと、それは無理です。</b> <br> しょうじきにいうと、それはむりです。 <br><br> (正直) <br> [sound:4c-s-正直に言うと、それは無理です。.mp3]
[sound:4c-k-素直.mp3]	<b>素直</b> <br> すなお <br> obedient, meek, docile, unaffected; honest, frank
素直	<b>すなお</b> <br> obedient, meek, docile, unaffected; honest, frank <br> [sound:4c-k-素直.mp3]
obedient, meek, docile, unaffected; honest, frank	<b>素直</b> <br> すなお <br> [sound:4c-k-素直.mp3]
[sound:4c-s-彼は素直な性格です。.mp3]	<b>彼は素直な性格です。</b> <br> かれはすなおなせいかくです。 <br><br> (素直) <br> He has a straightforward personality.
彼は素直な性格です。 <br><br> (素直)	<b>かれはすなおなせいかくです。</b> <br> He has a straightforward personality. <br> [sound:4c-s-彼は素直な性格です。.mp3]
He has a straightforward personality.	<b>彼は素直な性格です。</b> <br> かれはすなおなせいかくです。 <br><br> (素直) <br> [sound:4c-s-彼は素直な性格です。.mp3]
[sound:4c-k-両国.mp3]	<b>両国</b> <br> りょうこく, りょうごく <br> both countries
両国	<b>りょうこく, りょうごく</b> <br> both countries <br> [sound:4c-k-両国.mp3]
both countries	<b>両国</b> <br> りょうこく, りょうごく <br> [sound:4c-k-両国.mp3]
[sound:4c-s-両国の関係は良好です。.mp3]	<b>両国の関係は良好です。</b> <br> りょうこくのかんけいはりょうこうです。 <br><br> (両国) <br> The relationship between both countries is good.
両国の関係は良好です。 <br><br> (両国)	<b>りょうこくのかんけいはりょうこうです。</b> <br> The relationship between both countries is good. <br> [sound:4c-s-両国の関係は良好です。.mp3]
The relationship between both countries is good.	<b>両国の関係は良好です。</b> <br> りょうこくのかんけいはりょうこうです。 <br><br> (両国) <br> [sound:4c-s-両国の関係は良好です。.mp3]
[sound:4c-k-両党.mp3]	<b>両党</b> <br> りょうとう <br> both political parties
両党	<b>りょうとう</b> <br> both political parties <br> [sound:4c-k-両党.mp3]
both political parties	<b>両党</b> <br> りょうとう <br> [sound:4c-k-両党.mp3]
[sound:4c-s-両党が協議を行いました。.mp3]	<b>両党が協議を行いました。</b> <br> りょうとうがきょうぎをおこないました。 <br><br> (両党) <br> Both parties held discussions.
両党が協議を行いました。 <br><br> (両党)	<b>りょうとうがきょうぎをおこないました。</b> <br> Both parties held discussions. <br> [sound:4c-s-両党が協議を行いました。.mp3]
Both parties held discussions.	<b>両党が協議を行いました。</b> <br> りょうとうがきょうぎをおこないました。 <br><br> (両党) <br> [sound:4c-s-両党が協議を行いました。.mp3]
[sound:4c-k-両方.mp3]	<b>両方</b> <br> りょうほう <br> both sides, both parties
両方	<b>りょうほう</b> <br> both sides, both parties <br> [sound:4c-k-両方.mp3]
both sides, both parties	<b>両方</b> <br> りょうほう <br> [sound:4c-k-両方.mp3]
[sound:4c-s-両方の意見を聞きたいです。.mp3]	<b>両方の意見を聞きたいです。</b> <br> りょうほうのいけんをききたいです。 <br><br> (両方) <br> I want to hear both opinions.
両方の意見を聞きたいです。 <br><br> (両方)	<b>りょうほうのいけんをききたいです。</b> <br> I want to hear both opinions. <br> [sound:4c-s-両方の意見を聞きたいです。.mp3]
I want to hear both opinions.	<b>両方の意見を聞きたいです。</b> <br> りょうほうのいけんをききたいです。 <br><br> (両方) <br> [sound:4c-s-両方の意見を聞きたいです。.mp3]
[sound:4c-k-両面.mp3]	<b>両面</b> <br> りょうめん <br> both sides, two sides, double-sided
両面	<b>りょうめん</b> <br> both sides, two sides, double-sided <br> [sound:4c-k-両面.mp3]
both sides, two sides, double-sided	<b>両面</b> <br> りょうめん <br> [sound:4c-k-両面.mp3]
[sound:4c-s-この問題には両面があります。.mp3]	<b>この問題には両面があります。</b> <br> このもんだいにはりょうめんがあります。 <br><br> (両面) <br> This issue has two sides.
この問題には両面があります。 <br><br> (両面)	<b>このもんだいにはりょうめんがあります。</b> <br> This issue has two sides. <br> [sound:4c-s-この問題には両面があります。.mp3]
This issue has two sides.	<b>この問題には両面があります。</b> <br> このもんだいにはりょうめんがあります。 <br><br> (両面) <br> [sound:4c-s-この問題には両面があります。.mp3]
[sound:4c-k-朝.mp3]	<b>朝</b> <br> あさ, あした <br> morning
朝	<b>あさ, あした</b> <br> morning <br> [sound:4c-k-朝.mp3]
morning	<b>朝</b> <br> あさ, あした <br> [sound:4c-k-朝.mp3]
[sound:4c-s-朝の空気は爽やかです。.mp3]	<b>朝の空気は爽やかです。</b> <br> あさのくうきはさわやかです。 <br><br> (朝) <br> The morning air is refreshing.
朝の空気は爽やかです。 <br><br> (朝)	<b>あさのくうきはさわやかです。</b> <br> The morning air is refreshing. <br> [sound:4c-s-朝の空気は爽やかです。.mp3]
The morning air is refreshing.	<b>朝の空気は爽やかです。</b> <br> あさのくうきはさわやかです。 <br><br> (朝) <br> [sound:4c-s-朝の空気は爽やかです。.mp3]
[sound:4c-k-北朝鮮.mp3]	<b>北朝鮮</b> <br> きたちょうせん <br> North Korea
北朝鮮	<b>きたちょうせん</b> <br> North Korea <br> [sound:4c-k-北朝鮮.mp3]
North Korea	<b>北朝鮮</b> <br> きたちょうせん <br> [sound:4c-k-北朝鮮.mp3]
[sound:4c-s-北朝鮮のニュースを読んだ。.mp3]	<b>北朝鮮のニュースを読んだ。</b> <br> きたちょうせんのニュースをよんだ。 <br><br> (北朝鮮) <br> I read the news about North Korea.
北朝鮮のニュースを読んだ。 <br><br> (北朝鮮)	<b>きたちょうせんのニュースをよんだ。</b> <br> I read the news about North Korea. <br> [sound:4c-s-北朝鮮のニュースを読んだ。.mp3]
I read the news about North Korea.	<b>北朝鮮のニュースを読んだ。</b> <br> きたちょうせんのニュースをよんだ。 <br><br> (北朝鮮) <br> [sound:4c-s-北朝鮮のニュースを読んだ。.mp3]
[sound:4c-k-朝食.mp3]	<b>朝食</b> <br> ちょうしょく <br> breakfast
朝食	<b>ちょうしょく</b> <br> breakfast <br> [sound:4c-k-朝食.mp3]
breakfast	<b>朝食</b> <br> ちょうしょく <br> [sound:4c-k-朝食.mp3]
[sound:4c-s-朝食はパンとコーヒーです。.mp3]	<b>朝食はパンとコーヒーです。</b> <br> ちょうしょくはパンとコーヒーです。 <br><br> (朝食) <br> Breakfast is bread and coffee.
朝食はパンとコーヒーです。 <br><br> (朝食)	<b>ちょうしょくはパンとコーヒーです。</b> <br> Breakfast is bread and coffee. <br> [sound:4c-s-朝食はパンとコーヒーです。.mp3]
Breakfast is bread and coffee.	<b>朝食はパンとコーヒーです。</b> <br> ちょうしょくはパンとコーヒーです。 <br><br> (朝食) <br> [sound:4c-s-朝食はパンとコーヒーです。.mp3]
[sound:4c-k-毎朝.mp3]	<b>毎朝</b> <br> まいあさ, まいちょう <br> every morning
毎朝	<b>まいあさ, まいちょう</b> <br> every morning <br> [sound:4c-k-毎朝.mp3]
every morning	<b>毎朝</b> <br> まいあさ, まいちょう <br> [sound:4c-k-毎朝.mp3]
[sound:4c-s-毎朝ジョギングをします。.mp3]	<b>毎朝ジョギングをします。</b> <br> まいあさジョギングをします。 <br><br> (毎朝) <br> I go jogging every morning.
毎朝ジョギングをします。 <br><br> (毎朝)	<b>まいあさジョギングをします。</b> <br> I go jogging every morning. <br> [sound:4c-s-毎朝ジョギングをします。.mp3]
I go jogging every morning.	<b>毎朝ジョギングをします。</b> <br> まいあさジョギングをします。 <br><br> (毎朝) <br> [sound:4c-s-毎朝ジョギングをします。.mp3]
[sound:4c-k-革.mp3]	<b>革</b> <br> かわ <br> skin, hide, leather, fur, pelt, bark, shell
革	<b>かわ</b> <br> skin, hide, leather, fur, pelt, bark, shell <br> [sound:4c-k-革.mp3]
skin, hide, leather, fur, pelt, bark, shell	<b>革</b> <br> かわ <br> [sound:4c-k-革.mp3]
[sound:4c-s-このバッグは革製です。.mp3]	<b>このバッグは革製です。</b> <br> このバッグはかわせいです。 <br><br> (革) <br> This bag is made of leather.
このバッグは革製です。 <br><br> (革)	<b>このバッグはかわせいです。</b> <br> This bag is made of leather. <br> [sound:4c-s-このバッグは革製です。.mp3]
This bag is made of leather.	<b>このバッグは革製です。</b> <br> このバッグはかわせいです。 <br><br> (革) <br> [sound:4c-s-このバッグは革製です。.mp3]
[sound:4c-k-改革.mp3]	<b>改革</b> <br> かいかく <br> reform, reformation, innovation
改革	<b>かいかく</b> <br> reform, reformation, innovation <br> [sound:4c-k-改革.mp3]
reform, reformation, innovation	<b>改革</b> <br> かいかく <br> [sound:4c-k-改革.mp3]
[sound:4c-s-政府は改革を進めています。.mp3]	<b>政府は改革を進めています。</b> <br> せいふはかいかくをすすめています。 <br><br> (改革) <br> The government is promoting reform.
政府は改革を進めています。 <br><br> (改革)	<b>せいふはかいかくをすすめています。</b> <br> The government is promoting reform. <br> [sound:4c-s-政府は改革を進めています。.mp3]
The government is promoting reform.	<b>政府は改革を進めています。</b> <br> せいふはかいかくをすすめています。 <br><br> (改革) <br> [sound:4c-s-政府は改革を進めています。.mp3]
[sound:4c-k-農地改革.mp3]	<b>農地改革</b> <br> のうちかいかく <br> agrarian reform
農地改革	<b>のうちかいかく</b> <br> agrarian reform <br> [sound:4c-k-農地改革.mp3]
agrarian reform	<b>農地改革</b> <br> のうちかいかく <br> [sound:4c-k-農地改革.mp3]
[sound:4c-s-農地改革が実施されました。.mp3]	<b>農地改革が実施されました。</b> <br> のうちかいかくがじっしされました。 <br><br> (農地改革) <br> Agricultural reform was implemented.
農地改革が実施されました。 <br><br> (農地改革)	<b>のうちかいかくがじっしされました。</b> <br> Agricultural reform was implemented. <br> [sound:4c-s-農地改革が実施されました。.mp3]
Agricultural reform was implemented.	<b>農地改革が実施されました。</b> <br> のうちかいかくがじっしされました。 <br><br> (農地改革) <br> [sound:4c-s-農地改革が実施されました。.mp3]
[sound:4c-k-革靴.mp3]	<b>革靴</b> <br> かわぐつ <br> leather shoes
革靴	<b>かわぐつ</b> <br> leather shoes <br> [sound:4c-k-革靴.mp3]
leather shoes	<b>革靴</b> <br> かわぐつ <br> [sound:4c-k-革靴.mp3]
[sound:4c-s-革靴を磨きました。.mp3]	<b>革靴を磨きました。</b> <br> かわぐつをみがきました。 <br><br> (革靴) <br> I polished my leather shoes.
革靴を磨きました。 <br><br> (革靴)	<b>かわぐつをみがきました。</b> <br> I polished my leather shoes. <br> [sound:4c-s-革靴を磨きました。.mp3]
I polished my leather shoes.	<b>革靴を磨きました。</b> <br> かわぐつをみがきました。 <br><br> (革靴) <br> [sound:4c-s-革靴を磨きました。.mp3]
[sound:4c-k-価格.mp3]	<b>価格</b> <br> かかく <br> price, value, cost
価格	<b>かかく</b> <br> price, value, cost <br> [sound:4c-k-価格.mp3]
price, value, cost	<b>価格</b> <br> かかく <br> [sound:4c-k-価格.mp3]
[sound:4c-s-この商品の価格は高いです。.mp3]	<b>この商品の価格は高いです。</b> <br> このしょうひんのかかくはたかいです。 <br><br> (価格) <br> This product is expensive.
この商品の価格は高いです。 <br><br> (価格)	<b>このしょうひんのかかくはたかいです。</b> <br> This product is expensive. <br> [sound:4c-s-この商品の価格は高いです。.mp3]
This product is expensive.	<b>この商品の価格は高いです。</b> <br> このしょうひんのかかくはたかいです。 <br><br> (価格) <br> [sound:4c-s-この商品の価格は高いです。.mp3]
[sound:4c-k-株価.mp3]	<b>株価</b> <br> かぶか <br> stock prices
株価	<b>かぶか</b> <br> stock prices <br> [sound:4c-k-株価.mp3]
stock prices	<b>株価</b> <br> かぶか <br> [sound:4c-k-株価.mp3]
[sound:4c-s-今日の株価は下がりました。.mp3]	<b>今日の株価は下がりました。</b> <br> きょうのかぶかはさがりました。 <br><br> (株価) <br> Today's stock prices went down.
今日の株価は下がりました。 <br><br> (株価)	<b>きょうのかぶかはさがりました。</b> <br> Today's stock prices went down. <br> [sound:4c-s-今日の株価は下がりました。.mp3]
Today's stock prices went down.	<b>今日の株価は下がりました。</b> <br> きょうのかぶかはさがりました。 <br><br> (株価) <br> [sound:4c-s-今日の株価は下がりました。.mp3]
[sound:4c-k-米価.mp3]	<b>米価</b> <br> べいか <br> rice price
米価	<b>べいか</b> <br> rice price <br> [sound:4c-k-米価.mp3]
rice price	<b>米価</b> <br> べいか <br> [sound:4c-k-米価.mp3]
[sound:4c-s-米価が上昇しています。.mp3]	<b>米価が上昇しています。</b> <br> べいかがじょうしょうしています。 <br><br> (米価) <br> Rice prices are increasing.
米価が上昇しています。 <br><br> (米価)	<b>べいかがじょうしょうしています。</b> <br> Rice prices are increasing. <br> [sound:4c-s-米価が上昇しています。.mp3]
Rice prices are increasing.	<b>米価が上昇しています。</b> <br> べいかがじょうしょうしています。 <br><br> (米価) <br> [sound:4c-s-米価が上昇しています。.mp3]
[sound:4c-k-時価.mp3]	<b>時価</b> <br> じか <br> current value, price, market value
時価	<b>じか</b> <br> current value, price, market value <br> [sound:4c-k-時価.mp3]
current value, price, market value	<b>時価</b> <br> じか <br> [sound:4c-k-時価.mp3]
[sound:4c-s-時価で販売されています。.mp3]	<b>時価で販売されています。</b> <br> じかではんばいされています。 <br><br> (時価) <br> It is sold at market price.
時価で販売されています。 <br><br> (時価)	<b>じかではんばいされています。</b> <br> It is sold at market price. <br> [sound:4c-s-時価で販売されています。.mp3]
It is sold at market price.	<b>時価で販売されています。</b> <br> じかではんばいされています。 <br><br> (時価) <br> [sound:4c-s-時価で販売されています。.mp3]
[sound:4c-k-株式.mp3]	<b>株式</b> <br> かぶしき <br> stock (company)
株式	<b>かぶしき</b> <br> stock (company) <br> [sound:4c-k-株式.mp3]
stock (company)	<b>株式</b> <br> かぶしき <br> [sound:4c-k-株式.mp3]
[sound:4c-s-彼は株式を購入しました。.mp3]	<b>彼は株式を購入しました。</b> <br> かれはかぶしきをこうにゅうしました。 <br><br> (株式) <br> He bought stocks.
彼は株式を購入しました。 <br><br> (株式)	<b>かれはかぶしきをこうにゅうしました。</b> <br> He bought stocks. <br> [sound:4c-s-彼は株式を購入しました。.mp3]
He bought stocks.	<b>彼は株式を購入しました。</b> <br> かれはかぶしきをこうにゅうしました。 <br><br> (株式) <br> [sound:4c-s-彼は株式を購入しました。.mp3]
[sound:4c-k-公式.mp3]	<b>公式</b> <br> こうしき <br> formality, formal, official; formula
公式	<b>こうしき</b> <br> formality, formal, official; formula <br> [sound:4c-k-公式.mp3]
formality, formal, official; formula	<b>公式</b> <br> こうしき <br> [sound:4c-k-公式.mp3]
[sound:4c-s-公式発表がありました。.mp3]	<b>公式発表がありました。</b> <br> こうしきはっぴょうがありました。 <br><br> (公式) <br> There was an official announcement.
公式発表がありました。 <br><br> (公式)	<b>こうしきはっぴょうがありました。</b> <br> There was an official announcement. <br> [sound:4c-s-公式発表がありました。.mp3]
There was an official announcement.	<b>公式発表がありました。</b> <br> こうしきはっぴょうがありました。 <br><br> (公式) <br> [sound:4c-s-公式発表がありました。.mp3]
