[sound:4c-k-株式会社.mp3]	<b>株式会社</b> <br> かぶしきがいしゃ <br> public company, corporation, KK, formula for an incorporated public company
株式会社	<b>かぶしきがいしゃ</b> <br> public company, corporation, KK, formula for an incorporated public company <br> [sound:4c-k-株式会社.mp3]
public company, corporation, KK, formula for an incorporated public company	<b>株式会社</b> <br> かぶしきがいしゃ <br> [sound:4c-k-株式会社.mp3]
[sound:4c-s-彼は株式会社の社長です。.mp3]	<b>彼は株式会社の社長です。</b> <br> かれはかぶしきがいしゃのしゃちょうです。 <br><br> (株式会社) <br> He is the president of the corporation.
彼は株式会社の社長です。 <br><br> (株式会社)	<b>かれはかぶしきがいしゃのしゃちょうです。</b> <br> He is the president of the corporation. <br> [sound:4c-s-彼は株式会社の社長です。.mp3]
He is the president of the corporation.	<b>彼は株式会社の社長です。</b> <br> かれはかぶしきがいしゃのしゃちょうです。 <br><br> (株式会社) <br> [sound:4c-s-彼は株式会社の社長です。.mp3]
[sound:4c-k-儀式.mp3]	<b>儀式</b> <br> ぎしき <br> ceremony, rite, ritual, service
儀式	<b>ぎしき</b> <br> ceremony, rite, ritual, service <br> [sound:4c-k-儀式.mp3]
ceremony, rite, ritual, service	<b>儀式</b> <br> ぎしき <br> [sound:4c-k-儀式.mp3]
[sound:4c-s-儀式が厳かに行われました。.mp3]	<b>儀式が厳かに行われました。</b> <br> ぎしきがおごそかにおこなわれました。 <br><br> (儀式) <br> The ceremony was solemnly conducted.
儀式が厳かに行われました。 <br><br> (儀式)	<b>ぎしきがおごそかにおこなわれました。</b> <br> The ceremony was solemnly conducted. <br> [sound:4c-s-儀式が厳かに行われました。.mp3]
The ceremony was solemnly conducted.	<b>儀式が厳かに行われました。</b> <br> ぎしきがおごそかにおこなわれました。 <br><br> (儀式) <br> [sound:4c-s-儀式が厳かに行われました。.mp3]
[sound:4c-k-確か.mp3]	<b>確か</b> <br> たしか <br> certain, sure, definite; if I'm not mistaken, if I remember correctly
確か	<b>たしか</b> <br> certain, sure, definite; if I'm not mistaken, if I remember correctly <br> [sound:4c-k-確か.mp3]
certain, sure, definite; if I'm not mistaken, if I remember correctly	<b>確か</b> <br> たしか <br> [sound:4c-k-確か.mp3]
[sound:4c-s-確かにその通りです。.mp3]	<b>確かにその通りです。</b> <br> たしかにそのとおりです。 <br><br> (確か) <br> That is certainly true.
確かにその通りです。 <br><br> (確か)	<b>たしかにそのとおりです。</b> <br> That is certainly true. <br> [sound:4c-s-確かにその通りです。.mp3]
That is certainly true.	<b>確かにその通りです。</b> <br> たしかにそのとおりです。 <br><br> (確か) <br> [sound:4c-s-確かにその通りです。.mp3]
[sound:4c-k-確実.mp3]	<b>確実</b> <br> かくじつ <br> certainty, reliability, soundness
確実	<b>かくじつ</b> <br> certainty, reliability, soundness <br> [sound:4c-k-確実.mp3]
certainty, reliability, soundness	<b>確実</b> <br> かくじつ <br> [sound:4c-k-確実.mp3]
[sound:4c-s-成功は確実です。.mp3]	<b>成功は確実です。</b> <br> せいこうはかくじつです。 <br><br> (確実) <br> Success is certain.
成功は確実です。 <br><br> (確実)	<b>せいこうはかくじつです。</b> <br> Success is certain. <br> [sound:4c-s-成功は確実です。.mp3]
Success is certain.	<b>成功は確実です。</b> <br> せいこうはかくじつです。 <br><br> (確実) <br> [sound:4c-s-成功は確実です。.mp3]
[sound:4c-k-確率.mp3]	<b>確率</b> <br> かくりつ <br> probability, likelihood, chances
確率	<b>かくりつ</b> <br> probability, likelihood, chances <br> [sound:4c-k-確率.mp3]
probability, likelihood, chances	<b>確率</b> <br> かくりつ <br> [sound:4c-k-確率.mp3]
[sound:4c-s-勝つ確率は低いです。.mp3]	<b>勝つ確率は低いです。</b> <br> かつかくりつはひくいです。 <br><br> (確率) <br> The probability of winning is low.
勝つ確率は低いです。 <br><br> (確率)	<b>かつかくりつはひくいです。</b> <br> The probability of winning is low. <br> [sound:4c-s-勝つ確率は低いです。.mp3]
The probability of winning is low.	<b>勝つ確率は低いです。</b> <br> かつかくりつはひくいです。 <br><br> (確率) <br> [sound:4c-s-勝つ確率は低いです。.mp3]
[sound:4c-k-確執.mp3]	<b>確執</b> <br> かくしつ <br> discord, antagonism
確執	<b>かくしつ</b> <br> discord, antagonism <br> [sound:4c-k-確執.mp3]
discord, antagonism	<b>確執</b> <br> かくしつ <br> [sound:4c-k-確執.mp3]
[sound:4c-s-両者の間に確執があります。.mp3]	<b>両者の間に確執があります。</b> <br> りょうしゃのあいだにかくしつがあります。 <br><br> (確執) <br> There is a conflict between the two.
両者の間に確執があります。 <br><br> (確執)	<b>りょうしゃのあいだにかくしつがあります。</b> <br> There is a conflict between the two. <br> [sound:4c-s-両者の間に確執があります。.mp3]
There is a conflict between the two.	<b>両者の間に確執があります。</b> <br> りょうしゃのあいだにかくしつがあります。 <br><br> (確執) <br> [sound:4c-s-両者の間に確執があります。.mp3]
[sound:4c-k-村.mp3]	<b>村</b> <br> むら <br> village
村	<b>むら</b> <br> village <br> [sound:4c-k-村.mp3]
village	<b>村</b> <br> むら <br> [sound:4c-k-村.mp3]
[sound:4c-s-村に帰省しました。.mp3]	<b>村に帰省しました。</b> <br> むらにきせいしました。 <br><br> (村) <br> I went back to my village.
村に帰省しました。 <br><br> (村)	<b>むらにきせいしました。</b> <br> I went back to my village. <br> [sound:4c-s-村に帰省しました。.mp3]
I went back to my village.	<b>村に帰省しました。</b> <br> むらにきせいしました。 <br><br> (村) <br> [sound:4c-s-村に帰省しました。.mp3]
[sound:4c-k-市町村.mp3]	<b>市町村</b> <br> しちょうそん <br> cities, towns and villages, municipalities
市町村	<b>しちょうそん</b> <br> cities, towns and villages, municipalities <br> [sound:4c-k-市町村.mp3]
cities, towns and villages, municipalities	<b>市町村</b> <br> しちょうそん <br> [sound:4c-k-市町村.mp3]
[sound:4c-s-市町村の役所に行きました。.mp3]	<b>市町村の役所に行きました。</b> <br> しちょうそんのやくしょにいきました。 <br><br> (市町村) <br> I went to the municipal office.
市町村の役所に行きました。 <br><br> (市町村)	<b>しちょうそんのやくしょにいきました。</b> <br> I went to the municipal office. <br> [sound:4c-s-市町村の役所に行きました。.mp3]
I went to the municipal office.	<b>市町村の役所に行きました。</b> <br> しちょうそんのやくしょにいきました。 <br><br> (市町村) <br> [sound:4c-s-市町村の役所に行きました。.mp3]
[sound:4c-k-村民.mp3]	<b>村民</b> <br> そんみん <br> villager
村民	<b>そんみん</b> <br> villager <br> [sound:4c-k-村民.mp3]
villager	<b>村民</b> <br> そんみん <br> [sound:4c-k-村民.mp3]
[sound:4c-s-村民の協力が不可欠です。.mp3]	<b>村民の協力が不可欠です。</b> <br> そんみんのきょうりょくがふかけつです。 <br><br> (村民) <br> Citizen cooperation is essential.
村民の協力が不可欠です。 <br><br> (村民)	<b>そんみんのきょうりょくがふかけつです。</b> <br> Citizen cooperation is essential. <br> [sound:4c-s-村民の協力が不可欠です。.mp3]
Citizen cooperation is essential.	<b>村民の協力が不可欠です。</b> <br> そんみんのきょうりょくがふかけつです。 <br><br> (村民) <br> [sound:4c-s-村民の協力が不可欠です。.mp3]
[sound:4c-k-村議会.mp3]	<b>村議会</b> <br> そんぎかい <br> village assembly
村議会	<b>そんぎかい</b> <br> village assembly <br> [sound:4c-k-村議会.mp3]
village assembly	<b>村議会</b> <br> そんぎかい <br> [sound:4c-k-村議会.mp3]
[sound:4c-s-村議会で新しい法律が決まりました。.mp3]	<b>村議会で新しい法律が決まりました。</b> <br> そんぎかいであたらしいほうりつがきまりました。 <br><br> (村議会) <br> A new law was decided in the village council.
村議会で新しい法律が決まりました。 <br><br> (村議会)	<b>そんぎかいであたらしいほうりつがきまりました。</b> <br> A new law was decided in the village council. <br> [sound:4c-s-村議会で新しい法律が決まりました。.mp3]
A new law was decided in the village council.	<b>村議会で新しい法律が決まりました。</b> <br> そんぎかいであたらしいほうりつがきまりました。 <br><br> (村議会) <br> [sound:4c-s-村議会で新しい法律が決まりました。.mp3]
[sound:4c-k-前提.mp3]	<b>前提</b> <br> ぜんてい <br> preamble, premise, reason, prerequisite, condition, assumption, hypothesis
前提	<b>ぜんてい</b> <br> preamble, premise, reason, prerequisite, condition, assumption, hypothesis <br> [sound:4c-k-前提.mp3]
preamble, premise, reason, prerequisite, condition, assumption, hypothesis	<b>前提</b> <br> ぜんてい <br> [sound:4c-k-前提.mp3]
[sound:4c-s-この話の前提を説明します。.mp3]	<b>この話の前提を説明します。</b> <br> このはなしのぜんていをせつめいします。 <br><br> (前提) <br> I will explain the premise of this story.
この話の前提を説明します。 <br><br> (前提)	<b>このはなしのぜんていをせつめいします。</b> <br> I will explain the premise of this story. <br> [sound:4c-s-この話の前提を説明します。.mp3]
I will explain the premise of this story.	<b>この話の前提を説明します。</b> <br> このはなしのぜんていをせつめいします。 <br><br> (前提) <br> [sound:4c-s-この話の前提を説明します。.mp3]
[sound:4c-k-提案.mp3]	<b>提案</b> <br> ていあん <br> proposal, proposition, suggestion
提案	<b>ていあん</b> <br> proposal, proposition, suggestion <br> [sound:4c-k-提案.mp3]
proposal, proposition, suggestion	<b>提案</b> <br> ていあん <br> [sound:4c-k-提案.mp3]
[sound:4c-s-新しい計画を提案しました。.mp3]	<b>新しい計画を提案しました。</b> <br> あたらしいけいかくをていあんしました。 <br><br> (提案) <br> I proposed a new plan.
新しい計画を提案しました。 <br><br> (提案)	<b>あたらしいけいかくをていあんしました。</b> <br> I proposed a new plan. <br> [sound:4c-s-新しい計画を提案しました。.mp3]
I proposed a new plan.	<b>新しい計画を提案しました。</b> <br> あたらしいけいかくをていあんしました。 <br><br> (提案) <br> [sound:4c-s-新しい計画を提案しました。.mp3]
[sound:4c-k-提供者.mp3]	<b>提供者</b> <br> ていきょうしゃ <br> donor, contributer, provider
提供者	<b>ていきょうしゃ</b> <br> donor, contributer, provider <br> [sound:4c-k-提供者.mp3]
donor, contributer, provider	<b>提供者</b> <br> ていきょうしゃ <br> [sound:4c-k-提供者.mp3]
[sound:4c-s-サービスの提供者は会社です。.mp3]	<b>サービスの提供者は会社です。</b> <br> サービスのていきょうしゃはかいしゃです。 <br><br> (提供者) <br> The provider of the service is a company.
サービスの提供者は会社です。 <br><br> (提供者)	<b>サービスのていきょうしゃはかいしゃです。</b> <br> The provider of the service is a company. <br> [sound:4c-s-サービスの提供者は会社です。.mp3]
The provider of the service is a company.	<b>サービスの提供者は会社です。</b> <br> サービスのていきょうしゃはかいしゃです。 <br><br> (提供者) <br> [sound:4c-s-サービスの提供者は会社です。.mp3]
[sound:4c-k-提起.mp3]	<b>提起</b> <br> ていき <br> bring suit, file a claim, raise a question
提起	<b>ていき</b> <br> bring suit, file a claim, raise a question <br> [sound:4c-k-提起.mp3]
bring suit, file a claim, raise a question	<b>提起</b> <br> ていき <br> [sound:4c-k-提起.mp3]
[sound:4c-s-この問題を提起します。.mp3]	<b>この問題を提起します。</b> <br> このもんだいをていきします。 <br><br> (提起) <br> I will raise this issue.
この問題を提起します。 <br><br> (提起)	<b>このもんだいをていきします。</b> <br> I will raise this issue. <br> [sound:4c-s-この問題を提起します。.mp3]
I will raise this issue.	<b>この問題を提起します。</b> <br> このもんだいをていきします。 <br><br> (提起) <br> [sound:4c-s-この問題を提起します。.mp3]
[sound:4c-k-運.mp3]	<b>運</b> <br> うん <br> fortune, luck
運	<b>うん</b> <br> fortune, luck <br> [sound:4c-k-運.mp3]
fortune, luck	<b>運</b> <br> うん <br> [sound:4c-k-運.mp3]
[sound:4c-s-運が良かったです。.mp3]	<b>運が良かったです。</b> <br> うんがよかったです。 <br><br> (運) <br> I was lucky.
運が良かったです。 <br><br> (運)	<b>うんがよかったです。</b> <br> I was lucky. <br> [sound:4c-s-運が良かったです。.mp3]
I was lucky.	<b>運が良かったです。</b> <br> うんがよかったです。 <br><br> (運) <br> [sound:4c-s-運が良かったです。.mp3]
[sound:4c-k-運ぶ.mp3]	<b>運ぶ</b> <br> はこぶ <br> to carry, to transport, to move, to convey; to come, to go; to wield (a tool, etc.), to use; to go (well, etc.), to proceed, to progress
運ぶ	<b>はこぶ</b> <br> to carry, to transport, to move, to convey; to come, to go; to wield (a tool, etc.), to use; to go (well, etc.), to proceed, to progress <br> [sound:4c-k-運ぶ.mp3]
to carry, to transport, to move, to convey; to come, to go; to wield (a tool, etc.), to use; to go (well, etc.), to proceed, to progress	<b>運ぶ</b> <br> はこぶ <br> [sound:4c-k-運ぶ.mp3]
[sound:4c-s-荷物を運んでください。.mp3]	<b>荷物を運んでください。</b> <br> にもつをはこんでください。 <br><br> (運ぶ) <br> Please carry the luggage.
荷物を運んでください。 <br><br> (運ぶ)	<b>にもつをはこんでください。</b> <br> Please carry the luggage. <br> [sound:4c-s-荷物を運んでください。.mp3]
Please carry the luggage.	<b>荷物を運んでください。</b> <br> にもつをはこんでください。 <br><br> (運ぶ) <br> [sound:4c-s-荷物を運んでください。.mp3]
[sound:4c-k-運び.mp3]	<b>運び</b> <br> はこび <br> progress, pace, carriage, step, stage
運び	<b>はこび</b> <br> progress, pace, carriage, step, stage <br> [sound:4c-k-運び.mp3]
progress, pace, carriage, step, stage	<b>運び</b> <br> はこび <br> [sound:4c-k-運び.mp3]
[sound:4c-s-慎重に運びました。.mp3]	<b>慎重に運びました。</b> <br> しんちょうにはこびました。 <br><br> (運び) <br> I transported it carefully.
慎重に運びました。 <br><br> (運び)	<b>しんちょうにはこびました。</b> <br> I transported it carefully. <br> [sound:4c-s-慎重に運びました。.mp3]
I transported it carefully.	<b>慎重に運びました。</b> <br> しんちょうにはこびました。 <br><br> (運び) <br> [sound:4c-s-慎重に運びました。.mp3]
[sound:4c-k-運転手.mp3]	<b>運転手</b> <br> うんてんしゅ <br> driver, chauffeur
運転手	<b>うんてんしゅ</b> <br> driver, chauffeur <br> [sound:4c-k-運転手.mp3]
driver, chauffeur	<b>運転手</b> <br> うんてんしゅ <br> [sound:4c-k-運転手.mp3]
[sound:4c-s-運転手が親切でした。.mp3]	<b>運転手が親切でした。</b> <br> うんてんしゅがしんせつでした。 <br><br> (運転手) <br> The driver was kind.
運転手が親切でした。 <br><br> (運転手)	<b>うんてんしゅがしんせつでした。</b> <br> The driver was kind. <br> [sound:4c-s-運転手が親切でした。.mp3]
The driver was kind.	<b>運転手が親切でした。</b> <br> うんてんしゅがしんせつでした。 <br><br> (運転手) <br> [sound:4c-s-運転手が親切でした。.mp3]
[sound:4c-k-終わり.mp3]	<b>終わり</b> <br> おわり <br> the end
終わり	<b>おわり</b> <br> the end <br> [sound:4c-k-終わり.mp3]
the end	<b>終わり</b> <br> おわり <br> [sound:4c-k-終わり.mp3]
[sound:4c-s-イベントの終わりに挨拶しました。.mp3]	<b>イベントの終わりに挨拶しました。</b> <br> イベントのおわりにあいさつしました。 <br><br> (終わり) <br> I greeted everyone at the end of the event.
イベントの終わりに挨拶しました。 <br><br> (終わり)	<b>イベントのおわりにあいさつしました。</b> <br> I greeted everyone at the end of the event. <br> [sound:4c-s-イベントの終わりに挨拶しました。.mp3]
I greeted everyone at the end of the event.	<b>イベントの終わりに挨拶しました。</b> <br> イベントのおわりにあいさつしました。 <br><br> (終わり) <br> [sound:4c-s-イベントの終わりに挨拶しました。.mp3]
[sound:4c-k-最終.mp3]	<b>最終</b> <br> さいしゅう <br> last, final, closing
最終	<b>さいしゅう</b> <br> last, final, closing <br> [sound:4c-k-最終.mp3]
last, final, closing	<b>最終</b> <br> さいしゅう <br> [sound:4c-k-最終.mp3]
[sound:4c-s-最終決定をしました。.mp3]	<b>最終決定をしました。</b> <br> さいしゅうけっていをしました。 <br><br> (最終) <br> I made the final decision.
最終決定をしました。 <br><br> (最終)	<b>さいしゅうけっていをしました。</b> <br> I made the final decision. <br> [sound:4c-s-最終決定をしました。.mp3]
I made the final decision.	<b>最終決定をしました。</b> <br> さいしゅうけっていをしました。 <br><br> (最終) <br> [sound:4c-s-最終決定をしました。.mp3]
[sound:4c-k-終日.mp3]	<b>終日</b> <br> しゅうじつ, ひねもす, ひめもす, ひもすがら <br> all day, for a whole day
終日	<b>しゅうじつ, ひねもす, ひめもす, ひもすがら</b> <br> all day, for a whole day <br> [sound:4c-k-終日.mp3]
all day, for a whole day	<b>終日</b> <br> しゅうじつ, ひねもす, ひめもす, ひもすがら <br> [sound:4c-k-終日.mp3]
[sound:4c-s-終日雨が降っていました。.mp3]	<b>終日雨が降っていました。</b> <br> しゅうじつあめがふっていました。 <br><br> (終日) <br> It rained all day.
終日雨が降っていました。 <br><br> (終日)	<b>しゅうじつあめがふっていました。</b> <br> It rained all day. <br> [sound:4c-s-終日雨が降っていました。.mp3]
It rained all day.	<b>終日雨が降っていました。</b> <br> しゅうじつあめがふっていました。 <br><br> (終日) <br> [sound:4c-s-終日雨が降っていました。.mp3]
[sound:4c-k-終盤.mp3]	<b>終盤</b> <br> しゅうばん <br> endgame, final stage
終盤	<b>しゅうばん</b> <br> endgame, final stage <br> [sound:4c-k-終盤.mp3]
endgame, final stage	<b>終盤</b> <br> しゅうばん <br> [sound:4c-k-終盤.mp3]
[sound:4c-s-試合は終盤に入りました。.mp3]	<b>試合は終盤に入りました。</b> <br> しあいはしゅうばんにはいりました。 <br><br> (終盤) <br> The game entered the final stage.
試合は終盤に入りました。 <br><br> (終盤)	<b>しあいはしゅうばんにはいりました。</b> <br> The game entered the final stage. <br> [sound:4c-s-試合は終盤に入りました。.mp3]
The game entered the final stage.	<b>試合は終盤に入りました。</b> <br> しあいはしゅうばんにはいりました。 <br><br> (終盤) <br> [sound:4c-s-試合は終盤に入りました。.mp3]
[sound:4c-k-挙げる.mp3]	<b>挙げる</b> <br> あげる <br> to raise, to elevate; to do up (one's hair); to fly (a kite, etc.), to launch (fireworks, etc.), to surface (a submarine, etc.); to land (a boat); to deep-fry; to show someone (into a room); (uk) to summon (for geishas, etc.); to send someone (away); to enrol (one's child in school) (enroll); to increase (price, quality, status, etc.); to make (a loud sound), to raise (one's voice); to earn (something desirable); to praise; to give (an example, etc.), to cite; to summon up (all of one's energy, etc.); to arrest; to nominate; to give; to offer up (incense, a prayer, etc.) to the gods (or Buddha, etc.); to bear (a child); to conduct (a ceremony, esp. a wedding); (of the tide) to come in; to vomit; (after the -te form of a verb) to do for (the sake of someone else); (after the -masu stem of a verb) to complete; used after the -masu stem of a humble verb to increase the level of humility
挙げる	<b>あげる</b> <br> to raise, to elevate; to do up (one's hair); to fly (a kite, etc.), to launch (fireworks, etc.), to surface (a submarine, etc.); to land (a boat); to deep-fry; to show someone (into a room); (uk) to summon (for geishas, etc.); to send someone (away); to enrol (one's child in school) (enroll); to increase (price, quality, status, etc.); to make (a loud sound), to raise (one's voice); to earn (something desirable); to praise; to give (an example, etc.), to cite; to summon up (all of one's energy, etc.); to arrest; to nominate; to give; to offer up (incense, a prayer, etc.) to the gods (or Buddha, etc.); to bear (a child); to conduct (a ceremony, esp. a wedding); (of the tide) to come in; to vomit; (after the -te form of a verb) to do for (the sake of someone else); (after the -masu stem of a verb) to complete; used after the -masu stem of a humble verb to increase the level of humility <br> [sound:4c-k-挙げる.mp3]
to raise, to elevate; to do up (one's hair); to fly (a kite, etc.), to launch (fireworks, etc.), to surface (a submarine, etc.); to land (a boat); to deep-fry; to show someone (into a room); (uk) to summon (for geishas, etc.); to send someone (away); to enrol (one's child in school) (enroll); to increase (price, quality, status, etc.); to make (a loud sound), to raise (one's voice); to earn (something desirable); to praise; to give (an example, etc.), to cite; to summon up (all of one's energy, etc.); to arrest; to nominate; to give; to offer up (incense, a prayer, etc.) to the gods (or Buddha, etc.); to bear (a child); to conduct (a ceremony, esp. a wedding); (of the tide) to come in; to vomit; (after the -te form of a verb) to do for (the sake of someone else); (after the -masu stem of a verb) to complete; used after the -masu stem of a humble verb to increase the level of humility	<b>挙げる</b> <br> あげる <br> [sound:4c-k-挙げる.mp3]
[sound:4c-s-例を挙げて説明します。.mp3]	<b>例を挙げて説明します。</b> <br> れいをあげてせつめいします。 <br><br> (挙げる) <br> I will explain with examples.
例を挙げて説明します。 <br><br> (挙げる)	<b>れいをあげてせつめいします。</b> <br> I will explain with examples. <br> [sound:4c-s-例を挙げて説明します。.mp3]
I will explain with examples.	<b>例を挙げて説明します。</b> <br> れいをあげてせつめいします。 <br><br> (挙げる) <br> [sound:4c-s-例を挙げて説明します。.mp3]
[sound:4c-k-選挙.mp3]	<b>選挙</b> <br> せんきょ <br> election
選挙	<b>せんきょ</b> <br> election <br> [sound:4c-k-選挙.mp3]
election	<b>選挙</b> <br> せんきょ <br> [sound:4c-k-選挙.mp3]
[sound:4c-s-選挙の日が近づいています。.mp3]	<b>選挙の日が近づいています。</b> <br> せんきょのひがちかづいています。 <br><br> (選挙) <br> The election day is approaching.
選挙の日が近づいています。 <br><br> (選挙)	<b>せんきょのひがちかづいています。</b> <br> The election day is approaching. <br> [sound:4c-s-選挙の日が近づいています。.mp3]
The election day is approaching.	<b>選挙の日が近づいています。</b> <br> せんきょのひがちかづいています。 <br><br> (選挙) <br> [sound:4c-s-選挙の日が近づいています。.mp3]
[sound:4c-k-快挙.mp3]	<b>快挙</b> <br> かいきょ <br> brilliant achievement
快挙	<b>かいきょ</b> <br> brilliant achievement <br> [sound:4c-k-快挙.mp3]
brilliant achievement	<b>快挙</b> <br> かいきょ <br> [sound:4c-k-快挙.mp3]
[sound:4c-s-彼の成功は快挙です。.mp3]	<b>彼の成功は快挙です。</b> <br> かれのせいこうはかいきょです。 <br><br> (快挙) <br> His success is a remarkable achievement.
彼の成功は快挙です。 <br><br> (快挙)	<b>かれのせいこうはかいきょです。</b> <br> His success is a remarkable achievement. <br> [sound:4c-s-彼の成功は快挙です。.mp3]
His success is a remarkable achievement.	<b>彼の成功は快挙です。</b> <br> かれのせいこうはかいきょです。 <br><br> (快挙) <br> [sound:4c-s-彼の成功は快挙です。.mp3]
[sound:4c-k-選挙権.mp3]	<b>選挙権</b> <br> せんきょけん <br> suffrage
選挙権	<b>せんきょけん</b> <br> suffrage <br> [sound:4c-k-選挙権.mp3]
suffrage	<b>選挙権</b> <br> せんきょけん <br> [sound:4c-k-選挙権.mp3]
[sound:4c-s-選挙権を持っていますか？ .mp3]	<b>選挙権を持っていますか？   </b> <br> せんきょけんをもっていますか？ <br><br> (選挙権) <br> Do you have the right to vote?
選挙権を持っていますか？    <br><br> (選挙権)	<b>せんきょけんをもっていますか？</b> <br> Do you have the right to vote? <br> [sound:4c-s-選挙権を持っていますか？ .mp3]
Do you have the right to vote?	<b>選挙権を持っていますか？   </b> <br> せんきょけんをもっていますか？ <br><br> (選挙権) <br> [sound:4c-s-選挙権を持っていますか？ .mp3]
[sound:4c-k-結果.mp3]	<b>結果</b> <br> けっか <br> result, consequence
結果	<b>けっか</b> <br> result, consequence <br> [sound:4c-k-結果.mp3]
result, consequence	<b>結果</b> <br> けっか <br> [sound:4c-k-結果.mp3]
[sound:4c-s-試験の結果が発表されました。.mp3]	<b>試験の結果が発表されました。</b> <br> しけんのけっかがはっぴょうされました。 <br><br> (結果) <br> The exam results have been announced.
試験の結果が発表されました。 <br><br> (結果)	<b>しけんのけっかがはっぴょうされました。</b> <br> The exam results have been announced. <br> [sound:4c-s-試験の結果が発表されました。.mp3]
The exam results have been announced.	<b>試験の結果が発表されました。</b> <br> しけんのけっかがはっぴょうされました。 <br><br> (結果) <br> [sound:4c-s-試験の結果が発表されました。.mp3]
[sound:4c-k-効果.mp3]	<b>効果</b> <br> こうか <br> effect, effectiveness, efficacy, result
効果	<b>こうか</b> <br> effect, effectiveness, efficacy, result <br> [sound:4c-k-効果.mp3]
effect, effectiveness, efficacy, result	<b>効果</b> <br> こうか <br> [sound:4c-k-効果.mp3]
[sound:4c-s-この薬は効果があります。.mp3]	<b>この薬は効果があります。</b> <br> このくすりはこうかがあります。 <br><br> (効果) <br> This medicine is effective.
この薬は効果があります。 <br><br> (効果)	<b>このくすりはこうかがあります。</b> <br> This medicine is effective. <br> [sound:4c-s-この薬は効果があります。.mp3]
This medicine is effective.	<b>この薬は効果があります。</b> <br> このくすりはこうかがあります。 <br><br> (効果) <br> [sound:4c-s-この薬は効果があります。.mp3]
[sound:4c-k-果実.mp3]	<b>果実</b> <br> かじつ <br> fruit, nut, berry
果実	<b>かじつ</b> <br> fruit, nut, berry <br> [sound:4c-k-果実.mp3]
fruit, nut, berry	<b>果実</b> <br> かじつ <br> [sound:4c-k-果実.mp3]
[sound:4c-s-果実が熟しました。.mp3]	<b>果実が熟しました。</b> <br> かじつがじゅくしました。 <br><br> (果実) <br> The fruit has ripened.
果実が熟しました。 <br><br> (果実)	<b>かじつがじゅくしました。</b> <br> The fruit has ripened. <br> [sound:4c-s-果実が熟しました。.mp3]
The fruit has ripened.	<b>果実が熟しました。</b> <br> かじつがじゅくしました。 <br><br> (果実) <br> [sound:4c-s-果実が熟しました。.mp3]
[sound:4c-k-果敢.mp3]	<b>果敢</b> <br> かかん <br> resolute, determined, bold
果敢	<b>かかん</b> <br> resolute, determined, bold <br> [sound:4c-k-果敢.mp3]
resolute, determined, bold	<b>果敢</b> <br> かかん <br> [sound:4c-k-果敢.mp3]
[sound:4c-s-彼は果敢に挑戦しました。.mp3]	<b>彼は果敢に挑戦しました。</b> <br> かれはかかんにちょうせんしました。 <br><br> (果敢) <br> He boldly took on the challenge.
彼は果敢に挑戦しました。 <br><br> (果敢)	<b>かれはかかんにちょうせんしました。</b> <br> He boldly took on the challenge. <br> [sound:4c-s-彼は果敢に挑戦しました。.mp3]
He boldly took on the challenge.	<b>彼は果敢に挑戦しました。</b> <br> かれはかかんにちょうせんしました。 <br><br> (果敢) <br> [sound:4c-s-彼は果敢に挑戦しました。.mp3]
[sound:4c-k-西.mp3]	<b>西</b> <br> にし <br> west
西	<b>にし</b> <br> west <br> [sound:4c-k-西.mp3]
west	<b>西</b> <br> にし <br> [sound:4c-k-西.mp3]
[sound:4c-s-西の空が美しいです。.mp3]	<b>西の空が美しいです。</b> <br> にしのそらがうつくしいです。 <br><br> (西) <br> The western sky is beautiful.
西の空が美しいです。 <br><br> (西)	<b>にしのそらがうつくしいです。</b> <br> The western sky is beautiful. <br> [sound:4c-s-西の空が美しいです。.mp3]
The western sky is beautiful.	<b>西の空が美しいです。</b> <br> にしのそらがうつくしいです。 <br><br> (西) <br> [sound:4c-s-西の空が美しいです。.mp3]
[sound:4c-k-関西.mp3]	<b>関西</b> <br> かんさい, かんせい <br> Kansai (south-western half of Japan, including Osaka)
関西	<b>かんさい, かんせい</b> <br> Kansai (south-western half of Japan, including Osaka) <br> [sound:4c-k-関西.mp3]
Kansai (south-western half of Japan, including Osaka)	<b>関西</b> <br> かんさい, かんせい <br> [sound:4c-k-関西.mp3]
[sound:4c-s-関西地方に旅行しました。.mp3]	<b>関西地方に旅行しました。</b> <br> かんさいちほうにりょこうしました。 <br><br> (関西) <br> I traveled to the Kansai region.
関西地方に旅行しました。 <br><br> (関西)	<b>かんさいちほうにりょこうしました。</b> <br> I traveled to the Kansai region. <br> [sound:4c-s-関西地方に旅行しました。.mp3]
I traveled to the Kansai region.	<b>関西地方に旅行しました。</b> <br> かんさいちほうにりょこうしました。 <br><br> (関西) <br> [sound:4c-s-関西地方に旅行しました。.mp3]
[sound:4c-k-西日本.mp3]	<b>西日本</b> <br> にしにほん, にしにっぽん <br> western Japan
西日本	<b>にしにほん, にしにっぽん</b> <br> western Japan <br> [sound:4c-k-西日本.mp3]
western Japan	<b>西日本</b> <br> にしにほん, にしにっぽん <br> [sound:4c-k-西日本.mp3]
[sound:4c-s-西日本は温暖な気候です。.mp3]	<b>西日本は温暖な気候です。</b> <br> にしにほんはおんだんなきこうです。 <br><br> (西日本) <br> Western Japan has a warm climate.
西日本は温暖な気候です。 <br><br> (西日本)	<b>にしにほんはおんだんなきこうです。</b> <br> Western Japan has a warm climate. <br> [sound:4c-s-西日本は温暖な気候です。.mp3]
Western Japan has a warm climate.	<b>西日本は温暖な気候です。</b> <br> にしにほんはおんだんなきこうです。 <br><br> (西日本) <br> [sound:4c-s-西日本は温暖な気候です。.mp3]
[sound:4c-k-西洋.mp3]	<b>西洋</b> <br> せいよう <br> the west, Western countries
西洋	<b>せいよう</b> <br> the west, Western countries <br> [sound:4c-k-西洋.mp3]
the west, Western countries	<b>西洋</b> <br> せいよう <br> [sound:4c-k-西洋.mp3]
[sound:4c-s-西洋の文化を学びます。.mp3]	<b>西洋の文化を学びます。</b> <br> せいようのぶんかをまなびます。 <br><br> (西洋) <br> I study Western culture.
西洋の文化を学びます。 <br><br> (西洋)	<b>せいようのぶんかをまなびます。</b> <br> I study Western culture. <br> [sound:4c-s-西洋の文化を学びます。.mp3]
I study Western culture.	<b>西洋の文化を学びます。</b> <br> せいようのぶんかをまなびます。 <br><br> (西洋) <br> [sound:4c-s-西洋の文化を学びます。.mp3]
[sound:4c-k-勢い.mp3]	<b>勢い</b> <br> いきおい <br> force, vigor, vigour, energy, spirit, life; influence, authority, power, might; impetus, momentum, course (of events); naturally, necessarily
勢い	<b>いきおい</b> <br> force, vigor, vigour, energy, spirit, life; influence, authority, power, might; impetus, momentum, course (of events); naturally, necessarily <br> [sound:4c-k-勢い.mp3]
force, vigor, vigour, energy, spirit, life; influence, authority, power, might; impetus, momentum, course (of events); naturally, necessarily	<b>勢い</b> <br> いきおい <br> [sound:4c-k-勢い.mp3]
[sound:4c-s-彼の演説には勢いがあります。.mp3]	<b>彼の演説には勢いがあります。</b> <br> かれのえんぜつにはいきおいがあります。 <br><br> (勢い) <br> His speech has momentum.
彼の演説には勢いがあります。 <br><br> (勢い)	<b>かれのえんぜつにはいきおいがあります。</b> <br> His speech has momentum. <br> [sound:4c-s-彼の演説には勢いがあります。.mp3]
His speech has momentum.	<b>彼の演説には勢いがあります。</b> <br> かれのえんぜつにはいきおいがあります。 <br><br> (勢い) <br> [sound:4c-s-彼の演説には勢いがあります。.mp3]
[sound:4c-k-勢み.mp3]	<b>勢み</b> <br> はずみ <br> bounce, spring, rebound; momentum, inertia; spur of the moment, impulse
勢み	<b>はずみ</b> <br> bounce, spring, rebound; momentum, inertia; spur of the moment, impulse <br> [sound:4c-k-勢み.mp3]
bounce, spring, rebound; momentum, inertia; spur of the moment, impulse	<b>勢み</b> <br> はずみ <br> [sound:4c-k-勢み.mp3]
[sound:4c-s-勢みよく水が流れています。.mp3]	<b>勢みよく水が流れています。</b> <br> いきみよくみずがながれています。 <br><br> (勢み) <br> The water is flowing vigorously.
勢みよく水が流れています。 <br><br> (勢み)	<b>いきみよくみずがながれています。</b> <br> The water is flowing vigorously. <br> [sound:4c-s-勢みよく水が流れています。.mp3]
The water is flowing vigorously.	<b>勢みよく水が流れています。</b> <br> いきみよくみずがながれています。 <br><br> (勢み) <br> [sound:4c-s-勢みよく水が流れています。.mp3]
[sound:4c-k-伊勢丹.mp3]	<b>伊勢丹</b> <br> いせたん <br> Isetan (department store)
伊勢丹	<b>いせたん</b> <br> Isetan (department store) <br> [sound:4c-k-伊勢丹.mp3]
Isetan (department store)	<b>伊勢丹</b> <br> いせたん <br> [sound:4c-k-伊勢丹.mp3]
[sound:4c-s-伊勢丹で買い物しました。.mp3]	<b>伊勢丹で買い物しました。</b> <br> いせたんでかいものしました。 <br><br> (伊勢丹) <br> I shopped at Isetan.
伊勢丹で買い物しました。 <br><br> (伊勢丹)	<b>いせたんでかいものしました。</b> <br> I shopped at Isetan. <br> [sound:4c-s-伊勢丹で買い物しました。.mp3]
I shopped at Isetan.	<b>伊勢丹で買い物しました。</b> <br> いせたんでかいものしました。 <br><br> (伊勢丹) <br> [sound:4c-s-伊勢丹で買い物しました。.mp3]
[sound:4c-k-優勢.mp3]	<b>優勢</b> <br> ゆうせい <br> superiority, superior power, predominance, preponderance
優勢	<b>ゆうせい</b> <br> superiority, superior power, predominance, preponderance <br> [sound:4c-k-優勢.mp3]
superiority, superior power, predominance, preponderance	<b>優勢</b> <br> ゆうせい <br> [sound:4c-k-優勢.mp3]
[sound:4c-s-彼のチームが優勢です。.mp3]	<b>彼のチームが優勢です。</b> <br> かれのチームがゆうせいです。 <br><br> (優勢) <br> His team is in the lead.
彼のチームが優勢です。 <br><br> (優勢)	<b>かれのチームがゆうせいです。</b> <br> His team is in the lead. <br> [sound:4c-s-彼のチームが優勢です。.mp3]
His team is in the lead.	<b>彼のチームが優勢です。</b> <br> かれのチームがゆうせいです。 <br><br> (優勢) <br> [sound:4c-s-彼のチームが優勢です。.mp3]
[sound:4c-k-削減.mp3]	<b>削減</b> <br> さくげん <br> cut, reduction, curtailment
削減	<b>さくげん</b> <br> cut, reduction, curtailment <br> [sound:4c-k-削減.mp3]
cut, reduction, curtailment	<b>削減</b> <br> さくげん <br> [sound:4c-k-削減.mp3]
[sound:4c-s-経費を削減します。.mp3]	<b>経費を削減します。</b> <br> けいひをさくげんします。 <br><br> (削減) <br> We will reduce expenses.
経費を削減します。 <br><br> (削減)	<b>けいひをさくげんします。</b> <br> We will reduce expenses. <br> [sound:4c-s-経費を削減します。.mp3]
We will reduce expenses.	<b>経費を削減します。</b> <br> けいひをさくげんします。 <br><br> (削減) <br> [sound:4c-s-経費を削減します。.mp3]
[sound:4c-k-減税.mp3]	<b>減税</b> <br> げんぜい <br> tax reduction
減税	<b>げんぜい</b> <br> tax reduction <br> [sound:4c-k-減税.mp3]
tax reduction	<b>減税</b> <br> げんぜい <br> [sound:4c-k-減税.mp3]
[sound:4c-s-減税政策が実施されました。.mp3]	<b>減税政策が実施されました。</b> <br> げんぜいせいさくがじっしされました。 <br><br> (減税) <br> A tax reduction policy was implemented.
減税政策が実施されました。 <br><br> (減税)	<b>げんぜいせいさくがじっしされました。</b> <br> A tax reduction policy was implemented. <br> [sound:4c-s-減税政策が実施されました。.mp3]
A tax reduction policy was implemented.	<b>減税政策が実施されました。</b> <br> げんぜいせいさくがじっしされました。 <br><br> (減税) <br> [sound:4c-s-減税政策が実施されました。.mp3]
[sound:4c-k-減額.mp3]	<b>減額</b> <br> げんがく <br> reduction, diminution, abatement
減額	<b>げんがく</b> <br> reduction, diminution, abatement <br> [sound:4c-k-減額.mp3]
reduction, diminution, abatement	<b>減額</b> <br> げんがく <br> [sound:4c-k-減額.mp3]
[sound:4c-s-料金が減額されました。.mp3]	<b>料金が減額されました。</b> <br> りょうきんがげんがくされました。 <br><br> (減額) <br> The fee was reduced.
料金が減額されました。 <br><br> (減額)	<b>りょうきんがげんがくされました。</b> <br> The fee was reduced. <br> [sound:4c-s-料金が減額されました。.mp3]
The fee was reduced.	<b>料金が減額されました。</b> <br> りょうきんがげんがくされました。 <br><br> (減額) <br> [sound:4c-s-料金が減額されました。.mp3]
[sound:4c-k-減産.mp3]	<b>減産</b> <br> げんさん <br> reduction in production
減産	<b>げんさん</b> <br> reduction in production <br> [sound:4c-k-減産.mp3]
reduction in production	<b>減産</b> <br> げんさん <br> [sound:4c-k-減産.mp3]
[sound:4c-s-工場は減産を決定しました。.mp3]	<b>工場は減産を決定しました。</b> <br> こうじょうはげんさんをけっていしました。 <br><br> (減産) <br> The factory decided to cut production.
工場は減産を決定しました。 <br><br> (減産)	<b>こうじょうはげんさんをけっていしました。</b> <br> The factory decided to cut production. <br> [sound:4c-s-工場は減産を決定しました。.mp3]
The factory decided to cut production.	<b>工場は減産を決定しました。</b> <br> こうじょうはげんさんをけっていしました。 <br><br> (減産) <br> [sound:4c-s-工場は減産を決定しました。.mp3]
[sound:4c-k-台.mp3]	<b>台</b> <br> だい <br> stand, rack, table; support; belt; counter for machines, incl. vehicles; setting (e.g. in jewellery)
台	<b>だい</b> <br> stand, rack, table; support; belt; counter for machines, incl. vehicles; setting (e.g. in jewellery) <br> [sound:4c-k-台.mp3]
stand, rack, table; support; belt; counter for machines, incl. vehicles; setting (e.g. in jewellery)	<b>台</b> <br> だい <br> [sound:4c-k-台.mp3]
[sound:4c-s-台の上に置いてください。.mp3]	<b>台の上に置いてください。</b> <br> だいのうえにおいてください。 <br><br> (台) <br> Please put it on the stand.
台の上に置いてください。 <br><br> (台)	<b>だいのうえにおいてください。</b> <br> Please put it on the stand. <br> [sound:4c-s-台の上に置いてください。.mp3]
Please put it on the stand.	<b>台の上に置いてください。</b> <br> だいのうえにおいてください。 <br><br> (台) <br> [sound:4c-s-台の上に置いてください。.mp3]
[sound:4c-k-台湾.mp3]	<b>台湾</b> <br> たいわん <br> Taiwan
台湾	<b>たいわん</b> <br> Taiwan <br> [sound:4c-k-台湾.mp3]
Taiwan	<b>台湾</b> <br> たいわん <br> [sound:4c-k-台湾.mp3]
[sound:4c-s-台湾に旅行しました。.mp3]	<b>台湾に旅行しました。</b> <br> たいわんにりょこうしました。 <br><br> (台湾) <br> I traveled to Taiwan.
台湾に旅行しました。 <br><br> (台湾)	<b>たいわんにりょこうしました。</b> <br> I traveled to Taiwan. <br> [sound:4c-s-台湾に旅行しました。.mp3]
I traveled to Taiwan.	<b>台湾に旅行しました。</b> <br> たいわんにりょこうしました。 <br><br> (台湾) <br> [sound:4c-s-台湾に旅行しました。.mp3]
[sound:4c-k-土台.mp3]	<b>土台</b> <br> どだい <br> foundation, base, basis
土台	<b>どだい</b> <br> foundation, base, basis <br> [sound:4c-k-土台.mp3]
foundation, base, basis	<b>土台</b> <br> どだい <br> [sound:4c-k-土台.mp3]
[sound:4c-s-家の土台をしっかり作ります。.mp3]	<b>家の土台をしっかり作ります。</b> <br> いえのどだいをしっかりつくります。 <br><br> (土台) <br> We build a solid foundation for the house.
家の土台をしっかり作ります。 <br><br> (土台)	<b>いえのどだいをしっかりつくります。</b> <br> We build a solid foundation for the house. <br> [sound:4c-s-家の土台をしっかり作ります。.mp3]
We build a solid foundation for the house.	<b>家の土台をしっかり作ります。</b> <br> いえのどだいをしっかりつくります。 <br><br> (土台) <br> [sound:4c-s-家の土台をしっかり作ります。.mp3]
[sound:4c-k-屋台.mp3]	<b>屋台</b> <br> やたい <br> cart, esp. food cart; (festival) float
屋台	<b>やたい</b> <br> cart, esp. food cart; (festival) float <br> [sound:4c-k-屋台.mp3]
cart, esp. food cart; (festival) float	<b>屋台</b> <br> やたい <br> [sound:4c-k-屋台.mp3]
[sound:4c-s-屋台でラーメンを食べました。.mp3]	<b>屋台でラーメンを食べました。</b> <br> やたいでラーメンをたべました。 <br><br> (屋台) <br> I ate ramen at a food stall.
屋台でラーメンを食べました。 <br><br> (屋台)	<b>やたいでラーメンをたべました。</b> <br> I ate ramen at a food stall. <br> [sound:4c-s-屋台でラーメンを食べました。.mp3]
I ate ramen at a food stall.	<b>屋台でラーメンを食べました。</b> <br> やたいでラーメンをたべました。 <br><br> (屋台) <br> [sound:4c-s-屋台でラーメンを食べました。.mp3]
[sound:4c-k-広い.mp3]	<b>広い</b> <br> ひろい <br> spacious, vast, wide
広い	<b>ひろい</b> <br> spacious, vast, wide <br> [sound:4c-k-広い.mp3]
spacious, vast, wide	<b>広い</b> <br> ひろい <br> [sound:4c-k-広い.mp3]
[sound:4c-s-広い庭があります。.mp3]	<b>広い庭があります。</b> <br> ひろいにわがあります。 <br><br> (広い) <br> There is a large garden.
広い庭があります。 <br><br> (広い)	<b>ひろいにわがあります。</b> <br> There is a large garden. <br> [sound:4c-s-広い庭があります。.mp3]
There is a large garden.	<b>広い庭があります。</b> <br> ひろいにわがあります。 <br><br> (広い) <br> [sound:4c-s-広い庭があります。.mp3]
[sound:4c-k-広がり.mp3]	<b>広がり</b> <br> ひろがり <br> spread, span
広がり	<b>ひろがり</b> <br> spread, span <br> [sound:4c-k-広がり.mp3]
spread, span	<b>広がり</b> <br> ひろがり <br> [sound:4c-k-広がり.mp3]
[sound:4c-s-湖の広がりが美しいです。.mp3]	<b>湖の広がりが美しいです。</b> <br> みずうみのひろがりがうつくしいです。 <br><br> (広がり) <br> The expanse of the lake is beautiful.
湖の広がりが美しいです。 <br><br> (広がり)	<b>みずうみのひろがりがうつくしいです。</b> <br> The expanse of the lake is beautiful. <br> [sound:4c-s-湖の広がりが美しいです。.mp3]
The expanse of the lake is beautiful.	<b>湖の広がりが美しいです。</b> <br> みずうみのひろがりがうつくしいです。 <br><br> (広がり) <br> [sound:4c-s-湖の広がりが美しいです。.mp3]
[sound:4c-k-幅広い.mp3]	<b>幅広い</b> <br> はばひろい <br> extensive, wide, broad
幅広い	<b>はばひろい</b> <br> extensive, wide, broad <br> [sound:4c-k-幅広い.mp3]
extensive, wide, broad	<b>幅広い</b> <br> はばひろい <br> [sound:4c-k-幅広い.mp3]
[sound:4c-s-彼の知識は幅広いです。.mp3]	<b>彼の知識は幅広いです。</b> <br> かれのちしきははばひろいです。 <br><br> (幅広い) <br> His knowledge is extensive.
彼の知識は幅広いです。 <br><br> (幅広い)	<b>かれのちしきははばひろいです。</b> <br> His knowledge is extensive. <br> [sound:4c-s-彼の知識は幅広いです。.mp3]
His knowledge is extensive.	<b>彼の知識は幅広いです。</b> <br> かれのちしきははばひろいです。 <br><br> (幅広い) <br> [sound:4c-s-彼の知識は幅広いです。.mp3]
[sound:4c-k-広大.mp3]	<b>広大</b> <br> こうだい <br> huge, very large, vast, extensive, magnificent, grand
広大	<b>こうだい</b> <br> huge, very large, vast, extensive, magnificent, grand <br> [sound:4c-k-広大.mp3]
huge, very large, vast, extensive, magnificent, grand	<b>広大</b> <br> こうだい <br> [sound:4c-k-広大.mp3]
[sound:4c-s-広大な土地を所有しています。.mp3]	<b>広大な土地を所有しています。</b> <br> こうだいなとちをしょゆうしています。 <br><br> (広大) <br> He owns vast land.
広大な土地を所有しています。 <br><br> (広大)	<b>こうだいなとちをしょゆうしています。</b> <br> He owns vast land. <br> [sound:4c-s-広大な土地を所有しています。.mp3]
He owns vast land.	<b>広大な土地を所有しています。</b> <br> こうだいなとちをしょゆうしています。 <br><br> (広大) <br> [sound:4c-s-広大な土地を所有しています。.mp3]
[sound:4c-k-内容.mp3]	<b>内容</b> <br> ないよう <br> subject, contents, matter, substance, detail, import
内容	<b>ないよう</b> <br> subject, contents, matter, substance, detail, import <br> [sound:4c-k-内容.mp3]
subject, contents, matter, substance, detail, import	<b>内容</b> <br> ないよう <br> [sound:4c-k-内容.mp3]
[sound:4c-s-この本の内容は面白いです。.mp3]	<b>この本の内容は面白いです。</b> <br> このほんのないようはおもしろいです。 <br><br> (内容) <br> The content of this book is interesting.
この本の内容は面白いです。 <br><br> (内容)	<b>このほんのないようはおもしろいです。</b> <br> The content of this book is interesting. <br> [sound:4c-s-この本の内容は面白いです。.mp3]
The content of this book is interesting.	<b>この本の内容は面白いです。</b> <br> このほんのないようはおもしろいです。 <br><br> (内容) <br> [sound:4c-s-この本の内容は面白いです。.mp3]
[sound:4c-k-容疑者.mp3]	<b>容疑者</b> <br> ようぎしゃ <br> suspect (person)
容疑者	<b>ようぎしゃ</b> <br> suspect (person) <br> [sound:4c-k-容疑者.mp3]
suspect (person)	<b>容疑者</b> <br> ようぎしゃ <br> [sound:4c-k-容疑者.mp3]
[sound:4c-s-容疑者が逮捕されました。.mp3]	<b>容疑者が逮捕されました。</b> <br> ようぎしゃがたいほされました。 <br><br> (容疑者) <br> The suspect has been arrested.
容疑者が逮捕されました。 <br><br> (容疑者)	<b>ようぎしゃがたいほされました。</b> <br> The suspect has been arrested. <br> [sound:4c-s-容疑者が逮捕されました。.mp3]
The suspect has been arrested.	<b>容疑者が逮捕されました。</b> <br> ようぎしゃがたいほされました。 <br><br> (容疑者) <br> [sound:4c-s-容疑者が逮捕されました。.mp3]
[sound:4c-k-全容.mp3]	<b>全容</b> <br> ぜんよう <br> full portrait, whole aspect, full story
全容	<b>ぜんよう</b> <br> full portrait, whole aspect, full story <br> [sound:4c-k-全容.mp3]
full portrait, whole aspect, full story	<b>全容</b> <br> ぜんよう <br> [sound:4c-k-全容.mp3]
[sound:4c-s-事件の全容が明らかになりました。.mp3]	<b>事件の全容が明らかになりました。</b> <br> じけんのぜんようがあきらかになりました。 <br><br> (全容) <br> The full picture of the incident has become clear.
事件の全容が明らかになりました。 <br><br> (全容)	<b>じけんのぜんようがあきらかになりました。</b> <br> The full picture of the incident has become clear. <br> [sound:4c-s-事件の全容が明らかになりました。.mp3]
The full picture of the incident has become clear.	<b>事件の全容が明らかになりました。</b> <br> じけんのぜんようがあきらかになりました。 <br><br> (全容) <br> [sound:4c-s-事件の全容が明らかになりました。.mp3]
[sound:4c-k-容量.mp3]	<b>容量</b> <br> ようりょう <br> capacity, electrical capacitance
容量	<b>ようりょう</b> <br> capacity, electrical capacitance <br> [sound:4c-k-容量.mp3]
capacity, electrical capacitance	<b>容量</b> <br> ようりょう <br> [sound:4c-k-容量.mp3]
[sound:4c-s-このUSBの容量は32GBです。.mp3]	<b>このUSBの容量は32GBです。</b> <br> このUSBのようりょうは32GBです。 <br><br> (容量) <br> This USB has a capacity of 32GB.
このUSBの容量は32GBです。 <br><br> (容量)	<b>このUSBのようりょうは32GBです。</b> <br> This USB has a capacity of 32GB. <br> [sound:4c-s-このUSBの容量は32GBです。.mp3]
This USB has a capacity of 32GB.	<b>このUSBの容量は32GBです。</b> <br> このUSBのようりょうは32GBです。 <br><br> (容量) <br> [sound:4c-s-このUSBの容量は32GBです。.mp3]
[sound:4c-k-必ず.mp3]	<b>必ず</b> <br> かならず <br> necessarily, certainly, without fail, positively, invariably
必ず	<b>かならず</b> <br> necessarily, certainly, without fail, positively, invariably <br> [sound:4c-k-必ず.mp3]
necessarily, certainly, without fail, positively, invariably	<b>必ず</b> <br> かならず <br> [sound:4c-k-必ず.mp3]
[sound:4c-s-必ず時間通りに来てください。.mp3]	<b>必ず時間通りに来てください。</b> <br> かならずじかんどおりにきてください。 <br><br> (必ず) <br> Please be on time.
必ず時間通りに来てください。 <br><br> (必ず)	<b>かならずじかんどおりにきてください。</b> <br> Please be on time. <br> [sound:4c-s-必ず時間通りに来てください。.mp3]
Please be on time.	<b>必ず時間通りに来てください。</b> <br> かならずじかんどおりにきてください。 <br><br> (必ず) <br> [sound:4c-s-必ず時間通りに来てください。.mp3]
[sound:4c-k-必ずしも.mp3]	<b>必ずしも</b> <br> かならずしも <br> (not) always, (not) necessarily, (not) all, (not) entirely
必ずしも	<b>かならずしも</b> <br> (not) always, (not) necessarily, (not) all, (not) entirely <br> [sound:4c-k-必ずしも.mp3]
(not) always, (not) necessarily, (not) all, (not) entirely	<b>必ずしも</b> <br> かならずしも <br> [sound:4c-k-必ずしも.mp3]
[sound:4c-s-それは必ずしも正しくありません。.mp3]	<b>それは必ずしも正しくありません。</b> <br> それはかならずしもただしくありません。 <br><br> (必ずしも) <br> That is not necessarily correct.
それは必ずしも正しくありません。 <br><br> (必ずしも)	<b>それはかならずしもただしくありません。</b> <br> That is not necessarily correct. <br> [sound:4c-s-それは必ずしも正しくありません。.mp3]
That is not necessarily correct.	<b>それは必ずしも正しくありません。</b> <br> それはかならずしもただしくありません。 <br><br> (必ずしも) <br> [sound:4c-s-それは必ずしも正しくありません。.mp3]
[sound:4c-k-必勝.mp3]	<b>必勝</b> <br> ひっしょう <br> certain victory
必勝	<b>ひっしょう</b> <br> certain victory <br> [sound:4c-k-必勝.mp3]
certain victory	<b>必勝</b> <br> ひっしょう <br> [sound:4c-k-必勝.mp3]
[sound:4c-s-必勝を目指します。.mp3]	<b>必勝を目指します。</b> <br> ひっしょうをめざします。 <br><br> (必勝) <br> We aim for certain victory.
必勝を目指します。 <br><br> (必勝)	<b>ひっしょうをめざします。</b> <br> We aim for certain victory. <br> [sound:4c-s-必勝を目指します。.mp3]
We aim for certain victory.	<b>必勝を目指します。</b> <br> ひっしょうをめざします。 <br><br> (必勝) <br> [sound:4c-s-必勝を目指します。.mp3]
[sound:4c-k-必然的.mp3]	<b>必然的</b> <br> ひつぜんてき <br> inevitable, necessary
必然的	<b>ひつぜんてき</b> <br> inevitable, necessary <br> [sound:4c-k-必然的.mp3]
inevitable, necessary	<b>必然的</b> <br> ひつぜんてき <br> [sound:4c-k-必然的.mp3]
[sound:4c-s-成功は必然的です。.mp3]	<b>成功は必然的です。</b> <br> せいこうはひつぜんてきです。 <br><br> (必然的) <br> Success is inevitable.
成功は必然的です。 <br><br> (必然的)	<b>せいこうはひつぜんてきです。</b> <br> Success is inevitable. <br> [sound:4c-s-成功は必然的です。.mp3]
Success is inevitable.	<b>成功は必然的です。</b> <br> せいこうはひつぜんてきです。 <br><br> (必然的) <br> [sound:4c-s-成功は必然的です。.mp3]
[sound:4c-k-応じる.mp3]	<b>応じる</b> <br> おうじる <br> to respond, to satisfy, to accept, to comply with, to apply for
応じる	<b>おうじる</b> <br> to respond, to satisfy, to accept, to comply with, to apply for <br> [sound:4c-k-応じる.mp3]
to respond, to satisfy, to accept, to comply with, to apply for	<b>応じる</b> <br> おうじる <br> [sound:4c-k-応じる.mp3]
[sound:4c-s-リクエストに応じます。.mp3]	<b>リクエストに応じます。</b> <br> リクエストにおうじます。 <br><br> (応じる) <br> I will respond to the request.
リクエストに応じます。 <br><br> (応じる)	<b>リクエストにおうじます。</b> <br> I will respond to the request. <br> [sound:4c-s-リクエストに応じます。.mp3]
I will respond to the request.	<b>リクエストに応じます。</b> <br> リクエストにおうじます。 <br><br> (応じる) <br> [sound:4c-s-リクエストに応じます。.mp3]
[sound:4c-k-対応.mp3]	<b>対応</b> <br> たいおう <br> interaction, correspondence, coping with, dealing with, support
対応	<b>たいおう</b> <br> interaction, correspondence, coping with, dealing with, support <br> [sound:4c-k-対応.mp3]
interaction, correspondence, coping with, dealing with, support	<b>対応</b> <br> たいおう <br> [sound:4c-k-対応.mp3]
[sound:4c-s-問題に迅速に対応しました。.mp3]	<b>問題に迅速に対応しました。</b> <br> もんだいにじんそくにたいおうしました。 <br><br> (対応) <br> We quickly responded to the issue.
問題に迅速に対応しました。 <br><br> (対応)	<b>もんだいにじんそくにたいおうしました。</b> <br> We quickly responded to the issue. <br> [sound:4c-s-問題に迅速に対応しました。.mp3]
We quickly responded to the issue.	<b>問題に迅速に対応しました。</b> <br> もんだいにじんそくにたいおうしました。 <br><br> (対応) <br> [sound:4c-s-問題に迅速に対応しました。.mp3]
[sound:4c-k-適応.mp3]	<b>適応</b> <br> てきおう <br> adaptation, accommodation, conformity
適応	<b>てきおう</b> <br> adaptation, accommodation, conformity <br> [sound:4c-k-適応.mp3]
adaptation, accommodation, conformity	<b>適応</b> <br> てきおう <br> [sound:4c-k-適応.mp3]
[sound:4c-s-新しい環境に適応しました。.mp3]	<b>新しい環境に適応しました。</b> <br> あたらしいかんきょうにてきおうしました。 <br><br> (適応) <br> I adapted to the new environment.
新しい環境に適応しました。 <br><br> (適応)	<b>あたらしいかんきょうにてきおうしました。</b> <br> I adapted to the new environment. <br> [sound:4c-s-新しい環境に適応しました。.mp3]
I adapted to the new environment.	<b>新しい環境に適応しました。</b> <br> あたらしいかんきょうにてきおうしました。 <br><br> (適応) <br> [sound:4c-s-新しい環境に適応しました。.mp3]
[sound:4c-k-応答.mp3]	<b>応答</b> <br> おうとう <br> reply, answer, response
応答	<b>おうとう</b> <br> reply, answer, response <br> [sound:4c-k-応答.mp3]
reply, answer, response	<b>応答</b> <br> おうとう <br> [sound:4c-k-応答.mp3]
[sound:4c-s-電話の応答がありません。.mp3]	<b>電話の応答がありません。</b> <br> でんわのおうとうがありません。 <br><br> (応答) <br> There is no response to the call.
電話の応答がありません。 <br><br> (応答)	<b>でんわのおうとうがありません。</b> <br> There is no response to the call. <br> [sound:4c-s-電話の応答がありません。.mp3]
There is no response to the call.	<b>電話の応答がありません。</b> <br> でんわのおうとうがありません。 <br><br> (応答) <br> [sound:4c-s-電話の応答がありません。.mp3]
[sound:4c-k-演説.mp3]	<b>演説</b> <br> えんぜつ <br> speech, address
演説	<b>えんぜつ</b> <br> speech, address <br> [sound:4c-k-演説.mp3]
speech, address	<b>演説</b> <br> えんぜつ <br> [sound:4c-k-演説.mp3]
[sound:4c-s-大統領が演説をしました。.mp3]	<b>大統領が演説をしました。</b> <br> だいとうりょうがえんぜつをしました。 <br><br> (演説) <br> The president gave a speech.
大統領が演説をしました。 <br><br> (演説)	<b>だいとうりょうがえんぜつをしました。</b> <br> The president gave a speech. <br> [sound:4c-s-大統領が演説をしました。.mp3]
The president gave a speech.	<b>大統領が演説をしました。</b> <br> だいとうりょうがえんぜつをしました。 <br><br> (演説) <br> [sound:4c-s-大統領が演説をしました。.mp3]
[sound:4c-k-公演.mp3]	<b>公演</b> <br> こうえん <br> public performance; sumo exhibition in a foreign country
公演	<b>こうえん</b> <br> public performance; sumo exhibition in a foreign country <br> [sound:4c-k-公演.mp3]
public performance; sumo exhibition in a foreign country	<b>公演</b> <br> こうえん <br> [sound:4c-k-公演.mp3]
[sound:4c-s-公演を見に行きました。.mp3]	<b>公演を見に行きました。</b> <br> こうえんをみにいきました。 <br><br> (公演) <br> I went to see the performance.
公演を見に行きました。 <br><br> (公演)	<b>こうえんをみにいきました。</b> <br> I went to see the performance. <br> [sound:4c-s-公演を見に行きました。.mp3]
I went to see the performance.	<b>公演を見に行きました。</b> <br> こうえんをみにいきました。 <br><br> (公演) <br> [sound:4c-s-公演を見に行きました。.mp3]
[sound:4c-k-演習.mp3]	<b>演習</b> <br> えんしゅう <br> practice, practise, exercises, manoeuvres, maneuvers, practicum
演習	<b>えんしゅう</b> <br> practice, practise, exercises, manoeuvres, maneuvers, practicum <br> [sound:4c-k-演習.mp3]
practice, practise, exercises, manoeuvres, maneuvers, practicum	<b>演習</b> <br> えんしゅう <br> [sound:4c-k-演習.mp3]
[sound:4c-s-数学の演習問題を解きました。.mp3]	<b>数学の演習問題を解きました。</b> <br> すうがくのえんしゅうもんだいをときました。 <br><br> (演習) <br> I solved the math exercises.
数学の演習問題を解きました。 <br><br> (演習)	<b>すうがくのえんしゅうもんだいをときました。</b> <br> I solved the math exercises. <br> [sound:4c-s-数学の演習問題を解きました。.mp3]
I solved the math exercises.	<b>数学の演習問題を解きました。</b> <br> すうがくのえんしゅうもんだいをときました。 <br><br> (演習) <br> [sound:4c-s-数学の演習問題を解きました。.mp3]
[sound:4c-k-主演.mp3]	<b>主演</b> <br> しゅえん <br> starring, playing the leading part
主演	<b>しゅえん</b> <br> starring, playing the leading part <br> [sound:4c-k-主演.mp3]
starring, playing the leading part	<b>主演</b> <br> しゅえん <br> [sound:4c-k-主演.mp3]
[sound:4c-s-この映画の主演は有名な俳優です。.mp3]	<b>この映画の主演は有名な俳優です。</b> <br> このえいがのしゅえんはゆうめいなはいゆうです。 <br><br> (主演) <br> The lead role in this movie is played by a famous actor.
この映画の主演は有名な俳優です。 <br><br> (主演)	<b>このえいがのしゅえんはゆうめいなはいゆうです。</b> <br> The lead role in this movie is played by a famous actor. <br> [sound:4c-s-この映画の主演は有名な俳優です。.mp3]
The lead role in this movie is played by a famous actor.	<b>この映画の主演は有名な俳優です。</b> <br> このえいがのしゅえんはゆうめいなはいゆうです。 <br><br> (主演) <br> [sound:4c-s-この映画の主演は有名な俳優です。.mp3]
[sound:4c-k-電話.mp3]	<b>電話</b> <br> でんわ <br> telephone
電話	<b>でんわ</b> <br> telephone <br> [sound:4c-k-電話.mp3]
telephone	<b>電話</b> <br> でんわ <br> [sound:4c-k-電話.mp3]
[sound:4c-s-友達に電話しました。.mp3]	<b>友達に電話しました。</b> <br> ともだちにでんわしました。 <br><br> (電話) <br> I called my friend.
友達に電話しました。 <br><br> (電話)	<b>ともだちにでんわしました。</b> <br> I called my friend. <br> [sound:4c-s-友達に電話しました。.mp3]
I called my friend.	<b>友達に電話しました。</b> <br> ともだちにでんわしました。 <br><br> (電話) <br> [sound:4c-s-友達に電話しました。.mp3]
[sound:4c-k-電気.mp3]	<b>電気</b> <br> でんき <br> electricity; (electric) light
電気	<b>でんき</b> <br> electricity; (electric) light <br> [sound:4c-k-電気.mp3]
electricity; (electric) light	<b>電気</b> <br> でんき <br> [sound:4c-k-電気.mp3]
[sound:4c-s-電気をつけてください。.mp3]	<b>電気をつけてください。</b> <br> でんきをつけてください。 <br><br> (電気) <br> Please turn on the lights.
電気をつけてください。 <br><br> (電気)	<b>でんきをつけてください。</b> <br> Please turn on the lights. <br> [sound:4c-s-電気をつけてください。.mp3]
Please turn on the lights.	<b>電気をつけてください。</b> <br> でんきをつけてください。 <br><br> (電気) <br> [sound:4c-s-電気をつけてください。.mp3]
[sound:4c-k-発電.mp3]	<b>発電</b> <br> はつでん <br> generation (e.g. power)
発電	<b>はつでん</b> <br> generation (e.g. power) <br> [sound:4c-k-発電.mp3]
generation (e.g. power)	<b>発電</b> <br> はつでん <br> [sound:4c-k-発電.mp3]
[sound:4c-s-風力発電が注目されています。.mp3]	<b>風力発電が注目されています。</b> <br> ふうりょくはつでんがちゅうもくされています。 <br><br> (発電) <br> Wind power generation is gaining attention.
風力発電が注目されています。 <br><br> (発電)	<b>ふうりょくはつでんがちゅうもくされています。</b> <br> Wind power generation is gaining attention. <br> [sound:4c-s-風力発電が注目されています。.mp3]
Wind power generation is gaining attention.	<b>風力発電が注目されています。</b> <br> ふうりょくはつでんがちゅうもくされています。 <br><br> (発電) <br> [sound:4c-s-風力発電が注目されています。.mp3]
[sound:4c-k-発電所.mp3]	<b>発電所</b> <br> はつでんしょ <br> power plant, power station
発電所	<b>はつでんしょ</b> <br> power plant, power station <br> [sound:4c-k-発電所.mp3]
power plant, power station	<b>発電所</b> <br> はつでんしょ <br> [sound:4c-k-発電所.mp3]
[sound:4c-s-新しい発電所が建設されています。.mp3]	<b>新しい発電所が建設されています。</b> <br> あたらしいはつでんしょがけんせつされています。 <br><br> (発電所) <br> A new power plant is being constructed.
新しい発電所が建設されています。 <br><br> (発電所)	<b>あたらしいはつでんしょがけんせつされています。</b> <br> A new power plant is being constructed. <br> [sound:4c-s-新しい発電所が建設されています。.mp3]
A new power plant is being constructed.	<b>新しい発電所が建設されています。</b> <br> あたらしいはつでんしょがけんせつされています。 <br><br> (発電所) <br> [sound:4c-s-新しい発電所が建設されています。.mp3]
[sound:4c-k-歳出.mp3]	<b>歳出</b> <br> さいしゅつ <br> annual expenditure
歳出	<b>さいしゅつ</b> <br> annual expenditure <br> [sound:4c-k-歳出.mp3]
annual expenditure	<b>歳出</b> <br> さいしゅつ <br> [sound:4c-k-歳出.mp3]
[sound:4c-s-政府の歳出を削減します。.mp3]	<b>政府の歳出を削減します。</b> <br> せいふのさいしゅつをさくげんします。 <br><br> (歳出) <br> The government will reduce expenditures.
政府の歳出を削減します。 <br><br> (歳出)	<b>せいふのさいしゅつをさくげんします。</b> <br> The government will reduce expenditures. <br> [sound:4c-s-政府の歳出を削減します。.mp3]
The government will reduce expenditures.	<b>政府の歳出を削減します。</b> <br> せいふのさいしゅつをさくげんします。 <br><br> (歳出) <br> [sound:4c-s-政府の歳出を削減します。.mp3]
[sound:4c-k-歳入.mp3]	<b>歳入</b> <br> さいにゅう <br> annual revenue or income
歳入	<b>さいにゅう</b> <br> annual revenue or income <br> [sound:4c-k-歳入.mp3]
annual revenue or income	<b>歳入</b> <br> さいにゅう <br> [sound:4c-k-歳入.mp3]
[sound:4c-s-歳入が増加しました。.mp3]	<b>歳入が増加しました。</b> <br> さいにゅうがぞうかしました。 <br><br> (歳入) <br> Revenue has increased.
歳入が増加しました。 <br><br> (歳入)	<b>さいにゅうがぞうかしました。</b> <br> Revenue has increased. <br> [sound:4c-s-歳入が増加しました。.mp3]
Revenue has increased.	<b>歳入が増加しました。</b> <br> さいにゅうがぞうかしました。 <br><br> (歳入) <br> [sound:4c-s-歳入が増加しました。.mp3]
[sound:4c-k-歳末.mp3]	<b>歳末</b> <br> さいまつ <br> year end
歳末	<b>さいまつ</b> <br> year end <br> [sound:4c-k-歳末.mp3]
year end	<b>歳末</b> <br> さいまつ <br> [sound:4c-k-歳末.mp3]
[sound:4c-s-歳末のセールが始まりました。.mp3]	<b>歳末のセールが始まりました。</b> <br> さいまつのセールがはじまりました。 <br><br> (歳末) <br> End-of-year sales have begun.
歳末のセールが始まりました。 <br><br> (歳末)	<b>さいまつのセールがはじまりました。</b> <br> End-of-year sales have begun. <br> [sound:4c-s-歳末のセールが始まりました。.mp3]
End-of-year sales have begun.	<b>歳末のセールが始まりました。</b> <br> さいまつのセールがはじまりました。 <br><br> (歳末) <br> [sound:4c-s-歳末のセールが始まりました。.mp3]
[sound:4c-k-歳時記.mp3]	<b>歳時記</b> <br> さいじき <br> almanac of seasonal words (for haiku poets)
歳時記	<b>さいじき</b> <br> almanac of seasonal words (for haiku poets) <br> [sound:4c-k-歳時記.mp3]
almanac of seasonal words (for haiku poets)	<b>歳時記</b> <br> さいじき <br> [sound:4c-k-歳時記.mp3]
[sound:4c-s-歳時記を読んでいます。.mp3]	<b>歳時記を読んでいます。</b> <br> さいじきをよんでいます。 <br><br> (歳時記) <br> I am reading a seasonal almanac.
歳時記を読んでいます。 <br><br> (歳時記)	<b>さいじきをよんでいます。</b> <br> I am reading a seasonal almanac. <br> [sound:4c-s-歳時記を読んでいます。.mp3]
I am reading a seasonal almanac.	<b>歳時記を読んでいます。</b> <br> さいじきをよんでいます。 <br><br> (歳時記) <br> [sound:4c-s-歳時記を読んでいます。.mp3]
[sound:4c-k-住.mp3]	<b>住</b> <br> じゅう <br> dwelling, living
住	<b>じゅう</b> <br> dwelling, living <br> [sound:4c-k-住.mp3]
dwelling, living	<b>住</b> <br> じゅう <br> [sound:4c-k-住.mp3]
[sound:4c-s-この町に住んでいます。.mp3]	<b>この町に住んでいます。</b> <br> このまちにすんでいます。 <br><br> (住) <br> I live in this town.
この町に住んでいます。 <br><br> (住)	<b>このまちにすんでいます。</b> <br> I live in this town. <br> [sound:4c-s-この町に住んでいます。.mp3]
I live in this town.	<b>この町に住んでいます。</b> <br> このまちにすんでいます。 <br><br> (住) <br> [sound:4c-s-この町に住んでいます。.mp3]
[sound:4c-k-住宅.mp3]	<b>住宅</b> <br> じゅうたく <br> residence, housing, residential building
住宅	<b>じゅうたく</b> <br> residence, housing, residential building <br> [sound:4c-k-住宅.mp3]
residence, housing, residential building	<b>住宅</b> <br> じゅうたく <br> [sound:4c-k-住宅.mp3]
[sound:4c-s-新しい住宅を購入しました。.mp3]	<b>新しい住宅を購入しました。</b> <br> あたらしいじゅうたくをこうにゅうしました。 <br><br> (住宅) <br> I bought a new house.
新しい住宅を購入しました。 <br><br> (住宅)	<b>あたらしいじゅうたくをこうにゅうしました。</b> <br> I bought a new house. <br> [sound:4c-s-新しい住宅を購入しました。.mp3]
I bought a new house.	<b>新しい住宅を購入しました。</b> <br> あたらしいじゅうたくをこうにゅうしました。 <br><br> (住宅) <br> [sound:4c-s-新しい住宅を購入しました。.mp3]
[sound:4c-k-住宅地.mp3]	<b>住宅地</b> <br> じゅうたくち <br> housing district, residential district
住宅地	<b>じゅうたくち</b> <br> housing district, residential district <br> [sound:4c-k-住宅地.mp3]
housing district, residential district	<b>住宅地</b> <br> じゅうたくち <br> [sound:4c-k-住宅地.mp3]
[sound:4c-s-この住宅地は静かです。.mp3]	<b>この住宅地は静かです。</b> <br> このじゅうたくちはしずかです。 <br><br> (住宅地) <br> This residential area is quiet.
この住宅地は静かです。 <br><br> (住宅地)	<b>このじゅうたくちはしずかです。</b> <br> This residential area is quiet. <br> [sound:4c-s-この住宅地は静かです。.mp3]
This residential area is quiet.	<b>この住宅地は静かです。</b> <br> このじゅうたくちはしずかです。 <br><br> (住宅地) <br> [sound:4c-s-この住宅地は静かです。.mp3]
[sound:4c-k-住友.mp3]	<b>住友</b> <br> すみとも <br> Sumitomo (company)
住友	<b>すみとも</b> <br> Sumitomo (company) <br> [sound:4c-k-住友.mp3]
Sumitomo (company)	<b>住友</b> <br> すみとも <br> [sound:4c-k-住友.mp3]
[sound:4c-s-住友銀行で口座を開設しました。.mp3]	<b>住友銀行で口座を開設しました。</b> <br> すみともぎんこうでこうざをかいせつしました。 <br><br> (住友) <br> I opened an account at Sumitomo Bank.
住友銀行で口座を開設しました。 <br><br> (住友)	<b>すみともぎんこうでこうざをかいせつしました。</b> <br> I opened an account at Sumitomo Bank. <br> [sound:4c-s-住友銀行で口座を開設しました。.mp3]
I opened an account at Sumitomo Bank.	<b>住友銀行で口座を開設しました。</b> <br> すみともぎんこうでこうざをかいせつしました。 <br><br> (住友) <br> [sound:4c-s-住友銀行で口座を開設しました。.mp3]
[sound:4c-k-争い.mp3]	<b>争い</b> <br> あらそい <br> dispute, strife, quarrel, dissension, conflict, rivalry, contest
争い	<b>あらそい</b> <br> dispute, strife, quarrel, dissension, conflict, rivalry, contest <br> [sound:4c-k-争い.mp3]
dispute, strife, quarrel, dissension, conflict, rivalry, contest	<b>争い</b> <br> あらそい <br> [sound:4c-k-争い.mp3]
[sound:4c-s-彼らの間で争いが起こりました。.mp3]	<b>彼らの間で争いが起こりました。</b> <br> かれらのあいだであらそいがおこりました。 <br><br> (争い) <br> A conflict arose between them.
彼らの間で争いが起こりました。 <br><br> (争い)	<b>かれらのあいだであらそいがおこりました。</b> <br> A conflict arose between them. <br> [sound:4c-s-彼らの間で争いが起こりました。.mp3]
A conflict arose between them.	<b>彼らの間で争いが起こりました。</b> <br> かれらのあいだであらそいがおこりました。 <br><br> (争い) <br> [sound:4c-s-彼らの間で争いが起こりました。.mp3]
[sound:4c-k-戦争.mp3]	<b>戦争</b> <br> せんそう <br> war
戦争	<b>せんそう</b> <br> war <br> [sound:4c-k-戦争.mp3]
war	<b>戦争</b> <br> せんそう <br> [sound:4c-k-戦争.mp3]
[sound:4c-s-戦争は悲劇を生みます。.mp3]	<b>戦争は悲劇を生みます。</b> <br> せんそうはひげきをうみます。 <br><br> (戦争) <br> War brings tragedy.
戦争は悲劇を生みます。 <br><br> (戦争)	<b>せんそうはひげきをうみます。</b> <br> War brings tragedy. <br> [sound:4c-s-戦争は悲劇を生みます。.mp3]
War brings tragedy.	<b>戦争は悲劇を生みます。</b> <br> せんそうはひげきをうみます。 <br><br> (戦争) <br> [sound:4c-s-戦争は悲劇を生みます。.mp3]
[sound:4c-k-争う.mp3]	<b>争う</b> <br> あらそう <br> to compete, to contest, to contend; to quarrel, to argue, to dispute, to be at variance, to oppose; (usu. in negative form) to deny (e.g. evidence)
争う	<b>あらそう</b> <br> to compete, to contest, to contend; to quarrel, to argue, to dispute, to be at variance, to oppose; (usu. in negative form) to deny (e.g. evidence) <br> [sound:4c-k-争う.mp3]
to compete, to contest, to contend; to quarrel, to argue, to dispute, to be at variance, to oppose; (usu. in negative form) to deny (e.g. evidence)	<b>争う</b> <br> あらそう <br> [sound:4c-k-争う.mp3]
[sound:4c-s-彼は勝利をめざして争った。.mp3]	<b>彼は勝利をめざして争った。</b> <br> かれはしょうりをめざしてあらそった。 <br><br> (争う) <br> He fought for victory.
彼は勝利をめざして争った。 <br><br> (争う)	<b>かれはしょうりをめざしてあらそった。</b> <br> He fought for victory. <br> [sound:4c-s-彼は勝利をめざして争った。.mp3]
He fought for victory.	<b>彼は勝利をめざして争った。</b> <br> かれはしょうりをめざしてあらそった。 <br><br> (争う) <br> [sound:4c-s-彼は勝利をめざして争った。.mp3]
[sound:4c-k-太平洋戦争.mp3]	<b>太平洋戦争</b> <br> たいへいようせんそう <br> the Pacific War
太平洋戦争	<b>たいへいようせんそう</b> <br> the Pacific War <br> [sound:4c-k-太平洋戦争.mp3]
the Pacific War	<b>太平洋戦争</b> <br> たいへいようせんそう <br> [sound:4c-k-太平洋戦争.mp3]
[sound:4c-s-太平洋戦争は1941年に始まりました。.mp3]	<b>太平洋戦争は1941年に始まりました。</b> <br> たいへいようせんそうは1941ねんにはじまりました。 <br><br> (太平洋戦争) <br> The Pacific War began in 1941.
太平洋戦争は1941年に始まりました。 <br><br> (太平洋戦争)	<b>たいへいようせんそうは1941ねんにはじまりました。</b> <br> The Pacific War began in 1941. <br> [sound:4c-s-太平洋戦争は1941年に始まりました。.mp3]
The Pacific War began in 1941.	<b>太平洋戦争は1941年に始まりました。</b> <br> たいへいようせんそうは1941ねんにはじまりました。 <br><br> (太平洋戦争) <br> [sound:4c-s-太平洋戦争は1941年に始まりました。.mp3]
[sound:4c-k-会談.mp3]	<b>会談</b> <br> かいだん <br> conversation, conference, discussion, interview
会談	<b>かいだん</b> <br> conversation, conference, discussion, interview <br> [sound:4c-k-会談.mp3]
conversation, conference, discussion, interview	<b>会談</b> <br> かいだん <br> [sound:4c-k-会談.mp3]
[sound:4c-s-両国の首脳が会談を行いました。.mp3]	<b>両国の首脳が会談を行いました。</b> <br> りょうこくのしゅのうがかいだんをおこないました。 <br><br> (会談) <br> The leaders of both countries held talks.
両国の首脳が会談を行いました。 <br><br> (会談)	<b>りょうこくのしゅのうがかいだんをおこないました。</b> <br> The leaders of both countries held talks. <br> [sound:4c-s-両国の首脳が会談を行いました。.mp3]
The leaders of both countries held talks.	<b>両国の首脳が会談を行いました。</b> <br> りょうこくのしゅのうがかいだんをおこないました。 <br><br> (会談) <br> [sound:4c-s-両国の首脳が会談を行いました。.mp3]
[sound:4c-k-相談.mp3]	<b>相談</b> <br> そうだん <br> consultation, discussion
相談	<b>そうだん</b> <br> consultation, discussion <br> [sound:4c-k-相談.mp3]
consultation, discussion	<b>相談</b> <br> そうだん <br> [sound:4c-k-相談.mp3]
[sound:4c-s-問題について相談しましょう。.mp3]	<b>問題について相談しましょう。</b> <br> もんだいについてそうだんしましょう。 <br><br> (相談) <br> Let's discuss the issue.
問題について相談しましょう。 <br><br> (相談)	<b>もんだいについてそうだんしましょう。</b> <br> Let's discuss the issue. <br> [sound:4c-s-問題について相談しましょう。.mp3]
Let's discuss the issue.	<b>問題について相談しましょう。</b> <br> もんだいについてそうだんしましょう。 <br><br> (相談) <br> [sound:4c-s-問題について相談しましょう。.mp3]
[sound:4c-k-対談.mp3]	<b>対談</b> <br> たいだん <br> talk, dialogue, conversation
対談	<b>たいだん</b> <br> talk, dialogue, conversation <br> [sound:4c-k-対談.mp3]
talk, dialogue, conversation	<b>対談</b> <br> たいだん <br> [sound:4c-k-対談.mp3]
[sound:4c-s-著名な作家が対談をしました。.mp3]	<b>著名な作家が対談をしました。</b> <br> ちょめいなさっかがたいだんをしました。 <br><br> (対談) <br> A famous writer had a conversation.
著名な作家が対談をしました。 <br><br> (対談)	<b>ちょめいなさっかがたいだんをしました。</b> <br> A famous writer had a conversation. <br> [sound:4c-s-著名な作家が対談をしました。.mp3]
A famous writer had a conversation.	<b>著名な作家が対談をしました。</b> <br> ちょめいなさっかがたいだんをしました。 <br><br> (対談) <br> [sound:4c-s-著名な作家が対談をしました。.mp3]
[sound:4c-k-座談会.mp3]	<b>座談会</b> <br> ざだんかい <br> symposium, round-table discussion
座談会	<b>ざだんかい</b> <br> symposium, round-table discussion <br> [sound:4c-k-座談会.mp3]
symposium, round-table discussion	<b>座談会</b> <br> ざだんかい <br> [sound:4c-k-座談会.mp3]
[sound:4c-s-座談会で意見を交換しました。.mp3]	<b>座談会で意見を交換しました。</b> <br> ざだんかいでいけんをこうかんしました。 <br><br> (座談会) <br> We exchanged opinions at the roundtable discussion.
座談会で意見を交換しました。 <br><br> (座談会)	<b>ざだんかいでいけんをこうかんしました。</b> <br> We exchanged opinions at the roundtable discussion. <br> [sound:4c-s-座談会で意見を交換しました。.mp3]
We exchanged opinions at the roundtable discussion.	<b>座談会で意見を交換しました。</b> <br> ざだんかいでいけんをこうかんしました。 <br><br> (座談会) <br> [sound:4c-s-座談会で意見を交換しました。.mp3]
[sound:4c-k-能.mp3]	<b>能</b> <br> のう <br> talent, gift, function; noh (theatre)
能	<b>のう</b> <br> talent, gift, function; noh (theatre) <br> [sound:4c-k-能.mp3]
talent, gift, function; noh (theatre)	<b>能</b> <br> のう <br> [sound:4c-k-能.mp3]
[sound:4c-s-彼は能の公演を観ました。.mp3]	<b>彼は能の公演を観ました。</b> <br> かれはのうのこうえんをみました。 <br><br> (能) <br> He watched a Noh theater performance.
彼は能の公演を観ました。 <br><br> (能)	<b>かれはのうのこうえんをみました。</b> <br> He watched a Noh theater performance. <br> [sound:4c-s-彼は能の公演を観ました。.mp3]
He watched a Noh theater performance.	<b>彼は能の公演を観ました。</b> <br> かれはのうのこうえんをみました。 <br><br> (能) <br> [sound:4c-s-彼は能の公演を観ました。.mp3]
[sound:4c-k-可能.mp3]	<b>可能</b> <br> かのう <br> possible, practicable, feasible
可能	<b>かのう</b> <br> possible, practicable, feasible <br> [sound:4c-k-可能.mp3]
possible, practicable, feasible	<b>可能</b> <br> かのう <br> [sound:4c-k-可能.mp3]
[sound:4c-s-それは可能な計画です。.mp3]	<b>それは可能な計画です。</b> <br> それはかのうなけいかくです。 <br><br> (可能) <br> That is a feasible plan.
それは可能な計画です。 <br><br> (可能)	<b>それはかのうなけいかくです。</b> <br> That is a feasible plan. <br> [sound:4c-s-それは可能な計画です。.mp3]
That is a feasible plan.	<b>それは可能な計画です。</b> <br> それはかのうなけいかくです。 <br><br> (可能) <br> [sound:4c-s-それは可能な計画です。.mp3]
[sound:4c-k-才能.mp3]	<b>才能</b> <br> さいのう <br> talent, ability
才能	<b>さいのう</b> <br> talent, ability <br> [sound:4c-k-才能.mp3]
talent, ability	<b>才能</b> <br> さいのう <br> [sound:4c-k-才能.mp3]
[sound:4c-s-彼には音楽の才能があります。.mp3]	<b>彼には音楽の才能があります。</b> <br> かれにはおんがくのさいのうがあります。 <br><br> (才能) <br> He has a talent for music.
彼には音楽の才能があります。 <br><br> (才能)	<b>かれにはおんがくのさいのうがあります。</b> <br> He has a talent for music. <br> [sound:4c-s-彼には音楽の才能があります。.mp3]
He has a talent for music.	<b>彼には音楽の才能があります。</b> <br> かれにはおんがくのさいのうがあります。 <br><br> (才能) <br> [sound:4c-s-彼には音楽の才能があります。.mp3]
[sound:4c-k-性能.mp3]	<b>性能</b> <br> せいのう <br> ability, performance, efficiency
性能	<b>せいのう</b> <br> ability, performance, efficiency <br> [sound:4c-k-性能.mp3]
ability, performance, efficiency	<b>性能</b> <br> せいのう <br> [sound:4c-k-性能.mp3]
[sound:4c-s-この車の性能は高いです。.mp3]	<b>この車の性能は高いです。</b> <br> このくるまのせいのうはたかいです。 <br><br> (性能) <br> This car has high performance.
この車の性能は高いです。 <br><br> (性能)	<b>このくるまのせいのうはたかいです。</b> <br> This car has high performance. <br> [sound:4c-s-この車の性能は高いです。.mp3]
This car has high performance.	<b>この車の性能は高いです。</b> <br> このくるまのせいのうはたかいです。 <br><br> (性能) <br> [sound:4c-s-この車の性能は高いです。.mp3]
[sound:4c-k-無料.mp3]	<b>無料</b> <br> むりょう <br> free, no charge
無料	<b>むりょう</b> <br> free, no charge <br> [sound:4c-k-無料.mp3]
free, no charge	<b>無料</b> <br> むりょう <br> [sound:4c-k-無料.mp3]
[sound:4c-s-このアプリは無料で使えます。.mp3]	<b>このアプリは無料で使えます。</b> <br> このアプリはむりょうでつかえます。 <br><br> (無料) <br> This app can be used for free.
このアプリは無料で使えます。 <br><br> (無料)	<b>このアプリはむりょうでつかえます。</b> <br> This app can be used for free. <br> [sound:4c-s-このアプリは無料で使えます。.mp3]
This app can be used for free.	<b>このアプリは無料で使えます。</b> <br> このアプリはむりょうでつかえます。 <br><br> (無料) <br> [sound:4c-s-このアプリは無料で使えます。.mp3]
[sound:4c-k-無職.mp3]	<b>無職</b> <br> むしょく <br> without an occupation
無職	<b>むしょく</b> <br> without an occupation <br> [sound:4c-k-無職.mp3]
without an occupation	<b>無職</b> <br> むしょく <br> [sound:4c-k-無職.mp3]
[sound:4c-s-彼は現在無職です。.mp3]	<b>彼は現在無職です。</b> <br> かれはげんざいむしょくです。 <br><br> (無職) <br> He is currently unemployed.
彼は現在無職です。 <br><br> (無職)	<b>かれはげんざいむしょくです。</b> <br> He is currently unemployed. <br> [sound:4c-s-彼は現在無職です。.mp3]
He is currently unemployed.	<b>彼は現在無職です。</b> <br> かれはげんざいむしょくです。 <br><br> (無職) <br> [sound:4c-s-彼は現在無職です。.mp3]
[sound:4c-k-有無.mp3]	<b>有無</b> <br> うむ, ゆうむ <br> existence or nonexistence, presence or absence; consent or refusal, yes or no; flag indicator, presence or absence marker
有無	<b>うむ, ゆうむ</b> <br> existence or nonexistence, presence or absence; consent or refusal, yes or no; flag indicator, presence or absence marker <br> [sound:4c-k-有無.mp3]
existence or nonexistence, presence or absence; consent or refusal, yes or no; flag indicator, presence or absence marker	<b>有無</b> <br> うむ, ゆうむ <br> [sound:4c-k-有無.mp3]
[sound:4c-s-経験の有無は問いません。.mp3]	<b>経験の有無は問いません。</b> <br> けいけんのうむはといません。 <br><br> (有無) <br> Experience is not required.
経験の有無は問いません。 <br><br> (有無)	<b>けいけんのうむはといません。</b> <br> Experience is not required. <br> [sound:4c-s-経験の有無は問いません。.mp3]
Experience is not required.	<b>経験の有無は問いません。</b> <br> けいけんのうむはといません。 <br><br> (有無) <br> [sound:4c-s-経験の有無は問いません。.mp3]
[sound:4c-k-無死.mp3]	<b>無死</b> <br> むし <br> baseball with no outs
無死	<b>むし</b> <br> baseball with no outs <br> [sound:4c-k-無死.mp3]
baseball with no outs	<b>無死</b> <br> むし <br> [sound:4c-k-無死.mp3]
[sound:4c-s-無死の状態で試合が進みました。.mp3]	<b>無死の状態で試合が進みました。</b> <br> むしのじょうたいでしあいがすすみました。 <br><br> (無死) <br> The game continued with no outs.
無死の状態で試合が進みました。 <br><br> (無死)	<b>むしのじょうたいでしあいがすすみました。</b> <br> The game continued with no outs. <br> [sound:4c-s-無死の状態で試合が進みました。.mp3]
The game continued with no outs.	<b>無死の状態で試合が進みました。</b> <br> むしのじょうたいでしあいがすすみました。 <br><br> (無死) <br> [sound:4c-s-無死の状態で試合が進みました。.mp3]
[sound:4c-k-再び.mp3]	<b>再び</b> <br> ふたたび <br> again, once more, a second time
再び	<b>ふたたび</b> <br> again, once more, a second time <br> [sound:4c-k-再び.mp3]
again, once more, a second time	<b>再び</b> <br> ふたたび <br> [sound:4c-k-再び.mp3]
[sound:4c-s-彼は再び挑戦しました。.mp3]	<b>彼は再び挑戦しました。</b> <br> かれはふたたびちょうせんしました。 <br><br> (再び) <br> He challenged himself again.
彼は再び挑戦しました。 <br><br> (再び)	<b>かれはふたたびちょうせんしました。</b> <br> He challenged himself again. <br> [sound:4c-s-彼は再び挑戦しました。.mp3]
He challenged himself again.	<b>彼は再び挑戦しました。</b> <br> かれはふたたびちょうせんしました。 <br><br> (再び) <br> [sound:4c-s-彼は再び挑戦しました。.mp3]
[sound:4c-k-再開.mp3]	<b>再開</b> <br> さいかい <br> reopening, resumption, restarting
再開	<b>さいかい</b> <br> reopening, resumption, restarting <br> [sound:4c-k-再開.mp3]
reopening, resumption, restarting	<b>再開</b> <br> さいかい <br> [sound:4c-k-再開.mp3]
[sound:4c-s-会議が再開されました。.mp3]	<b>会議が再開されました。</b> <br> かいぎがさいかいされました。 <br><br> (再開) <br> The meeting was resumed.
会議が再開されました。 <br><br> (再開)	<b>かいぎがさいかいされました。</b> <br> The meeting was resumed. <br> [sound:4c-s-会議が再開されました。.mp3]
The meeting was resumed.	<b>会議が再開されました。</b> <br> かいぎがさいかいされました。 <br><br> (再開) <br> [sound:4c-s-会議が再開されました。.mp3]
[sound:4c-k-再検討.mp3]	<b>再検討</b> <br> さいけんとう <br> re-examination, review, reappraisal
再検討	<b>さいけんとう</b> <br> re-examination, review, reappraisal <br> [sound:4c-k-再検討.mp3]
re-examination, review, reappraisal	<b>再検討</b> <br> さいけんとう <br> [sound:4c-k-再検討.mp3]
[sound:4c-s-計画を再検討します。.mp3]	<b>計画を再検討します。</b> <br> けいかくをさいけんとうします。 <br><br> (再検討) <br> We will reconsider the plan.
計画を再検討します。 <br><br> (再検討)	<b>けいかくをさいけんとうします。</b> <br> We will reconsider the plan. <br> [sound:4c-s-計画を再検討します。.mp3]
We will reconsider the plan.	<b>計画を再検討します。</b> <br> けいかくをさいけんとうします。 <br><br> (再検討) <br> [sound:4c-s-計画を再検討します。.mp3]
[sound:4c-k-再度.mp3]	<b>再度</b> <br> さいど <br> twice, again, second time
再度	<b>さいど</b> <br> twice, again, second time <br> [sound:4c-k-再度.mp3]
twice, again, second time	<b>再度</b> <br> さいど <br> [sound:4c-k-再度.mp3]
[sound:4c-s-再度挑戦してみます。.mp3]	<b>再度挑戦してみます。</b> <br> さいどちょうせんしてみます。 <br><br> (再度) <br> I will try again.
再度挑戦してみます。 <br><br> (再度)	<b>さいどちょうせんしてみます。</b> <br> I will try again. <br> [sound:4c-s-再度挑戦してみます。.mp3]
I will try again.	<b>再度挑戦してみます。</b> <br> さいどちょうせんしてみます。 <br><br> (再度) <br> [sound:4c-s-再度挑戦してみます。.mp3]
[sound:4c-k-上位.mp3]	<b>上位</b> <br> じょうい <br> superior (rank not class); higher order (e.g. byte); host computer (of connected device)
上位	<b>じょうい</b> <br> superior (rank not class); higher order (e.g. byte); host computer (of connected device) <br> [sound:4c-k-上位.mp3]
superior (rank not class); higher order (e.g. byte); host computer (of connected device)	<b>上位</b> <br> じょうい <br> [sound:4c-k-上位.mp3]
[sound:4c-s-彼は上位にランクインしました。.mp3]	<b>彼は上位にランクインしました。</b> <br> かれはじょういにランクインしました。 <br><br> (上位) <br> He ranked in the top positions.
彼は上位にランクインしました。 <br><br> (上位)	<b>かれはじょういにランクインしました。</b> <br> He ranked in the top positions. <br> [sound:4c-s-彼は上位にランクインしました。.mp3]
He ranked in the top positions.	<b>彼は上位にランクインしました。</b> <br> かれはじょういにランクインしました。 <br><br> (上位) <br> [sound:4c-s-彼は上位にランクインしました。.mp3]
[sound:4c-k-単位.mp3]	<b>単位</b> <br> たんい <br> unit, denomination; credit (in school)
単位	<b>たんい</b> <br> unit, denomination; credit (in school) <br> [sound:4c-k-単位.mp3]
unit, denomination; credit (in school)	<b>単位</b> <br> たんい <br> [sound:4c-k-単位.mp3]
[sound:4c-s-この科目の単位を取得しました。.mp3]	<b>この科目の単位を取得しました。</b> <br> このかもくのたんいをしゅとくしました。 <br><br> (単位) <br> I earned credits for this subject.
この科目の単位を取得しました。 <br><br> (単位)	<b>このかもくのたんいをしゅとくしました。</b> <br> I earned credits for this subject. <br> [sound:4c-s-この科目の単位を取得しました。.mp3]
I earned credits for this subject.	<b>この科目の単位を取得しました。</b> <br> このかもくのたんいをしゅとくしました。 <br><br> (単位) <br> [sound:4c-s-この科目の単位を取得しました。.mp3]
[sound:4c-k-本位.mp3]	<b>本位</b> <br> ほんい <br> standard, basis, principle
本位	<b>ほんい</b> <br> standard, basis, principle <br> [sound:4c-k-本位.mp3]
standard, basis, principle	<b>本位</b> <br> ほんい <br> [sound:4c-k-本位.mp3]
[sound:4c-s-彼の考えは利益本位です。.mp3]	<b>彼の考えは利益本位です。</b> <br> かれのかんがえはりえきほんいです。 <br><br> (本位) <br> His thinking is profit-oriented.
彼の考えは利益本位です。 <br><br> (本位)	<b>かれのかんがえはりえきほんいです。</b> <br> His thinking is profit-oriented. <br> [sound:4c-s-彼の考えは利益本位です。.mp3]
His thinking is profit-oriented.	<b>彼の考えは利益本位です。</b> <br> かれのかんがえはりえきほんいです。 <br><br> (本位) <br> [sound:4c-s-彼の考えは利益本位です。.mp3]
[sound:4c-k-優位.mp3]	<b>優位</b> <br> ゆうい <br> predominance, ascendancy, superiority
優位	<b>ゆうい</b> <br> predominance, ascendancy, superiority <br> [sound:4c-k-優位.mp3]
predominance, ascendancy, superiority	<b>優位</b> <br> ゆうい <br> [sound:4c-k-優位.mp3]
[sound:4c-s-この技術は優位にあります。.mp3]	<b>この技術は優位にあります。</b> <br> このぎじゅつはゆういにあります。 <br><br> (優位) <br> This technology has an advantage.
この技術は優位にあります。 <br><br> (優位)	<b>このぎじゅつはゆういにあります。</b> <br> This technology has an advantage. <br> [sound:4c-s-この技術は優位にあります。.mp3]
This technology has an advantage.	<b>この技術は優位にあります。</b> <br> このぎじゅつはゆういにあります。 <br><br> (優位) <br> [sound:4c-s-この技術は優位にあります。.mp3]
[sound:4c-k-措置.mp3]	<b>措置</b> <br> そち <br> measure, step
措置	<b>そち</b> <br> measure, step <br> [sound:4c-k-措置.mp3]
measure, step	<b>措置</b> <br> そち <br> [sound:4c-k-措置.mp3]
[sound:4c-s-政府は特別な措置を講じました。.mp3]	<b>政府は特別な措置を講じました。</b> <br> せいふはとくべつなそちをこうじました。 <br><br> (措置) <br> The government took special measures.
政府は特別な措置を講じました。 <br><br> (措置)	<b>せいふはとくべつなそちをこうじました。</b> <br> The government took special measures. <br> [sound:4c-s-政府は特別な措置を講じました。.mp3]
The government took special measures.	<b>政府は特別な措置を講じました。</b> <br> せいふはとくべつなそちをこうじました。 <br><br> (措置) <br> [sound:4c-s-政府は特別な措置を講じました。.mp3]
[sound:4c-k-設置.mp3]	<b>設置</b> <br> せっち <br> establishment, institution
設置	<b>せっち</b> <br> establishment, institution <br> [sound:4c-k-設置.mp3]
establishment, institution	<b>設置</b> <br> せっち <br> [sound:4c-k-設置.mp3]
[sound:4c-s-新しい機械が設置されました。.mp3]	<b>新しい機械が設置されました。</b> <br> あたらしいきかいがせっちされました。 <br><br> (設置) <br> A new machine has been installed.
新しい機械が設置されました。 <br><br> (設置)	<b>あたらしいきかいがせっちされました。</b> <br> A new machine has been installed. <br> [sound:4c-s-新しい機械が設置されました。.mp3]
A new machine has been installed.	<b>新しい機械が設置されました。</b> <br> あたらしいきかいがせっちされました。 <br><br> (設置) <br> [sound:4c-s-新しい機械が設置されました。.mp3]
[sound:4c-k-据え置き.mp3]	<b>据え置き</b> <br> すえおき <br> deferment (e.g. of savings), leaving (a thing) as it stands
据え置き	<b>すえおき</b> <br> deferment (e.g. of savings), leaving (a thing) as it stands <br> [sound:4c-k-据え置き.mp3]
deferment (e.g. of savings), leaving (a thing) as it stands	<b>据え置き</b> <br> すえおき <br> [sound:4c-k-据え置き.mp3]
[sound:4c-s-料金は据え置きです。.mp3]	<b>料金は据え置きです。</b> <br> りょうきんはすえおきです。 <br><br> (据え置き) <br> The fee remains unchanged.
料金は据え置きです。 <br><br> (据え置き)	<b>りょうきんはすえおきです。</b> <br> The fee remains unchanged. <br> [sound:4c-s-料金は据え置きです。.mp3]
The fee remains unchanged.	<b>料金は据え置きです。</b> <br> りょうきんはすえおきです。 <br><br> (据え置き) <br> [sound:4c-s-料金は据え置きです。.mp3]
[sound:4c-k-位置付け.mp3]	<b>位置付け</b> <br> いちづけ, いちつけ <br> placement, fixed position, mapping out, location
位置付け	<b>いちづけ, いちつけ</b> <br> placement, fixed position, mapping out, location <br> [sound:4c-k-位置付け.mp3]
placement, fixed position, mapping out, location	<b>位置付け</b> <br> いちづけ, いちつけ <br> [sound:4c-k-位置付け.mp3]
[sound:4c-s-このプロジェクトは重要な位置付けです。.mp3]	<b>このプロジェクトは重要な位置付けです。</b> <br> このプロジェクトはじゅうようないちづけです。 <br><br> (位置付け) <br> This project is positioned as important.
このプロジェクトは重要な位置付けです。 <br><br> (位置付け)	<b>このプロジェクトはじゅうようないちづけです。</b> <br> This project is positioned as important. <br> [sound:4c-s-このプロジェクトは重要な位置付けです。.mp3]
This project is positioned as important.	<b>このプロジェクトは重要な位置付けです。</b> <br> このプロジェクトはじゅうようないちづけです。 <br><br> (位置付け) <br> [sound:4c-s-このプロジェクトは重要な位置付けです。.mp3]
[sound:4c-k-企業.mp3]	<b>企業</b> <br> きぎょう <br> enterprise, undertaking, corporation, business
企業	<b>きぎょう</b> <br> enterprise, undertaking, corporation, business <br> [sound:4c-k-企業.mp3]
enterprise, undertaking, corporation, business	<b>企業</b> <br> きぎょう <br> [sound:4c-k-企業.mp3]
[sound:4c-s-企業の成長が期待されています。.mp3]	<b>企業の成長が期待されています。</b> <br> きぎょうのせいちょうがきたいされています。 <br><br> (企業) <br> Corporate growth is expected.
企業の成長が期待されています。 <br><br> (企業)	<b>きぎょうのせいちょうがきたいされています。</b> <br> Corporate growth is expected. <br> [sound:4c-s-企業の成長が期待されています。.mp3]
Corporate growth is expected.	<b>企業の成長が期待されています。</b> <br> きぎょうのせいちょうがきたいされています。 <br><br> (企業) <br> [sound:4c-s-企業の成長が期待されています。.mp3]
[sound:4c-k-企画.mp3]	<b>企画</b> <br> きかく <br> planning, project, plan, design
企画	<b>きかく</b> <br> planning, project, plan, design <br> [sound:4c-k-企画.mp3]
planning, project, plan, design	<b>企画</b> <br> きかく <br> [sound:4c-k-企画.mp3]
[sound:4c-s-新しい企画を考えました。.mp3]	<b>新しい企画を考えました。</b> <br> あたらしいきかくをかんがえました。 <br><br> (企画) <br> I came up with a new plan.
新しい企画を考えました。 <br><br> (企画)	<b>あたらしいきかくをかんがえました。</b> <br> I came up with a new plan. <br> [sound:4c-s-新しい企画を考えました。.mp3]
I came up with a new plan.	<b>新しい企画を考えました。</b> <br> あたらしいきかくをかんがえました。 <br><br> (企画) <br> [sound:4c-s-新しい企画を考えました。.mp3]
[sound:4c-k-私企業.mp3]	<b>私企業</b> <br> しきぎょう <br> private enterprise
私企業	<b>しきぎょう</b> <br> private enterprise <br> [sound:4c-k-私企業.mp3]
private enterprise	<b>私企業</b> <br> しきぎょう <br> [sound:4c-k-私企業.mp3]
[sound:4c-s-彼は私企業を経営しています。.mp3]	<b>彼は私企業を経営しています。</b> <br> かれはしきぎょうをけいえいしています。 <br><br> (私企業) <br> He runs a private company.
彼は私企業を経営しています。 <br><br> (私企業)	<b>かれはしきぎょうをけいえいしています。</b> <br> He runs a private company. <br> [sound:4c-s-彼は私企業を経営しています。.mp3]
He runs a private company.	<b>彼は私企業を経営しています。</b> <br> かれはしきぎょうをけいえいしています。 <br><br> (私企業) <br> [sound:4c-s-彼は私企業を経営しています。.mp3]
[sound:4c-k-中小企業庁.mp3]	<b>中小企業庁</b> <br> ちゅうしょうきぎょうちょう <br> (Japanese) Small and Medium Enterprise Agency
中小企業庁	<b>ちゅうしょうきぎょうちょう</b> <br> (Japanese) Small and Medium Enterprise Agency <br> [sound:4c-k-中小企業庁.mp3]
(Japanese) Small and Medium Enterprise Agency	<b>中小企業庁</b> <br> ちゅうしょうきぎょうちょう <br> [sound:4c-k-中小企業庁.mp3]
[sound:4c-s-中小企業庁の支援を受けました。.mp3]	<b>中小企業庁の支援を受けました。</b> <br> ちゅうしょうきぎょうちょうのしえんをうけました。 <br><br> (中小企業庁) <br> I received support from the Small and Medium Enterprise Agency.
中小企業庁の支援を受けました。 <br><br> (中小企業庁)	<b>ちゅうしょうきぎょうちょうのしえんをうけました。</b> <br> I received support from the Small and Medium Enterprise Agency. <br> [sound:4c-s-中小企業庁の支援を受けました。.mp3]
I received support from the Small and Medium Enterprise Agency.	<b>中小企業庁の支援を受けました。</b> <br> ちゅうしょうきぎょうちょうのしえんをうけました。 <br><br> (中小企業庁) <br> [sound:4c-s-中小企業庁の支援を受けました。.mp3]
[sound:4c-k-写真.mp3]	<b>写真</b> <br> しゃしん <br> photograph, photo; movie
写真	<b>しゃしん</b> <br> photograph, photo; movie <br> [sound:4c-k-写真.mp3]
photograph, photo; movie	<b>写真</b> <br> しゃしん <br> [sound:4c-k-写真.mp3]
[sound:4c-s-旅行の写真を撮りました。.mp3]	<b>旅行の写真を撮りました。</b> <br> りょこうのしゃしんをとりました。 <br><br> (写真) <br> I took pictures during the trip.
旅行の写真を撮りました。 <br><br> (写真)	<b>りょこうのしゃしんをとりました。</b> <br> I took pictures during the trip. <br> [sound:4c-s-旅行の写真を撮りました。.mp3]
I took pictures during the trip.	<b>旅行の写真を撮りました。</b> <br> りょこうのしゃしんをとりました。 <br><br> (写真) <br> [sound:4c-s-旅行の写真を撮りました。.mp3]
[sound:4c-k-真の.mp3]	<b>真の</b> <br> しんの <br> true, real, genuine, proper, utter
真の	<b>しんの</b> <br> true, real, genuine, proper, utter <br> [sound:4c-k-真の.mp3]
true, real, genuine, proper, utter	<b>真の</b> <br> しんの <br> [sound:4c-k-真の.mp3]
[sound:4c-s-彼は真のリーダーです。.mp3]	<b>彼は真のリーダーです。</b> <br> かれはしんのリーダーです。 <br><br> (真の) <br> He is a true leader.
彼は真のリーダーです。 <br><br> (真の)	<b>かれはしんのリーダーです。</b> <br> He is a true leader. <br> [sound:4c-s-彼は真のリーダーです。.mp3]
He is a true leader.	<b>彼は真のリーダーです。</b> <br> かれはしんのリーダーです。 <br><br> (真の) <br> [sound:4c-s-彼は真のリーダーです。.mp3]
[sound:4c-k-真っ暗.mp3]	<b>真っ暗</b> <br> まっくら <br> total darkness, pitch dark; bleak future, poor prospects
真っ暗	<b>まっくら</b> <br> total darkness, pitch dark; bleak future, poor prospects <br> [sound:4c-k-真っ暗.mp3]
total darkness, pitch dark; bleak future, poor prospects	<b>真っ暗</b> <br> まっくら <br> [sound:4c-k-真っ暗.mp3]
[sound:4c-s-部屋が真っ暗です。.mp3]	<b>部屋が真っ暗です。</b> <br> へやがまっくらです。 <br><br> (真っ暗) <br> The room is completely dark.
部屋が真っ暗です。 <br><br> (真っ暗)	<b>へやがまっくらです。</b> <br> The room is completely dark. <br> [sound:4c-s-部屋が真っ暗です。.mp3]
The room is completely dark.	<b>部屋が真っ暗です。</b> <br> へやがまっくらです。 <br><br> (真っ暗) <br> [sound:4c-s-部屋が真っ暗です。.mp3]
[sound:4c-k-真珠湾.mp3]	<b>真珠湾</b> <br> しんじゅわん <br> Pearl Harbor
真珠湾	<b>しんじゅわん</b> <br> Pearl Harbor <br> [sound:4c-k-真珠湾.mp3]
Pearl Harbor	<b>真珠湾</b> <br> しんじゅわん <br> [sound:4c-k-真珠湾.mp3]
[sound:4c-s-真珠湾攻撃は1941年でした。.mp3]	<b>真珠湾攻撃は1941年でした。</b> <br> しんじゅわんこうげきは1941ねんでした。 <br><br> (真珠湾) <br> The attack on Pearl Harbor was in 1941.
真珠湾攻撃は1941年でした。 <br><br> (真珠湾)	<b>しんじゅわんこうげきは1941ねんでした。</b> <br> The attack on Pearl Harbor was in 1941. <br> [sound:4c-s-真珠湾攻撃は1941年でした。.mp3]
The attack on Pearl Harbor was in 1941.	<b>真珠湾攻撃は1941年でした。</b> <br> しんじゅわんこうげきは1941ねんでした。 <br><br> (真珠湾) <br> [sound:4c-s-真珠湾攻撃は1941年でした。.mp3]
[sound:4c-k-流れ.mp3]	<b>流れ</b> <br> ながれ <br> stream, current, flow
流れ	<b>ながれ</b> <br> stream, current, flow <br> [sound:4c-k-流れ.mp3]
stream, current, flow	<b>流れ</b> <br> ながれ <br> [sound:4c-k-流れ.mp3]
[sound:4c-s-川の流れが速いです。.mp3]	<b>川の流れが速いです。</b> <br> かわのながれがはやいです。 <br><br> (流れ) <br> The river current is fast.
川の流れが速いです。 <br><br> (流れ)	<b>かわのながれがはやいです。</b> <br> The river current is fast. <br> [sound:4c-s-川の流れが速いです。.mp3]
The river current is fast.	<b>川の流れが速いです。</b> <br> かわのながれがはやいです。 <br><br> (流れ) <br> [sound:4c-s-川の流れが速いです。.mp3]
[sound:4c-k-交流.mp3]	<b>交流</b> <br> こうりゅう <br> intercourse, (cultural) exchange, intermingling; alternating current, AC
交流	<b>こうりゅう</b> <br> intercourse, (cultural) exchange, intermingling; alternating current, AC <br> [sound:4c-k-交流.mp3]
intercourse, (cultural) exchange, intermingling; alternating current, AC	<b>交流</b> <br> こうりゅう <br> [sound:4c-k-交流.mp3]
[sound:4c-s-異文化交流が大切です。.mp3]	<b>異文化交流が大切です。</b> <br> いぶんかこうりゅうがたいせつです。 <br><br> (交流) <br> Cultural exchange is important.
異文化交流が大切です。 <br><br> (交流)	<b>いぶんかこうりゅうがたいせつです。</b> <br> Cultural exchange is important. <br> [sound:4c-s-異文化交流が大切です。.mp3]
Cultural exchange is important.	<b>異文化交流が大切です。</b> <br> いぶんかこうりゅうがたいせつです。 <br><br> (交流) <br> [sound:4c-s-異文化交流が大切です。.mp3]
[sound:4c-k-流動.mp3]	<b>流動</b> <br> りゅうどう <br> flow
流動	<b>りゅうどう</b> <br> flow <br> [sound:4c-k-流動.mp3]
flow	<b>流動</b> <br> りゅうどう <br> [sound:4c-k-流動.mp3]
[sound:4c-s-市場の流動性が高いです。.mp3]	<b>市場の流動性が高いです。</b> <br> しじょうのりゅうどうせいがたかいです。 <br><br> (流動) <br> The market liquidity is high.
市場の流動性が高いです。 <br><br> (流動)	<b>しじょうのりゅうどうせいがたかいです。</b> <br> The market liquidity is high. <br> [sound:4c-s-市場の流動性が高いです。.mp3]
The market liquidity is high.	<b>市場の流動性が高いです。</b> <br> しじょうのりゅうどうせいがたかいです。 <br><br> (流動) <br> [sound:4c-s-市場の流動性が高いです。.mp3]
[sound:4c-k-火砕流.mp3]	<b>火砕流</b> <br> かさいりゅう <br> pyroclastic flow (type of volcanic eruption), stone wind
火砕流	<b>かさいりゅう</b> <br> pyroclastic flow (type of volcanic eruption), stone wind <br> [sound:4c-k-火砕流.mp3]
pyroclastic flow (type of volcanic eruption), stone wind	<b>火砕流</b> <br> かさいりゅう <br> [sound:4c-k-火砕流.mp3]
[sound:4c-s-火砕流が発生しました。.mp3]	<b>火砕流が発生しました。</b> <br> かさいりゅうがはっせいしました。 <br><br> (火砕流) <br> A pyroclastic flow occurred.
火砕流が発生しました。 <br><br> (火砕流)	<b>かさいりゅうがはっせいしました。</b> <br> A pyroclastic flow occurred. <br> [sound:4c-s-火砕流が発生しました。.mp3]
A pyroclastic flow occurred.	<b>火砕流が発生しました。</b> <br> かさいりゅうがはっせいしました。 <br><br> (火砕流) <br> [sound:4c-s-火砕流が発生しました。.mp3]
[sound:4c-k-価格.mp3]	<b>価格</b> <br> かかく <br> price, value, cost
価格	<b>かかく</b> <br> price, value, cost <br> [sound:4c-k-価格.mp3]
price, value, cost	<b>価格</b> <br> かかく <br> [sound:4c-k-価格.mp3]
[sound:4c-s-商品の価格が改定されました。.mp3]	<b>商品の価格が改定されました。</b> <br> しょうひんのかかくがかいていされました。 <br><br> (価格) <br> The product price has been revised.
商品の価格が改定されました。 <br><br> (価格)	<b>しょうひんのかかくがかいていされました。</b> <br> The product price has been revised. <br> [sound:4c-s-商品の価格が改定されました。.mp3]
The product price has been revised.	<b>商品の価格が改定されました。</b> <br> しょうひんのかかくがかいていされました。 <br><br> (価格) <br> [sound:4c-s-商品の価格が改定されました。.mp3]
[sound:4c-k-格差.mp3]	<b>格差</b> <br> かくさ <br> qualitative difference, disparity
格差	<b>かくさ</b> <br> qualitative difference, disparity <br> [sound:4c-k-格差.mp3]
qualitative difference, disparity	<b>格差</b> <br> かくさ <br> [sound:4c-k-格差.mp3]
[sound:4c-s-格差社会の問題について話し合います。.mp3]	<b>格差社会の問題について話し合います。</b> <br> かくさしゃかいのもんだいについてはなしあいます。 <br><br> (格差) <br> We will discuss the issues of a society with disparities.
格差社会の問題について話し合います。 <br><br> (格差)	<b>かくさしゃかいのもんだいについてはなしあいます。</b> <br> We will discuss the issues of a society with disparities. <br> [sound:4c-s-格差社会の問題について話し合います。.mp3]
We will discuss the issues of a society with disparities.	<b>格差社会の問題について話し合います。</b> <br> かくさしゃかいのもんだいについてはなしあいます。 <br><br> (格差) <br> [sound:4c-s-格差社会の問題について話し合います。.mp3]
[sound:4c-k-本格化.mp3]	<b>本格化</b> <br> ほんかくか <br> regularization, regularisation, getting up speed, proceeding at full tilt
本格化	<b>ほんかくか</b> <br> regularization, regularisation, getting up speed, proceeding at full tilt <br> [sound:4c-k-本格化.mp3]
regularization, regularisation, getting up speed, proceeding at full tilt	<b>本格化</b> <br> ほんかくか <br> [sound:4c-k-本格化.mp3]
[sound:4c-s-改革が本格化しています。.mp3]	<b>改革が本格化しています。</b> <br> かいかくがほんかくかしています。 <br><br> (本格化) <br> Reforms are becoming full-fledged.
改革が本格化しています。 <br><br> (本格化)	<b>かいかくがほんかくかしています。</b> <br> Reforms are becoming full-fledged. <br> [sound:4c-s-改革が本格化しています。.mp3]
Reforms are becoming full-fledged.	<b>改革が本格化しています。</b> <br> かいかくがほんかくかしています。 <br><br> (本格化) <br> [sound:4c-s-改革が本格化しています。.mp3]
[sound:4c-k-規格.mp3]	<b>規格</b> <br> きかく <br> standard, norm
規格	<b>きかく</b> <br> standard, norm <br> [sound:4c-k-規格.mp3]
standard, norm	<b>規格</b> <br> きかく <br> [sound:4c-k-規格.mp3]
[sound:4c-s-製品の規格を確認してください。.mp3]	<b>製品の規格を確認してください。</b> <br> せいひんのきかくをかくにんしてください。 <br><br> (規格) <br> Please check the product specifications.
製品の規格を確認してください。 <br><br> (規格)	<b>せいひんのきかくをかくにんしてください。</b> <br> Please check the product specifications. <br> [sound:4c-s-製品の規格を確認してください。.mp3]
Please check the product specifications.	<b>製品の規格を確認してください。</b> <br> せいひんのきかくをかくにんしてください。 <br><br> (規格) <br> [sound:4c-s-製品の規格を確認してください。.mp3]
[sound:4c-k-有.mp3]	<b>有</b> <br> ゆう <br> existence; possession, having; limited company
有	<b>ゆう</b> <br> existence; possession, having; limited company <br> [sound:4c-k-有.mp3]
existence; possession, having; limited company	<b>有</b> <br> ゆう <br> [sound:4c-k-有.mp3]
[sound:4c-s-彼は有名な作家です。.mp3]	<b>彼は有名な作家です。</b> <br> かれはゆうめいなさっかです。 <br><br> (有) <br> He is a famous writer.
彼は有名な作家です。 <br><br> (有)	<b>かれはゆうめいなさっかです。</b> <br> He is a famous writer. <br> [sound:4c-s-彼は有名な作家です。.mp3]
He is a famous writer.	<b>彼は有名な作家です。</b> <br> かれはゆうめいなさっかです。 <br><br> (有) <br> [sound:4c-s-彼は有名な作家です。.mp3]
[sound:4c-k-有効.mp3]	<b>有効</b> <br> ゆうこう <br> validity, legality, availability, effectiveness
有効	<b>ゆうこう</b> <br> validity, legality, availability, effectiveness <br> [sound:4c-k-有効.mp3]
validity, legality, availability, effectiveness	<b>有効</b> <br> ゆうこう <br> [sound:4c-k-有効.mp3]
[sound:4c-s-このチケットは有効です。.mp3]	<b>このチケットは有効です。</b> <br> このチケットはゆうこうです。 <br><br> (有効) <br> This ticket is valid.
このチケットは有効です。 <br><br> (有効)	<b>このチケットはゆうこうです。</b> <br> This ticket is valid. <br> [sound:4c-s-このチケットは有効です。.mp3]
This ticket is valid.	<b>このチケットは有効です。</b> <br> このチケットはゆうこうです。 <br><br> (有効) <br> [sound:4c-s-このチケットは有効です。.mp3]
[sound:4c-k-有罪.mp3]	<b>有罪</b> <br> ゆうざい <br> guilt, culpability
有罪	<b>ゆうざい</b> <br> guilt, culpability <br> [sound:4c-k-有罪.mp3]
guilt, culpability	<b>有罪</b> <br> ゆうざい <br> [sound:4c-k-有罪.mp3]
[sound:4c-s-裁判で有罪判決が出ました。.mp3]	<b>裁判で有罪判決が出ました。</b> <br> さいばんでゆうざいはんけつがでました。 <br><br> (有罪) <br> A guilty verdict was issued in court.
裁判で有罪判決が出ました。 <br><br> (有罪)	<b>さいばんでゆうざいはんけつがでました。</b> <br> A guilty verdict was issued in court. <br> [sound:4c-s-裁判で有罪判決が出ました。.mp3]
A guilty verdict was issued in court.	<b>裁判で有罪判決が出ました。</b> <br> さいばんでゆうざいはんけつがでました。 <br><br> (有罪) <br> [sound:4c-s-裁判で有罪判決が出ました。.mp3]
[sound:4c-k-有価証券.mp3]	<b>有価証券</b> <br> ゆうかしょうけん <br> marketable securities, stocks and bonds
有価証券	<b>ゆうかしょうけん</b> <br> marketable securities, stocks and bonds <br> [sound:4c-k-有価証券.mp3]
marketable securities, stocks and bonds	<b>有価証券</b> <br> ゆうかしょうけん <br> [sound:4c-k-有価証券.mp3]
[sound:4c-s-彼は有価証券を購入しました。.mp3]	<b>彼は有価証券を購入しました。</b> <br> かれはゆうかしょうけんをこうにゅうしました。 <br><br> (有価証券) <br> He bought securities.
彼は有価証券を購入しました。 <br><br> (有価証券)	<b>かれはゆうかしょうけんをこうにゅうしました。</b> <br> He bought securities. <br> [sound:4c-s-彼は有価証券を購入しました。.mp3]
He bought securities.	<b>彼は有価証券を購入しました。</b> <br> かれはゆうかしょうけんをこうにゅうしました。 <br><br> (有価証券) <br> [sound:4c-s-彼は有価証券を購入しました。.mp3]
[sound:4c-k-疑い.mp3]	<b>疑い</b> <br> うたがい <br> doubt, question, uncertainty, skepticism, scepticism, suspicion, distrust
疑い	<b>うたがい</b> <br> doubt, question, uncertainty, skepticism, scepticism, suspicion, distrust <br> [sound:4c-k-疑い.mp3]
doubt, question, uncertainty, skepticism, scepticism, suspicion, distrust	<b>疑い</b> <br> うたがい <br> [sound:4c-k-疑い.mp3]
[sound:4c-s-彼には疑いの余地がありません。.mp3]	<b>彼には疑いの余地がありません。</b> <br> かれにはうたがいのよちがありません。 <br><br> (疑い) <br> There is no room for doubt about him.
彼には疑いの余地がありません。 <br><br> (疑い)	<b>かれにはうたがいのよちがありません。</b> <br> There is no room for doubt about him. <br> [sound:4c-s-彼には疑いの余地がありません。.mp3]
There is no room for doubt about him.	<b>彼には疑いの余地がありません。</b> <br> かれにはうたがいのよちがありません。 <br><br> (疑い) <br> [sound:4c-s-彼には疑いの余地がありません。.mp3]
[sound:4c-k-容疑者.mp3]	<b>容疑者</b> <br> ようぎしゃ <br> suspect (person)
容疑者	<b>ようぎしゃ</b> <br> suspect (person) <br> [sound:4c-k-容疑者.mp3]
suspect (person)	<b>容疑者</b> <br> ようぎしゃ <br> [sound:4c-k-容疑者.mp3]
[sound:4c-s-警察が容疑者を逮捕しました。.mp3]	<b>警察が容疑者を逮捕しました。</b> <br> けいさつがようぎしゃをたいほしました。 <br><br> (容疑者) <br> The police arrested the suspect.
警察が容疑者を逮捕しました。 <br><br> (容疑者)	<b>けいさつがようぎしゃをたいほしました。</b> <br> The police arrested the suspect. <br> [sound:4c-s-警察が容疑者を逮捕しました。.mp3]
The police arrested the suspect.	<b>警察が容疑者を逮捕しました。</b> <br> けいさつがようぎしゃをたいほしました。 <br><br> (容疑者) <br> [sound:4c-s-警察が容疑者を逮捕しました。.mp3]
[sound:4c-k-懐疑.mp3]	<b>懐疑</b> <br> かいぎ <br> doubt, skepticism, scepticism, disbelief
懐疑	<b>かいぎ</b> <br> doubt, skepticism, scepticism, disbelief <br> [sound:4c-k-懐疑.mp3]
doubt, skepticism, scepticism, disbelief	<b>懐疑</b> <br> かいぎ <br> [sound:4c-k-懐疑.mp3]
[sound:4c-s-彼は懐疑的な考えを持っています。.mp3]	<b>彼は懐疑的な考えを持っています。</b> <br> かれはかいぎてきなかんがえをもっています。 <br><br> (懐疑) <br> He has a skeptical mindset.
彼は懐疑的な考えを持っています。 <br><br> (懐疑)	<b>かれはかいぎてきなかんがえをもっています。</b> <br> He has a skeptical mindset. <br> [sound:4c-s-彼は懐疑的な考えを持っています。.mp3]
He has a skeptical mindset.	<b>彼は懐疑的な考えを持っています。</b> <br> かれはかいぎてきなかんがえをもっています。 <br><br> (懐疑) <br> [sound:4c-s-彼は懐疑的な考えを持っています。.mp3]
[sound:4c-k-疑わしい.mp3]	<b>疑わしい</b> <br> うたがわしい <br> doubtful, questionable, uncertain, disputable, suspicious
疑わしい	<b>うたがわしい</b> <br> doubtful, questionable, uncertain, disputable, suspicious <br> [sound:4c-k-疑わしい.mp3]
doubtful, questionable, uncertain, disputable, suspicious	<b>疑わしい</b> <br> うたがわしい <br> [sound:4c-k-疑わしい.mp3]
[sound:4c-s-その情報は疑わしいです。.mp3]	<b>その情報は疑わしいです。</b> <br> そのじょうほうはうたがわしいです。 <br><br> (疑わしい) <br> That information is doubtful.
その情報は疑わしいです。 <br><br> (疑わしい)	<b>そのじょうほうはうたがわしいです。</b> <br> That information is doubtful. <br> [sound:4c-s-その情報は疑わしいです。.mp3]
That information is doubtful.	<b>その情報は疑わしいです。</b> <br> そのじょうほうはうたがわしいです。 <br><br> (疑わしい) <br> [sound:4c-s-その情報は疑わしいです。.mp3]
[sound:4c-k-口.mp3]	<b>口</b> <br> くち <br> mouth; opening, hole, gap, orifice; mouth (of a bottle), spout, nozzle, mouthpiece; gate, door, entrance, exit; speaking, speech, talk (i.e. gossip); taste, palate; mouth (to feed); opening (i.e. vacancy), available position; invitation, summons; kind, sort, type; opening (i.e. beginning); counter for mouthfuls, shares (of money), and swords
口	<b>くち</b> <br> mouth; opening, hole, gap, orifice; mouth (of a bottle), spout, nozzle, mouthpiece; gate, door, entrance, exit; speaking, speech, talk (i.e. gossip); taste, palate; mouth (to feed); opening (i.e. vacancy), available position; invitation, summons; kind, sort, type; opening (i.e. beginning); counter for mouthfuls, shares (of money), and swords <br> [sound:4c-k-口.mp3]
mouth; opening, hole, gap, orifice; mouth (of a bottle), spout, nozzle, mouthpiece; gate, door, entrance, exit; speaking, speech, talk (i.e. gossip); taste, palate; mouth (to feed); opening (i.e. vacancy), available position; invitation, summons; kind, sort, type; opening (i.e. beginning); counter for mouthfuls, shares (of money), and swords	<b>口</b> <br> くち <br> [sound:4c-k-口.mp3]
[sound:4c-s-口を大きく開けてください。.mp3]	<b>口を大きく開けてください。</b> <br> くちをおおきくあけてください。 <br><br> (口) <br> Please open your mouth wide.
口を大きく開けてください。 <br><br> (口)	<b>くちをおおきくあけてください。</b> <br> Please open your mouth wide. <br> [sound:4c-s-口を大きく開けてください。.mp3]
Please open your mouth wide.	<b>口を大きく開けてください。</b> <br> くちをおおきくあけてください。 <br><br> (口) <br> [sound:4c-s-口を大きく開けてください。.mp3]
[sound:4c-k-人口.mp3]	<b>人口</b> <br> じんこう <br> population; common talk
人口	<b>じんこう</b> <br> population; common talk <br> [sound:4c-k-人口.mp3]
population; common talk	<b>人口</b> <br> じんこう <br> [sound:4c-k-人口.mp3]
[sound:4c-s-日本の人口は減少しています。.mp3]	<b>日本の人口は減少しています。</b> <br> にほんのじんこうはげんしょうしています。 <br><br> (人口) <br> Japan's population is decreasing.
日本の人口は減少しています。 <br><br> (人口)	<b>にほんのじんこうはげんしょうしています。</b> <br> Japan's population is decreasing. <br> [sound:4c-s-日本の人口は減少しています。.mp3]
Japan's population is decreasing.	<b>日本の人口は減少しています。</b> <br> にほんのじんこうはげんしょうしています。 <br><br> (人口) <br> [sound:4c-s-日本の人口は減少しています。.mp3]
[sound:4c-k-川口.mp3]	<b>川口</b> <br> かわぐち, かこう <br> mouth of river, estuary
川口	<b>かわぐち, かこう</b> <br> mouth of river, estuary <br> [sound:4c-k-川口.mp3]
mouth of river, estuary	<b>川口</b> <br> かわぐち, かこう <br> [sound:4c-k-川口.mp3]
[sound:4c-s-川口市に住んでいます。.mp3]	<b>川口市に住んでいます。</b> <br> かわぐちしにすんでいます。 <br><br> (川口) <br> I live in Kawaguchi City.
川口市に住んでいます。 <br><br> (川口)	<b>かわぐちしにすんでいます。</b> <br> I live in Kawaguchi City. <br> [sound:4c-s-川口市に住んでいます。.mp3]
I live in Kawaguchi City.	<b>川口市に住んでいます。</b> <br> かわぐちしにすんでいます。 <br><br> (川口) <br> [sound:4c-s-川口市に住んでいます。.mp3]
[sound:4c-k-手口.mp3]	<b>手口</b> <br> てぐち <br> modus operandi, criminal technique, trick
手口	<b>てぐち</b> <br> modus operandi, criminal technique, trick <br> [sound:4c-k-手口.mp3]
modus operandi, criminal technique, trick	<b>手口</b> <br> てぐち <br> [sound:4c-k-手口.mp3]
[sound:4c-s-詐欺の手口を警戒してください。.mp3]	<b>詐欺の手口を警戒してください。</b> <br> さぎのてぐちをけいかいしてください。 <br><br> (手口) <br> Be wary of fraud methods.
詐欺の手口を警戒してください。 <br><br> (手口)	<b>さぎのてぐちをけいかいしてください。</b> <br> Be wary of fraud methods. <br> [sound:4c-s-詐欺の手口を警戒してください。.mp3]
Be wary of fraud methods.	<b>詐欺の手口を警戒してください。</b> <br> さぎのてぐちをけいかいしてください。 <br><br> (手口) <br> [sound:4c-s-詐欺の手口を警戒してください。.mp3]
[sound:4c-k-過ぎ.mp3]	<b>過ぎ</b> <br> すぎ <br> past, after; too (much), over (e.g. eating)
過ぎ	<b>すぎ</b> <br> past, after; too (much), over (e.g. eating) <br> [sound:4c-k-過ぎ.mp3]
past, after; too (much), over (e.g. eating)	<b>過ぎ</b> <br> すぎ <br> [sound:4c-k-過ぎ.mp3]
[sound:4c-s-時間が過ぎるのは早いです。.mp3]	<b>時間が過ぎるのは早いです。</b> <br> じかんがすぎるのははやいです。 <br><br> (過ぎ) <br> Time passes quickly.
時間が過ぎるのは早いです。 <br><br> (過ぎ)	<b>じかんがすぎるのははやいです。</b> <br> Time passes quickly. <br> [sound:4c-s-時間が過ぎるのは早いです。.mp3]
Time passes quickly.	<b>時間が過ぎるのは早いです。</b> <br> じかんがすぎるのははやいです。 <br><br> (過ぎ) <br> [sound:4c-s-時間が過ぎるのは早いです。.mp3]
[sound:4c-k-過去.mp3]	<b>過去</b> <br> かこ <br> the past, bygone days, the previous
過去	<b>かこ</b> <br> the past, bygone days, the previous <br> [sound:4c-k-過去.mp3]
the past, bygone days, the previous	<b>過去</b> <br> かこ <br> [sound:4c-k-過去.mp3]
[sound:4c-s-過去の経験を活かしましょう。.mp3]	<b>過去の経験を活かしましょう。</b> <br> かこのけいけんをいかしましょう。 <br><br> (過去) <br> Let's utilize past experiences.
過去の経験を活かしましょう。 <br><br> (過去)	<b>かこのけいけんをいかしましょう。</b> <br> Let's utilize past experiences. <br> [sound:4c-s-過去の経験を活かしましょう。.mp3]
Let's utilize past experiences.	<b>過去の経験を活かしましょう。</b> <br> かこのけいけんをいかしましょう。 <br><br> (過去) <br> [sound:4c-s-過去の経験を活かしましょう。.mp3]
[sound:4c-k-過剰.mp3]	<b>過剰</b> <br> かじょう <br> excess, over-
過剰	<b>かじょう</b> <br> excess, over- <br> [sound:4c-k-過剰.mp3]
excess, over-	<b>過剰</b> <br> かじょう <br> [sound:4c-k-過剰.mp3]
[sound:4c-s-過剰な期待をしないでください。.mp3]	<b>過剰な期待をしないでください。</b> <br> かじょうなきたいをしないでください。 <br><br> (過剰) <br> Don't have excessive expectations.
過剰な期待をしないでください。 <br><br> (過剰)	<b>かじょうなきたいをしないでください。</b> <br> Don't have excessive expectations. <br> [sound:4c-s-過剰な期待をしないでください。.mp3]
Don't have excessive expectations.	<b>過剰な期待をしないでください。</b> <br> かじょうなきたいをしないでください。 <br><br> (過剰) <br> [sound:4c-s-過剰な期待をしないでください。.mp3]
[sound:4c-k-過ち.mp3]	<b>過ち</b> <br> あやまち <br> fault, error, indiscretion, faux pas
過ち	<b>あやまち</b> <br> fault, error, indiscretion, faux pas <br> [sound:4c-k-過ち.mp3]
fault, error, indiscretion, faux pas	<b>過ち</b> <br> あやまち <br> [sound:4c-k-過ち.mp3]
[sound:4c-s-過ちを認めることが大切です。.mp3]	<b>過ちを認めることが大切です。</b> <br> あやまちをみとめることがたいせつです。 <br><br> (過ち) <br> It's important to admit mistakes.
過ちを認めることが大切です。 <br><br> (過ち)	<b>あやまちをみとめることがたいせつです。</b> <br> It's important to admit mistakes. <br> [sound:4c-s-過ちを認めることが大切です。.mp3]
It's important to admit mistakes.	<b>過ちを認めることが大切です。</b> <br> あやまちをみとめることがたいせつです。 <br><br> (過ち) <br> [sound:4c-s-過ちを認めることが大切です。.mp3]
[sound:4c-k-局.mp3]	<b>局</b> <br> きょく <br> channel (i.e. TV or radio), station, department; affair, situation
局	<b>きょく</b> <br> channel (i.e. TV or radio), station, department; affair, situation <br> [sound:4c-k-局.mp3]
channel (i.e. TV or radio), station, department; affair, situation	<b>局</b> <br> きょく <br> [sound:4c-k-局.mp3]
[sound:4c-s-テレビ局で働いています。.mp3]	<b>テレビ局で働いています。</b> <br> テレビきょくではたらいています。 <br><br> (局) <br> I work at a TV station.
テレビ局で働いています。 <br><br> (局)	<b>テレビきょくではたらいています。</b> <br> I work at a TV station. <br> [sound:4c-s-テレビ局で働いています。.mp3]
I work at a TV station.	<b>テレビ局で働いています。</b> <br> テレビきょくではたらいています。 <br><br> (局) <br> [sound:4c-s-テレビ局で働いています。.mp3]
[sound:4c-k-事務局.mp3]	<b>事務局</b> <br> じむきょく <br> secretariat, executive office
事務局	<b>じむきょく</b> <br> secretariat, executive office <br> [sound:4c-k-事務局.mp3]
secretariat, executive office	<b>事務局</b> <br> じむきょく <br> [sound:4c-k-事務局.mp3]
[sound:4c-s-事務局に問い合わせてください。.mp3]	<b>事務局に問い合わせてください。</b> <br> じむきょくにといあわせてください。 <br><br> (事務局) <br> Please contact the secretariat.
事務局に問い合わせてください。 <br><br> (事務局)	<b>じむきょくにといあわせてください。</b> <br> Please contact the secretariat. <br> [sound:4c-s-事務局に問い合わせてください。.mp3]
Please contact the secretariat.	<b>事務局に問い合わせてください。</b> <br> じむきょくにといあわせてください。 <br><br> (事務局) <br> [sound:4c-s-事務局に問い合わせてください。.mp3]
[sound:4c-k-郵便局.mp3]	<b>郵便局</b> <br> ゆうびんきょく <br> post office
郵便局	<b>ゆうびんきょく</b> <br> post office <br> [sound:4c-k-郵便局.mp3]
post office	<b>郵便局</b> <br> ゆうびんきょく <br> [sound:4c-k-郵便局.mp3]
[sound:4c-s-郵便局で手紙を出しました。.mp3]	<b>郵便局で手紙を出しました。</b> <br> ゆうびんきょくでてがみをだしました。 <br><br> (郵便局) <br> I sent a letter at the post office.
郵便局で手紙を出しました。 <br><br> (郵便局)	<b>ゆうびんきょくでてがみをだしました。</b> <br> I sent a letter at the post office. <br> [sound:4c-s-郵便局で手紙を出しました。.mp3]
I sent a letter at the post office.	<b>郵便局で手紙を出しました。</b> <br> ゆうびんきょくでてがみをだしました。 <br><br> (郵便局) <br> [sound:4c-s-郵便局で手紙を出しました。.mp3]
[sound:4c-k-対局.mp3]	<b>対局</b> <br> たいきょく <br> (playing) a game of go, shogi or chess, etc.
対局	<b>たいきょく</b> <br> (playing) a game of go, shogi or chess, etc. <br> [sound:4c-k-対局.mp3]
(playing) a game of go, shogi or chess, etc.	<b>対局</b> <br> たいきょく <br> [sound:4c-k-対局.mp3]
[sound:4c-s-囲碁の対局を観戦しました。.mp3]	<b>囲碁の対局を観戦しました。</b> <br> いごのたいきょくをかんせんしました。 <br><br> (対局) <br> I watched a Go match.
囲碁の対局を観戦しました。 <br><br> (対局)	<b>いごのたいきょくをかんせんしました。</b> <br> I watched a Go match. <br> [sound:4c-s-囲碁の対局を観戦しました。.mp3]
I watched a Go match.	<b>囲碁の対局を観戦しました。</b> <br> いごのたいきょくをかんせんしました。 <br><br> (対局) <br> [sound:4c-s-囲碁の対局を観戦しました。.mp3]
[sound:4c-k-少し.mp3]	<b>少し</b> <br> すこし <br> small quantity, little, few, something; little while; short distance
少し	<b>すこし</b> <br> small quantity, little, few, something; little while; short distance <br> [sound:4c-k-少し.mp3]
small quantity, little, few, something; little while; short distance	<b>少し</b> <br> すこし <br> [sound:4c-k-少し.mp3]
[sound:4c-s-少し休みましょう。.mp3]	<b>少し休みましょう。</b> <br> すこしやすみましょう。 <br><br> (少し) <br> Let's take a short break.
少し休みましょう。 <br><br> (少し)	<b>すこしやすみましょう。</b> <br> Let's take a short break. <br> [sound:4c-s-少し休みましょう。.mp3]
Let's take a short break.	<b>少し休みましょう。</b> <br> すこしやすみましょう。 <br><br> (少し) <br> [sound:4c-s-少し休みましょう。.mp3]
[sound:4c-k-少なくとも.mp3]	<b>少なくとも</b> <br> すくなくとも <br> at least
少なくとも	<b>すくなくとも</b> <br> at least <br> [sound:4c-k-少なくとも.mp3]
at least	<b>少なくとも</b> <br> すくなくとも <br> [sound:4c-k-少なくとも.mp3]
[sound:4c-s-少なくとも五人が参加します。.mp3]	<b>少なくとも五人が参加します。</b> <br> すくなくともごにんがさんかします。 <br><br> (少なくとも) <br> At least five people will participate.
少なくとも五人が参加します。 <br><br> (少なくとも)	<b>すくなくともごにんがさんかします。</b> <br> At least five people will participate. <br> [sound:4c-s-少なくとも五人が参加します。.mp3]
At least five people will participate.	<b>少なくとも五人が参加します。</b> <br> すくなくともごにんがさんかします。 <br><br> (少なくとも) <br> [sound:4c-s-少なくとも五人が参加します。.mp3]
[sound:4c-k-少ない.mp3]	<b>少ない</b> <br> すくない <br> few, a little, scarce, insufficient, seldom
少ない	<b>すくない</b> <br> few, a little, scarce, insufficient, seldom <br> [sound:4c-k-少ない.mp3]
few, a little, scarce, insufficient, seldom	<b>少ない</b> <br> すくない <br> [sound:4c-k-少ない.mp3]
[sound:4c-s-この町には店が少ないです。.mp3]	<b>この町には店が少ないです。</b> <br> このまちにはみせがすくないです。 <br><br> (少ない) <br> This town has few stores.
この町には店が少ないです。 <br><br> (少ない)	<b>このまちにはみせがすくないです。</b> <br> This town has few stores. <br> [sound:4c-s-この町には店が少ないです。.mp3]
This town has few stores.	<b>この町には店が少ないです。</b> <br> このまちにはみせがすくないです。 <br><br> (少ない) <br> [sound:4c-s-この町には店が少ないです。.mp3]
[sound:4c-k-少なからず.mp3]	<b>少なからず</b> <br> すくなからず <br> considerably, not a little, in no small numbers
少なからず	<b>すくなからず</b> <br> considerably, not a little, in no small numbers <br> [sound:4c-k-少なからず.mp3]
considerably, not a little, in no small numbers	<b>少なからず</b> <br> すくなからず <br> [sound:4c-k-少なからず.mp3]
[sound:4c-s-彼の発言には少なからず影響がある。.mp3]	<b>彼の発言には少なからず影響がある。</b> <br> かれのはつげんにはすくなからずえいきょうがある。 <br><br> (少なからず) <br> His statement has some impact.
彼の発言には少なからず影響がある。 <br><br> (少なからず)	<b>かれのはつげんにはすくなからずえいきょうがある。</b> <br> His statement has some impact. <br> [sound:4c-s-彼の発言には少なからず影響がある。.mp3]
His statement has some impact.	<b>彼の発言には少なからず影響がある。</b> <br> かれのはつげんにはすくなからずえいきょうがある。 <br><br> (少なからず) <br> [sound:4c-s-彼の発言には少なからず影響がある。.mp3]
[sound:4c-k-放る.mp3]	<b>放る</b> <br> ほうる, ほる <br> to let go, to abandon, to leave undone; to throw, to toss, to fling
放る	<b>ほうる, ほる</b> <br> to let go, to abandon, to leave undone; to throw, to toss, to fling <br> [sound:4c-k-放る.mp3]
to let go, to abandon, to leave undone; to throw, to toss, to fling	<b>放る</b> <br> ほうる, ほる <br> [sound:4c-k-放る.mp3]
[sound:4c-s-ボールを放ってください。.mp3]	<b>ボールを放ってください。</b> <br> ボールをほうってください。 <br><br> (放る) <br> Throw the ball.
ボールを放ってください。 <br><br> (放る)	<b>ボールをほうってください。</b> <br> Throw the ball. <br> [sound:4c-s-ボールを放ってください。.mp3]
Throw the ball.	<b>ボールを放ってください。</b> <br> ボールをほうってください。 <br><br> (放る) <br> [sound:4c-s-ボールを放ってください。.mp3]
[sound:4c-k-放送.mp3]	<b>放送</b> <br> ほうそう <br> broadcast, broadcasting
放送	<b>ほうそう</b> <br> broadcast, broadcasting <br> [sound:4c-k-放送.mp3]
broadcast, broadcasting	<b>放送</b> <br> ほうそう <br> [sound:4c-k-放送.mp3]
[sound:4c-s-番組は全国で放送されました。.mp3]	<b>番組は全国で放送されました。</b> <br> ばんぐみはぜんこくでほうそうされました。 <br><br> (放送) <br> The program was broadcast nationwide.
番組は全国で放送されました。 <br><br> (放送)	<b>ばんぐみはぜんこくでほうそうされました。</b> <br> The program was broadcast nationwide. <br> [sound:4c-s-番組は全国で放送されました。.mp3]
The program was broadcast nationwide.	<b>番組は全国で放送されました。</b> <br> ばんぐみはぜんこくでほうそうされました。 <br><br> (放送) <br> [sound:4c-s-番組は全国で放送されました。.mp3]
[sound:4c-k-放射能.mp3]	<b>放射能</b> <br> ほうしゃのう <br> radioactivity
放射能	<b>ほうしゃのう</b> <br> radioactivity <br> [sound:4c-k-放射能.mp3]
radioactivity	<b>放射能</b> <br> ほうしゃのう <br> [sound:4c-k-放射能.mp3]
[sound:4c-s-放射能の影響を調査します。.mp3]	<b>放射能の影響を調査します。</b> <br> ほうしゃのうのえいきょうをちょうさします。 <br><br> (放射能) <br> We will investigate the effects of radiation.
放射能の影響を調査します。 <br><br> (放射能)	<b>ほうしゃのうのえいきょうをちょうさします。</b> <br> We will investigate the effects of radiation. <br> [sound:4c-s-放射能の影響を調査します。.mp3]
We will investigate the effects of radiation.	<b>放射能の影響を調査します。</b> <br> ほうしゃのうのえいきょうをちょうさします。 <br><br> (放射能) <br> [sound:4c-s-放射能の影響を調査します。.mp3]
[sound:4c-k-放映.mp3]	<b>放映</b> <br> ほうえい <br> televising
放映	<b>ほうえい</b> <br> televising <br> [sound:4c-k-放映.mp3]
televising	<b>放映</b> <br> ほうえい <br> [sound:4c-k-放映.mp3]
[sound:4c-s-映画がテレビで放映されます。.mp3]	<b>映画がテレビで放映されます。</b> <br> えいががテレビでほうえいされます。 <br><br> (放映) <br> The movie will be televised.
映画がテレビで放映されます。 <br><br> (放映)	<b>えいががテレビでほうえいされます。</b> <br> The movie will be televised. <br> [sound:4c-s-映画がテレビで放映されます。.mp3]
The movie will be televised.	<b>映画がテレビで放映されます。</b> <br> えいががテレビでほうえいされます。 <br><br> (放映) <br> [sound:4c-s-映画がテレビで放映されます。.mp3]
[sound:4c-k-関税.mp3]	<b>関税</b> <br> かんぜい <br> customs, duty, tariff
関税	<b>かんぜい</b> <br> customs, duty, tariff <br> [sound:4c-k-関税.mp3]
customs, duty, tariff	<b>関税</b> <br> かんぜい <br> [sound:4c-k-関税.mp3]
[sound:4c-s-輸入品に関税がかかります。.mp3]	<b>輸入品に関税がかかります。</b> <br> ゆにゅうひんにかんぜいがかかります。 <br><br> (関税) <br> Import goods are subject to tariffs.
輸入品に関税がかかります。 <br><br> (関税)	<b>ゆにゅうひんにかんぜいがかかります。</b> <br> Import goods are subject to tariffs. <br> [sound:4c-s-輸入品に関税がかかります。.mp3]
Import goods are subject to tariffs.	<b>輸入品に関税がかかります。</b> <br> ゆにゅうひんにかんぜいがかかります。 <br><br> (関税) <br> [sound:4c-s-輸入品に関税がかかります。.mp3]
[sound:4c-k-減税.mp3]	<b>減税</b> <br> げんぜい <br> tax reduction
減税	<b>げんぜい</b> <br> tax reduction <br> [sound:4c-k-減税.mp3]
tax reduction	<b>減税</b> <br> げんぜい <br> [sound:4c-k-減税.mp3]
[sound:4c-s-政府は減税政策を発表しました。.mp3]	<b>政府は減税政策を発表しました。</b> <br> せいふはげんぜいせいさくをはっぴょうしました。 <br><br> (減税) <br> The government announced a tax reduction policy.
政府は減税政策を発表しました。 <br><br> (減税)	<b>せいふはげんぜいせいさくをはっぴょうしました。</b> <br> The government announced a tax reduction policy. <br> [sound:4c-s-政府は減税政策を発表しました。.mp3]
The government announced a tax reduction policy.	<b>政府は減税政策を発表しました。</b> <br> せいふはげんぜいせいさくをはっぴょうしました。 <br><br> (減税) <br> [sound:4c-s-政府は減税政策を発表しました。.mp3]
[sound:4c-k-税金.mp3]	<b>税金</b> <br> ぜいきん <br> tax, duty
税金	<b>ぜいきん</b> <br> tax, duty <br> [sound:4c-k-税金.mp3]
tax, duty	<b>税金</b> <br> ぜいきん <br> [sound:4c-k-税金.mp3]
[sound:4c-s-税金を納めました。.mp3]	<b>税金を納めました。</b> <br> ぜいきんをおさめました。 <br><br> (税金) <br> I paid my taxes.
税金を納めました。 <br><br> (税金)	<b>ぜいきんをおさめました。</b> <br> I paid my taxes. <br> [sound:4c-s-税金を納めました。.mp3]
I paid my taxes.	<b>税金を納めました。</b> <br> ぜいきんをおさめました。 <br><br> (税金) <br> [sound:4c-s-税金を納めました。.mp3]
[sound:4c-k-税収.mp3]	<b>税収</b> <br> ぜいしゅう <br> tax yields, revenue
税収	<b>ぜいしゅう</b> <br> tax yields, revenue <br> [sound:4c-k-税収.mp3]
tax yields, revenue	<b>税収</b> <br> ぜいしゅう <br> [sound:4c-k-税収.mp3]
[sound:4c-s-税収が減少しています。.mp3]	<b>税収が減少しています。</b> <br> ぜいしゅうがげんしょうしています。 <br><br> (税収) <br> Tax revenue is decreasing.
税収が減少しています。 <br><br> (税収)	<b>ぜいしゅうがげんしょうしています。</b> <br> Tax revenue is decreasing. <br> [sound:4c-s-税収が減少しています。.mp3]
Tax revenue is decreasing.	<b>税収が減少しています。</b> <br> ぜいしゅうがげんしょうしています。 <br><br> (税収) <br> [sound:4c-s-税収が減少しています。.mp3]
[sound:4c-k-検査.mp3]	<b>検査</b> <br> けんさ <br> inspection (e.g. customs, factory), examination
検査	<b>けんさ</b> <br> inspection (e.g. customs, factory), examination <br> [sound:4c-k-検査.mp3]
inspection (e.g. customs, factory), examination	<b>検査</b> <br> けんさ <br> [sound:4c-k-検査.mp3]
[sound:4c-s-健康診断で検査を受けました。.mp3]	<b>健康診断で検査を受けました。</b> <br> けんこうしんだんでけんさをうけました。 <br><br> (検査) <br> I had a check-up during my health examination.
健康診断で検査を受けました。 <br><br> (検査)	<b>けんこうしんだんでけんさをうけました。</b> <br> I had a check-up during my health examination. <br> [sound:4c-s-健康診断で検査を受けました。.mp3]
I had a check-up during my health examination.	<b>健康診断で検査を受けました。</b> <br> けんこうしんだんでけんさをうけました。 <br><br> (検査) <br> [sound:4c-s-健康診断で検査を受けました。.mp3]
[sound:4c-k-検察.mp3]	<b>検察</b> <br> けんさつ <br> examination, prosecutor
検察	<b>けんさつ</b> <br> examination, prosecutor <br> [sound:4c-k-検察.mp3]
examination, prosecutor	<b>検察</b> <br> けんさつ <br> [sound:4c-k-検察.mp3]
[sound:4c-s-検察が事件を調査しています。.mp3]	<b>検察が事件を調査しています。</b> <br> けんさつがじけんをちょうさしています。 <br><br> (検察) <br> The prosecution is investigating the case.
検察が事件を調査しています。 <br><br> (検察)	<b>けんさつがじけんをちょうさしています。</b> <br> The prosecution is investigating the case. <br> [sound:4c-s-検察が事件を調査しています。.mp3]
The prosecution is investigating the case.	<b>検察が事件を調査しています。</b> <br> けんさつがじけんをちょうさしています。 <br><br> (検察) <br> [sound:4c-s-検察が事件を調査しています。.mp3]
[sound:4c-k-検診.mp3]	<b>検診</b> <br> けんしん <br> medical examination
検診	<b>けんしん</b> <br> medical examination <br> [sound:4c-k-検診.mp3]
medical examination	<b>検診</b> <br> けんしん <br> [sound:4c-k-検診.mp3]
[sound:4c-s-定期的に検診を受けています。.mp3]	<b>定期的に検診を受けています。</b> <br> ていきてきにけんしんをうけています。 <br><br> (検診) <br> I regularly undergo medical check-ups.
定期的に検診を受けています。 <br><br> (検診)	<b>ていきてきにけんしんをうけています。</b> <br> I regularly undergo medical check-ups. <br> [sound:4c-s-定期的に検診を受けています。.mp3]
I regularly undergo medical check-ups.	<b>定期的に検診を受けています。</b> <br> ていきてきにけんしんをうけています。 <br><br> (検診) <br> [sound:4c-s-定期的に検診を受けています。.mp3]
[sound:4c-k-検問.mp3]	<b>検問</b> <br> けんもん <br> inspection, examination
検問	<b>けんもん</b> <br> inspection, examination <br> [sound:4c-k-検問.mp3]
inspection, examination	<b>検問</b> <br> けんもん <br> [sound:4c-k-検問.mp3]
[sound:4c-s-警察が検問を実施しました。.mp3]	<b>警察が検問を実施しました。</b> <br> けいさつがけんもんをじっししました。 <br><br> (検問) <br> The police conducted a checkpoint inspection.
警察が検問を実施しました。 <br><br> (検問)	<b>けいさつがけんもんをじっししました。</b> <br> The police conducted a checkpoint inspection. <br> [sound:4c-s-警察が検問を実施しました。.mp3]
The police conducted a checkpoint inspection.	<b>警察が検問を実施しました。</b> <br> けいさつがけんもんをじっししました。 <br><br> (検問) <br> [sound:4c-s-警察が検問を実施しました。.mp3]
[sound:4c-k-藤.mp3]	<b>藤</b> <br> ふじ <br> wisteria, Wisteria floribunda
藤	<b>ふじ</b> <br> wisteria, Wisteria floribunda <br> [sound:4c-k-藤.mp3]
wisteria, Wisteria floribunda	<b>藤</b> <br> ふじ <br> [sound:4c-k-藤.mp3]
[sound:4c-s-藤の花が咲きました。.mp3]	<b>藤の花が咲きました。</b> <br> ふじのはながさきました。 <br><br> (藤) <br> Wisteria flowers have bloomed.
藤の花が咲きました。 <br><br> (藤)	<b>ふじのはながさきました。</b> <br> Wisteria flowers have bloomed. <br> [sound:4c-s-藤の花が咲きました。.mp3]
Wisteria flowers have bloomed.	<b>藤の花が咲きました。</b> <br> ふじのはながさきました。 <br><br> (藤) <br> [sound:4c-s-藤の花が咲きました。.mp3]
[sound:4c-k-葛藤.mp3]	<b>葛藤</b> <br> かっとう <br> conflict, complication, troubles, discord
葛藤	<b>かっとう</b> <br> conflict, complication, troubles, discord <br> [sound:4c-k-葛藤.mp3]
conflict, complication, troubles, discord	<b>葛藤</b> <br> かっとう <br> [sound:4c-k-葛藤.mp3]
[sound:4c-s-彼の心の中に葛藤があります。.mp3]	<b>彼の心の中に葛藤があります。</b> <br> かれのこころのなかにかっとうがあります。 <br><br> (葛藤) <br> He has inner conflict.
彼の心の中に葛藤があります。 <br><br> (葛藤)	<b>かれのこころのなかにかっとうがあります。</b> <br> He has inner conflict. <br> [sound:4c-s-彼の心の中に葛藤があります。.mp3]
He has inner conflict.	<b>彼の心の中に葛藤があります。</b> <br> かれのこころのなかにかっとうがあります。 <br><br> (葛藤) <br> [sound:4c-s-彼の心の中に葛藤があります。.mp3]
[sound:4c-k-藤原氏の出.mp3]	<b>藤原氏の出</b> <br> ふじわらしのしゅつ <br> of Fujiwara descent
藤原氏の出	<b>ふじわらしのしゅつ</b> <br> of Fujiwara descent <br> [sound:4c-k-藤原氏の出.mp3]
of Fujiwara descent	<b>藤原氏の出</b> <br> ふじわらしのしゅつ <br> [sound:4c-k-藤原氏の出.mp3]
[sound:4c-s-藤原氏の出自を調べています。.mp3]	<b>藤原氏の出自を調べています。</b> <br> ふじわらしのしゅつじをしらべています。 <br><br> (藤原氏の出) <br> I am researching the origins of the Fujiwara clan.
藤原氏の出自を調べています。 <br><br> (藤原氏の出)	<b>ふじわらしのしゅつじをしらべています。</b> <br> I am researching the origins of the Fujiwara clan. <br> [sound:4c-s-藤原氏の出自を調べています。.mp3]
I am researching the origins of the Fujiwara clan.	<b>藤原氏の出自を調べています。</b> <br> ふじわらしのしゅつじをしらべています。 <br><br> (藤原氏の出) <br> [sound:4c-s-藤原氏の出自を調べています。.mp3]
[sound:4c-k-藤袴.mp3]	<b>藤袴</b> <br> ふじばかま, フジバカマ <br> thoroughwort, Eupatorium fortunei (species of boneset), Eupatorium japonicum
藤袴	<b>ふじばかま, フジバカマ</b> <br> thoroughwort, Eupatorium fortunei (species of boneset), Eupatorium japonicum <br> [sound:4c-k-藤袴.mp3]
thoroughwort, Eupatorium fortunei (species of boneset), Eupatorium japonicum	<b>藤袴</b> <br> ふじばかま, フジバカマ <br> [sound:4c-k-藤袴.mp3]
[sound:4c-s-藤袴は秋の花です。.mp3]	<b>藤袴は秋の花です。</b> <br> ふじばかまはあきのはなです。 <br><br> (藤袴) <br> Thoroughwort is an autumn flower.
藤袴は秋の花です。 <br><br> (藤袴)	<b>ふじばかまはあきのはなです。</b> <br> Thoroughwort is an autumn flower. <br> [sound:4c-s-藤袴は秋の花です。.mp3]
Thoroughwort is an autumn flower.	<b>藤袴は秋の花です。</b> <br> ふじばかまはあきのはなです。 <br><br> (藤袴) <br> [sound:4c-s-藤袴は秋の花です。.mp3]
[sound:4c-k-町.mp3]	<b>町</b> <br> まち, ちょう <br> town, block, neighbourhood, neighborhood; street, road; 109.09 m; 0.99 hectares
町	<b>まち, ちょう</b> <br> town, block, neighbourhood, neighborhood; street, road; 109.09 m; 0.99 hectares <br> [sound:4c-k-町.mp3]
town, block, neighbourhood, neighborhood; street, road; 109.09 m; 0.99 hectares	<b>町</b> <br> まち, ちょう <br> [sound:4c-k-町.mp3]
[sound:4c-s-町の景色が美しいです。.mp3]	<b>町の景色が美しいです。</b> <br> まちのけしきがうつくしいです。 <br><br> (町) <br> The town’s scenery is beautiful.
町の景色が美しいです。 <br><br> (町)	<b>まちのけしきがうつくしいです。</b> <br> The town’s scenery is beautiful. <br> [sound:4c-s-町の景色が美しいです。.mp3]
The town’s scenery is beautiful.	<b>町の景色が美しいです。</b> <br> まちのけしきがうつくしいです。 <br><br> (町) <br> [sound:4c-s-町の景色が美しいです。.mp3]
[sound:4c-k-市町村.mp3]	<b>市町村</b> <br> しちょうそん <br> cities, towns and villages, municipalities
市町村	<b>しちょうそん</b> <br> cities, towns and villages, municipalities <br> [sound:4c-k-市町村.mp3]
cities, towns and villages, municipalities	<b>市町村</b> <br> しちょうそん <br> [sound:4c-k-市町村.mp3]
[sound:4c-s-市町村の役場に行きました。.mp3]	<b>市町村の役場に行きました。</b> <br> しちょうそんのやくばにいきました。 <br><br> (市町村) <br> I went to the municipal office.
市町村の役場に行きました。 <br><br> (市町村)	<b>しちょうそんのやくばにいきました。</b> <br> I went to the municipal office. <br> [sound:4c-s-市町村の役場に行きました。.mp3]
I went to the municipal office.	<b>市町村の役場に行きました。</b> <br> しちょうそんのやくばにいきました。 <br><br> (市町村) <br> [sound:4c-s-市町村の役場に行きました。.mp3]
[sound:4c-k-町並み.mp3]	<b>町並み</b> <br> まちなみ <br> street (of stores and houses), townscape, (look of) stores and houses on street
町並み	<b>まちなみ</b> <br> street (of stores and houses), townscape, (look of) stores and houses on street <br> [sound:4c-k-町並み.mp3]
street (of stores and houses), townscape, (look of) stores and houses on street	<b>町並み</b> <br> まちなみ <br> [sound:4c-k-町並み.mp3]
[sound:4c-s-町並みを散歩しました。.mp3]	<b>町並みを散歩しました。</b> <br> まちなみをさんぽしました。 <br><br> (町並み) <br> I took a walk through the streets.
町並みを散歩しました。 <br><br> (町並み)	<b>まちなみをさんぽしました。</b> <br> I took a walk through the streets. <br> [sound:4c-s-町並みを散歩しました。.mp3]
I took a walk through the streets.	<b>町並みを散歩しました。</b> <br> まちなみをさんぽしました。 <br><br> (町並み) <br> [sound:4c-s-町並みを散歩しました。.mp3]
[sound:4c-k-室町.mp3]	<b>室町</b> <br> むろまち <br> Muromachi (era 1392-1573, or 1333-1573, or 1336-1573)
室町	<b>むろまち</b> <br> Muromachi (era 1392-1573, or 1333-1573, or 1336-1573) <br> [sound:4c-k-室町.mp3]
Muromachi (era 1392-1573, or 1333-1573, or 1336-1573)	<b>室町</b> <br> むろまち <br> [sound:4c-k-室町.mp3]
[sound:4c-s-室町時代の文化を学びました。.mp3]	<b>室町時代の文化を学びました。</b> <br> むろまちじだいのぶんかをまなびました。 <br><br> (室町) <br> I studied the culture of the Muromachi period.
室町時代の文化を学びました。 <br><br> (室町)	<b>むろまちじだいのぶんかをまなびました。</b> <br> I studied the culture of the Muromachi period. <br> [sound:4c-s-室町時代の文化を学びました。.mp3]
I studied the culture of the Muromachi period.	<b>室町時代の文化を学びました。</b> <br> むろまちじだいのぶんかをまなびました。 <br><br> (室町) <br> [sound:4c-s-室町時代の文化を学びました。.mp3]
[sound:4c-k-常.mp3]	<b>常</b> <br> とこ <br> ever, endless
常	<b>とこ</b> <br> ever, endless <br> [sound:4c-k-常.mp3]
ever, endless	<b>常</b> <br> とこ <br> [sound:4c-k-常.mp3]
[sound:4c-s-彼は常に冷静です。.mp3]	<b>彼は常に冷静です。</b> <br> かれはつねにれいせいです。 <br><br> (常) <br> He is always calm.
