経済的な理由で留学を断念しました。 <br><br> (経済的)	<b>けいざいてきなりゆうでりゅうがくをだんねんしました。</b> <br> I gave up studying abroad for financial reasons. <br> [sound:4c-s-経済的な理由で留学を断念しました。.mp3]
I gave up studying abroad for financial reasons.	<b>経済的な理由で留学を断念しました。</b> <br> けいざいてきなりゆうでりゅうがくをだんねんしました。 <br><br> (経済的) <br> [sound:4c-s-経済的な理由で留学を断念しました。.mp3]
[sound:4c-k-経済的.mp3]	<b>経済的</b> <br> けいざいてき <br> economic, economical
経済的	<b>けいざいてき</b> <br> economic, economical <br> [sound:4c-k-経済的.mp3]
economic, economical	<b>経済的</b> <br> けいざいてき <br> [sound:4c-k-経済的.mp3]
[sound:4c-s-経済界のリーダーと話し合いを行いました。.mp3]	<b>経済界のリーダーと話し合いを行いました。</b> <br> けいざいかいのりーだーとはなしあいをおこないました。 <br><br> (経済界) <br> I held talks with leaders of the business world.
経済界のリーダーと話し合いを行いました。 <br><br> (経済界)	<b>けいざいかいのりーだーとはなしあいをおこないました。</b> <br> I held talks with leaders of the business world. <br> [sound:4c-s-経済界のリーダーと話し合いを行いました。.mp3]
I held talks with leaders of the business world.	<b>経済界のリーダーと話し合いを行いました。</b> <br> けいざいかいのりーだーとはなしあいをおこないました。 <br><br> (経済界) <br> [sound:4c-s-経済界のリーダーと話し合いを行いました。.mp3]
[sound:4c-k-経済界.mp3]	<b>経済界</b> <br> けいざいかい <br> economic world, financial circles
経済界	<b>けいざいかい</b> <br> economic world, financial circles <br> [sound:4c-k-経済界.mp3]
economic world, financial circles	<b>経済界</b> <br> けいざいかい <br> [sound:4c-k-経済界.mp3]
[sound:4c-s-経済企画庁が新たな成長戦略を発表しました。.mp3]	<b>経済企画庁が新たな成長戦略を発表しました。</b> <br> けいざいきかくちょうがあらたなせいちょうせんりゃくをはっぴょうしました。 <br><br> (経済企画庁) <br> The Economic Planning Agency announced a new growth strategy.
経済企画庁が新たな成長戦略を発表しました。 <br><br> (経済企画庁)	<b>けいざいきかくちょうがあらたなせいちょうせんりゃくをはっぴょうしました。</b> <br> The Economic Planning Agency announced a new growth strategy. <br> [sound:4c-s-経済企画庁が新たな成長戦略を発表しました。.mp3]
The Economic Planning Agency announced a new growth strategy.	<b>経済企画庁が新たな成長戦略を発表しました。</b> <br> けいざいきかくちょうがあらたなせいちょうせんりゃくをはっぴょうしました。 <br><br> (経済企画庁) <br> [sound:4c-s-経済企画庁が新たな成長戦略を発表しました。.mp3]
[sound:4c-k-経済企画庁.mp3]	<b>経済企画庁</b> <br> けいざいきかくちょう <br> Economic Planning Agency
経済企画庁	<b>けいざいきかくちょう</b> <br> Economic Planning Agency <br> [sound:4c-k-経済企画庁.mp3]
Economic Planning Agency	<b>経済企画庁</b> <br> けいざいきかくちょう <br> [sound:4c-k-経済企画庁.mp3]
[sound:4c-s-共済制度に加入しています。.mp3]	<b>共済制度に加入しています。</b> <br> きょうさいせいどにかにゅうしています。 <br><br> (共済) <br> I am enrolled in the mutual aid system.
共済制度に加入しています。 <br><br> (共済)	<b>きょうさいせいどにかにゅうしています。</b> <br> I am enrolled in the mutual aid system. <br> [sound:4c-s-共済制度に加入しています。.mp3]
I am enrolled in the mutual aid system.	<b>共済制度に加入しています。</b> <br> きょうさいせいどにかにゅうしています。 <br><br> (共済) <br> [sound:4c-s-共済制度に加入しています。.mp3]
[sound:4c-k-共済.mp3]	<b>共済</b> <br> きょうさい <br> mutual aid
共済	<b>きょうさい</b> <br> mutual aid <br> [sound:4c-k-共済.mp3]
mutual aid	<b>共済</b> <br> きょうさい <br> [sound:4c-k-共済.mp3]
[sound:4c-s-文書を整理してください。.mp3]	<b>文書を整理してください。</b> <br> ぶんしょをせいりしてください。 <br><br> (文書) <br> Please organize the documents.
文書を整理してください。 <br><br> (文書)	<b>ぶんしょをせいりしてください。</b> <br> Please organize the documents. <br> [sound:4c-s-文書を整理してください。.mp3]
Please organize the documents.	<b>文書を整理してください。</b> <br> ぶんしょをせいりしてください。 <br><br> (文書) <br> [sound:4c-s-文書を整理してください。.mp3]
[sound:4c-k-文書.mp3]	<b>文書</b> <br> ぶんしょ, もんじょ <br> document, writing, letter, paperwork, note, records, archives
文書	<b>ぶんしょ, もんじょ</b> <br> document, writing, letter, paperwork, note, records, archives <br> [sound:4c-k-文書.mp3]
document, writing, letter, paperwork, note, records, archives	<b>文書</b> <br> ぶんしょ, もんじょ <br> [sound:4c-k-文書.mp3]
[sound:4c-s-この教科書はとてもわかりやすいです。.mp3]	<b>この教科書はとてもわかりやすいです。</b> <br> このきょうかしょはとてもわかりやすいです。 <br><br> (教科書) <br> This textbook is very easy to understand.
この教科書はとてもわかりやすいです。 <br><br> (教科書)	<b>このきょうかしょはとてもわかりやすいです。</b> <br> This textbook is very easy to understand. <br> [sound:4c-s-この教科書はとてもわかりやすいです。.mp3]
This textbook is very easy to understand.	<b>この教科書はとてもわかりやすいです。</b> <br> このきょうかしょはとてもわかりやすいです。 <br><br> (教科書) <br> [sound:4c-s-この教科書はとてもわかりやすいです。.mp3]
[sound:4c-k-教科書.mp3]	<b>教科書</b> <br> きょうかしょ <br> textbook, text book
教科書	<b>きょうかしょ</b> <br> textbook, text book <br> [sound:4c-k-教科書.mp3]
textbook, text book	<b>教科書</b> <br> きょうかしょ <br> [sound:4c-k-教科書.mp3]
[sound:4c-s-近所の書店で本を買いました。.mp3]	<b>近所の書店で本を買いました。</b> <br> きんじょのしょてんでほんをかいました。 <br><br> (書店) <br> I bought a book at the local bookstore.
近所の書店で本を買いました。 <br><br> (書店)	<b>きんじょのしょてんでほんをかいました。</b> <br> I bought a book at the local bookstore. <br> [sound:4c-s-近所の書店で本を買いました。.mp3]
I bought a book at the local bookstore.	<b>近所の書店で本を買いました。</b> <br> きんじょのしょてんでほんをかいました。 <br><br> (書店) <br> [sound:4c-s-近所の書店で本を買いました。.mp3]
[sound:4c-k-書店.mp3]	<b>書店</b> <br> しょてん <br> bookshop, bookstore
書店	<b>しょてん</b> <br> bookshop, bookstore <br> [sound:4c-k-書店.mp3]
bookshop, bookstore	<b>書店</b> <br> しょてん <br> [sound:4c-k-書店.mp3]
[sound:4c-s-彼の最新の著書が出版されました。.mp3]	<b>彼の最新の著書が出版されました。</b> <br> かれのさいしんのちょしょがしゅっぱんされました。 <br><br> (著書) <br> His latest book has been published.
彼の最新の著書が出版されました。 <br><br> (著書)	<b>かれのさいしんのちょしょがしゅっぱんされました。</b> <br> His latest book has been published. <br> [sound:4c-s-彼の最新の著書が出版されました。.mp3]
His latest book has been published.	<b>彼の最新の著書が出版されました。</b> <br> かれのさいしんのちょしょがしゅっぱんされました。 <br><br> (著書) <br> [sound:4c-s-彼の最新の著書が出版されました。.mp3]
[sound:4c-k-著書.mp3]	<b>著書</b> <br> ちょしょ <br> literary work, book
著書	<b>ちょしょ</b> <br> literary work, book <br> [sound:4c-k-著書.mp3]
literary work, book	<b>著書</b> <br> ちょしょ <br> [sound:4c-k-著書.mp3]
[sound:4c-s-彼の著書は世界中で読まれています。.mp3]	<b>彼の著書は世界中で読まれています。</b> <br> かれのちょしょはせかいじゅうでよまれています。 <br><br> (著書) <br> His book is read around the world。
彼の著書は世界中で読まれています。 <br><br> (著書)	<b>かれのちょしょはせかいじゅうでよまれています。</b> <br> His book is read around the world。 <br> [sound:4c-s-彼の著書は世界中で読まれています。.mp3]
His book is read around the world。	<b>彼の著書は世界中で読まれています。</b> <br> かれのちょしょはせかいじゅうでよまれています。 <br><br> (著書) <br> [sound:4c-s-彼の著書は世界中で読まれています。.mp3]
[sound:4c-k-府警.mp3]	<b>府警</b> <br> ふけい <br> prefectural police
府警	<b>ふけい</b> <br> prefectural police <br> [sound:4c-k-府警.mp3]
prefectural police	<b>府警</b> <br> ふけい <br> [sound:4c-k-府警.mp3]
[sound:4c-s-事件の捜査は府警が担当しています。.mp3]	<b>事件の捜査は府警が担当しています。</b> <br> じけんのそうさはふけいがたんとうしています。 <br><br> (府警) <br> The prefectural police are handling the investigation.
事件の捜査は府警が担当しています。 <br><br> (府警)	<b>じけんのそうさはふけいがたんとうしています。</b> <br> The prefectural police are handling the investigation. <br> [sound:4c-s-事件の捜査は府警が担当しています。.mp3]
The prefectural police are handling the investigation.	<b>事件の捜査は府警が担当しています。</b> <br> じけんのそうさはふけいがたんとうしています。 <br><br> (府警) <br> [sound:4c-s-事件の捜査は府警が担当しています。.mp3]
[sound:4c-k-府立.mp3]	<b>府立</b> <br> ふりつ <br> managed by an urban prefecture
府立	<b>ふりつ</b> <br> managed by an urban prefecture <br> [sound:4c-k-府立.mp3]
managed by an urban prefecture	<b>府立</b> <br> ふりつ <br> [sound:4c-k-府立.mp3]
[sound:4c-s-彼は府立高校に通っています。.mp3]	<b>彼は府立高校に通っています。</b> <br> かれはふりつこうこうにかよっています。 <br><br> (府立) <br> He attends a prefectural high school.
彼は府立高校に通っています。 <br><br> (府立)	<b>かれはふりつこうこうにかよっています。</b> <br> He attends a prefectural high school. <br> [sound:4c-s-彼は府立高校に通っています。.mp3]
He attends a prefectural high school.	<b>彼は府立高校に通っています。</b> <br> かれはふりつこうこうにかよっています。 <br><br> (府立) <br> [sound:4c-s-彼は府立高校に通っています。.mp3]
[sound:4c-k-府中.mp3]	<b>府中</b> <br> ふちゅう <br> Fuchuu (in Tokyo)
府中	<b>ふちゅう</b> <br> Fuchuu (in Tokyo) <br> [sound:4c-k-府中.mp3]
Fuchuu (in Tokyo)	<b>府中</b> <br> ふちゅう <br> [sound:4c-k-府中.mp3]
[sound:4c-s-彼は府中市に住んでいます。.mp3]	<b>彼は府中市に住んでいます。</b> <br> かれはふちゅうしにすんでいます。 <br><br> (府中) <br> He lives in Fuchu City.
彼は府中市に住んでいます。 <br><br> (府中)	<b>かれはふちゅうしにすんでいます。</b> <br> He lives in Fuchu City. <br> [sound:4c-s-彼は府中市に住んでいます。.mp3]
He lives in Fuchu City.	<b>彼は府中市に住んでいます。</b> <br> かれはふちゅうしにすんでいます。 <br><br> (府中) <br> [sound:4c-s-彼は府中市に住んでいます。.mp3]
[sound:4c-k-州政府.mp3]	<b>州政府</b> <br> しゅうせいふ <br> state government
州政府	<b>しゅうせいふ</b> <br> state government <br> [sound:4c-k-州政府.mp3]
state government	<b>州政府</b> <br> しゅうせいふ <br> [sound:4c-k-州政府.mp3]
[sound:4c-s-州政府は新しい法律を可決しました。.mp3]	<b>州政府は新しい法律を可決しました。</b> <br> しゅうせいふはあたらしいほうりつをかけつしました。 <br><br> (州政府) <br> The state government passed a new law.
州政府は新しい法律を可決しました。 <br><br> (州政府)	<b>しゅうせいふはあたらしいほうりつをかけつしました。</b> <br> The state government passed a new law. <br> [sound:4c-s-州政府は新しい法律を可決しました。.mp3]
The state government passed a new law.	<b>州政府は新しい法律を可決しました。</b> <br> しゅうせいふはあたらしいほうりつをかけつしました。 <br><br> (州政府) <br> [sound:4c-s-州政府は新しい法律を可決しました。.mp3]
[sound:4c-k-活性.mp3]	<b>活性</b> <br> かっせい <br> activity
活性	<b>かっせい</b> <br> activity <br> [sound:4c-k-活性.mp3]
activity	<b>活性</b> <br> かっせい <br> [sound:4c-k-活性.mp3]
[sound:4c-s-この物質は細胞の活性を高めます。.mp3]	<b>この物質は細胞の活性を高めます。</b> <br> このぶっしつはさいぼうのかっせいをたかめます。 <br><br> (活性) <br> This substance increases cell activity.
この物質は細胞の活性を高めます。 <br><br> (活性)	<b>このぶっしつはさいぼうのかっせいをたかめます。</b> <br> This substance increases cell activity. <br> [sound:4c-s-この物質は細胞の活性を高めます。.mp3]
This substance increases cell activity.	<b>この物質は細胞の活性を高めます。</b> <br> このぶっしつはさいぼうのかっせいをたかめます。 <br><br> (活性) <br> [sound:4c-s-この物質は細胞の活性を高めます。.mp3]
[sound:4c-k-活躍.mp3]	<b>活躍</b> <br> かつやく <br> activity (esp. energetic), great efforts, conspicuous service; to flourish, to participate actively, to play an active role
活躍	<b>かつやく</b> <br> activity (esp. energetic), great efforts, conspicuous service; to flourish, to participate actively, to play an active role <br> [sound:4c-k-活躍.mp3]
activity (esp. energetic), great efforts, conspicuous service; to flourish, to participate actively, to play an active role	<b>活躍</b> <br> かつやく <br> [sound:4c-k-活躍.mp3]
[sound:4c-s-彼は海外で活躍しています。.mp3]	<b>彼は海外で活躍しています。</b> <br> かれはかいがいでかつやくしています。 <br><br> (活躍) <br> He is active abroad.
彼は海外で活躍しています。 <br><br> (活躍)	<b>かれはかいがいでかつやくしています。</b> <br> He is active abroad. <br> [sound:4c-s-彼は海外で活躍しています。.mp3]
He is active abroad.	<b>彼は海外で活躍しています。</b> <br> かれはかいがいでかつやくしています。 <br><br> (活躍) <br> [sound:4c-s-彼は海外で活躍しています。.mp3]
[sound:4c-k-復活.mp3]	<b>復活</b> <br> ふっかつ <br> revival (e.g. musical), come-back; restoration, rebirth, resurrection
復活	<b>ふっかつ</b> <br> revival (e.g. musical), come-back; restoration, rebirth, resurrection <br> [sound:4c-k-復活.mp3]
revival (e.g. musical), come-back; restoration, rebirth, resurrection	<b>復活</b> <br> ふっかつ <br> [sound:4c-k-復活.mp3]
[sound:4c-s-伝統行事が復活しました。.mp3]	<b>伝統行事が復活しました。</b> <br> でんとうぎょうじがふっかつしました。 <br><br> (復活) <br> The traditional event was revived.
伝統行事が復活しました。 <br><br> (復活)	<b>でんとうぎょうじがふっかつしました。</b> <br> The traditional event was revived. <br> [sound:4c-s-伝統行事が復活しました。.mp3]
The traditional event was revived.	<b>伝統行事が復活しました。</b> <br> でんとうぎょうじがふっかつしました。 <br><br> (復活) <br> [sound:4c-s-伝統行事が復活しました。.mp3]
[sound:4c-k-活用.mp3]	<b>活用</b> <br> かつよう <br> practical use, application; conjugation, declension, inflection
活用	<b>かつよう</b> <br> practical use, application; conjugation, declension, inflection <br> [sound:4c-k-活用.mp3]
practical use, application; conjugation, declension, inflection	<b>活用</b> <br> かつよう <br> [sound:4c-k-活用.mp3]
[sound:4c-s-時間を有効に活用しましょう。.mp3]	<b>時間を有効に活用しましょう。</b> <br> じかんをゆうこうにかつようしましょう。 <br><br> (活用) <br> Let’s use our time effectively.
時間を有効に活用しましょう。 <br><br> (活用)	<b>じかんをゆうこうにかつようしましょう。</b> <br> Let’s use our time effectively. <br> [sound:4c-s-時間を有効に活用しましょう。.mp3]
Let’s use our time effectively.	<b>時間を有効に活用しましょう。</b> <br> じかんをゆうこうにかつようしましょう。 <br><br> (活用) <br> [sound:4c-s-時間を有効に活用しましょう。.mp3]
[sound:4c-k-原告.mp3]	<b>原告</b> <br> げんこく <br> plaintiff, accuser, prosecutor
原告	<b>げんこく</b> <br> plaintiff, accuser, prosecutor <br> [sound:4c-k-原告.mp3]
plaintiff, accuser, prosecutor	<b>原告</b> <br> げんこく <br> [sound:4c-k-原告.mp3]
[sound:4c-s-原告が証言を行いました。.mp3]	<b>原告が証言を行いました。</b> <br> げんこくがしょうげんをおこないました。 <br><br> (原告) <br> The plaintiff testified.
原告が証言を行いました。 <br><br> (原告)	<b>げんこくがしょうげんをおこないました。</b> <br> The plaintiff testified. <br> [sound:4c-s-原告が証言を行いました。.mp3]
The plaintiff testified.	<b>原告が証言を行いました。</b> <br> げんこくがしょうげんをおこないました。 <br><br> (原告) <br> [sound:4c-s-原告が証言を行いました。.mp3]
[sound:4c-k-原発.mp3]	<b>原発</b> <br> げんぱつ <br> nuclear power plant, nuclear power supply
原発	<b>げんぱつ</b> <br> nuclear power plant, nuclear power supply <br> [sound:4c-k-原発.mp3]
nuclear power plant, nuclear power supply	<b>原発</b> <br> げんぱつ <br> [sound:4c-k-原発.mp3]
[sound:4c-s-原発の再稼働に反対しています。.mp3]	<b>原発の再稼働に反対しています。</b> <br> げんぱつのさいかどうにはんたいしています。 <br><br> (原発) <br> I am opposed to the restart of nuclear power plants.
原発の再稼働に反対しています。 <br><br> (原発)	<b>げんぱつのさいかどうにはんたいしています。</b> <br> I am opposed to the restart of nuclear power plants. <br> [sound:4c-s-原発の再稼働に反対しています。.mp3]
I am opposed to the restart of nuclear power plants.	<b>原発の再稼働に反対しています。</b> <br> げんぱつのさいかどうにはんたいしています。 <br><br> (原発) <br> [sound:4c-s-原発の再稼働に反対しています。.mp3]
[sound:4c-k-原油.mp3]	<b>原油</b> <br> げんゆ <br> crude oil
原油	<b>げんゆ</b> <br> crude oil <br> [sound:4c-k-原油.mp3]
crude oil	<b>原油</b> <br> げんゆ <br> [sound:4c-k-原油.mp3]
[sound:4c-s-原油価格が上昇しています。.mp3]	<b>原油価格が上昇しています。</b> <br> げんゆかかくがじょうしょうしています。 <br><br> (原油) <br> Crude oil prices are rising.
原油価格が上昇しています。 <br><br> (原油)	<b>げんゆかかくがじょうしょうしています。</b> <br> Crude oil prices are rising. <br> [sound:4c-s-原油価格が上昇しています。.mp3]
Crude oil prices are rising.	<b>原油価格が上昇しています。</b> <br> げんゆかかくがじょうしょうしています。 <br><br> (原油) <br> [sound:4c-s-原油価格が上昇しています。.mp3]
[sound:4c-k-原理.mp3]	<b>原理</b> <br> げんり <br> principle, theory, fundamental truth
原理	<b>げんり</b> <br> principle, theory, fundamental truth <br> [sound:4c-k-原理.mp3]
principle, theory, fundamental truth	<b>原理</b> <br> げんり <br> [sound:4c-k-原理.mp3]
[sound:4c-s-この機械は簡単な原理で動きます。.mp3]	<b>この機械は簡単な原理で動きます。</b> <br> このきかいはかんたんなげんりでうごきます。 <br><br> (原理) <br> This machine works on a simple principle.
この機械は簡単な原理で動きます。 <br><br> (原理)	<b>このきかいはかんたんなげんりでうごきます。</b> <br> This machine works on a simple principle. <br> [sound:4c-s-この機械は簡単な原理で動きます。.mp3]
This machine works on a simple principle.	<b>この機械は簡単な原理で動きます。</b> <br> このきかいはかんたんなげんりでうごきます。 <br><br> (原理) <br> [sound:4c-s-この機械は簡単な原理で動きます。.mp3]
[sound:4c-k-先生.mp3]	<b>先生</b> <br> せんせい <br> teacher, master, doctor; with names of teachers, etc. as an honorific
先生	<b>せんせい</b> <br> teacher, master, doctor; with names of teachers, etc. as an honorific <br> [sound:4c-k-先生.mp3]
teacher, master, doctor; with names of teachers, etc. as an honorific	<b>先生</b> <br> せんせい <br> [sound:4c-k-先生.mp3]
[sound:4c-s-彼は私の高校の先生です。.mp3]	<b>彼は私の高校の先生です。</b> <br> かれはわたしのこうこうのせんせいです。 <br><br> (先生) <br> He is my high school teacher.
彼は私の高校の先生です。 <br><br> (先生)	<b>かれはわたしのこうこうのせんせいです。</b> <br> He is my high school teacher. <br> [sound:4c-s-彼は私の高校の先生です。.mp3]
He is my high school teacher.	<b>彼は私の高校の先生です。</b> <br> かれはわたしのこうこうのせんせいです。 <br><br> (先生) <br> [sound:4c-s-彼は私の高校の先生です。.mp3]
[sound:4c-k-先発.mp3]	<b>先発</b> <br> せんぱつ <br> forerunner, advance party, going on ahead; being in a (team sports) match or game from the start, starting
先発	<b>せんぱつ</b> <br> forerunner, advance party, going on ahead; being in a (team sports) match or game from the start, starting <br> [sound:4c-k-先発.mp3]
forerunner, advance party, going on ahead; being in a (team sports) match or game from the start, starting	<b>先発</b> <br> せんぱつ <br> [sound:4c-k-先発.mp3]
[sound:4c-s-今日の先発投手は田中選手です。.mp3]	<b>今日の先発投手は田中選手です。</b> <br> きょうのせんぱつとうしゅはたなかせんしゅです。 <br><br> (先発) <br> Today's starting pitcher is Tanaka.
今日の先発投手は田中選手です。 <br><br> (先発)	<b>きょうのせんぱつとうしゅはたなかせんしゅです。</b> <br> Today's starting pitcher is Tanaka. <br> [sound:4c-s-今日の先発投手は田中選手です。.mp3]
Today's starting pitcher is Tanaka.	<b>今日の先発投手は田中選手です。</b> <br> きょうのせんぱつとうしゅはたなかせんしゅです。 <br><br> (先発) <br> [sound:4c-s-今日の先発投手は田中選手です。.mp3]
[sound:4c-k-優先.mp3]	<b>優先</b> <br> ゆうせん <br> preference, priority, precedence
優先	<b>ゆうせん</b> <br> preference, priority, precedence <br> [sound:4c-k-優先.mp3]
preference, priority, precedence	<b>優先</b> <br> ゆうせん <br> [sound:4c-k-優先.mp3]
[sound:4c-s-安全が最優先です。.mp3]	<b>安全が最優先です。</b> <br> あんぜんがさいゆうせんです。 <br><br> (優先) <br> Safety is the top priority.
安全が最優先です。 <br><br> (優先)	<b>あんぜんがさいゆうせんです。</b> <br> Safety is the top priority. <br> [sound:4c-s-安全が最優先です。.mp3]
Safety is the top priority.	<b>安全が最優先です。</b> <br> あんぜんがさいゆうせんです。 <br><br> (優先) <br> [sound:4c-s-安全が最優先です。.mp3]
[sound:4c-k-先進.mp3]	<b>先進</b> <br> せんしん <br> seniority, advance, leadership
先進	<b>せんしん</b> <br> seniority, advance, leadership <br> [sound:4c-k-先進.mp3]
seniority, advance, leadership	<b>先進</b> <br> せんしん <br> [sound:4c-k-先進.mp3]
[sound:4c-s-先進国の支援が必要です。.mp3]	<b>先進国の支援が必要です。</b> <br> せんしんこくのしえんがひつようです。 <br><br> (先進) <br> Support from developed countries is necessary。
先進国の支援が必要です。 <br><br> (先進)	<b>せんしんこくのしえんがひつようです。</b> <br> Support from developed countries is necessary。 <br> [sound:4c-s-先進国の支援が必要です。.mp3]
Support from developed countries is necessary。	<b>先進国の支援が必要です。</b> <br> せんしんこくのしえんがひつようです。 <br><br> (先進) <br> [sound:4c-s-先進国の支援が必要です。.mp3]
[sound:4c-k-共に.mp3]	<b>共に</b> <br> ともに <br> sharing with, participate in, both, alike, together, along with, with, including
共に	<b>ともに</b> <br> sharing with, participate in, both, alike, together, along with, with, including <br> [sound:4c-k-共に.mp3]
sharing with, participate in, both, alike, together, along with, with, including	<b>共に</b> <br> ともに <br> [sound:4c-k-共に.mp3]
[sound:4c-s-彼らは苦楽を共にしました。.mp3]	<b>彼らは苦楽を共にしました。</b> <br> かれらはくらくをともにしました。 <br><br> (共に) <br> They shared both joy and sorrow.
彼らは苦楽を共にしました。 <br><br> (共に)	<b>かれらはくらくをともにしました。</b> <br> They shared both joy and sorrow. <br> [sound:4c-s-彼らは苦楽を共にしました。.mp3]
They shared both joy and sorrow.	<b>彼らは苦楽を共にしました。</b> <br> かれらはくらくをともにしました。 <br><br> (共に) <br> [sound:4c-s-彼らは苦楽を共にしました。.mp3]
[sound:4c-k-共通.mp3]	<b>共通</b> <br> きょうつう <br> commonness, community
共通	<b>きょうつう</b> <br> commonness, community <br> [sound:4c-k-共通.mp3]
commonness, community	<b>共通</b> <br> きょうつう <br> [sound:4c-k-共通.mp3]
[sound:4c-s-共通の目標に向かって努力しましょう。.mp3]	<b>共通の目標に向かって努力しましょう。</b> <br> きょうつうのもくひょうにむかってどりょくしましょう。 <br><br> (共通) <br> Let’s strive toward a common goal.
共通の目標に向かって努力しましょう。 <br><br> (共通)	<b>きょうつうのもくひょうにむかってどりょくしましょう。</b> <br> Let’s strive toward a common goal. <br> [sound:4c-s-共通の目標に向かって努力しましょう。.mp3]
Let’s strive toward a common goal.	<b>共通の目標に向かって努力しましょう。</b> <br> きょうつうのもくひょうにむかってどりょくしましょう。 <br><br> (共通) <br> [sound:4c-s-共通の目標に向かって努力しましょう。.mp3]
[sound:4c-k-共同体.mp3]	<b>共同体</b> <br> きょうどうたい <br> cooperative body, cooperative system, collective, community
共同体	<b>きょうどうたい</b> <br> cooperative body, cooperative system, collective, community <br> [sound:4c-k-共同体.mp3]
cooperative body, cooperative system, collective, community	<b>共同体</b> <br> きょうどうたい <br> [sound:4c-k-共同体.mp3]
[sound:4c-s-私たちは地域共同体の一員です。.mp3]	<b>私たちは地域共同体の一員です。</b> <br> わたしたちはちいききょうどうたいのいちいんです。 <br><br> (共同体) <br> We are members of a local community.
私たちは地域共同体の一員です。 <br><br> (共同体)	<b>わたしたちはちいききょうどうたいのいちいんです。</b> <br> We are members of a local community. <br> [sound:4c-s-私たちは地域共同体の一員です。.mp3]
We are members of a local community.	<b>私たちは地域共同体の一員です。</b> <br> わたしたちはちいききょうどうたいのいちいんです。 <br><br> (共同体) <br> [sound:4c-s-私たちは地域共同体の一員です。.mp3]
[sound:4c-k-公共.mp3]	<b>公共</b> <br> こうきょう <br> public, community, public service, society, communal
公共	<b>こうきょう</b> <br> public, community, public service, society, communal <br> [sound:4c-k-公共.mp3]
public, community, public service, society, communal	<b>公共</b> <br> こうきょう <br> [sound:4c-k-公共.mp3]
[sound:4c-s-公共の場ではマナーを守りましょう。.mp3]	<b>公共の場ではマナーを守りましょう。</b> <br> こうきょうのばではまなーをまもりましょう。 <br><br> (公共) <br> Let’s observe manners in public places.
公共の場ではマナーを守りましょう。 <br><br> (公共)	<b>こうきょうのばではまなーをまもりましょう。</b> <br> Let’s observe manners in public places. <br> [sound:4c-s-公共の場ではマナーを守りましょう。.mp3]
Let’s observe manners in public places.	<b>公共の場ではマナーを守りましょう。</b> <br> こうきょうのばではまなーをまもりましょう。 <br><br> (公共) <br> [sound:4c-s-公共の場ではマナーを守りましょう。.mp3]
[sound:4c-k-得点.mp3]	<b>得点</b> <br> とくてん <br> score, points made, marks obtained, runs
得点	<b>とくてん</b> <br> score, points made, marks obtained, runs <br> [sound:4c-k-得点.mp3]
score, points made, marks obtained, runs	<b>得点</b> <br> とくてん <br> [sound:4c-k-得点.mp3]
[sound:4c-s-チームは後半に得点しました。.mp3]	<b>チームは後半に得点しました。</b> <br> ちーむはこうはんにとくてんしました。 <br><br> (得点) <br> The team scored in the second half.
チームは後半に得点しました。 <br><br> (得点)	<b>ちーむはこうはんにとくてんしました。</b> <br> The team scored in the second half. <br> [sound:4c-s-チームは後半に得点しました。.mp3]
The team scored in the second half.	<b>チームは後半に得点しました。</b> <br> ちーむはこうはんにとくてんしました。 <br><br> (得点) <br> [sound:4c-s-チームは後半に得点しました。.mp3]
[sound:4c-k-獲得.mp3]	<b>獲得</b> <br> かくとく <br> acquisition, possession
獲得	<b>かくとく</b> <br> acquisition, possession <br> [sound:4c-k-獲得.mp3]
acquisition, possession	<b>獲得</b> <br> かくとく <br> [sound:4c-k-獲得.mp3]
[sound:4c-s-彼は優勝を獲得しました。.mp3]	<b>彼は優勝を獲得しました。</b> <br> かれはゆうしょうをかくとくしました。 <br><br> (獲得) <br> He won the championship.
彼は優勝を獲得しました。 <br><br> (獲得)	<b>かれはゆうしょうをかくとくしました。</b> <br> He won the championship. <br> [sound:4c-s-彼は優勝を獲得しました。.mp3]
He won the championship.	<b>彼は優勝を獲得しました。</b> <br> かれはゆうしょうをかくとくしました。 <br><br> (獲得) <br> [sound:4c-s-彼は優勝を獲得しました。.mp3]
[sound:4c-k-説得.mp3]	<b>説得</b> <br> せっとく <br> persuasion
説得	<b>せっとく</b> <br> persuasion <br> [sound:4c-k-説得.mp3]
persuasion	<b>説得</b> <br> せっとく <br> [sound:4c-k-説得.mp3]
[sound:4c-s-彼を説得するのは難しいです。.mp3]	<b>彼を説得するのは難しいです。</b> <br> かれをせっとくするのはむずかしいです。 <br><br> (説得) <br> Persuading him is difficult.
彼を説得するのは難しいです。 <br><br> (説得)	<b>かれをせっとくするのはむずかしいです。</b> <br> Persuading him is difficult. <br> [sound:4c-s-彼を説得するのは難しいです。.mp3]
Persuading him is difficult.	<b>彼を説得するのは難しいです。</b> <br> かれをせっとくするのはむずかしいです。 <br><br> (説得) <br> [sound:4c-s-彼を説得するのは難しいです。.mp3]
[sound:4c-k-得票.mp3]	<b>得票</b> <br> とくひょう <br> number of votes polled, poll votes
得票	<b>とくひょう</b> <br> number of votes polled, poll votes <br> [sound:4c-k-得票.mp3]
number of votes polled, poll votes	<b>得票</b> <br> とくひょう <br> [sound:4c-k-得票.mp3]
[sound:4c-s-彼は多くの得票を得ました。.mp3]	<b>彼は多くの得票を得ました。</b> <br> かれはおおくのとくひょうをえました。 <br><br> (得票) <br> He received many votes.
彼は多くの得票を得ました。 <br><br> (得票)	<b>かれはおおくのとくひょうをえました。</b> <br> He received many votes. <br> [sound:4c-s-彼は多くの得票を得ました。.mp3]
He received many votes.	<b>彼は多くの得票を得ました。</b> <br> かれはおおくのとくひょうをえました。 <br><br> (得票) <br> [sound:4c-s-彼は多くの得票を得ました。.mp3]
[sound:4c-k-理解.mp3]	<b>理解</b> <br> りかい <br> understanding, comprehension
理解	<b>りかい</b> <br> understanding, comprehension <br> [sound:4c-k-理解.mp3]
understanding, comprehension	<b>理解</b> <br> りかい <br> [sound:4c-k-理解.mp3]
[sound:4c-s-説明を聞いてようやく理解できました。.mp3]	<b>説明を聞いてようやく理解できました。</b> <br> せつめいをきいてようやくりかいできました。 <br><br> (理解) <br> I finally understood after hearing the explanation.
説明を聞いてようやく理解できました。 <br><br> (理解)	<b>せつめいをきいてようやくりかいできました。</b> <br> I finally understood after hearing the explanation. <br> [sound:4c-s-説明を聞いてようやく理解できました。.mp3]
I finally understood after hearing the explanation.	<b>説明を聞いてようやく理解できました。</b> <br> せつめいをきいてようやくりかいできました。 <br><br> (理解) <br> [sound:4c-s-説明を聞いてようやく理解できました。.mp3]
[sound:4c-k-解除.mp3]	<b>解除</b> <br> かいじょ <br> cancellation, rescinding, release, calling off, lifting (sanctions), delisting
解除	<b>かいじょ</b> <br> cancellation, rescinding, release, calling off, lifting (sanctions), delisting <br> [sound:4c-k-解除.mp3]
cancellation, rescinding, release, calling off, lifting (sanctions), delisting	<b>解除</b> <br> かいじょ <br> [sound:4c-k-解除.mp3]
[sound:4c-s-警報が解除されました。.mp3]	<b>警報が解除されました。</b> <br> けいほうがかいじょされました。 <br><br> (解除) <br> The warning was lifted.
警報が解除されました。 <br><br> (解除)	<b>けいほうがかいじょされました。</b> <br> The warning was lifted. <br> [sound:4c-s-警報が解除されました。.mp3]
The warning was lifted.	<b>警報が解除されました。</b> <br> けいほうがかいじょされました。 <br><br> (解除) <br> [sound:4c-s-警報が解除されました。.mp3]
[sound:4c-k-解放.mp3]	<b>解放</b> <br> かいほう <br> release, unleashing, liberation, emancipation, setting free; deallocation (of computer memory)
解放	<b>かいほう</b> <br> release, unleashing, liberation, emancipation, setting free; deallocation (of computer memory) <br> [sound:4c-k-解放.mp3]
release, unleashing, liberation, emancipation, setting free; deallocation (of computer memory)	<b>解放</b> <br> かいほう <br> [sound:4c-k-解放.mp3]
[sound:4c-s-囚人が解放されました。.mp3]	<b>囚人が解放されました。</b> <br> しゅうじんがかいほうされました。 <br><br> (解放) <br> The prisoner was released.
囚人が解放されました。 <br><br> (解放)	<b>しゅうじんがかいほうされました。</b> <br> The prisoner was released. <br> [sound:4c-s-囚人が解放されました。.mp3]
The prisoner was released.	<b>囚人が解放されました。</b> <br> しゅうじんがかいほうされました。 <br><br> (解放) <br> [sound:4c-s-囚人が解放されました。.mp3]
[sound:4c-k-解明.mp3]	<b>解明</b> <br> かいめい <br> clarification, elucidation, explication
解明	<b>かいめい</b> <br> clarification, elucidation, explication <br> [sound:4c-k-解明.mp3]
clarification, elucidation, explication	<b>解明</b> <br> かいめい <br> [sound:4c-k-解明.mp3]
[sound:4c-s-問題の原因を解明しました。.mp3]	<b>問題の原因を解明しました。</b> <br> もんだいのげんいんをかいめいしました。 <br><br> (解明) <br> The cause of the problem was clarified.
問題の原因を解明しました。 <br><br> (解明)	<b>もんだいのげんいんをかいめいしました。</b> <br> The cause of the problem was clarified. <br> [sound:4c-s-問題の原因を解明しました。.mp3]
The cause of the problem was clarified.	<b>問題の原因を解明しました。</b> <br> もんだいのげんいんをかいめいしました。 <br><br> (解明) <br> [sound:4c-s-問題の原因を解明しました。.mp3]
[sound:4c-k-指名.mp3]	<b>指名</b> <br> しめい <br> name, nominate, designate
指名	<b>しめい</b> <br> name, nominate, designate <br> [sound:4c-k-指名.mp3]
name, nominate, designate	<b>指名</b> <br> しめい <br> [sound:4c-k-指名.mp3]
[sound:4c-s-彼が議長に指名されました。.mp3]	<b>彼が議長に指名されました。</b> <br> かれがぎちょうにしめいされました。 <br><br> (指名) <br> He was nominated as the chairperson.
彼が議長に指名されました。 <br><br> (指名)	<b>かれがぎちょうにしめいされました。</b> <br> He was nominated as the chairperson. <br> [sound:4c-s-彼が議長に指名されました。.mp3]
He was nominated as the chairperson.	<b>彼が議長に指名されました。</b> <br> かれがぎちょうにしめいされました。 <br><br> (指名) <br> [sound:4c-s-彼が議長に指名されました。.mp3]
[sound:4c-k-氏名.mp3]	<b>氏名</b> <br> しめい <br> full name, identity
氏名	<b>しめい</b> <br> full name, identity <br> [sound:4c-k-氏名.mp3]
full name, identity	<b>氏名</b> <br> しめい <br> [sound:4c-k-氏名.mp3]
[sound:4c-s-氏名を記入してください。.mp3]	<b>氏名を記入してください。</b> <br> しめいをきにゅうしてください。 <br><br> (氏名) <br> Please fill in your full name.
氏名を記入してください。 <br><br> (氏名)	<b>しめいをきにゅうしてください。</b> <br> Please fill in your full name. <br> [sound:4c-s-氏名を記入してください。.mp3]
Please fill in your full name.	<b>氏名を記入してください。</b> <br> しめいをきにゅうしてください。 <br><br> (氏名) <br> [sound:4c-s-氏名を記入してください。.mp3]
[sound:4c-k-有名.mp3]	<b>有名</b> <br> ゆうめい <br> famous; fame
有名	<b>ゆうめい</b> <br> famous; fame <br> [sound:4c-k-有名.mp3]
famous; fame	<b>有名</b> <br> ゆうめい <br> [sound:4c-k-有名.mp3]
[sound:4c-s-彼女は有名な作家です。.mp3]	<b>彼女は有名な作家です。</b> <br> かのじょはゆうめいなさっかです。 <br><br> (有名) <br> She is a famous author.
彼女は有名な作家です。 <br><br> (有名)	<b>かのじょはゆうめいなさっかです。</b> <br> She is a famous author. <br> [sound:4c-s-彼女は有名な作家です。.mp3]
She is a famous author.	<b>彼女は有名な作家です。</b> <br> かのじょはゆうめいなさっかです。 <br><br> (有名) <br> [sound:4c-s-彼女は有名な作家です。.mp3]
[sound:4c-k-署名.mp3]	<b>署名</b> <br> しょめい <br> signature
署名	<b>しょめい</b> <br> signature <br> [sound:4c-k-署名.mp3]
signature	<b>署名</b> <br> しょめい <br> [sound:4c-k-署名.mp3]
[sound:4c-s-この書類に署名してください。.mp3]	<b>この書類に署名してください。</b> <br> このしょるいにしょめいしてください。 <br><br> (署名) <br> Please sign this document.
この書類に署名してください。 <br><br> (署名)	<b>このしょるいにしょめいしてください。</b> <br> Please sign this document. <br> [sound:4c-s-この書類に署名してください。.mp3]
Please sign this document.	<b>この書類に署名してください。</b> <br> このしょるいにしょめいしてください。 <br><br> (署名) <br> [sound:4c-s-この書類に署名してください。.mp3]
[sound:4c-k-交換.mp3]	<b>交換</b> <br> こうかん <br> exchange, interchange, switching, reciprocity, barter, substitution, replacement, clearing (of checks, cheques)
交換	<b>こうかん</b> <br> exchange, interchange, switching, reciprocity, barter, substitution, replacement, clearing (of checks, cheques) <br> [sound:4c-k-交換.mp3]
exchange, interchange, switching, reciprocity, barter, substitution, replacement, clearing (of checks, cheques)	<b>交換</b> <br> こうかん <br> [sound:4c-k-交換.mp3]
[sound:4c-s-名刺を交換しました。.mp3]	<b>名刺を交換しました。</b> <br> めいしをこうかんしました。 <br><br> (交換) <br> We exchanged business cards.
名刺を交換しました。 <br><br> (交換)	<b>めいしをこうかんしました。</b> <br> We exchanged business cards. <br> [sound:4c-s-名刺を交換しました。.mp3]
We exchanged business cards.	<b>名刺を交換しました。</b> <br> めいしをこうかんしました。 <br><br> (交換) <br> [sound:4c-s-名刺を交換しました。.mp3]
[sound:4c-k-交通.mp3]	<b>交通</b> <br> こうつう <br> communication, transportation, traffic, intercourse
交通	<b>こうつう</b> <br> communication, transportation, traffic, intercourse <br> [sound:4c-k-交通.mp3]
communication, transportation, traffic, intercourse	<b>交通</b> <br> こうつう <br> [sound:4c-k-交通.mp3]
[sound:4c-s-交通事故が発生しました。.mp3]	<b>交通事故が発生しました。</b> <br> こうつうじこがはっせいしました。 <br><br> (交通) <br> A traffic accident occurred.
交通事故が発生しました。 <br><br> (交通)	<b>こうつうじこがはっせいしました。</b> <br> A traffic accident occurred. <br> [sound:4c-s-交通事故が発生しました。.mp3]
A traffic accident occurred.	<b>交通事故が発生しました。</b> <br> こうつうじこがはっせいしました。 <br><br> (交通) <br> [sound:4c-s-交通事故が発生しました。.mp3]
[sound:4c-k-国交.mp3]	<b>国交</b> <br> こっこう <br> diplomatic relations
国交	<b>こっこう</b> <br> diplomatic relations <br> [sound:4c-k-国交.mp3]
diplomatic relations	<b>国交</b> <br> こっこう <br> [sound:4c-k-国交.mp3]
[sound:4c-s-両国は国交を樹立しました。.mp3]	<b>両国は国交を樹立しました。</b> <br> りょうこくはこっこうをじゅりつしました。 <br><br> (国交) <br> The two countries established diplomatic relations.
両国は国交を樹立しました。 <br><br> (国交)	<b>りょうこくはこっこうをじゅりつしました。</b> <br> The two countries established diplomatic relations. <br> [sound:4c-s-両国は国交を樹立しました。.mp3]
The two countries established diplomatic relations.	<b>両国は国交を樹立しました。</b> <br> りょうこくはこっこうをじゅりつしました。 <br><br> (国交) <br> [sound:4c-s-両国は国交を樹立しました。.mp3]
[sound:4c-k-交代.mp3]	<b>交代</b> <br> こうたい <br> alternation, change, relief, relay, shift, substitution (sports, etc.)
交代	<b>こうたい</b> <br> alternation, change, relief, relay, shift, substitution (sports, etc.) <br> [sound:4c-k-交代.mp3]
alternation, change, relief, relay, shift, substitution (sports, etc.)	<b>交代</b> <br> こうたい <br> [sound:4c-k-交代.mp3]
[sound:4c-s-選手が交代しました。.mp3]	<b>選手が交代しました。</b> <br> せんしゅがこうたいしました。 <br><br> (交代) <br> The player was substituted.
選手が交代しました。 <br><br> (交代)	<b>せんしゅがこうたいしました。</b> <br> The player was substituted. <br> [sound:4c-s-選手が交代しました。.mp3]
The player was substituted.	<b>選手が交代しました。</b> <br> せんしゅがこうたいしました。 <br><br> (交代) <br> [sound:4c-s-選手が交代しました。.mp3]
[sound:4c-k-資産.mp3]	<b>資産</b> <br> しさん <br> property, fortune, means, assets
資産	<b>しさん</b> <br> property, fortune, means, assets <br> [sound:4c-k-資産.mp3]
property, fortune, means, assets	<b>資産</b> <br> しさん <br> [sound:4c-k-資産.mp3]
[sound:4c-s-彼は大きな資産を持っています。.mp3]	<b>彼は大きな資産を持っています。</b> <br> かれはおおきなしさんをもっています。 <br><br> (資産) <br> He owns significant assets.
彼は大きな資産を持っています。 <br><br> (資産)	<b>かれはおおきなしさんをもっています。</b> <br> He owns significant assets. <br> [sound:4c-s-彼は大きな資産を持っています。.mp3]
He owns significant assets.	<b>彼は大きな資産を持っています。</b> <br> かれはおおきなしさんをもっています。 <br><br> (資産) <br> [sound:4c-s-彼は大きな資産を持っています。.mp3]
[sound:4c-k-資料.mp3]	<b>資料</b> <br> しりょう <br> materials, data, document
資料	<b>しりょう</b> <br> materials, data, document <br> [sound:4c-k-資料.mp3]
materials, data, document	<b>資料</b> <br> しりょう <br> [sound:4c-k-資料.mp3]
[sound:4c-s-必要な資料を集めています。.mp3]	<b>必要な資料を集めています。</b> <br> ひつようなしりょうをあつめています。 <br><br> (資料) <br> I am gathering the necessary materials.
必要な資料を集めています。 <br><br> (資料)	<b>ひつようなしりょうをあつめています。</b> <br> I am gathering the necessary materials. <br> [sound:4c-s-必要な資料を集めています。.mp3]
I am gathering the necessary materials.	<b>必要な資料を集めています。</b> <br> ひつようなしりょうをあつめています。 <br><br> (資料) <br> [sound:4c-s-必要な資料を集めています。.mp3]
[sound:4c-k-資格.mp3]	<b>資格</b> <br> しかく <br> qualifications, requirements, capabilities
資格	<b>しかく</b> <br> qualifications, requirements, capabilities <br> [sound:4c-k-資格.mp3]
qualifications, requirements, capabilities	<b>資格</b> <br> しかく <br> [sound:4c-k-資格.mp3]
[sound:4c-s-教師になるには資格が必要です。.mp3]	<b>教師になるには資格が必要です。</b> <br> きょうしになるにはしかくがひつようです。 <br><br> (資格) <br> You need qualifications to become a teacher.
教師になるには資格が必要です。 <br><br> (資格)	<b>きょうしになるにはしかくがひつようです。</b> <br> You need qualifications to become a teacher. <br> [sound:4c-s-教師になるには資格が必要です。.mp3]
You need qualifications to become a teacher.	<b>教師になるには資格が必要です。</b> <br> きょうしになるにはしかくがひつようです。 <br><br> (資格) <br> [sound:4c-s-教師になるには資格が必要です。.mp3]
[sound:4c-k-資源.mp3]	<b>資源</b> <br> しげん <br> resources
資源	<b>しげん</b> <br> resources <br> [sound:4c-k-資源.mp3]
resources	<b>資源</b> <br> しげん <br> [sound:4c-k-資源.mp3]
[sound:4c-s-天然資源を大切にしましょう。.mp3]	<b>天然資源を大切にしましょう。</b> <br> てんねんしげんをたいせつにしましょう。 <br><br> (資源) <br> Let’s take care of natural resources.
天然資源を大切にしましょう。 <br><br> (資源)	<b>てんねんしげんをたいせつにしましょう。</b> <br> Let’s take care of natural resources. <br> [sound:4c-s-天然資源を大切にしましょう。.mp3]
Let’s take care of natural resources.	<b>天然資源を大切にしましょう。</b> <br> てんねんしげんをたいせつにしましょう。 <br><br> (資源) <br> [sound:4c-s-天然資源を大切にしましょう。.mp3]
[sound:4c-k-予想.mp3]	<b>予想</b> <br> よそう <br> expectation, anticipation, prediction, forecast
予想	<b>よそう</b> <br> expectation, anticipation, prediction, forecast <br> [sound:4c-k-予想.mp3]
expectation, anticipation, prediction, forecast	<b>予想</b> <br> よそう <br> [sound:4c-k-予想.mp3]
[sound:4c-s-天気予報では明日晴れると予想されています。.mp3]	<b>天気予報では明日晴れると予想されています。</b> <br> てんきよほうではあすはれるとよそうされています。 <br><br> (予想) <br> The weather forecast predicts it will be sunny tomorrow.
天気予報では明日晴れると予想されています。 <br><br> (予想)	<b>てんきよほうではあすはれるとよそうされています。</b> <br> The weather forecast predicts it will be sunny tomorrow. <br> [sound:4c-s-天気予報では明日晴れると予想されています。.mp3]
The weather forecast predicts it will be sunny tomorrow.	<b>天気予報では明日晴れると予想されています。</b> <br> てんきよほうではあすはれるとよそうされています。 <br><br> (予想) <br> [sound:4c-s-天気予報では明日晴れると予想されています。.mp3]
[sound:4c-k-予測.mp3]	<b>予測</b> <br> よそく <br> prediction, estimation
予測	<b>よそく</b> <br> prediction, estimation <br> [sound:4c-k-予測.mp3]
prediction, estimation	<b>予測</b> <br> よそく <br> [sound:4c-k-予測.mp3]
[sound:4c-s-彼は試合の結果を予測しました。.mp3]	<b>彼は試合の結果を予測しました。</b> <br> かれはしあいのけっかをよそくしました。 <br><br> (予測) <br> He predicted the outcome of the match.
彼は試合の結果を予測しました。 <br><br> (予測)	<b>かれはしあいのけっかをよそくしました。</b> <br> He predicted the outcome of the match. <br> [sound:4c-s-彼は試合の結果を予測しました。.mp3]
He predicted the outcome of the match.	<b>彼は試合の結果を予測しました。</b> <br> かれはしあいのけっかをよそくしました。 <br><br> (予測) <br> [sound:4c-s-彼は試合の結果を予測しました。.mp3]
[sound:4c-k-予備.mp3]	<b>予備</b> <br> よび <br> preparation, preliminaries, reserve, spare
予備	<b>よび</b> <br> preparation, preliminaries, reserve, spare <br> [sound:4c-k-予備.mp3]
preparation, preliminaries, reserve, spare	<b>予備</b> <br> よび <br> [sound:4c-k-予備.mp3]
[sound:4c-s-予備の電池を持って行きましょう。.mp3]	<b>予備の電池を持って行きましょう。</b> <br> よびのでんちをもっていきましょう。 <br><br> (予備) <br> Let’s bring extra batteries.
予備の電池を持って行きましょう。 <br><br> (予備)	<b>よびのでんちをもっていきましょう。</b> <br> Let’s bring extra batteries. <br> [sound:4c-s-予備の電池を持って行きましょう。.mp3]
Let’s bring extra batteries.	<b>予備の電池を持って行きましょう。</b> <br> よびのでんちをもっていきましょう。 <br><br> (予備) <br> [sound:4c-s-予備の電池を持って行きましょう。.mp3]
[sound:4c-k-予防.mp3]	<b>予防</b> <br> よぼう <br> prevention, precaution, protection against
予防	<b>よぼう</b> <br> prevention, precaution, protection against <br> [sound:4c-k-予防.mp3]
prevention, precaution, protection against	<b>予防</b> <br> よぼう <br> [sound:4c-k-予防.mp3]
[sound:4c-s-病気の予防が重要です。.mp3]	<b>病気の予防が重要です。</b> <br> びょうきのよぼうがじゅうようです。 <br><br> (予防) <br> Disease prevention is important.
病気の予防が重要です。 <br><br> (予防)	<b>びょうきのよぼうがじゅうようです。</b> <br> Disease prevention is important. <br> [sound:4c-s-病気の予防が重要です。.mp3]
Disease prevention is important.	<b>病気の予防が重要です。</b> <br> びょうきのよぼうがじゅうようです。 <br><br> (予防) <br> [sound:4c-s-病気の予防が重要です。.mp3]
[sound:4c-k-谷川.mp3]	<b>谷川</b> <br> たにがわ <br> mountain stream
谷川	<b>たにがわ</b> <br> mountain stream <br> [sound:4c-k-谷川.mp3]
mountain stream	<b>谷川</b> <br> たにがわ <br> [sound:4c-k-谷川.mp3]
[sound:4c-s-谷川の水はとてもきれいです。.mp3]	<b>谷川の水はとてもきれいです。</b> <br> たにがわの水はとてもきれいです。 <br><br> (谷川) <br> The water in the valley river is very clean.
谷川の水はとてもきれいです。 <br><br> (谷川)	<b>たにがわの水はとてもきれいです。</b> <br> The water in the valley river is very clean. <br> [sound:4c-s-谷川の水はとてもきれいです。.mp3]
The water in the valley river is very clean.	<b>谷川の水はとてもきれいです。</b> <br> たにがわの水はとてもきれいです。 <br><br> (谷川) <br> [sound:4c-s-谷川の水はとてもきれいです。.mp3]
[sound:4c-k-江戸川.mp3]	<b>江戸川</b> <br> えどがわ <br> Edo River
江戸川	<b>えどがわ</b> <br> Edo River <br> [sound:4c-k-江戸川.mp3]
Edo River	<b>江戸川</b> <br> えどがわ <br> [sound:4c-k-江戸川.mp3]
[sound:4c-s-江戸川で釣りをしました。.mp3]	<b>江戸川で釣りをしました。</b> <br> えどがわでつりをしました。 <br><br> (江戸川) <br> I went fishing in the Edogawa River.
江戸川で釣りをしました。 <br><br> (江戸川)	<b>えどがわでつりをしました。</b> <br> I went fishing in the Edogawa River. <br> [sound:4c-s-江戸川で釣りをしました。.mp3]
I went fishing in the Edogawa River.	<b>江戸川で釣りをしました。</b> <br> えどがわでつりをしました。 <br><br> (江戸川) <br> [sound:4c-s-江戸川で釣りをしました。.mp3]
[sound:4c-k-川口.mp3]	<b>川口</b> <br> かわぐち, かこう <br> mouth of river, estuary
川口	<b>かわぐち, かこう</b> <br> mouth of river, estuary <br> [sound:4c-k-川口.mp3]
mouth of river, estuary	<b>川口</b> <br> かわぐち, かこう <br> [sound:4c-k-川口.mp3]
[sound:4c-s-川口駅の近くに住んでいます。.mp3]	<b>川口駅の近くに住んでいます。</b> <br> かわぐちえきのちかくにすんでいます。 <br><br> (川口) <br> I live near Kawaguchi station.
川口駅の近くに住んでいます。 <br><br> (川口)	<b>かわぐちえきのちかくにすんでいます。</b> <br> I live near Kawaguchi station. <br> [sound:4c-s-川口駅の近くに住んでいます。.mp3]
I live near Kawaguchi station.	<b>川口駅の近くに住んでいます。</b> <br> かわぐちえきのちかくにすんでいます。 <br><br> (川口) <br> [sound:4c-s-川口駅の近くに住んでいます。.mp3]
[sound:4c-k-川上.mp3]	<b>川上</b> <br> かわかみ <br> upper reaches of a river
川上	<b>かわかみ</b> <br> upper reaches of a river <br> [sound:4c-k-川上.mp3]
upper reaches of a river	<b>川上</b> <br> かわかみ <br> [sound:4c-k-川上.mp3]
[sound:4c-s-川上にある温泉に行きました。.mp3]	<b>川上にある温泉に行きました。</b> <br> かわかみにあるおんせんにいきました。 <br><br> (川上) <br> I went to the hot springs upstream.
川上にある温泉に行きました。 <br><br> (川上)	<b>かわかみにあるおんせんにいきました。</b> <br> I went to the hot springs upstream. <br> [sound:4c-s-川上にある温泉に行きました。.mp3]
I went to the hot springs upstream.	<b>川上にある温泉に行きました。</b> <br> かわかみにあるおんせんにいきました。 <br><br> (川上) <br> [sound:4c-s-川上にある温泉に行きました。.mp3]
[sound:4c-k-向き.mp3]	<b>向き</b> <br> むき <br> direction, orientation, aspect, situation, exposure, suitability, tendency
向き	<b>むき</b> <br> direction, orientation, aspect, situation, exposure, suitability, tendency <br> [sound:4c-k-向き.mp3]
direction, orientation, aspect, situation, exposure, suitability, tendency	<b>向き</b> <br> むき <br> [sound:4c-k-向き.mp3]
[sound:4c-s-この部屋は北向きです。.mp3]	<b>この部屋は北向きです。</b> <br> このへやはきたむきです。 <br><br> (向き) <br> This room faces north.
この部屋は北向きです。 <br><br> (向き)	<b>このへやはきたむきです。</b> <br> This room faces north. <br> [sound:4c-s-この部屋は北向きです。.mp3]
This room faces north.	<b>この部屋は北向きです。</b> <br> このへやはきたむきです。 <br><br> (向き) <br> [sound:4c-s-この部屋は北向きです。.mp3]
[sound:4c-k-向上.mp3]	<b>向上</b> <br> こうじょう <br> elevation, rise, improvement, advancement, progress
向上	<b>こうじょう</b> <br> elevation, rise, improvement, advancement, progress <br> [sound:4c-k-向上.mp3]
elevation, rise, improvement, advancement, progress	<b>向上</b> <br> こうじょう <br> [sound:4c-k-向上.mp3]
[sound:4c-s-英語のスキルを向上させたいです。.mp3]	<b>英語のスキルを向上させたいです。</b> <br> えいごのすきるをこうじょうさせたいです。 <br><br> (向上) <br> I want to improve my English skills.
英語のスキルを向上させたいです。 <br><br> (向上)	<b>えいごのすきるをこうじょうさせたいです。</b> <br> I want to improve my English skills. <br> [sound:4c-s-英語のスキルを向上させたいです。.mp3]
I want to improve my English skills.	<b>英語のスキルを向上させたいです。</b> <br> えいごのすきるをこうじょうさせたいです。 <br><br> (向上) <br> [sound:4c-s-英語のスキルを向上させたいです。.mp3]
[sound:4c-k-動向.mp3]	<b>動向</b> <br> どうこう <br> trend, tendency, movement, attitude
動向	<b>どうこう</b> <br> trend, tendency, movement, attitude <br> [sound:4c-k-動向.mp3]
trend, tendency, movement, attitude	<b>動向</b> <br> どうこう <br> [sound:4c-k-動向.mp3]
[sound:4c-s-市場の動向を調べています。.mp3]	<b>市場の動向を調べています。</b> <br> しじょうのどうこうをしらべています。 <br><br> (動向) <br> I am studying the trends in the market.
市場の動向を調べています。 <br><br> (動向)	<b>しじょうのどうこうをしらべています。</b> <br> I am studying the trends in the market. <br> [sound:4c-s-市場の動向を調べています。.mp3]
I am studying the trends in the market.	<b>市場の動向を調べています。</b> <br> しじょうのどうこうをしらべています。 <br><br> (動向) <br> [sound:4c-s-市場の動向を調べています。.mp3]
[sound:4c-k-向い.mp3]	<b>向い</b> <br> むかい <br> facing, opposite, across the street, other side
向い	<b>むかい</b> <br> facing, opposite, across the street, other side <br> [sound:4c-k-向い.mp3]
facing, opposite, across the street, other side	<b>向い</b> <br> むかい <br> [sound:4c-k-向い.mp3]
[sound:4c-s-向いの店でランチを食べました。.mp3]	<b>向いの店でランチを食べました。</b> <br> むかいのみせでランチをたべました。 <br><br> (向い) <br> I had lunch at the store across the street.
向いの店でランチを食べました。 <br><br> (向い)	<b>むかいのみせでランチをたべました。</b> <br> I had lunch at the store across the street. <br> [sound:4c-s-向いの店でランチを食べました。.mp3]
I had lunch at the store across the street.	<b>向いの店でランチを食べました。</b> <br> むかいのみせでランチをたべました。 <br><br> (向い) <br> [sound:4c-s-向いの店でランチを食べました。.mp3]
[sound:4c-k-実際.mp3]	<b>実際</b> <br> じっさい <br> practicality, practical; reality, actuality, actual conditions; bhutakoti (limit of reality)
実際	<b>じっさい</b> <br> practicality, practical; reality, actuality, actual conditions; bhutakoti (limit of reality) <br> [sound:4c-k-実際.mp3]
practicality, practical; reality, actuality, actual conditions; bhutakoti (limit of reality)	<b>実際</b> <br> じっさい <br> [sound:4c-k-実際.mp3]
[sound:4c-s-実際には違う結果が出ました。.mp3]	<b>実際には違う結果が出ました。</b> <br> じっさいにはちがうけっかがでました。 <br><br> (実際) <br> In reality, a different result came out.
実際には違う結果が出ました。 <br><br> (実際)	<b>じっさいにはちがうけっかがでました。</b> <br> In reality, a different result came out. <br> [sound:4c-s-実際には違う結果が出ました。.mp3]
In reality, a different result came out.	<b>実際には違う結果が出ました。</b> <br> じっさいにはちがうけっかがでました。 <br><br> (実際) <br> [sound:4c-s-実際には違う結果が出ました。.mp3]
[sound:4c-k-国際化.mp3]	<b>国際化</b> <br> こくさいか <br> internationalization, internationalisation, i18n (in IT)
国際化	<b>こくさいか</b> <br> internationalization, internationalisation, i18n (in IT) <br> [sound:4c-k-国際化.mp3]
internationalization, internationalisation, i18n (in IT)	<b>国際化</b> <br> こくさいか <br> [sound:4c-k-国際化.mp3]
[sound:4c-s-国際化が進んでいます。.mp3]	<b>国際化が進んでいます。</b> <br> こくさいかがすすんでいます。 <br><br> (国際化) <br> Globalization is progressing.
国際化が進んでいます。 <br><br> (国際化)	<b>こくさいかがすすんでいます。</b> <br> Globalization is progressing. <br> [sound:4c-s-国際化が進んでいます。.mp3]
Globalization is progressing.	<b>国際化が進んでいます。</b> <br> こくさいかがすすんでいます。 <br><br> (国際化) <br> [sound:4c-s-国際化が進んでいます。.mp3]
[sound:4c-k-国際法.mp3]	<b>国際法</b> <br> こくさいほう <br> international laws
国際法	<b>こくさいほう</b> <br> international laws <br> [sound:4c-k-国際法.mp3]
international laws	<b>国際法</b> <br> こくさいほう <br> [sound:4c-k-国際法.mp3]
[sound:4c-s-国際法を守ることは重要です。.mp3]	<b>国際法を守ることは重要です。</b> <br> こくさいほうをまもることはじゅうようです。 <br><br> (国際法) <br> Observing international law is important.
国際法を守ることは重要です。 <br><br> (国際法)	<b>こくさいほうをまもることはじゅうようです。</b> <br> Observing international law is important. <br> [sound:4c-s-国際法を守ることは重要です。.mp3]
Observing international law is important.	<b>国際法を守ることは重要です。</b> <br> こくさいほうをまもることはじゅうようです。 <br><br> (国際法) <br> [sound:4c-s-国際法を守ることは重要です。.mp3]
[sound:4c-k-交際.mp3]	<b>交際</b> <br> こうさい <br> company, friendship, association, society, acquaintance
交際	<b>こうさい</b> <br> company, friendship, association, society, acquaintance <br> [sound:4c-k-交際.mp3]
company, friendship, association, society, acquaintance	<b>交際</b> <br> こうさい <br> [sound:4c-k-交際.mp3]
[sound:4c-s-彼とは長い交際を続けています。.mp3]	<b>彼とは長い交際を続けています。</b> <br> かれとはながいこうさいをつづけています。 <br><br> (交際) <br> I have been in a long relationship with him.
彼とは長い交際を続けています。 <br><br> (交際)	<b>かれとはながいこうさいをつづけています。</b> <br> I have been in a long relationship with him. <br> [sound:4c-s-彼とは長い交際を続けています。.mp3]
I have been in a long relationship with him.	<b>彼とは長い交際を続けています。</b> <br> かれとはながいこうさいをつづけています。 <br><br> (交際) <br> [sound:4c-s-彼とは長い交際を続けています。.mp3]
[sound:4c-k-査察.mp3]	<b>査察</b> <br> ささつ <br> inspection (for compliance), investigation (tax, etc.)
査察	<b>ささつ</b> <br> inspection (for compliance), investigation (tax, etc.) <br> [sound:4c-k-査察.mp3]
inspection (for compliance), investigation (tax, etc.)	<b>査察</b> <br> ささつ <br> [sound:4c-k-査察.mp3]
[sound:4c-s-政府は工場に査察を行いました。.mp3]	<b>政府は工場に査察を行いました。</b> <br> せいふはこうじょうにささつをおこないました。 <br><br> (査察) <br> The government conducted an inspection at the factory.
政府は工場に査察を行いました。 <br><br> (査察)	<b>せいふはこうじょうにささつをおこないました。</b> <br> The government conducted an inspection at the factory. <br> [sound:4c-s-政府は工場に査察を行いました。.mp3]
The government conducted an inspection at the factory.	<b>政府は工場に査察を行いました。</b> <br> せいふはこうじょうにささつをおこないました。 <br><br> (査察) <br> [sound:4c-s-政府は工場に査察を行いました。.mp3]
[sound:4c-k-審査.mp3]	<b>審査</b> <br> しんさ <br> judging, inspection, examination, investigation
審査	<b>しんさ</b> <br> judging, inspection, examination, investigation <br> [sound:4c-k-審査.mp3]
judging, inspection, examination, investigation	<b>審査</b> <br> しんさ <br> [sound:4c-k-審査.mp3]
[sound:4c-s-映画は審査を通過しました。.mp3]	<b>映画は審査を通過しました。</b> <br> えいがはしんさをつうかしました。 <br><br> (審査) <br> The movie passed the review.
映画は審査を通過しました。 <br><br> (審査)	<b>えいがはしんさをつうかしました。</b> <br> The movie passed the review. <br> [sound:4c-s-映画は審査を通過しました。.mp3]
The movie passed the review.	<b>映画は審査を通過しました。</b> <br> えいがはしんさをつうかしました。 <br><br> (審査) <br> [sound:4c-s-映画は審査を通過しました。.mp3]
[sound:4c-k-実態調査.mp3]	<b>実態調査</b> <br> じったいちょうさ <br> factual investigation
実態調査	<b>じったいちょうさ</b> <br> factual investigation <br> [sound:4c-k-実態調査.mp3]
factual investigation	<b>実態調査</b> <br> じったいちょうさ <br> [sound:4c-k-実態調査.mp3]
[sound:4c-s-実態調査を行う予定です。.mp3]	<b>実態調査を行う予定です。</b> <br> じったいちょうさをおこなうよていです。 <br><br> (実態調査) <br> A survey of the actual conditions is planned.
実態調査を行う予定です。 <br><br> (実態調査)	<b>じったいちょうさをおこなうよていです。</b> <br> A survey of the actual conditions is planned. <br> [sound:4c-s-実態調査を行う予定です。.mp3]
A survey of the actual conditions is planned.	<b>実態調査を行う予定です。</b> <br> じったいちょうさをおこなうよていです。 <br><br> (実態調査) <br> [sound:4c-s-実態調査を行う予定です。.mp3]
[sound:4c-k-監査役.mp3]	<b>監査役</b> <br> かんさやく <br> auditor, inspector
監査役	<b>かんさやく</b> <br> auditor, inspector <br> [sound:4c-k-監査役.mp3]
auditor, inspector	<b>監査役</b> <br> かんさやく <br> [sound:4c-k-監査役.mp3]
[sound:4c-s-監査役が財務報告を確認しました。.mp3]	<b>監査役が財務報告を確認しました。</b> <br> かんさやくがざいむほうこくをかくにんしました。 <br><br> (監査役) <br> The auditor checked the financial reports.
監査役が財務報告を確認しました。 <br><br> (監査役)	<b>かんさやくがざいむほうこくをかくにんしました。</b> <br> The auditor checked the financial reports. <br> [sound:4c-s-監査役が財務報告を確認しました。.mp3]
The auditor checked the financial reports.	<b>監査役が財務報告を確認しました。</b> <br> かんさやくがざいむほうこくをかくにんしました。 <br><br> (監査役) <br> [sound:4c-s-監査役が財務報告を確認しました。.mp3]
[sound:4c-k-決勝.mp3]	<b>決勝</b> <br> けっしょう <br> decision of a contest, finals (in sports)
決勝	<b>けっしょう</b> <br> decision of a contest, finals (in sports) <br> [sound:4c-k-決勝.mp3]
decision of a contest, finals (in sports)	<b>決勝</b> <br> けっしょう <br> [sound:4c-k-決勝.mp3]
[sound:4c-s-決勝戦は来週行われます。.mp3]	<b>決勝戦は来週行われます。</b> <br> けっしょうせんはらいしゅうおこなわれます。 <br><br> (決勝) <br> The final match will take place next week.
決勝戦は来週行われます。 <br><br> (決勝)	<b>けっしょうせんはらいしゅうおこなわれます。</b> <br> The final match will take place next week. <br> [sound:4c-s-決勝戦は来週行われます。.mp3]
The final match will take place next week.	<b>決勝戦は来週行われます。</b> <br> けっしょうせんはらいしゅうおこなわれます。 <br><br> (決勝) <br> [sound:4c-s-決勝戦は来週行われます。.mp3]
[sound:4c-k-勝利.mp3]	<b>勝利</b> <br> しょうり <br> victory, triumph, conquest, success, win
勝利	<b>しょうり</b> <br> victory, triumph, conquest, success, win <br> [sound:4c-k-勝利.mp3]
victory, triumph, conquest, success, win	<b>勝利</b> <br> しょうり <br> [sound:4c-k-勝利.mp3]
[sound:4c-s-彼は勝利を収めました。.mp3]	<b>彼は勝利を収めました。</b> <br> かれはしょうりをおさめました。 <br><br> (勝利) <br> He achieved victory.
彼は勝利を収めました。 <br><br> (勝利)	<b>かれはしょうりをおさめました。</b> <br> He achieved victory. <br> [sound:4c-s-彼は勝利を収めました。.mp3]
He achieved victory.	<b>彼は勝利を収めました。</b> <br> かれはしょうりをおさめました。 <br><br> (勝利) <br> [sound:4c-s-彼は勝利を収めました。.mp3]
[sound:4c-k-勝負.mp3]	<b>勝負</b> <br> しょうぶ <br> victory or defeat, match, contest, game, bout
勝負	<b>しょうぶ</b> <br> victory or defeat, match, contest, game, bout <br> [sound:4c-k-勝負.mp3]
victory or defeat, match, contest, game, bout	<b>勝負</b> <br> しょうぶ <br> [sound:4c-k-勝負.mp3]
[sound:4c-s-今日の試合は勝負です。.mp3]	<b>今日の試合は勝負です。</b> <br> きょうのしあいはしょうぶです。 <br><br> (勝負) <br> Todays' match is crucial.
今日の試合は勝負です。 <br><br> (勝負)	<b>きょうのしあいはしょうぶです。</b> <br> Todays' match is crucial. <br> [sound:4c-s-今日の試合は勝負です。.mp3]
Todays' match is crucial.	<b>今日の試合は勝負です。</b> <br> きょうのしあいはしょうぶです。 <br><br> (勝負) <br> [sound:4c-s-今日の試合は勝負です。.mp3]
[sound:4c-k-連勝.mp3]	<b>連勝</b> <br> れんしょう <br> consecutive victories, series of victories
連勝	<b>れんしょう</b> <br> consecutive victories, series of victories <br> [sound:4c-k-連勝.mp3]
consecutive victories, series of victories	<b>連勝</b> <br> れんしょう <br> [sound:4c-k-連勝.mp3]
[sound:4c-s-彼は今、10連勝しています。.mp3]	<b>彼は今、10連勝しています。</b> <br> かれはいま、10れんしょうしています。 <br><br> (連勝) <br> He is on a 10-game winning streak.
彼は今、10連勝しています。 <br><br> (連勝)	<b>かれはいま、10れんしょうしています。</b> <br> He is on a 10-game winning streak. <br> [sound:4c-s-彼は今、10連勝しています。.mp3]
He is on a 10-game winning streak.	<b>彼は今、10連勝しています。</b> <br> かれはいま、10れんしょうしています。 <br><br> (連勝) <br> [sound:4c-s-彼は今、10連勝しています。.mp3]
[sound:4c-k-場面.mp3]	<b>場面</b> <br> ばめん <br> scene, setting (e.g. of novel)
場面	<b>ばめん</b> <br> scene, setting (e.g. of novel) <br> [sound:4c-k-場面.mp3]
scene, setting (e.g. of novel)	<b>場面</b> <br> ばめん <br> [sound:4c-k-場面.mp3]
[sound:4c-s-映画の最も感動的な場面はここです。.mp3]	<b>映画の最も感動的な場面はここです。</b> <br> えいがのもっともかんどうてきなばめんはここです。 <br><br> (場面) <br> The most emotional scene in the movie is here.
映画の最も感動的な場面はここです。 <br><br> (場面)	<b>えいがのもっともかんどうてきなばめんはここです。</b> <br> The most emotional scene in the movie is here. <br> [sound:4c-s-映画の最も感動的な場面はここです。.mp3]
The most emotional scene in the movie is here.	<b>映画の最も感動的な場面はここです。</b> <br> えいがのもっともかんどうてきなばめんはここです。 <br><br> (場面) <br> [sound:4c-s-映画の最も感動的な場面はここです。.mp3]
[sound:4c-k-画面.mp3]	<b>画面</b> <br> がめん <br> terminal screen, scene, picture, the field (in TV), photo
画面	<b>がめん</b> <br> terminal screen, scene, picture, the field (in TV), photo <br> [sound:4c-k-画面.mp3]
terminal screen, scene, picture, the field (in TV), photo	<b>画面</b> <br> がめん <br> [sound:4c-k-画面.mp3]
[sound:4c-s-画面が突然暗くなりました。.mp3]	<b>画面が突然暗くなりました。</b> <br> がめんがとつぜんくらくなりました。 <br><br> (画面) <br> The screen suddenly went dark.
画面が突然暗くなりました。 <br><br> (画面)	<b>がめんがとつぜんくらくなりました。</b> <br> The screen suddenly went dark. <br> [sound:4c-s-画面が突然暗くなりました。.mp3]
The screen suddenly went dark.	<b>画面が突然暗くなりました。</b> <br> がめんがとつぜんくらくなりました。 <br><br> (画面) <br> [sound:4c-s-画面が突然暗くなりました。.mp3]
[sound:4c-k-局面.mp3]	<b>局面</b> <br> きょくめん <br> checkerboard, aspect, situation
局面	<b>きょくめん</b> <br> checkerboard, aspect, situation <br> [sound:4c-k-局面.mp3]
checkerboard, aspect, situation	<b>局面</b> <br> きょくめん <br> [sound:4c-k-局面.mp3]
[sound:4c-s-試合は新しい局面に入りました。.mp3]	<b>試合は新しい局面に入りました。</b> <br> しあいはあたらしいきょくめんにはいりました。 <br><br> (局面) <br> The game has entered a new phase.
試合は新しい局面に入りました。 <br><br> (局面)	<b>しあいはあたらしいきょくめんにはいりました。</b> <br> The game has entered a new phase. <br> [sound:4c-s-試合は新しい局面に入りました。.mp3]
The game has entered a new phase.	<b>試合は新しい局面に入りました。</b> <br> しあいはあたらしいきょくめんにはいりました。 <br><br> (局面) <br> [sound:4c-s-試合は新しい局面に入りました。.mp3]
[sound:4c-k-社会面.mp3]	<b>社会面</b> <br> しゃかいめん <br> society or local news page
社会面	<b>しゃかいめん</b> <br> society or local news page <br> [sound:4c-k-社会面.mp3]
society or local news page	<b>社会面</b> <br> しゃかいめん <br> [sound:4c-k-社会面.mp3]
[sound:4c-s-新聞の社会面で記事が掲載されました。.mp3]	<b>新聞の社会面で記事が掲載されました。</b> <br> しんぶんのしゃかいめんできじがけいさいされました。 <br><br> (社会面) <br> An article was published on the social page of the newspaper.
新聞の社会面で記事が掲載されました。 <br><br> (社会面)	<b>しんぶんのしゃかいめんできじがけいさいされました。</b> <br> An article was published on the social page of the newspaper. <br> [sound:4c-s-新聞の社会面で記事が掲載されました。.mp3]
An article was published on the social page of the newspaper.	<b>新聞の社会面で記事が掲載されました。</b> <br> しんぶんのしゃかいめんできじがけいさいされました。 <br><br> (社会面) <br> [sound:4c-s-新聞の社会面で記事が掲載されました。.mp3]
[sound:4c-k-公取委.mp3]	<b>公取委</b> <br> こうとりい <br> Fair Trade Commission
公取委	<b>こうとりい</b> <br> Fair Trade Commission <br> [sound:4c-k-公取委.mp3]
Fair Trade Commission	<b>公取委</b> <br> こうとりい <br> [sound:4c-k-公取委.mp3]
[sound:4c-s-公取委が企業合併を調査しています。.mp3]	<b>公取委が企業合併を調査しています。</b> <br> こうとりいがきぎょうがっぺいをちょうさしています。 <br><br> (公取委) <br> The Fair Trade Commission is investigating a corporate merger.
公取委が企業合併を調査しています。 <br><br> (公取委)	<b>こうとりいがきぎょうがっぺいをちょうさしています。</b> <br> The Fair Trade Commission is investigating a corporate merger. <br> [sound:4c-s-公取委が企業合併を調査しています。.mp3]
The Fair Trade Commission is investigating a corporate merger.	<b>公取委が企業合併を調査しています。</b> <br> こうとりいがきぎょうがっぺいをちょうさしています。 <br><br> (公取委) <br> [sound:4c-s-公取委が企業合併を調査しています。.mp3]
[sound:4c-k-委託.mp3]	<b>委託</b> <br> いたく <br> consign (goods (for sale) to a firm), entrust (person with something), commit
委託	<b>いたく</b> <br> consign (goods (for sale) to a firm), entrust (person with something), commit <br> [sound:4c-k-委託.mp3]
consign (goods (for sale) to a firm), entrust (person with something), commit	<b>委託</b> <br> いたく <br> [sound:4c-k-委託.mp3]
[sound:4c-s-プロジェクトは外部に委託されました。.mp3]	<b>プロジェクトは外部に委託されました。</b> <br> ぷろじぇくとはがいぶにいたくされました。 <br><br> (委託) <br> The project was outsourced.
プロジェクトは外部に委託されました。 <br><br> (委託)	<b>ぷろじぇくとはがいぶにいたくされました。</b> <br> The project was outsourced. <br> [sound:4c-s-プロジェクトは外部に委託されました。.mp3]
The project was outsourced.	<b>プロジェクトは外部に委託されました。</b> <br> ぷろじぇくとはがいぶにいたくされました。 <br><br> (委託) <br> [sound:4c-s-プロジェクトは外部に委託されました。.mp3]
[sound:4c-k-教育委員会.mp3]	<b>教育委員会</b> <br> きょういくいいんかい <br> Board of Education
教育委員会	<b>きょういくいいんかい</b> <br> Board of Education <br> [sound:4c-k-教育委員会.mp3]
Board of Education	<b>教育委員会</b> <br> きょういくいいんかい <br> [sound:4c-k-教育委員会.mp3]
[sound:4c-s-教育委員会が新しいカリキュラムを発表しました。.mp3]	<b>教育委員会が新しいカリキュラムを発表しました。</b> <br> きょういくいいんかいがあたらしいかりきゅらむをはっぴょうしました。 <br><br> (教育委員会) <br> The Board of Education announced a new curriculum.
教育委員会が新しいカリキュラムを発表しました。 <br><br> (教育委員会)	<b>きょういくいいんかいがあたらしいかりきゅらむをはっぴょうしました。</b> <br> The Board of Education announced a new curriculum. <br> [sound:4c-s-教育委員会が新しいカリキュラムを発表しました。.mp3]
The Board of Education announced a new curriculum.	<b>教育委員会が新しいカリキュラムを発表しました。</b> <br> きょういくいいんかいがあたらしいかりきゅらむをはっぴょうしました。 <br><br> (教育委員会) <br> [sound:4c-s-教育委員会が新しいカリキュラムを発表しました。.mp3]
[sound:4c-k-執行委員.mp3]	<b>執行委員</b> <br> しっこういいん <br> executive committee
執行委員	<b>しっこういいん</b> <br> executive committee <br> [sound:4c-k-執行委員.mp3]
executive committee	<b>執行委員</b> <br> しっこういいん <br> [sound:4c-k-執行委員.mp3]
[sound:4c-s-執行委員が会議を開きました。.mp3]	<b>執行委員が会議を開きました。</b> <br> しっこういいんがかいぎをひらきました。 <br><br> (執行委員) <br> The executive committee held a meeting.
執行委員が会議を開きました。 <br><br> (執行委員)	<b>しっこういいんがかいぎをひらきました。</b> <br> The executive committee held a meeting. <br> [sound:4c-s-執行委員が会議を開きました。.mp3]
The executive committee held a meeting.	<b>執行委員が会議を開きました。</b> <br> しっこういいんがかいぎをひらきました。 <br><br> (執行委員) <br> [sound:4c-s-執行委員が会議を開きました。.mp3]
[sound:4c-k-広告.mp3]	<b>広告</b> <br> こうこく <br> advertisement
広告	<b>こうこく</b> <br> advertisement <br> [sound:4c-k-広告.mp3]
advertisement	<b>広告</b> <br> こうこく <br> [sound:4c-k-広告.mp3]
[sound:4c-s-テレビ広告が流れています。.mp3]	<b>テレビ広告が流れています。</b> <br> てれびこうこくがながれています。 <br><br> (広告) <br> A TV advertisement is airing.
テレビ広告が流れています。 <br><br> (広告)	<b>てれびこうこくがながれています。</b> <br> A TV advertisement is airing. <br> [sound:4c-s-テレビ広告が流れています。.mp3]
A TV advertisement is airing.	<b>テレビ広告が流れています。</b> <br> てれびこうこくがながれています。 <br><br> (広告) <br> [sound:4c-s-テレビ広告が流れています。.mp3]
[sound:4c-k-報告書.mp3]	<b>報告書</b> <br> ほうこくしょ <br> (written) report
報告書	<b>ほうこくしょ</b> <br> (written) report <br> [sound:4c-k-報告書.mp3]
(written) report	<b>報告書</b> <br> ほうこくしょ <br> [sound:4c-k-報告書.mp3]
[sound:4c-s-報告書の提出期限は来週です。.mp3]	<b>報告書の提出期限は来週です。</b> <br> ほうこくしょのていしゅつきげんはらいしゅうです。 <br><br> (報告書) <br> The deadline for submitting the report is next week.
報告書の提出期限は来週です。 <br><br> (報告書)	<b>ほうこくしょのていしゅつきげんはらいしゅうです。</b> <br> The deadline for submitting the report is next week. <br> [sound:4c-s-報告書の提出期限は来週です。.mp3]
The deadline for submitting the report is next week.	<b>報告書の提出期限は来週です。</b> <br> ほうこくしょのていしゅつきげんはらいしゅうです。 <br><br> (報告書) <br> [sound:4c-s-報告書の提出期限は来週です。.mp3]
[sound:4c-k-原告.mp3]	<b>原告</b> <br> げんこく <br> plaintiff, accuser, prosecutor
原告	<b>げんこく</b> <br> plaintiff, accuser, prosecutor <br> [sound:4c-k-原告.mp3]
plaintiff, accuser, prosecutor	<b>原告</b> <br> げんこく <br> [sound:4c-k-原告.mp3]
[sound:4c-s-原告は証拠を提出しました。.mp3]	<b>原告は証拠を提出しました。</b> <br> げんこくはしょうこをていしゅつしました。 <br><br> (原告) <br> The plaintiff submitted evidence.
原告は証拠を提出しました。 <br><br> (原告)	<b>げんこくはしょうこをていしゅつしました。</b> <br> The plaintiff submitted evidence. <br> [sound:4c-s-原告は証拠を提出しました。.mp3]
The plaintiff submitted evidence.	<b>原告は証拠を提出しました。</b> <br> げんこくはしょうこをていしゅつしました。 <br><br> (原告) <br> [sound:4c-s-原告は証拠を提出しました。.mp3]
[sound:4c-k-勧告.mp3]	<b>勧告</b> <br> かんこく <br> advice, counsel, remonstrance, recommendation
勧告	<b>かんこく</b> <br> advice, counsel, remonstrance, recommendation <br> [sound:4c-k-勧告.mp3]
advice, counsel, remonstrance, recommendation	<b>勧告</b> <br> かんこく <br> [sound:4c-k-勧告.mp3]
[sound:4c-s-政府は環境保護に関する勧告を出しました。.mp3]	<b>政府は環境保護に関する勧告を出しました。</b> <br> せいふはかんきょうほごにかんするかんこくをだしました。 <br><br> (勧告) <br> The government issued recommendations concerning environmental protection.
政府は環境保護に関する勧告を出しました。 <br><br> (勧告)	<b>せいふはかんきょうほごにかんするかんこくをだしました。</b> <br> The government issued recommendations concerning environmental protection. <br> [sound:4c-s-政府は環境保護に関する勧告を出しました。.mp3]
The government issued recommendations concerning environmental protection.	<b>政府は環境保護に関する勧告を出しました。</b> <br> せいふはかんきょうほごにかんするかんこくをだしました。 <br><br> (勧告) <br> [sound:4c-s-政府は環境保護に関する勧告を出しました。.mp3]
[sound:4c-k-軍縮.mp3]	<b>軍縮</b> <br> ぐんしゅく <br> disarmament, limitation of arms
軍縮	<b>ぐんしゅく</b> <br> disarmament, limitation of arms <br> [sound:4c-k-軍縮.mp3]
disarmament, limitation of arms	<b>軍縮</b> <br> ぐんしゅく <br> [sound:4c-k-軍縮.mp3]
[sound:4c-s-国際社会で軍縮が進められています。.mp3]	<b>国際社会で軍縮が進められています。</b> <br> こくさいしゃかいでぐんしゅくがすすめられています。 <br><br> (軍縮) <br> Arms reduction is being promoted in the international community.
国際社会で軍縮が進められています。 <br><br> (軍縮)	<b>こくさいしゃかいでぐんしゅくがすすめられています。</b> <br> Arms reduction is being promoted in the international community. <br> [sound:4c-s-国際社会で軍縮が進められています。.mp3]
Arms reduction is being promoted in the international community.	<b>国際社会で軍縮が進められています。</b> <br> こくさいしゃかいでぐんしゅくがすすめられています。 <br><br> (軍縮) <br> [sound:4c-s-国際社会で軍縮が進められています。.mp3]
[sound:4c-k-空軍.mp3]	<b>空軍</b> <br> くうぐん <br> Air Force
空軍	<b>くうぐん</b> <br> Air Force <br> [sound:4c-k-空軍.mp3]
Air Force	<b>空軍</b> <br> くうぐん <br> [sound:4c-k-空軍.mp3]
[sound:4c-s-空軍の飛行機が演習を行っています。.mp3]	<b>空軍の飛行機が演習を行っています。</b> <br> くうぐんのひこうきがえんしゅうをおこなっています。 <br><br> (空軍) <br> The air force planes are conducting drills.
空軍の飛行機が演習を行っています。 <br><br> (空軍)	<b>くうぐんのひこうきがえんしゅうをおこなっています。</b> <br> The air force planes are conducting drills. <br> [sound:4c-s-空軍の飛行機が演習を行っています。.mp3]
The air force planes are conducting drills.	<b>空軍の飛行機が演習を行っています。</b> <br> くうぐんのひこうきがえんしゅうをおこなっています。 <br><br> (空軍) <br> [sound:4c-s-空軍の飛行機が演習を行っています。.mp3]
[sound:4c-k-軍人.mp3]	<b>軍人</b> <br> ぐんじん <br> military personnel, soldier
軍人	<b>ぐんじん</b> <br> military personnel, soldier <br> [sound:4c-k-軍人.mp3]
military personnel, soldier	<b>軍人</b> <br> ぐんじん <br> [sound:4c-k-軍人.mp3]
[sound:4c-s-彼は軍人として戦いました。.mp3]	<b>彼は軍人として戦いました。</b> <br> かれはぐんじんとしてたたかいました。 <br><br> (軍人) <br> He fought as a soldier.
彼は軍人として戦いました。 <br><br> (軍人)	<b>かれはぐんじんとしてたたかいました。</b> <br> He fought as a soldier. <br> [sound:4c-s-彼は軍人として戦いました。.mp3]
He fought as a soldier.	<b>彼は軍人として戦いました。</b> <br> かれはぐんじんとしてたたかいました。 <br><br> (軍人) <br> [sound:4c-s-彼は軍人として戦いました。.mp3]
[sound:4c-k-軍部.mp3]	<b>軍部</b> <br> ぐんぶ <br> military authorities, army circles
軍部	<b>ぐんぶ</b> <br> military authorities, army circles <br> [sound:4c-k-軍部.mp3]
military authorities, army circles	<b>軍部</b> <br> ぐんぶ <br> [sound:4c-k-軍部.mp3]
[sound:4c-s-軍部の影響が強かった時代です。.mp3]	<b>軍部の影響が強かった時代です。</b> <br> ぐんぶのえいきょうがつよかったじだいです。 <br><br> (軍部) <br> It was an era when the military had strong influence.
軍部の影響が強かった時代です。 <br><br> (軍部)	<b>ぐんぶのえいきょうがつよかったじだいです。</b> <br> It was an era when the military had strong influence. <br> [sound:4c-s-軍部の影響が強かった時代です。.mp3]
It was an era when the military had strong influence.	<b>軍部の影響が強かった時代です。</b> <br> ぐんぶのえいきょうがつよかったじだいです。 <br><br> (軍部) <br> [sound:4c-s-軍部の影響が強かった時代です。.mp3]
[sound:4c-k-文書.mp3]	<b>文書</b> <br> ぶんしょ, もんじょ <br> document, writing, letter, paperwork, note, records, archives
文書	<b>ぶんしょ, もんじょ</b> <br> document, writing, letter, paperwork, note, records, archives <br> [sound:4c-k-文書.mp3]
document, writing, letter, paperwork, note, records, archives	<b>文書</b> <br> ぶんしょ, もんじょ <br> [sound:4c-k-文書.mp3]
[sound:4c-s-重要な文書を保管しています。.mp3]	<b>重要な文書を保管しています。</b> <br> じゅうようなぶんしょをほかんしています。 <br><br> (文書) <br> We are storing important documents.
重要な文書を保管しています。 <br><br> (文書)	<b>じゅうようなぶんしょをほかんしています。</b> <br> We are storing important documents. <br> [sound:4c-s-重要な文書を保管しています。.mp3]
We are storing important documents.	<b>重要な文書を保管しています。</b> <br> じゅうようなぶんしょをほかんしています。 <br><br> (文書) <br> [sound:4c-s-重要な文書を保管しています。.mp3]
[sound:4c-k-文字.mp3]	<b>文字</b> <br> もじ, もんじ <br> letter (of alphabet), character; literal
文字	<b>もじ, もんじ</b> <br> letter (of alphabet), character; literal <br> [sound:4c-k-文字.mp3]
letter (of alphabet), character; literal	<b>文字</b> <br> もじ, もんじ <br> [sound:4c-k-文字.mp3]
[sound:4c-s-この文字は古代のもので、意味が不明です。.mp3]	<b>この文字は古代のもので、意味が不明です。</b> <br> このもじはこだいのもので、いみがふめいです。 <br><br> (文字) <br> This character is ancient, and its meaning is unclear.
この文字は古代のもので、意味が不明です。 <br><br> (文字)	<b>このもじはこだいのもので、いみがふめいです。</b> <br> This character is ancient, and its meaning is unclear. <br> [sound:4c-s-この文字は古代のもので、意味が不明です。.mp3]
This character is ancient, and its meaning is unclear.	<b>この文字は古代のもので、意味が不明です。</b> <br> このもじはこだいのもので、いみがふめいです。 <br><br> (文字) <br> [sound:4c-s-この文字は古代のもので、意味が不明です。.mp3]
[sound:4c-k-文部省.mp3]	<b>文部省</b> <br> もんぶしょう <br> Ministry of Education, Culture, Sports, Science and Technology
文部省	<b>もんぶしょう</b> <br> Ministry of Education, Culture, Sports, Science and Technology <br> [sound:4c-k-文部省.mp3]
Ministry of Education, Culture, Sports, Science and Technology	<b>文部省</b> <br> もんぶしょう <br> [sound:4c-k-文部省.mp3]
[sound:4c-s-文部省は教育改革を進めています。.mp3]	<b>文部省は教育改革を進めています。</b> <br> もんぶしょうはきょういくかいかくをすすめています。 <br><br> (文部省) <br> The Ministry of Education is advancing educational reforms.
文部省は教育改革を進めています。 <br><br> (文部省)	<b>もんぶしょうはきょういくかいかくをすすめています。</b> <br> The Ministry of Education is advancing educational reforms. <br> [sound:4c-s-文部省は教育改革を進めています。.mp3]
The Ministry of Education is advancing educational reforms.	<b>文部省は教育改革を進めています。</b> <br> もんぶしょうはきょういくかいかくをすすめています。 <br><br> (文部省) <br> [sound:4c-s-文部省は教育改革を進めています。.mp3]
[sound:4c-k-注文.mp3]	<b>注文</b> <br> ちゅうもん <br> order, request
注文	<b>ちゅうもん</b> <br> order, request <br> [sound:4c-k-注文.mp3]
order, request	<b>注文</b> <br> ちゅうもん <br> [sound:4c-k-注文.mp3]
[sound:4c-s-レストランで注文をしました。.mp3]	<b>レストランで注文をしました。</b> <br> れすとらんでちゅうもんをしました。 <br><br> (注文) <br> I placed an order at the restaurant.
レストランで注文をしました。 <br><br> (注文)	<b>れすとらんでちゅうもんをしました。</b> <br> I placed an order at the restaurant. <br> [sound:4c-s-レストランで注文をしました。.mp3]
I placed an order at the restaurant.	<b>レストランで注文をしました。</b> <br> れすとらんでちゅうもんをしました。 <br><br> (注文) <br> [sound:4c-s-レストランで注文をしました。.mp3]
[sound:4c-k-反応.mp3]	<b>反応</b> <br> はんのう <br> reaction, response
反応	<b>はんのう</b> <br> reaction, response <br> [sound:4c-k-反応.mp3]
reaction, response	<b>反応</b> <br> はんのう <br> [sound:4c-k-反応.mp3]
[sound:4c-s-そのニュースに対する反応は様々でした。.mp3]	<b>そのニュースに対する反応は様々でした。</b> <br> そのにゅーすにたいするはんのうはさまざまでした。 <br><br> (反応) <br> The reactions to the news were diverse.
そのニュースに対する反応は様々でした。 <br><br> (反応)	<b>そのにゅーすにたいするはんのうはさまざまでした。</b> <br> The reactions to the news were diverse. <br> [sound:4c-s-そのニュースに対する反応は様々でした。.mp3]
The reactions to the news were diverse.	<b>そのニュースに対する反応は様々でした。</b> <br> そのにゅーすにたいするはんのうはさまざまでした。 <br><br> (反応) <br> [sound:4c-s-そのニュースに対する反応は様々でした。.mp3]
[sound:4c-k-反省.mp3]	<b>反省</b> <br> はんせい <br> reflection, reconsideration, introspection, meditation, contemplation
反省	<b>はんせい</b> <br> reflection, reconsideration, introspection, meditation, contemplation <br> [sound:4c-k-反省.mp3]
reflection, reconsideration, introspection, meditation, contemplation	<b>反省</b> <br> はんせい <br> [sound:4c-k-反省.mp3]
[sound:4c-s-試合の後、反省会が行われました。.mp3]	<b>試合の後、反省会が行われました。</b> <br> しあいのあと、はんせいかいがおこなわれました。 <br><br> (反省) <br> After the match, a debriefing session was held.
試合の後、反省会が行われました。 <br><br> (反省)	<b>しあいのあと、はんせいかいがおこなわれました。</b> <br> After the match, a debriefing session was held. <br> [sound:4c-s-試合の後、反省会が行われました。.mp3]
After the match, a debriefing session was held.	<b>試合の後、反省会が行われました。</b> <br> しあいのあと、はんせいかいがおこなわれました。 <br><br> (反省) <br> [sound:4c-s-試合の後、反省会が行われました。.mp3]
[sound:4c-k-反.mp3]	<b>反</b> <br> たん <br> variable measure of fabric (28.8 cm in width), for kimonos: at least 10 m in length, for haori: at least 7.27 m in length, for other clothes: at least 6.06 m in length; 300 tsubo (991.74 meters square, 0.24506 acres); six ken (10.91 m)
反	<b>たん</b> <br> variable measure of fabric (28.8 cm in width), for kimonos: at least 10 m in length, for haori: at least 7.27 m in length, for other clothes: at least 6.06 m in length; 300 tsubo (991.74 meters square, 0.24506 acres); six ken (10.91 m) <br> [sound:4c-k-反.mp3]
variable measure of fabric (28.8 cm in width), for kimonos: at least 10 m in length, for haori: at least 7.27 m in length, for other clothes: at least 6.06 m in length; 300 tsubo (991.74 meters square, 0.24506 acres); six ken (10.91 m)	<b>反</b> <br> たん <br> [sound:4c-k-反.mp3]
[sound:4c-s-反論をする前に、考えを整理しましょう。.mp3]	<b>反論をする前に、考えを整理しましょう。</b> <br> はんろんをするまえに、かんがえをせいりしましょう。 <br><br> (反) <br> Let’s organize our thoughts before making a counterargument.
反論をする前に、考えを整理しましょう。 <br><br> (反)	<b>はんろんをするまえに、かんがえをせいりしましょう。</b> <br> Let’s organize our thoughts before making a counterargument. <br> [sound:4c-s-反論をする前に、考えを整理しましょう。.mp3]
Let’s organize our thoughts before making a counterargument.	<b>反論をする前に、考えを整理しましょう。</b> <br> はんろんをするまえに、かんがえをせいりしましょう。 <br><br> (反) <br> [sound:4c-s-反論をする前に、考えを整理しましょう。.mp3]
[sound:4c-k-反響.mp3]	<b>反響</b> <br> はんきょう <br> echo, reverberation, repercussion, reaction, influence
反響	<b>はんきょう</b> <br> echo, reverberation, repercussion, reaction, influence <br> [sound:4c-k-反響.mp3]
echo, reverberation, repercussion, reaction, influence	<b>反響</b> <br> はんきょう <br> [sound:4c-k-反響.mp3]
[sound:4c-s-新しい映画には大きな反響がありました。.mp3]	<b>新しい映画には大きな反響がありました。</b> <br> あたらしいえいがにはおおきなはんきょうがありました。 <br><br> (反響) <br> The new movie received a great response.
新しい映画には大きな反響がありました。 <br><br> (反響)	<b>あたらしいえいがにはおおきなはんきょうがありました。</b> <br> The new movie received a great response. <br> [sound:4c-s-新しい映画には大きな反響がありました。.mp3]
The new movie received a great response.	<b>新しい映画には大きな反響がありました。</b> <br> あたらしいえいがにはおおきなはんきょうがありました。 <br><br> (反響) <br> [sound:4c-s-新しい映画には大きな反響がありました。.mp3]
[sound:4c-k-元気.mp3]	<b>元気</b> <br> げんき <br> health(y), robust, vigor, vigour, energy, vitality, vim, stamina, spirit, courage, pep
元気	<b>げんき</b> <br> health(y), robust, vigor, vigour, energy, vitality, vim, stamina, spirit, courage, pep <br> [sound:4c-k-元気.mp3]
health(y), robust, vigor, vigour, energy, vitality, vim, stamina, spirit, courage, pep	<b>元気</b> <br> げんき <br> [sound:4c-k-元気.mp3]
[sound:4c-s-彼はいつも元気です。.mp3]	<b>彼はいつも元気です。</b> <br> かれはいつもげんきです。 <br><br> (元気) <br> He is always energetic.
彼はいつも元気です。 <br><br> (元気)	<b>かれはいつもげんきです。</b> <br> He is always energetic. <br> [sound:4c-s-彼はいつも元気です。.mp3]
He is always energetic.	<b>彼はいつも元気です。</b> <br> かれはいつもげんきです。 <br><br> (元気) <br> [sound:4c-s-彼はいつも元気です。.mp3]
[sound:4c-k-元日.mp3]	<b>元日</b> <br> がんじつ, がんにち <br> New Year's Day
元日	<b>がんじつ, がんにち</b> <br> New Year's Day <br> [sound:4c-k-元日.mp3]
New Year's Day	<b>元日</b> <br> がんじつ, がんにち <br> [sound:4c-k-元日.mp3]
[sound:4c-s-元日には家族と過ごします。.mp3]	<b>元日には家族と過ごします。</b> <br> がんじつにはかぞくとすごします。 <br><br> (元日) <br> I spend New Year's Day with my family.
元日には家族と過ごします。 <br><br> (元日)	<b>がんじつにはかぞくとすごします。</b> <br> I spend New Year's Day with my family. <br> [sound:4c-s-元日には家族と過ごします。.mp3]
I spend New Year's Day with my family.	<b>元日には家族と過ごします。</b> <br> がんじつにはかぞくとすごします。 <br><br> (元日) <br> [sound:4c-s-元日には家族と過ごします。.mp3]
[sound:4c-k-身元.mp3]	<b>身元</b> <br> みもと <br> person's identity, ID, past, background
身元	<b>みもと</b> <br> person's identity, ID, past, background <br> [sound:4c-k-身元.mp3]
person's identity, ID, past, background	<b>身元</b> <br> みもと <br> [sound:4c-k-身元.mp3]
[sound:4c-s-身元確認を行ってください。.mp3]	<b>身元確認を行ってください。</b> <br> みもとけんさをおこなってください。 <br><br> (身元) <br> Please confirm your identity.
身元確認を行ってください。 <br><br> (身元)	<b>みもとけんさをおこなってください。</b> <br> Please confirm your identity. <br> [sound:4c-s-身元確認を行ってください。.mp3]
Please confirm your identity.	<b>身元確認を行ってください。</b> <br> みもとけんさをおこなってください。 <br><br> (身元) <br> [sound:4c-s-身元確認を行ってください。.mp3]
[sound:4c-k-足元.mp3]	<b>足元</b> <br> あしもと, そっか <br> at one's feet, underfoot; gait, pace, step; you, thou
足元	<b>あしもと, そっか</b> <br> at one's feet, underfoot; gait, pace, step; you, thou <br> [sound:4c-k-足元.mp3]
at one's feet, underfoot; gait, pace, step; you, thou	<b>足元</b> <br> あしもと, そっか <br> [sound:4c-k-足元.mp3]
[sound:4c-s-足元に気をつけてください。.mp3]	<b>足元に気をつけてください。</b> <br> あしもとにきをつけてください。 <br><br> (足元) <br> Please watch your step.
足元に気をつけてください。 <br><br> (足元)	<b>あしもとにきをつけてください。</b> <br> Please watch your step. <br> [sound:4c-s-足元に気をつけてください。.mp3]
Please watch your step.	<b>足元に気をつけてください。</b> <br> あしもとにきをつけてください。 <br><br> (足元) <br> [sound:4c-s-足元に気をつけてください。.mp3]
[sound:4c-k-重み.mp3]	<b>重み</b> <br> おもみ <br> importance, weight, dignity, emphasis
重み	<b>おもみ</b> <br> importance, weight, dignity, emphasis <br> [sound:4c-k-重み.mp3]
importance, weight, dignity, emphasis	<b>重み</b> <br> おもみ <br> [sound:4c-k-重み.mp3]
[sound:4c-s-その言葉には重みがあります。.mp3]	<b>その言葉には重みがあります。</b> <br> そのことばにはおもみがあります。 <br><br> (重み) <br> Those words carry weight.
その言葉には重みがあります。 <br><br> (重み)	<b>そのことばにはおもみがあります。</b> <br> Those words carry weight. <br> [sound:4c-s-その言葉には重みがあります。.mp3]
Those words carry weight.	<b>その言葉には重みがあります。</b> <br> そのことばにはおもみがあります。 <br><br> (重み) <br> [sound:4c-s-その言葉には重みがあります。.mp3]
[sound:4c-k-貴重.mp3]	<b>貴重</b> <br> きちょう <br> precious, valuable
貴重	<b>きちょう</b> <br> precious, valuable <br> [sound:4c-k-貴重.mp3]
precious, valuable	<b>貴重</b> <br> きちょう <br> [sound:4c-k-貴重.mp3]
[sound:4c-s-貴重な経験をしました。.mp3]	<b>貴重な経験をしました。</b> <br> きちょうなけいけんをしました。 <br><br> (貴重) <br> I had a valuable experience.
貴重な経験をしました。 <br><br> (貴重)	<b>きちょうなけいけんをしました。</b> <br> I had a valuable experience. <br> [sound:4c-s-貴重な経験をしました。.mp3]
I had a valuable experience.	<b>貴重な経験をしました。</b> <br> きちょうなけいけんをしました。 <br><br> (貴重) <br> [sound:4c-s-貴重な経験をしました。.mp3]
[sound:4c-k-重ねる.mp3]	<b>重ねる</b> <br> かさねる <br> to pile up, to put something on another, to heap up, to add, to repeat
重ねる	<b>かさねる</b> <br> to pile up, to put something on another, to heap up, to add, to repeat <br> [sound:4c-k-重ねる.mp3]
to pile up, to put something on another, to heap up, to add, to repeat	<b>重ねる</b> <br> かさねる <br> [sound:4c-k-重ねる.mp3]
[sound:4c-s-彼は努力を重ねて成功しました。.mp3]	<b>彼は努力を重ねて成功しました。</b> <br> かれはどりょくをかさねてせいこうしました。 <br><br> (重ねる) <br> He succeeded by continually putting in effort.
彼は努力を重ねて成功しました。 <br><br> (重ねる)	<b>かれはどりょくをかさねてせいこうしました。</b> <br> He succeeded by continually putting in effort. <br> [sound:4c-s-彼は努力を重ねて成功しました。.mp3]
He succeeded by continually putting in effort.	<b>彼は努力を重ねて成功しました。</b> <br> かれはどりょくをかさねてせいこうしました。 <br><br> (重ねる) <br> [sound:4c-s-彼は努力を重ねて成功しました。.mp3]
[sound:4c-k-重視.mp3]	<b>重視</b> <br> じゅうし <br> importance, stress, serious consideration
重視	<b>じゅうし</b> <br> importance, stress, serious consideration <br> [sound:4c-k-重視.mp3]
importance, stress, serious consideration	<b>重視</b> <br> じゅうし <br> [sound:4c-k-重視.mp3]
[sound:4c-s-環境問題を重視しています。.mp3]	<b>環境問題を重視しています。</b> <br> かんきょうもんだいをじゅうししています。 <br><br> (重視) <br> I prioritize environmental issues.
環境問題を重視しています。 <br><br> (重視)	<b>かんきょうもんだいをじゅうししています。</b> <br> I prioritize environmental issues. <br> [sound:4c-s-環境問題を重視しています。.mp3]
I prioritize environmental issues.	<b>環境問題を重視しています。</b> <br> かんきょうもんだいをじゅうししています。 <br><br> (重視) <br> [sound:4c-s-環境問題を重視しています。.mp3]
[sound:4c-k-近鉄.mp3]	<b>近鉄</b> <br> きんてつ <br> Kinki Nippon Tetsudou (railway co.)
近鉄	<b>きんてつ</b> <br> Kinki Nippon Tetsudou (railway co.) <br> [sound:4c-k-近鉄.mp3]
Kinki Nippon Tetsudou (railway co.)	<b>近鉄</b> <br> きんてつ <br> [sound:4c-k-近鉄.mp3]
[sound:4c-s-近鉄電車で大阪に行きました。.mp3]	<b>近鉄電車で大阪に行きました。</b> <br> きんてつでんしゃでおおさかにいきました。 <br><br> (近鉄) <br> I went to Osaka by Kintetsu train.
近鉄電車で大阪に行きました。 <br><br> (近鉄)	<b>きんてつでんしゃでおおさかにいきました。</b> <br> I went to Osaka by Kintetsu train. <br> [sound:4c-s-近鉄電車で大阪に行きました。.mp3]
I went to Osaka by Kintetsu train.	<b>近鉄電車で大阪に行きました。</b> <br> きんてつでんしゃでおおさかにいきました。 <br><br> (近鉄) <br> [sound:4c-s-近鉄電車で大阪に行きました。.mp3]
[sound:4c-k-側近.mp3]	<b>側近</b> <br> そっきん <br> close associate, close aide, brains-truster
側近	<b>そっきん</b> <br> close associate, close aide, brains-truster <br> [sound:4c-k-側近.mp3]
close associate, close aide, brains-truster	<b>側近</b> <br> そっきん <br> [sound:4c-k-側近.mp3]
[sound:4c-s-大統領の側近が会議に出席しました。.mp3]	<b>大統領の側近が会議に出席しました。</b> <br> だいとうりょうのそっきんがかいぎにしゅっせきしました。 <br><br> (側近) <br> The president's close aide attended the meeting.
大統領の側近が会議に出席しました。 <br><br> (側近)	<b>だいとうりょうのそっきんがかいぎにしゅっせきしました。</b> <br> The president's close aide attended the meeting. <br> [sound:4c-s-大統領の側近が会議に出席しました。.mp3]
The president's close aide attended the meeting.	<b>大統領の側近が会議に出席しました。</b> <br> だいとうりょうのそっきんがかいぎにしゅっせきしました。 <br><br> (側近) <br> [sound:4c-s-大統領の側近が会議に出席しました。.mp3]
[sound:4c-k-近所.mp3]	<b>近所</b> <br> きんじょ <br> neighbourhood, neighborhood
近所	<b>きんじょ</b> <br> neighbourhood, neighborhood <br> [sound:4c-k-近所.mp3]
neighbourhood, neighborhood	<b>近所</b> <br> きんじょ <br> [sound:4c-k-近所.mp3]
[sound:4c-s-近所の公園で遊びました。.mp3]	<b>近所の公園で遊びました。</b> <br> きんじょのこうえんであそびました。 <br><br> (近所) <br> I played at the park in my neighborhood.
近所の公園で遊びました。 <br><br> (近所)	<b>きんじょのこうえんであそびました。</b> <br> I played at the park in my neighborhood. <br> [sound:4c-s-近所の公園で遊びました。.mp3]
I played at the park in my neighborhood.	<b>近所の公園で遊びました。</b> <br> きんじょのこうえんであそびました。 <br><br> (近所) <br> [sound:4c-s-近所の公園で遊びました。.mp3]
[sound:4c-k-近年.mp3]	<b>近年</b> <br> きんねん <br> recent years
近年	<b>きんねん</b> <br> recent years <br> [sound:4c-k-近年.mp3]
recent years	<b>近年</b> <br> きんねん <br> [sound:4c-k-近年.mp3]
[sound:4c-s-近年、テクノロジーは急速に進化しています。.mp3]	<b>近年、テクノロジーは急速に進化しています。</b> <br> きんねん、てくのろじーはきゅうそくにしんかしています。 <br><br> (近年) <br> In recent years, technology has rapidly evolved.
近年、テクノロジーは急速に進化しています。 <br><br> (近年)	<b>きんねん、てくのろじーはきゅうそくにしんかしています。</b> <br> In recent years, technology has rapidly evolved. <br> [sound:4c-s-近年、テクノロジーは急速に進化しています。.mp3]
In recent years, technology has rapidly evolved.	<b>近年、テクノロジーは急速に進化しています。</b> <br> きんねん、てくのろじーはきゅうそくにしんかしています。 <br><br> (近年) <br> [sound:4c-s-近年、テクノロジーは急速に進化しています。.mp3]
[sound:4c-k-千代.mp3]	<b>千代</b> <br> せんだい, ちよ <br> thousand years; very long period, forever
千代	<b>せんだい, ちよ</b> <br> thousand years; very long period, forever <br> [sound:4c-k-千代.mp3]
thousand years; very long period, forever	<b>千代</b> <br> せんだい, ちよ <br> [sound:4c-k-千代.mp3]
[sound:4c-s-千代田区は東京の中心にあります。.mp3]	<b>千代田区は東京の中心にあります。</b> <br> ちよだくはとうきょうのちゅうしんにあります。 <br><br> (千代) <br> Chiyoda is located at the center of Tokyo.
千代田区は東京の中心にあります。 <br><br> (千代)	<b>ちよだくはとうきょうのちゅうしんにあります。</b> <br> Chiyoda is located at the center of Tokyo. <br> [sound:4c-s-千代田区は東京の中心にあります。.mp3]
Chiyoda is located at the center of Tokyo.	<b>千代田区は東京の中心にあります。</b> <br> ちよだくはとうきょうのちゅうしんにあります。 <br><br> (千代) <br> [sound:4c-s-千代田区は東京の中心にあります。.mp3]
[sound:4c-k-千里.mp3]	<b>千里</b> <br> せんり <br> 1000 ri, (a) long distance
千里	<b>せんり</b> <br> 1000 ri, (a) long distance <br> [sound:4c-k-千里.mp3]
1000 ri, (a) long distance	<b>千里</b> <br> せんり <br> [sound:4c-k-千里.mp3]
[sound:4c-s-千里の道も一歩から。.mp3]	<b>千里の道も一歩から。</b> <br> せんりのみちもいっぽから。 <br><br> (千里) <br> A journey of a thousand miles begins with a single step.
千里の道も一歩から。 <br><br> (千里)	<b>せんりのみちもいっぽから。</b> <br> A journey of a thousand miles begins with a single step. <br> [sound:4c-s-千里の道も一歩から。.mp3]
A journey of a thousand miles begins with a single step.	<b>千里の道も一歩から。</b> <br> せんりのみちもいっぽから。 <br><br> (千里) <br> [sound:4c-s-千里の道も一歩から。.mp3]
[sound:4c-k-千秋楽.mp3]	<b>千秋楽</b> <br> せんしゅうらく <br> concluding festivities, final day of a sumo tournament, concluding program, concluding programme
千秋楽	<b>せんしゅうらく</b> <br> concluding festivities, final day of a sumo tournament, concluding program, concluding programme <br> [sound:4c-k-千秋楽.mp3]
concluding festivities, final day of a sumo tournament, concluding program, concluding programme	<b>千秋楽</b> <br> せんしゅうらく <br> [sound:4c-k-千秋楽.mp3]
[sound:4c-s-千秋楽の試合は盛り上がりました。.mp3]	<b>千秋楽の試合は盛り上がりました。</b> <br> せんしゅうらくのしあいはもりあがりました。 <br><br> (千秋楽) <br> The final match was exciting.
千秋楽の試合は盛り上がりました。 <br><br> (千秋楽)	<b>せんしゅうらくのしあいはもりあがりました。</b> <br> The final match was exciting. <br> [sound:4c-s-千秋楽の試合は盛り上がりました。.mp3]
The final match was exciting.	<b>千秋楽の試合は盛り上がりました。</b> <br> せんしゅうらくのしあいはもりあがりました。 <br><br> (千秋楽) <br> [sound:4c-s-千秋楽の試合は盛り上がりました。.mp3]
[sound:4c-k-千島.mp3]	<b>千島</b> <br> ちしま <br> Kurile Islands
千島	<b>ちしま</b> <br> Kurile Islands <br> [sound:4c-k-千島.mp3]
Kurile Islands	<b>千島</b> <br> ちしま <br> [sound:4c-k-千島.mp3]
[sound:4c-s-千島列島には美しい自然があります。.mp3]	<b>千島列島には美しい自然があります。</b> <br> ちしまれっとうにはうつくしいしぜんがあります。 <br><br> (千島) <br> The Kuril Islands have beautiful nature.
千島列島には美しい自然があります。 <br><br> (千島)	<b>ちしまれっとうにはうつくしいしぜんがあります。</b> <br> The Kuril Islands have beautiful nature. <br> [sound:4c-s-千島列島には美しい自然があります。.mp3]
The Kuril Islands have beautiful nature.	<b>千島列島には美しい自然があります。</b> <br> ちしまれっとうにはうつくしいしぜんがあります。 <br><br> (千島) <br> [sound:4c-s-千島列島には美しい自然があります。.mp3]
[sound:4c-k-選考.mp3]	<b>選考</b> <br> せんこう <br> selection, screening
選考	<b>せんこう</b> <br> selection, screening <br> [sound:4c-k-選考.mp3]
selection, screening	<b>選考</b> <br> せんこう <br> [sound:4c-k-選考.mp3]
[sound:4c-s-選考基準に基づいて選ばれました。.mp3]	<b>選考基準に基づいて選ばれました。</b> <br> せんこうきじゅんにもとづいてえらばれました。 <br><br> (選考) <br> I was chosen based on the selection criteria.
選考基準に基づいて選ばれました。 <br><br> (選考)	<b>せんこうきじゅんにもとづいてえらばれました。</b> <br> I was chosen based on the selection criteria. <br> [sound:4c-s-選考基準に基づいて選ばれました。.mp3]
I was chosen based on the selection criteria.	<b>選考基準に基づいて選ばれました。</b> <br> せんこうきじゅんにもとづいてえらばれました。 <br><br> (選考) <br> [sound:4c-s-選考基準に基づいて選ばれました。.mp3]
[sound:4c-k-考える.mp3]	<b>考える</b> <br> かんがえる <br> to consider, to think about
考える	<b>かんがえる</b> <br> to consider, to think about <br> [sound:4c-k-考える.mp3]
to consider, to think about	<b>考える</b> <br> かんがえる <br> [sound:4c-k-考える.mp3]
[sound:4c-s-問題をよく考えてから決めましょう。.mp3]	<b>問題をよく考えてから決めましょう。</b> <br> もんだいをよくかんがえてからきめましょう。 <br><br> (考える) <br> Let’s think carefully before making a decision.
問題をよく考えてから決めましょう。 <br><br> (考える)	<b>もんだいをよくかんがえてからきめましょう。</b> <br> Let’s think carefully before making a decision. <br> [sound:4c-s-問題をよく考えてから決めましょう。.mp3]
Let’s think carefully before making a decision.	<b>問題をよく考えてから決めましょう。</b> <br> もんだいをよくかんがえてからきめましょう。 <br><br> (考える) <br> [sound:4c-s-問題をよく考えてから決めましょう。.mp3]
[sound:4c-k-思考.mp3]	<b>思考</b> <br> しこう <br> thought, consideration, thinking
思考	<b>しこう</b> <br> thought, consideration, thinking <br> [sound:4c-k-思考.mp3]
thought, consideration, thinking	<b>思考</b> <br> しこう <br> [sound:4c-k-思考.mp3]
[sound:4c-s-彼は深い思考を持っています。.mp3]	<b>彼は深い思考を持っています。</b> <br> かれはふかいしこうをもっています。 <br><br> (思考) <br> He has deep thinking.
彼は深い思考を持っています。 <br><br> (思考)	<b>かれはふかいしこうをもっています。</b> <br> He has deep thinking. <br> [sound:4c-s-彼は深い思考を持っています。.mp3]
He has deep thinking.	<b>彼は深い思考を持っています。</b> <br> かれはふかいしこうをもっています。 <br><br> (思考) <br> [sound:4c-s-彼は深い思考を持っています。.mp3]
[sound:4c-k-考古学.mp3]	<b>考古学</b> <br> こうこがく <br> archaeology, archeology
考古学	<b>こうこがく</b> <br> archaeology, archeology <br> [sound:4c-k-考古学.mp3]
archaeology, archeology	<b>考古学</b> <br> こうこがく <br> [sound:4c-k-考古学.mp3]
[sound:4c-s-考古学の研究者が発掘作業を行いました。.mp3]	<b>考古学の研究者が発掘作業を行いました。</b> <br> こうこがくのけんきゅうしゃがはっくつさぎょうをおこないました。 <br><br> (考古学) <br> Archaeologists conducted excavation work.
考古学の研究者が発掘作業を行いました。 <br><br> (考古学)	<b>こうこがくのけんきゅうしゃがはっくつさぎょうをおこないました。</b> <br> Archaeologists conducted excavation work. <br> [sound:4c-s-考古学の研究者が発掘作業を行いました。.mp3]
Archaeologists conducted excavation work.	<b>考古学の研究者が発掘作業を行いました。</b> <br> こうこがくのけんきゅうしゃがはっくつさぎょうをおこないました。 <br><br> (考古学) <br> [sound:4c-s-考古学の研究者が発掘作業を行いました。.mp3]
[sound:4c-k-批判.mp3]	<b>批判</b> <br> ひはん <br> criticism, judgement, judgment, comment
批判	<b>ひはん</b> <br> criticism, judgement, judgment, comment <br> [sound:4c-k-批判.mp3]
criticism, judgement, judgment, comment	<b>批判</b> <br> ひはん <br> [sound:4c-k-批判.mp3]
[sound:4c-s-彼の行動に対する批判が増えています。.mp3]	<b>彼の行動に対する批判が増えています。</b> <br> かれのこうどうにたいするひはんがふえています。 <br><br> (批判) <br> Criticism of his actions is increasing.
彼の行動に対する批判が増えています。 <br><br> (批判)	<b>かれのこうどうにたいするひはんがふえています。</b> <br> Criticism of his actions is increasing. <br> [sound:4c-s-彼の行動に対する批判が増えています。.mp3]
Criticism of his actions is increasing.	<b>彼の行動に対する批判が増えています。</b> <br> かれのこうどうにたいするひはんがふえています。 <br><br> (批判) <br> [sound:4c-s-彼の行動に対する批判が増えています。.mp3]
[sound:4c-k-公判.mp3]	<b>公判</b> <br> こうはん <br> public hearing, trial
公判	<b>こうはん</b> <br> public hearing, trial <br> [sound:4c-k-公判.mp3]
public hearing, trial	<b>公判</b> <br> こうはん <br> [sound:4c-k-公判.mp3]
[sound:4c-s-裁判所で公判が開かれました。.mp3]	<b>裁判所で公判が開かれました。</b> <br> さいばんしょでこうはんがひらかれました。 <br><br> (公判) <br> A public trial was held at the courthouse.
裁判所で公判が開かれました。 <br><br> (公判)	<b>さいばんしょでこうはんがひらかれました。</b> <br> A public trial was held at the courthouse. <br> [sound:4c-s-裁判所で公判が開かれました。.mp3]
A public trial was held at the courthouse.	<b>裁判所で公判が開かれました。</b> <br> さいばんしょでこうはんがひらかれました。 <br><br> (公判) <br> [sound:4c-s-裁判所で公判が開かれました。.mp3]
[sound:4c-k-裁判所.mp3]	<b>裁判所</b> <br> さいばんしょ <br> court, courthouse
裁判所	<b>さいばんしょ</b> <br> court, courthouse <br> [sound:4c-k-裁判所.mp3]
court, courthouse	<b>裁判所</b> <br> さいばんしょ <br> [sound:4c-k-裁判所.mp3]
[sound:4c-s-裁判所の前で集会が開かれました。.mp3]	<b>裁判所の前で集会が開かれました。</b> <br> さいばんしょのまえでしゅうかいがひらかれました。 <br><br> (裁判所) <br> A rally was held in front of the courthouse.
裁判所の前で集会が開かれました。 <br><br> (裁判所)	<b>さいばんしょのまえでしゅうかいがひらかれました。</b> <br> A rally was held in front of the courthouse. <br> [sound:4c-s-裁判所の前で集会が開かれました。.mp3]
A rally was held in front of the courthouse.	<b>裁判所の前で集会が開かれました。</b> <br> さいばんしょのまえでしゅうかいがひらかれました。 <br><br> (裁判所) <br> [sound:4c-s-裁判所の前で集会が開かれました。.mp3]
[sound:4c-k-審判.mp3]	<b>審判</b> <br> しんぱん, しんばん <br> refereeing, trial, judgement, judgment, umpire, referee
審判	<b>しんぱん, しんばん</b> <br> refereeing, trial, judgement, judgment, umpire, referee <br> [sound:4c-k-審判.mp3]
refereeing, trial, judgement, judgment, umpire, referee	<b>審判</b> <br> しんぱん, しんばん <br> [sound:4c-k-審判.mp3]
[sound:4c-s-試合の審判は公正でした。.mp3]	<b>試合の審判は公正でした。</b> <br> しあいのしんぱんはこうせいでした。 <br><br> (審判) <br> The referee of the match was fair.
試合の審判は公正でした。 <br><br> (審判)	<b>しあいのしんぱんはこうせいでした。</b> <br> The referee of the match was fair. <br> [sound:4c-s-試合の審判は公正でした。.mp3]
The referee of the match was fair.	<b>試合の審判は公正でした。</b> <br> しあいのしんぱんはこうせいでした。 <br><br> (審判) <br> [sound:4c-s-試合の審判は公正でした。.mp3]
[sound:4c-k-公認.mp3]	<b>公認</b> <br> こうにん <br> official recognition, authorization, authorisation, licence, license, accreditation
公認	<b>こうにん</b> <br> official recognition, authorization, authorisation, licence, license, accreditation <br> [sound:4c-k-公認.mp3]
official recognition, authorization, authorisation, licence, license, accreditation	<b>公認</b> <br> こうにん <br> [sound:4c-k-公認.mp3]
[sound:4c-s-その団体は政府によって公認されています。.mp3]	<b>その団体は政府によって公認されています。</b> <br> そのだんたいはせいふによってこうにんされています。 <br><br> (公認) <br> The organization is officially recognized by the government.
その団体は政府によって公認されています。 <br><br> (公認)	<b>そのだんたいはせいふによってこうにんされています。</b> <br> The organization is officially recognized by the government. <br> [sound:4c-s-その団体は政府によって公認されています。.mp3]
The organization is officially recognized by the government.	<b>その団体は政府によって公認されています。</b> <br> そのだんたいはせいふによってこうにんされています。 <br><br> (公認) <br> [sound:4c-s-その団体は政府によって公認されています。.mp3]
[sound:4c-k-認定.mp3]	<b>認定</b> <br> にんてい <br> authorization, authorisation, acknowledgment, acknowledgement, certification, recognition
認定	<b>にんてい</b> <br> authorization, authorisation, acknowledgment, acknowledgement, certification, recognition <br> [sound:4c-k-認定.mp3]
authorization, authorisation, acknowledgment, acknowledgement, certification, recognition	<b>認定</b> <br> にんてい <br> [sound:4c-k-認定.mp3]
[sound:4c-s-新しい資格が認定されました。.mp3]	<b>新しい資格が認定されました。</b> <br> あたらしいしかくがにんていされました。 <br><br> (認定) <br> A new certification has been recognized.
新しい資格が認定されました。 <br><br> (認定)	<b>あたらしいしかくがにんていされました。</b> <br> A new certification has been recognized. <br> [sound:4c-s-新しい資格が認定されました。.mp3]
A new certification has been recognized.	<b>新しい資格が認定されました。</b> <br> あたらしいしかくがにんていされました。 <br><br> (認定) <br> [sound:4c-s-新しい資格が認定されました。.mp3]
[sound:4c-k-認可.mp3]	<b>認可</b> <br> にんか <br> approval, license, licence, permission
認可	<b>にんか</b> <br> approval, license, licence, permission <br> [sound:4c-k-認可.mp3]
approval, license, licence, permission	<b>認可</b> <br> にんか <br> [sound:4c-k-認可.mp3]
[sound:4c-s-この施設は政府の認可を受けました。.mp3]	<b>この施設は政府の認可を受けました。</b> <br> このしせつはせいふのにんかをうけました。 <br><br> (認可) <br> This facility has received government approval.
この施設は政府の認可を受けました。 <br><br> (認可)	<b>このしせつはせいふのにんかをうけました。</b> <br> This facility has received government approval. <br> [sound:4c-s-この施設は政府の認可を受けました。.mp3]
This facility has received government approval.	<b>この施設は政府の認可を受けました。</b> <br> このしせつはせいふのにんかをうけました。 <br><br> (認可) <br> [sound:4c-s-この施設は政府の認可を受けました。.mp3]
[sound:4c-k-容認.mp3]	<b>容認</b> <br> ようにん <br> approval
容認	<b>ようにん</b> <br> approval <br> [sound:4c-k-容認.mp3]
approval	<b>容認</b> <br> ようにん <br> [sound:4c-k-容認.mp3]
[sound:4c-s-その提案は多くの人に容認されました。.mp3]	<b>その提案は多くの人に容認されました。</b> <br> そのていあんはおおくのひとにようにんされました。 <br><br> (容認) <br> The proposal was accepted by many people.
その提案は多くの人に容認されました。 <br><br> (容認)	<b>そのていあんはおおくのひとにようにんされました。</b> <br> The proposal was accepted by many people. <br> [sound:4c-s-その提案は多くの人に容認されました。.mp3]
The proposal was accepted by many people.	<b>その提案は多くの人に容認されました。</b> <br> そのていあんはおおくのひとにようにんされました。 <br><br> (容認) <br> [sound:4c-s-その提案は多くの人に容認されました。.mp3]
[sound:4c-k-企画.mp3]	<b>企画</b> <br> きかく <br> planning, project, plan, design
企画	<b>きかく</b> <br> planning, project, plan, design <br> [sound:4c-k-企画.mp3]
planning, project, plan, design	<b>企画</b> <br> きかく <br> [sound:4c-k-企画.mp3]
[sound:4c-s-新しいプロジェクトを企画しています。.mp3]	<b>新しいプロジェクトを企画しています。</b> <br> あたらしいぷろじぇくとをきかくしています。 <br><br> (企画) <br> I am planning a new project.
新しいプロジェクトを企画しています。 <br><br> (企画)	<b>あたらしいぷろじぇくとをきかくしています。</b> <br> I am planning a new project. <br> [sound:4c-s-新しいプロジェクトを企画しています。.mp3]
I am planning a new project.	<b>新しいプロジェクトを企画しています。</b> <br> あたらしいぷろじぇくとをきかくしています。 <br><br> (企画) <br> [sound:4c-s-新しいプロジェクトを企画しています。.mp3]
[sound:4c-k-絵画.mp3]	<b>絵画</b> <br> かいが <br> picture, painting
絵画	<b>かいが</b> <br> picture, painting <br> [sound:4c-k-絵画.mp3]
picture, painting	<b>絵画</b> <br> かいが <br> [sound:4c-k-絵画.mp3]
[sound:4c-s-この絵画はとても美しいです。.mp3]	<b>この絵画はとても美しいです。</b> <br> このかいがはとてもびしつです。 <br><br> (絵画) <br> This painting is very beautiful.
この絵画はとても美しいです。 <br><br> (絵画)	<b>このかいがはとてもびしつです。</b> <br> This painting is very beautiful. <br> [sound:4c-s-この絵画はとても美しいです。.mp3]
This painting is very beautiful.	<b>この絵画はとても美しいです。</b> <br> このかいがはとてもびしつです。 <br><br> (絵画) <br> [sound:4c-s-この絵画はとても美しいです。.mp3]
[sound:4c-k-画面.mp3]	<b>画面</b> <br> がめん <br> terminal screen, scene, picture, the field (in TV), photo
画面	<b>がめん</b> <br> terminal screen, scene, picture, the field (in TV), photo <br> [sound:4c-k-画面.mp3]
terminal screen, scene, picture, the field (in TV), photo	<b>画面</b> <br> がめん <br> [sound:4c-k-画面.mp3]
[sound:4c-s-画面がフリーズしました。.mp3]	<b>画面がフリーズしました。</b> <br> がめんがふりーずしました。 <br><br> (画面) <br> The screen froze.
画面がフリーズしました。 <br><br> (画面)	<b>がめんがふりーずしました。</b> <br> The screen froze. <br> [sound:4c-s-画面がフリーズしました。.mp3]
The screen froze.	<b>画面がフリーズしました。</b> <br> がめんがふりーずしました。 <br><br> (画面) <br> [sound:4c-s-画面がフリーズしました。.mp3]
[sound:4c-k-画家.mp3]	<b>画家</b> <br> がか <br> painter, artist
画家	<b>がか</b> <br> painter, artist <br> [sound:4c-k-画家.mp3]
painter, artist	<b>画家</b> <br> がか <br> [sound:4c-k-画家.mp3]
[sound:4c-s-彼は有名な画家です。.mp3]	<b>彼は有名な画家です。</b> <br> かれはゆうめいながかです。 <br><br> (画家) <br> He is a famous painter.
彼は有名な画家です。 <br><br> (画家)	<b>かれはゆうめいながかです。</b> <br> He is a famous painter. <br> [sound:4c-s-彼は有名な画家です。.mp3]
He is a famous painter.	<b>彼は有名な画家です。</b> <br> かれはゆうめいながかです。 <br><br> (画家) <br> [sound:4c-s-彼は有名な画家です。.mp3]
[sound:4c-k-東海.mp3]	<b>東海</b> <br> とうかい <br> region south of Tokyo on Pacific Ocean side of Japan, eastern sea
東海	<b>とうかい</b> <br> region south of Tokyo on Pacific Ocean side of Japan, eastern sea <br> [sound:4c-k-東海.mp3]
region south of Tokyo on Pacific Ocean side of Japan, eastern sea	<b>東海</b> <br> とうかい <br> [sound:4c-k-東海.mp3]
[sound:4c-s-東海地方に旅行に行きました。.mp3]	<b>東海地方に旅行に行きました。</b> <br> とうかいちほうにりょこうにいきました。 <br><br> (東海) <br> I traveled to the Tokai region.
東海地方に旅行に行きました。 <br><br> (東海)	<b>とうかいちほうにりょこうにいきました。</b> <br> I traveled to the Tokai region. <br> [sound:4c-s-東海地方に旅行に行きました。.mp3]
I traveled to the Tokai region.	<b>東海地方に旅行に行きました。</b> <br> とうかいちほうにりょこうにいきました。 <br><br> (東海) <br> [sound:4c-s-東海地方に旅行に行きました。.mp3]
[sound:4c-k-海軍.mp3]	<b>海軍</b> <br> かいぐん <br> navy
海軍	<b>かいぐん</b> <br> navy <br> [sound:4c-k-海軍.mp3]
navy	<b>海軍</b> <br> かいぐん <br> [sound:4c-k-海軍.mp3]
[sound:4c-s-海軍の船が港に到着しました。.mp3]	<b>海軍の船が港に到着しました。</b> <br> かいぐんのふねがみなとにとうちゃくしました。 <br><br> (海軍) <br> The navy ship arrived at the port.
海軍の船が港に到着しました。 <br><br> (海軍)	<b>かいぐんのふねがみなとにとうちゃくしました。</b> <br> The navy ship arrived at the port. <br> [sound:4c-s-海軍の船が港に到着しました。.mp3]
The navy ship arrived at the port.	<b>海軍の船が港に到着しました。</b> <br> かいぐんのふねがみなとにとうちゃくしました。 <br><br> (海軍) <br> [sound:4c-s-海軍の船が港に到着しました。.mp3]
[sound:4c-k-海上.mp3]	<b>海上</b> <br> かいじょう <br> (by, at, on) sea, maritime, marine
海上	<b>かいじょう</b> <br> (by, at, on) sea, maritime, marine <br> [sound:4c-k-海上.mp3]
(by, at, on) sea, maritime, marine	<b>海上</b> <br> かいじょう <br> [sound:4c-k-海上.mp3]
[sound:4c-s-海上で事故が発生しました。.mp3]	<b>海上で事故が発生しました。</b> <br> かいじょうでじこがはっせいしました。 <br><br> (海上) <br> A maritime accident occurred.
海上で事故が発生しました。 <br><br> (海上)	<b>かいじょうでじこがはっせいしました。</b> <br> A maritime accident occurred. <br> [sound:4c-s-海上で事故が発生しました。.mp3]
A maritime accident occurred.	<b>海上で事故が発生しました。</b> <br> かいじょうでじこがはっせいしました。 <br><br> (海上) <br> [sound:4c-s-海上で事故が発生しました。.mp3]
[sound:4c-k-海岸.mp3]	<b>海岸</b> <br> かいがん <br> coast, beach
海岸	<b>かいがん</b> <br> coast, beach <br> [sound:4c-k-海岸.mp3]
coast, beach	<b>海岸</b> <br> かいがん <br> [sound:4c-k-海岸.mp3]
[sound:4c-s-海岸で散歩をしました。.mp3]	<b>海岸で散歩をしました。</b> <br> かいがんでさんぽをしました。 <br><br> (海岸) <br> I took a walk along the beach.
海岸で散歩をしました。 <br><br> (海岸)	<b>かいがんでさんぽをしました。</b> <br> I took a walk along the beach. <br> [sound:4c-s-海岸で散歩をしました。.mp3]
I took a walk along the beach.	<b>海岸で散歩をしました。</b> <br> かいがんでさんぽをしました。 <br><br> (海岸) <br> [sound:4c-s-海岸で散歩をしました。.mp3]
[sound:4c-k-参加.mp3]	<b>参加</b> <br> さんか <br> participation
参加	<b>さんか</b> <br> participation <br> [sound:4c-k-参加.mp3]
participation	<b>参加</b> <br> さんか <br> [sound:4c-k-参加.mp3]
[sound:4c-s-イベントに参加することを決めました。.mp3]	<b>イベントに参加することを決めました。</b> <br> いべんとにさんかすることをきめました。 <br><br> (参加) <br> I decided to participate in the event.
イベントに参加することを決めました。 <br><br> (参加)	<b>いべんとにさんかすることをきめました。</b> <br> I decided to participate in the event. <br> [sound:4c-s-イベントに参加することを決めました。.mp3]
I decided to participate in the event.	<b>イベントに参加することを決めました。</b> <br> いべんとにさんかすることをきめました。 <br><br> (参加) <br> [sound:4c-s-イベントに参加することを決めました。.mp3]
[sound:4c-k-参照.mp3]	<b>参照</b> <br> さんしょう <br> reference, bibliographical reference, consultation, browsing (e.g. when selecting a file to upload on a computer), checking out
参照	<b>さんしょう</b> <br> reference, bibliographical reference, consultation, browsing (e.g. when selecting a file to upload on a computer), checking out <br> [sound:4c-k-参照.mp3]
reference, bibliographical reference, consultation, browsing (e.g. when selecting a file to upload on a computer), checking out	<b>参照</b> <br> さんしょう <br> [sound:4c-k-参照.mp3]
[sound:4c-s-参考資料を参照してください。.mp3]	<b>参考資料を参照してください。</b> <br> さんこうしりょうをさんしょうしてください。 <br><br> (参照) <br> Please refer to the reference materials.
参考資料を参照してください。 <br><br> (参照)	<b>さんこうしりょうをさんしょうしてください。</b> <br> Please refer to the reference materials. <br> [sound:4c-s-参考資料を参照してください。.mp3]
Please refer to the reference materials.	<b>参考資料を参照してください。</b> <br> さんこうしりょうをさんしょうしてください。 <br><br> (参照) <br> [sound:4c-s-参考資料を参照してください。.mp3]
[sound:4c-k-参事官.mp3]	<b>参事官</b> <br> さんじかん <br> councillor, councilor
参事官	<b>さんじかん</b> <br> councillor, councilor <br> [sound:4c-k-参事官.mp3]
councillor, councilor	<b>参事官</b> <br> さんじかん <br> [sound:4c-k-参事官.mp3]
[sound:4c-s-参事官が会議に出席しました。.mp3]	<b>参事官が会議に出席しました。</b> <br> さんじかんがかいぎにしゅっせきしました。 <br><br> (参事官) <br> The counselor attended the meeting.
参事官が会議に出席しました。 <br><br> (参事官)	<b>さんじかんがかいぎにしゅっせきしました。</b> <br> The counselor attended the meeting. <br> [sound:4c-s-参事官が会議に出席しました。.mp3]
The counselor attended the meeting.	<b>参事官が会議に出席しました。</b> <br> さんじかんがかいぎにしゅっせきしました。 <br><br> (参事官) <br> [sound:4c-s-参事官が会議に出席しました。.mp3]
[sound:4c-k-販売.mp3]	<b>販売</b> <br> はんばい <br> sales, selling, marketing
販売	<b>はんばい</b> <br> sales, selling, marketing <br> [sound:4c-k-販売.mp3]
sales, selling, marketing	<b>販売</b> <br> はんばい <br> [sound:4c-k-販売.mp3]
[sound:4c-s-新商品を販売しています。.mp3]	<b>新商品を販売しています。</b> <br> しんしょうひんをはんばいしています。 <br><br> (販売) <br> We are selling new products.
新商品を販売しています。 <br><br> (販売)	<b>しんしょうひんをはんばいしています。</b> <br> We are selling new products. <br> [sound:4c-s-新商品を販売しています。.mp3]
We are selling new products.	<b>新商品を販売しています。</b> <br> しんしょうひんをはんばいしています。 <br><br> (販売) <br> [sound:4c-s-新商品を販売しています。.mp3]
[sound:4c-k-売り.mp3]	<b>売り</b> <br> うり <br> sale, selling; selling point, gimmick
売り	<b>うり</b> <br> sale, selling; selling point, gimmick <br> [sound:4c-k-売り.mp3]
sale, selling; selling point, gimmick	<b>売り</b> <br> うり <br> [sound:4c-k-売り.mp3]
[sound:4c-s-この店の売りは新鮮な野菜です。.mp3]	<b>この店の売りは新鮮な野菜です。</b> <br> このみせのうりはしんせんなやさいです。 <br><br> (売り) <br> The store’s specialty is fresh vegetables.
この店の売りは新鮮な野菜です。 <br><br> (売り)	<b>このみせのうりはしんせんなやさいです。</b> <br> The store’s specialty is fresh vegetables. <br> [sound:4c-s-この店の売りは新鮮な野菜です。.mp3]
The store’s specialty is fresh vegetables.	<b>この店の売りは新鮮な野菜です。</b> <br> このみせのうりはしんせんなやさいです。 <br><br> (売り) <br> [sound:4c-s-この店の売りは新鮮な野菜です。.mp3]
[sound:4c-k-商売.mp3]	<b>商売</b> <br> しょうばい <br> trade, business, commerce, transaction, occupation
商売	<b>しょうばい</b> <br> trade, business, commerce, transaction, occupation <br> [sound:4c-k-商売.mp3]
trade, business, commerce, transaction, occupation	<b>商売</b> <br> しょうばい <br> [sound:4c-k-商売.mp3]
[sound:4c-s-彼の商売は順調に進んでいます。.mp3]	<b>彼の商売は順調に進んでいます。</b> <br> かれのしょうばいはじゅんちょうにすすんでいます。 <br><br> (商売) <br> His business is progressing smoothly.
彼の商売は順調に進んでいます。 <br><br> (商売)	<b>かれのしょうばいはじゅんちょうにすすんでいます。</b> <br> His business is progressing smoothly. <br> [sound:4c-s-彼の商売は順調に進んでいます。.mp3]
His business is progressing smoothly.	<b>彼の商売は順調に進んでいます。</b> <br> かれのしょうばいはじゅんちょうにすすんでいます。 <br><br> (商売) <br> [sound:4c-s-彼の商売は順調に進んでいます。.mp3]
[sound:4c-k-売り場.mp3]	<b>売り場</b> <br> うりば <br> place where things are sold, point of sale, POS, sales floor, counter (in shop)
売り場	<b>うりば</b> <br> place where things are sold, point of sale, POS, sales floor, counter (in shop) <br> [sound:4c-k-売り場.mp3]
place where things are sold, point of sale, POS, sales floor, counter (in shop)	<b>売り場</b> <br> うりば <br> [sound:4c-k-売り場.mp3]
[sound:4c-s-売り場にはたくさんの人がいます。.mp3]	<b>売り場にはたくさんの人がいます。</b> <br> うりばにはたくさんのひとがいます。 <br><br> (売り場) <br> There are many people in the sales area.
売り場にはたくさんの人がいます。 <br><br> (売り場)	<b>うりばにはたくさんのひとがいます。</b> <br> There are many people in the sales area. <br> [sound:4c-s-売り場にはたくさんの人がいます。.mp3]
There are many people in the sales area.	<b>売り場にはたくさんの人がいます。</b> <br> うりばにはたくさんのひとがいます。 <br><br> (売り場) <br> [sound:4c-s-売り場にはたくさんの人がいます。.mp3]
[sound:4c-k-利.mp3]	<b>利</b> <br> り <br> advantage, benefit, profit, interest
利	<b>り</b> <br> advantage, benefit, profit, interest <br> [sound:4c-k-利.mp3]
advantage, benefit, profit, interest	<b>利</b> <br> り <br> [sound:4c-k-利.mp3]
[sound:4c-s-利子が少ない銀行を選びました。.mp3]	<b>利子が少ない銀行を選びました。</b> <br> りしがすくないぎんこうをえらびました。 <br><br> (利) <br> I chose a bank with low interest rates.
利子が少ない銀行を選びました。 <br><br> (利)	<b>りしがすくないぎんこうをえらびました。</b> <br> I chose a bank with low interest rates. <br> [sound:4c-s-利子が少ない銀行を選びました。.mp3]
I chose a bank with low interest rates.	<b>利子が少ない銀行を選びました。</b> <br> りしがすくないぎんこうをえらびました。 <br><br> (利) <br> [sound:4c-s-利子が少ない銀行を選びました。.mp3]
[sound:4c-k-金利.mp3]	<b>金利</b> <br> きんり <br> interest rates
金利	<b>きんり</b> <br> interest rates <br> [sound:4c-k-金利.mp3]
interest rates	<b>金利</b> <br> きんり <br> [sound:4c-k-金利.mp3]
[sound:4c-s-金利が上昇しています。.mp3]	<b>金利が上昇しています。</b> <br> きんりがじょうしょうしています。 <br><br> (金利) <br> Interest rates are rising.
金利が上昇しています。 <br><br> (金利)	<b>きんりがじょうしょうしています。</b> <br> Interest rates are rising. <br> [sound:4c-s-金利が上昇しています。.mp3]
Interest rates are rising.	<b>金利が上昇しています。</b> <br> きんりがじょうしょうしています。 <br><br> (金利) <br> [sound:4c-s-金利が上昇しています。.mp3]
[sound:4c-k-経常利益.mp3]	<b>経常利益</b> <br> けいじょうりえき <br> current profits, ordinary profit, income before income taxes
経常利益	<b>けいじょうりえき</b> <br> current profits, ordinary profit, income before income taxes <br> [sound:4c-k-経常利益.mp3]
current profits, ordinary profit, income before income taxes	<b>経常利益</b> <br> けいじょうりえき <br> [sound:4c-k-経常利益.mp3]
[sound:4c-s-経常利益は前年よりも増加しました。.mp3]	<b>経常利益は前年よりも増加しました。</b> <br> けいじょうりえきはぜんねんよりもぞうかしました。 <br><br> (経常利益) <br> Operating profit increased compared to the previous year.
経常利益は前年よりも増加しました。 <br><br> (経常利益)	<b>けいじょうりえきはぜんねんよりもぞうかしました。</b> <br> Operating profit increased compared to the previous year. <br> [sound:4c-s-経常利益は前年よりも増加しました。.mp3]
Operating profit increased compared to the previous year.	<b>経常利益は前年よりも増加しました。</b> <br> けいじょうりえきはぜんねんよりもぞうかしました。 <br><br> (経常利益) <br> [sound:4c-s-経常利益は前年よりも増加しました。.mp3]
[sound:4c-k-利下げ.mp3]	<b>利下げ</b> <br> りさげ <br> decrease in interest rates
利下げ	<b>りさげ</b> <br> decrease in interest rates <br> [sound:4c-k-利下げ.mp3]
decrease in interest rates	<b>利下げ</b> <br> りさげ <br> [sound:4c-k-利下げ.mp3]
[sound:4c-s-利下げが発表されました。.mp3]	<b>利下げが発表されました。</b> <br> りさげがはっぴょうされました。 <br><br> (利下げ) <br> An interest rate cut was announced.
利下げが発表されました。 <br><br> (利下げ)	<b>りさげがはっぴょうされました。</b> <br> An interest rate cut was announced. <br> [sound:4c-s-利下げが発表されました。.mp3]
An interest rate cut was announced.	<b>利下げが発表されました。</b> <br> りさげがはっぴょうされました。 <br><br> (利下げ) <br> [sound:4c-s-利下げが発表されました。.mp3]
[sound:4c-k-組.mp3]	<b>組</b> <br> くみ <br> set (of items); group (of people), class (of students), company (esp. construction), family (i.e. mafia), team; typesetting, composition
組	<b>くみ</b> <br> set (of items); group (of people), class (of students), company (esp. construction), family (i.e. mafia), team; typesetting, composition <br> [sound:4c-k-組.mp3]
set (of items); group (of people), class (of students), company (esp. construction), family (i.e. mafia), team; typesetting, composition	<b>組</b> <br> くみ <br> [sound:4c-k-組.mp3]
[sound:4c-s-私たちの組は6人です。.mp3]	<b>私たちの組は6人です。</b> <br> わたしたちのくみはろくにんです。 <br><br> (組) <br> There are six people in our group.
私たちの組は6人です。 <br><br> (組)	<b>わたしたちのくみはろくにんです。</b> <br> There are six people in our group. <br> [sound:4c-s-私たちの組は6人です。.mp3]
There are six people in our group.	<b>私たちの組は6人です。</b> <br> わたしたちのくみはろくにんです。 <br><br> (組) <br> [sound:4c-s-私たちの組は6人です。.mp3]
[sound:4c-k-組織.mp3]	<b>組織</b> <br> そしき <br> organization, organisation; structure, construction; tissue; system
組織	<b>そしき</b> <br> organization, organisation; structure, construction; tissue; system <br> [sound:4c-k-組織.mp3]
organization, organisation; structure, construction; tissue; system	<b>組織</b> <br> そしき <br> [sound:4c-k-組織.mp3]
[sound:4c-s-この組織は世界中に支部を持っています。.mp3]	<b>この組織は世界中に支部を持っています。</b> <br> このそしきはせかいじゅうにしぶをもっています。 <br><br> (組織) <br> This organization has branches all over the world.
この組織は世界中に支部を持っています。 <br><br> (組織)	<b>このそしきはせかいじゅうにしぶをもっています。</b> <br> This organization has branches all over the world. <br> [sound:4c-s-この組織は世界中に支部を持っています。.mp3]
This organization has branches all over the world.	<b>この組織は世界中に支部を持っています。</b> <br> このそしきはせかいじゅうにしぶをもっています。 <br><br> (組織) <br> [sound:4c-s-この組織は世界中に支部を持っています。.mp3]
[sound:4c-k-労働組合.mp3]	<b>労働組合</b> <br> ろうどうくみあい <br> labor union, labour union
労働組合	<b>ろうどうくみあい</b> <br> labor union, labour union <br> [sound:4c-k-労働組合.mp3]
labor union, labour union	<b>労働組合</b> <br> ろうどうくみあい <br> [sound:4c-k-労働組合.mp3]
[sound:4c-s-労働組合が新しい契約を結びました。.mp3]	<b>労働組合が新しい契約を結びました。</b> <br> ろうどうくみあいがあたらしいけいやくをむすびました。 <br><br> (労働組合) <br> The labor union signed a new contract.
労働組合が新しい契約を結びました。 <br><br> (労働組合)	<b>ろうどうくみあいがあたらしいけいやくをむすびました。</b> <br> The labor union signed a new contract. <br> [sound:4c-s-労働組合が新しい契約を結びました。.mp3]
The labor union signed a new contract.	<b>労働組合が新しい契約を結びました。</b> <br> ろうどうくみあいがあたらしいけいやくをむすびました。 <br><br> (労働組合) <br> [sound:4c-s-労働組合が新しい契約を結びました。.mp3]
[sound:4c-k-組長.mp3]	<b>組長</b> <br> くみちょう <br> boss (yakuza)
組長	<b>くみちょう</b> <br> boss (yakuza) <br> [sound:4c-k-組長.mp3]
boss (yakuza)	<b>組長</b> <br> くみちょう <br> [sound:4c-k-組長.mp3]
[sound:4c-s-彼は組長としてリーダーシップを発揮しています。.mp3]	<b>彼は組長としてリーダーシップを発揮しています。</b> <br> かれはくみちょうとしてりーだーしっぷをはっきしています。 <br><br> (組長) <br> He is showing leadership as the group leader.
彼は組長としてリーダーシップを発揮しています。 <br><br> (組長)	<b>かれはくみちょうとしてりーだーしっぷをはっきしています。</b> <br> He is showing leadership as the group leader. <br> [sound:4c-s-彼は組長としてリーダーシップを発揮しています。.mp3]
He is showing leadership as the group leader.	<b>彼は組長としてリーダーシップを発揮しています。</b> <br> かれはくみちょうとしてりーだーしっぷをはっきしています。 <br><br> (組長) <br> [sound:4c-s-彼は組長としてリーダーシップを発揮しています。.mp3]
[sound:4c-k-知る.mp3]	<b>知る</b> <br> しる <br> to know, to understand, to be acquainted with, to feel
知る	<b>しる</b> <br> to know, to understand, to be acquainted with, to feel <br> [sound:4c-k-知る.mp3]
to know, to understand, to be acquainted with, to feel	<b>知る</b> <br> しる <br> [sound:4c-k-知る.mp3]
[sound:4c-s-私はその事実を知りませんでした。.mp3]	<b>私はその事実を知りませんでした。</b> <br> わたしはそのじじつをしりませんでした。 <br><br> (知る) <br> I did not know that fact.
私はその事実を知りませんでした。 <br><br> (知る)	<b>わたしはそのじじつをしりませんでした。</b> <br> I did not know that fact. <br> [sound:4c-s-私はその事実を知りませんでした。.mp3]
I did not know that fact.	<b>私はその事実を知りませんでした。</b> <br> わたしはそのじじつをしりませんでした。 <br><br> (知る) <br> [sound:4c-s-私はその事実を知りませんでした。.mp3]
[sound:4c-k-知事.mp3]	<b>知事</b> <br> ちじ <br> prefectural governor
知事	<b>ちじ</b> <br> prefectural governor <br> [sound:4c-k-知事.mp3]
prefectural governor	<b>知事</b> <br> ちじ <br> [sound:4c-k-知事.mp3]
[sound:4c-s-知事は今日の会議に出席します。.mp3]	<b>知事は今日の会議に出席します。</b> <br> ちじはきょうのかいぎにしゅっせきします。 <br><br> (知事) <br> The governor will attend today's meeting.
知事は今日の会議に出席します。 <br><br> (知事)	<b>ちじはきょうのかいぎにしゅっせきします。</b> <br> The governor will attend today's meeting. <br> [sound:4c-s-知事は今日の会議に出席します。.mp3]
The governor will attend today's meeting.	<b>知事は今日の会議に出席します。</b> <br> ちじはきょうのかいぎにしゅっせきします。 <br><br> (知事) <br> [sound:4c-s-知事は今日の会議に出席します。.mp3]
[sound:4c-k-通知.mp3]	<b>通知</b> <br> つうち <br> notice, notification, report, posting
通知	<b>つうち</b> <br> notice, notification, report, posting <br> [sound:4c-k-通知.mp3]
notice, notification, report, posting	<b>通知</b> <br> つうち <br> [sound:4c-k-通知.mp3]
[sound:4c-s-新しい通知が届きました。.mp3]	<b>新しい通知が届きました。</b> <br> あたらしいつうちがとどきました。 <br><br> (通知) <br> A new notification has arrived.
新しい通知が届きました。 <br><br> (通知)	<b>あたらしいつうちがとどきました。</b> <br> A new notification has arrived. <br> [sound:4c-s-新しい通知が届きました。.mp3]
A new notification has arrived.	<b>新しい通知が届きました。</b> <br> あたらしいつうちがとどきました。 <br><br> (通知) <br> [sound:4c-s-新しい通知が届きました。.mp3]
[sound:4c-k-副知事.mp3]	<b>副知事</b> <br> ふくちじ <br> lieutenant governor
副知事	<b>ふくちじ</b> <br> lieutenant governor <br> [sound:4c-k-副知事.mp3]
lieutenant governor	<b>副知事</b> <br> ふくちじ <br> [sound:4c-k-副知事.mp3]
[sound:4c-s-副知事が行政改革を発表しました。.mp3]	<b>副知事が行政改革を発表しました。</b> <br> ふくちじがぎょうせいかいかくをはっぴょうしました。 <br><br> (副知事) <br> The deputy governor announced administrative reforms.
副知事が行政改革を発表しました。 <br><br> (副知事)	<b>ふくちじがぎょうせいかいかくをはっぴょうしました。</b> <br> The deputy governor announced administrative reforms. <br> [sound:4c-s-副知事が行政改革を発表しました。.mp3]
The deputy governor announced administrative reforms.	<b>副知事が行政改革を発表しました。</b> <br> ふくちじがぎょうせいかいかくをはっぴょうしました。 <br><br> (副知事) <br> [sound:4c-s-副知事が行政改革を発表しました。.mp3]
[sound:4c-k-法案.mp3]	<b>法案</b> <br> ほうあん <br> bill (law)
法案	<b>ほうあん</b> <br> bill (law) <br> [sound:4c-k-法案.mp3]
bill (law)	<b>法案</b> <br> ほうあん <br> [sound:4c-k-法案.mp3]
[sound:4c-s-その法案は議会で承認されました。.mp3]	<b>その法案は議会で承認されました。</b> <br> そのほうあんはぎかいでしょうにんされました。 <br><br> (法案) <br> The bill was approved in the parliament.
その法案は議会で承認されました。 <br><br> (法案)	<b>そのほうあんはぎかいでしょうにんされました。</b> <br> The bill was approved in the parliament. <br> [sound:4c-s-その法案は議会で承認されました。.mp3]
The bill was approved in the parliament.	<b>その法案は議会で承認されました。</b> <br> そのほうあんはぎかいでしょうにんされました。 <br><br> (法案) <br> [sound:4c-s-その法案は議会で承認されました。.mp3]
[sound:4c-k-提案.mp3]	<b>提案</b> <br> ていあん <br> proposal, proposition, suggestion
提案	<b>ていあん</b> <br> proposal, proposition, suggestion <br> [sound:4c-k-提案.mp3]
proposal, proposition, suggestion	<b>提案</b> <br> ていあん <br> [sound:4c-k-提案.mp3]
[sound:4c-s-彼は新しい提案をしました。.mp3]	<b>彼は新しい提案をしました。</b> <br> かれはあたらしいていあんをしました。 <br><br> (提案) <br> He made a new proposal.
彼は新しい提案をしました。 <br><br> (提案)	<b>かれはあたらしいていあんをしました。</b> <br> He made a new proposal. <br> [sound:4c-s-彼は新しい提案をしました。.mp3]
He made a new proposal.	<b>彼は新しい提案をしました。</b> <br> かれはあたらしいていあんをしました。 <br><br> (提案) <br> [sound:4c-s-彼は新しい提案をしました。.mp3]
[sound:4c-k-試案.mp3]	<b>試案</b> <br> しあん <br> tentative
試案	<b>しあん</b> <br> tentative <br> [sound:4c-k-試案.mp3]
tentative	<b>試案</b> <br> しあん <br> [sound:4c-k-試案.mp3]
[sound:4c-s-この試案はまだ検討中です。.mp3]	<b>この試案はまだ検討中です。</b> <br> このしあんはまだけんとうちゅうです。 <br><br> (試案) <br> This draft proposal is still under consideration.
この試案はまだ検討中です。 <br><br> (試案)	<b>このしあんはまだけんとうちゅうです。</b> <br> This draft proposal is still under consideration. <br> [sound:4c-s-この試案はまだ検討中です。.mp3]
This draft proposal is still under consideration.	<b>この試案はまだ検討中です。</b> <br> このしあんはまだけんとうちゅうです。 <br><br> (試案) <br> [sound:4c-s-この試案はまだ検討中です。.mp3]
[sound:4c-k-立案.mp3]	<b>立案</b> <br> りつあん <br> draft, draught, (rough) design
立案	<b>りつあん</b> <br> draft, draught, (rough) design <br> [sound:4c-k-立案.mp3]
draft, draught, (rough) design	<b>立案</b> <br> りつあん <br> [sound:4c-k-立案.mp3]
[sound:4c-s-新しい政策の立案が進んでいます。.mp3]	<b>新しい政策の立案が進んでいます。</b> <br> あたらしいせいさくのりつあんがすすんでいます。 <br><br> (立案) <br> The drafting of the new policy is progressing.
新しい政策の立案が進んでいます。 <br><br> (立案)	<b>あたらしいせいさくのりつあんがすすんでいます。</b> <br> The drafting of the new policy is progressing. <br> [sound:4c-s-新しい政策の立案が進んでいます。.mp3]
The drafting of the new policy is progressing.	<b>新しい政策の立案が進んでいます。</b> <br> あたらしいせいさくのりつあんがすすんでいます。 <br><br> (立案) <br> [sound:4c-s-新しい政策の立案が進んでいます。.mp3]
[sound:4c-k-道.mp3]	<b>道</b> <br> みち <br> road, street, way, path, course, route, lane; distance, ways (e.g. "a long ways"); the way (of proper conduct, etc.), one's way, morals; teachings (esp. Confucian or Buddhist), dogma; field (of medicine, etc.), subject; way, method, means
道	<b>みち</b> <br> road, street, way, path, course, route, lane; distance, ways (e.g. "a long ways"); the way (of proper conduct, etc.), one's way, morals; teachings (esp. Confucian or Buddhist), dogma; field (of medicine, etc.), subject; way, method, means <br> [sound:4c-k-道.mp3]
road, street, way, path, course, route, lane; distance, ways (e.g. "a long ways"); the way (of proper conduct, etc.), one's way, morals; teachings (esp. Confucian or Buddhist), dogma; field (of medicine, etc.), subject; way, method, means	<b>道</b> <br> みち <br> [sound:4c-k-道.mp3]
[sound:4c-s-この道はとても混んでいます。.mp3]	<b>この道はとても混んでいます。</b> <br> このみちはとてもこんでいます。 <br><br> (道) <br> This road is very crowded.
この道はとても混んでいます。 <br><br> (道)	<b>このみちはとてもこんでいます。</b> <br> This road is very crowded. <br> [sound:4c-s-この道はとても混んでいます。.mp3]
This road is very crowded.	<b>この道はとても混んでいます。</b> <br> このみちはとてもこんでいます。 <br><br> (道) <br> [sound:4c-s-この道はとても混んでいます。.mp3]
[sound:4c-k-報道.mp3]	<b>報道</b> <br> ほうどう <br> information, report, journalism
報道	<b>ほうどう</b> <br> information, report, journalism <br> [sound:4c-k-報道.mp3]
information, report, journalism	<b>報道</b> <br> ほうどう <br> [sound:4c-k-報道.mp3]
[sound:4c-s-報道陣が事件の現場に集まりました。.mp3]	<b>報道陣が事件の現場に集まりました。</b> <br> ほうどうじんがじけんのげんばにあつまりました。 <br><br> (報道) <br> The press gathered at the scene of the incident.
報道陣が事件の現場に集まりました。 <br><br> (報道)	<b>ほうどうじんがじけんのげんばにあつまりました。</b> <br> The press gathered at the scene of the incident. <br> [sound:4c-s-報道陣が事件の現場に集まりました。.mp3]
The press gathered at the scene of the incident.	<b>報道陣が事件の現場に集まりました。</b> <br> ほうどうじんがじけんのげんばにあつまりました。 <br><br> (報道) <br> [sound:4c-s-報道陣が事件の現場に集まりました。.mp3]
[sound:4c-k-報道陣.mp3]	<b>報道陣</b> <br> ほうどうじん <br> press corps
報道陣	<b>ほうどうじん</b> <br> press corps <br> [sound:4c-k-報道陣.mp3]
press corps	<b>報道陣</b> <br> ほうどうじん <br> [sound:4c-k-報道陣.mp3]
[sound:4c-s-報道陣が記者会見を待っています。.mp3]	<b>報道陣が記者会見を待っています。</b> <br> ほうどうじんがきしゃかいけんをまっています。 <br><br> (報道陣) <br> The press is waiting for the press conference.
報道陣が記者会見を待っています。 <br><br> (報道陣)	<b>ほうどうじんがきしゃかいけんをまっています。</b> <br> The press is waiting for the press conference. <br> [sound:4c-s-報道陣が記者会見を待っています。.mp3]
The press is waiting for the press conference.	<b>報道陣が記者会見を待っています。</b> <br> ほうどうじんがきしゃかいけんをまっています。 <br><br> (報道陣) <br> [sound:4c-s-報道陣が記者会見を待っています。.mp3]
[sound:4c-k-高速道路.mp3]	<b>高速道路</b> <br> こうそくどうろ <br> highway, freeway, expressway, motorway
高速道路	<b>こうそくどうろ</b> <br> highway, freeway, expressway, motorway <br> [sound:4c-k-高速道路.mp3]
highway, freeway, expressway, motorway	<b>高速道路</b> <br> こうそくどうろ <br> [sound:4c-k-高速道路.mp3]
[sound:4c-s-高速道路は渋滞しています。.mp3]	<b>高速道路は渋滞しています。</b> <br> こうそくどうろはじゅうたいしています。 <br><br> (高速道路) <br> The highway is experiencing a traffic jam.
高速道路は渋滞しています。 <br><br> (高速道路)	<b>こうそくどうろはじゅうたいしています。</b> <br> The highway is experiencing a traffic jam. <br> [sound:4c-s-高速道路は渋滞しています。.mp3]
The highway is experiencing a traffic jam.	<b>高速道路は渋滞しています。</b> <br> こうそくどうろはじゅうたいしています。 <br><br> (高速道路) <br> [sound:4c-s-高速道路は渋滞しています。.mp3]
[sound:4c-k-信.mp3]	<b>信</b> <br> しん <br> honesty, fidelity; trust, reliance; (religious) faith; counter for received messages
信	<b>しん</b> <br> honesty, fidelity; trust, reliance; (religious) faith; counter for received messages <br> [sound:4c-k-信.mp3]
honesty, fidelity; trust, reliance; (religious) faith; counter for received messages	<b>信</b> <br> しん <br> [sound:4c-k-信.mp3]
[sound:4c-s-信頼関係が大切です。.mp3]	<b>信頼関係が大切です。</b> <br> しんらいかんけいがたいせつです。 <br><br> (信) <br> Trust is important.
信頼関係が大切です。 <br><br> (信)	<b>しんらいかんけいがたいせつです。</b> <br> Trust is important. <br> [sound:4c-s-信頼関係が大切です。.mp3]
Trust is important.	<b>信頼関係が大切です。</b> <br> しんらいかんけいがたいせつです。 <br><br> (信) <br> [sound:4c-s-信頼関係が大切です。.mp3]
[sound:4c-k-通信.mp3]	<b>通信</b> <br> つうしん <br> correspondence, communication, transmission, news, signal
通信	<b>つうしん</b> <br> correspondence, communication, transmission, news, signal <br> [sound:4c-k-通信.mp3]
correspondence, communication, transmission, news, signal	<b>通信</b> <br> つうしん <br> [sound:4c-k-通信.mp3]
[sound:4c-s-インターネット通信が遅いです。.mp3]	<b>インターネット通信が遅いです。</b> <br> いんたーねっとつうしんがおそいです。 <br><br> (通信) <br> The internet connection is slow.
インターネット通信が遅いです。 <br><br> (通信)	<b>いんたーねっとつうしんがおそいです。</b> <br> The internet connection is slow. <br> [sound:4c-s-インターネット通信が遅いです。.mp3]
The internet connection is slow.	<b>インターネット通信が遅いです。</b> <br> いんたーねっとつうしんがおそいです。 <br><br> (通信) <br> [sound:4c-s-インターネット通信が遅いです。.mp3]
[sound:4c-k-信号.mp3]	<b>信号</b> <br> しんごう <br> traffic lights, signal, semaphore
信号	<b>しんごう</b> <br> traffic lights, signal, semaphore <br> [sound:4c-k-信号.mp3]
traffic lights, signal, semaphore	<b>信号</b> <br> しんごう <br> [sound:4c-k-信号.mp3]
[sound:4c-s-信号が赤になったので止まりました。.mp3]	<b>信号が赤になったので止まりました。</b> <br> しんごうがあかになったのでとまりました。 <br><br> (信号) <br> I stopped because the traffic light turned red.
信号が赤になったので止まりました。 <br><br> (信号)	<b>しんごうがあかになったのでとまりました。</b> <br> I stopped because the traffic light turned red. <br> [sound:4c-s-信号が赤になったので止まりました。.mp3]
I stopped because the traffic light turned red.	<b>信号が赤になったので止まりました。</b> <br> しんごうがあかになったのでとまりました。 <br><br> (信号) <br> [sound:4c-s-信号が赤になったので止まりました。.mp3]
[sound:4c-k-受信.mp3]	<b>受信</b> <br> じゅしん <br> reception (e.g. radio), receipt
受信	<b>じゅしん</b> <br> reception (e.g. radio), receipt <br> [sound:4c-k-受信.mp3]
reception (e.g. radio), receipt	<b>受信</b> <br> じゅしん <br> [sound:4c-k-受信.mp3]
[sound:4c-s-メールを受信しました。.mp3]	<b>メールを受信しました。</b> <br> めーるをじゅしんしました。 <br><br> (受信) <br> I received an email.
メールを受信しました。 <br><br> (受信)	<b>めーるをじゅしんしました。</b> <br> I received an email. <br> [sound:4c-s-メールを受信しました。.mp3]
I received an email.	<b>メールを受信しました。</b> <br> めーるをじゅしんしました。 <br><br> (受信) <br> [sound:4c-s-メールを受信しました。.mp3]
[sound:4c-k-政策.mp3]	<b>政策</b> <br> せいさく <br> political measures, policy
政策	<b>せいさく</b> <br> political measures, policy <br> [sound:4c-k-政策.mp3]
political measures, policy	<b>政策</b> <br> せいさく <br> [sound:4c-k-政策.mp3]
[sound:4c-s-政府は新しい政策を発表しました。.mp3]	<b>政府は新しい政策を発表しました。</b> <br> せいふはあたらしいせいさくをはっぴょうしました。 <br><br> (政策) <br> The government announced a new policy.
政府は新しい政策を発表しました。 <br><br> (政策)	<b>せいふはあたらしいせいさくをはっぴょうしました。</b> <br> The government announced a new policy. <br> [sound:4c-s-政府は新しい政策を発表しました。.mp3]
The government announced a new policy.	<b>政府は新しい政策を発表しました。</b> <br> せいふはあたらしいせいさくをはっぴょうしました。 <br><br> (政策) <br> [sound:4c-s-政府は新しい政策を発表しました。.mp3]
[sound:4c-k-対策.mp3]	<b>対策</b> <br> たいさく <br> counter-plan, counter-measure
対策	<b>たいさく</b> <br> counter-plan, counter-measure <br> [sound:4c-k-対策.mp3]
counter-plan, counter-measure	<b>対策</b> <br> たいさく <br> [sound:4c-k-対策.mp3]
[sound:4c-s-地震に備えるための対策を講じました。.mp3]	<b>地震に備えるための対策を講じました。</b> <br> じしんにそなえるためのたいさくをこうじました。 <br><br> (対策) <br> We took measures to prepare for an earthquake.
地震に備えるための対策を講じました。 <br><br> (対策)	<b>じしんにそなえるためのたいさくをこうじました。</b> <br> We took measures to prepare for an earthquake. <br> [sound:4c-s-地震に備えるための対策を講じました。.mp3]
We took measures to prepare for an earthquake.	<b>地震に備えるための対策を講じました。</b> <br> じしんにそなえるためのたいさくをこうじました。 <br><br> (対策) <br> [sound:4c-s-地震に備えるための対策を講じました。.mp3]
[sound:4c-k-苦肉の策.mp3]	<b>苦肉の策</b> <br> くにくのさく <br> last resort, desperate measure taken under pressure of necessity
苦肉の策	<b>くにくのさく</b> <br> last resort, desperate measure taken under pressure of necessity <br> [sound:4c-k-苦肉の策.mp3]
last resort, desperate measure taken under pressure of necessity	<b>苦肉の策</b> <br> くにくのさく <br> [sound:4c-k-苦肉の策.mp3]
[sound:4c-s-苦肉の策として、彼は自分で問題を解決しました。.mp3]	<b>苦肉の策として、彼は自分で問題を解決しました。</b> <br> くにくのさくとして、かれはじぶんでもんだいをかいけつしました。 <br><br> (苦肉の策) <br> As a last resort, he solved the problem himself.
苦肉の策として、彼は自分で問題を解決しました。 <br><br> (苦肉の策)	<b>くにくのさくとして、かれはじぶんでもんだいをかいけつしました。</b> <br> As a last resort, he solved the problem himself. <br> [sound:4c-s-苦肉の策として、彼は自分で問題を解決しました。.mp3]
As a last resort, he solved the problem himself.	<b>苦肉の策として、彼は自分で問題を解決しました。</b> <br> くにくのさくとして、かれはじぶんでもんだいをかいけつしました。 <br><br> (苦肉の策) <br> [sound:4c-s-苦肉の策として、彼は自分で問題を解決しました。.mp3]
[sound:4c-k-国策.mp3]	<b>国策</b> <br> こくさく <br> national policy
国策	<b>こくさく</b> <br> national policy <br> [sound:4c-k-国策.mp3]
