the said person, he, she, same person	<b>同氏</b> <br> どうし <br> [sound:4c-k-同氏.mp3]
[sound:4c-s-同氏は重要な発言をしました。.mp3]	<b>同氏は重要な発言をしました。</b> <br> どうしはじゅうようなはつげんをしました。 <br><br> (同氏) <br> The same person made an important statement.
同氏は重要な発言をしました。 <br><br> (同氏)	<b>どうしはじゅうようなはつげんをしました。</b> <br> The same person made an important statement. <br> [sound:4c-s-同氏は重要な発言をしました。.mp3]
The same person made an important statement.	<b>同氏は重要な発言をしました。</b> <br> どうしはじゅうようなはつげんをしました。 <br><br> (同氏) <br> [sound:4c-s-同氏は重要な発言をしました。.mp3]
[sound:4c-k-両氏.mp3]	<b>両氏</b> <br> りょうし <br> both persons
両氏	<b>りょうし</b> <br> both persons <br> [sound:4c-k-両氏.mp3]
both persons	<b>両氏</b> <br> りょうし <br> [sound:4c-k-両氏.mp3]
[sound:4c-s-両氏は会議に参加しました。.mp3]	<b>両氏は会議に参加しました。</b> <br> りょうしはかいぎにさんかしました。 <br><br> (両氏) <br> Both individuals attended the meeting.
両氏は会議に参加しました。 <br><br> (両氏)	<b>りょうしはかいぎにさんかしました。</b> <br> Both individuals attended the meeting. <br> [sound:4c-s-両氏は会議に参加しました。.mp3]
Both individuals attended the meeting.	<b>両氏は会議に参加しました。</b> <br> りょうしはかいぎにさんかしました。 <br><br> (両氏) <br> [sound:4c-s-両氏は会議に参加しました。.mp3]
[sound:4c-k-現在.mp3]	<b>現在</b> <br> げんざい <br> now, current, present, present time, as of
現在	<b>げんざい</b> <br> now, current, present, present time, as of <br> [sound:4c-k-現在.mp3]
now, current, present, present time, as of	<b>現在</b> <br> げんざい <br> [sound:4c-k-現在.mp3]
[sound:4c-s-彼は現在、海外で働いています。.mp3]	<b>彼は現在、海外で働いています。</b> <br> かれはげんざい、かいがいではたらいています。 <br><br> (現在) <br> He is currently working abroad.
彼は現在、海外で働いています。 <br><br> (現在)	<b>かれはげんざい、かいがいではたらいています。</b> <br> He is currently working abroad. <br> [sound:4c-s-彼は現在、海外で働いています。.mp3]
He is currently working abroad.	<b>彼は現在、海外で働いています。</b> <br> かれはげんざい、かいがいではたらいています。 <br><br> (現在) <br> [sound:4c-s-彼は現在、海外で働いています。.mp3]
[sound:4c-k-現実.mp3]	<b>現実</b> <br> げんじつ <br> reality
現実	<b>げんじつ</b> <br> reality <br> [sound:4c-k-現実.mp3]
reality	<b>現実</b> <br> げんじつ <br> [sound:4c-k-現実.mp3]
[sound:4c-s-現実を受け入れることが重要です。.mp3]	<b>現実を受け入れることが重要です。</b> <br> げんじつをうけいれることがじゅうようです。 <br><br> (現実) <br> Accepting reality is important.
現実を受け入れることが重要です。 <br><br> (現実)	<b>げんじつをうけいれることがじゅうようです。</b> <br> Accepting reality is important. <br> [sound:4c-s-現実を受け入れることが重要です。.mp3]
Accepting reality is important.	<b>現実を受け入れることが重要です。</b> <br> げんじつをうけいれることがじゅうようです。 <br><br> (現実) <br> [sound:4c-s-現実を受け入れることが重要です。.mp3]
[sound:4c-k-現場.mp3]	<b>現場</b> <br> げんば, げんじょう <br> actual spot, scene, scene of the crime
現場	<b>げんば, げんじょう</b> <br> actual spot, scene, scene of the crime <br> [sound:4c-k-現場.mp3]
actual spot, scene, scene of the crime	<b>現場</b> <br> げんば, げんじょう <br> [sound:4c-k-現場.mp3]
[sound:4c-s-現場で問題を解決しました。.mp3]	<b>現場で問題を解決しました。</b> <br> げんばでもんだいをかいけつしました。 <br><br> (現場) <br> I solved the problem at the scene.
現場で問題を解決しました。 <br><br> (現場)	<b>げんばでもんだいをかいけつしました。</b> <br> I solved the problem at the scene. <br> [sound:4c-s-現場で問題を解決しました。.mp3]
I solved the problem at the scene.	<b>現場で問題を解決しました。</b> <br> げんばでもんだいをかいけつしました。 <br><br> (現場) <br> [sound:4c-s-現場で問題を解決しました。.mp3]
[sound:4c-k-現地.mp3]	<b>現地</b> <br> げんち <br> actual place, local
現地	<b>げんち</b> <br> actual place, local <br> [sound:4c-k-現地.mp3]
actual place, local	<b>現地</b> <br> げんち <br> [sound:4c-k-現地.mp3]
[sound:4c-s-現地での調査が行われました。.mp3]	<b>現地での調査が行われました。</b> <br> げんちでのちょうさがおこなわれました。 <br><br> (現地) <br> An investigation was conducted on-site.
現地での調査が行われました。 <br><br> (現地)	<b>げんちでのちょうさがおこなわれました。</b> <br> An investigation was conducted on-site. <br> [sound:4c-s-現地での調査が行われました。.mp3]
An investigation was conducted on-site.	<b>現地での調査が行われました。</b> <br> げんちでのちょうさがおこなわれました。 <br><br> (現地) <br> [sound:4c-s-現地での調査が行われました。.mp3]
[sound:4c-k-理.mp3]	<b>理</b> <br> り <br> reason, principle, logic; general principle (as opposed to individual concrete phenomenon); (in neo-Confucianism) the underlying principles of the cosmos
理	<b>り</b> <br> reason, principle, logic; general principle (as opposed to individual concrete phenomenon); (in neo-Confucianism) the underlying principles of the cosmos <br> [sound:4c-k-理.mp3]
reason, principle, logic; general principle (as opposed to individual concrete phenomenon); (in neo-Confucianism) the underlying principles of the cosmos	<b>理</b> <br> り <br> [sound:4c-k-理.mp3]
[sound:4c-s-物理学を学ぶのが好きです。.mp3]	<b>物理学を学ぶのが好きです。</b> <br> ぶつりがくをまなぶのがすきです。 <br><br> (理) <br> I like studying physics.
物理学を学ぶのが好きです。 <br><br> (理)	<b>ぶつりがくをまなぶのがすきです。</b> <br> I like studying physics. <br> [sound:4c-s-物理学を学ぶのが好きです。.mp3]
I like studying physics.	<b>物理学を学ぶのが好きです。</b> <br> ぶつりがくをまなぶのがすきです。 <br><br> (理) <br> [sound:4c-s-物理学を学ぶのが好きです。.mp3]
[sound:4c-k-管理.mp3]	<b>管理</b> <br> かんり <br> control, management (e.g. of a business)
管理	<b>かんり</b> <br> control, management (e.g. of a business) <br> [sound:4c-k-管理.mp3]
control, management (e.g. of a business)	<b>管理</b> <br> かんり <br> [sound:4c-k-管理.mp3]
[sound:4c-s-彼はプロジェクトの管理を担当しています。.mp3]	<b>彼はプロジェクトの管理を担当しています。</b> <br> かれはプロジェクトのかんりをたんとうしています。 <br><br> (管理) <br> He is in charge of project management.
彼はプロジェクトの管理を担当しています。 <br><br> (管理)	<b>かれはプロジェクトのかんりをたんとうしています。</b> <br> He is in charge of project management. <br> [sound:4c-s-彼はプロジェクトの管理を担当しています。.mp3]
He is in charge of project management.	<b>彼はプロジェクトの管理を担当しています。</b> <br> かれはプロジェクトのかんりをたんとうしています。 <br><br> (管理) <br> [sound:4c-s-彼はプロジェクトの管理を担当しています。.mp3]
[sound:4c-k-理事.mp3]	<b>理事</b> <br> りじ <br> director, board of directors
理事	<b>りじ</b> <br> director, board of directors <br> [sound:4c-k-理事.mp3]
director, board of directors	<b>理事</b> <br> りじ <br> [sound:4c-k-理事.mp3]
[sound:4c-s-彼は会社の理事を務めています。.mp3]	<b>彼は会社の理事を務めています。</b> <br> かれはかいしゃのりじをつとめています。 <br><br> (理事) <br> He serves as the company director.
彼は会社の理事を務めています。 <br><br> (理事)	<b>かれはかいしゃのりじをつとめています。</b> <br> He serves as the company director. <br> [sound:4c-s-彼は会社の理事を務めています。.mp3]
He serves as the company director.	<b>彼は会社の理事を務めています。</b> <br> かれはかいしゃのりじをつとめています。 <br><br> (理事) <br> [sound:4c-s-彼は会社の理事を務めています。.mp3]
[sound:4c-k-理由.mp3]	<b>理由</b> <br> りゆう <br> reason, pretext, motive
理由	<b>りゆう</b> <br> reason, pretext, motive <br> [sound:4c-k-理由.mp3]
reason, pretext, motive	<b>理由</b> <br> りゆう <br> [sound:4c-k-理由.mp3]
[sound:4c-s-彼が遅れた理由を説明してください。.mp3]	<b>彼が遅れた理由を説明してください。</b> <br> かれがおくれたりゆうをせつめいしてください。 <br><br> (理由) <br> Please explain the reason why he was late.
彼が遅れた理由を説明してください。 <br><br> (理由)	<b>かれがおくれたりゆうをせつめいしてください。</b> <br> Please explain the reason why he was late. <br> [sound:4c-s-彼が遅れた理由を説明してください。.mp3]
Please explain the reason why he was late.	<b>彼が遅れた理由を説明してください。</b> <br> かれがおくれたりゆうをせつめいしてください。 <br><br> (理由) <br> [sound:4c-s-彼が遅れた理由を説明してください。.mp3]
[sound:4c-k-調べ.mp3]	<b>調べ</b> <br> しらべ <br> investigation, inspection, examination; tune, note, melody
調べ	<b>しらべ</b> <br> investigation, inspection, examination; tune, note, melody <br> [sound:4c-k-調べ.mp3]
investigation, inspection, examination; tune, note, melody	<b>調べ</b> <br> しらべ <br> [sound:4c-k-調べ.mp3]
[sound:4c-s-彼は新しい情報を調べています。.mp3]	<b>彼は新しい情報を調べています。</b> <br> かれはあたらしいじょうほうをしらべています。 <br><br> (調べ) <br> He is looking up new information.
彼は新しい情報を調べています。 <br><br> (調べ)	<b>かれはあたらしいじょうほうをしらべています。</b> <br> He is looking up new information. <br> [sound:4c-s-彼は新しい情報を調べています。.mp3]
He is looking up new information.	<b>彼は新しい情報を調べています。</b> <br> かれはあたらしいじょうほうをしらべています。 <br><br> (調べ) <br> [sound:4c-s-彼は新しい情報を調べています。.mp3]
[sound:4c-k-調査.mp3]	<b>調査</b> <br> ちょうさ <br> investigation, examination, inquiry, enquiry, survey
調査	<b>ちょうさ</b> <br> investigation, examination, inquiry, enquiry, survey <br> [sound:4c-k-調査.mp3]
investigation, examination, inquiry, enquiry, survey	<b>調査</b> <br> ちょうさ <br> [sound:4c-k-調査.mp3]
[sound:4c-s-環境問題の調査を実施しました。.mp3]	<b>環境問題の調査を実施しました。</b> <br> かんきょうもんだいのちょうさをじっししました。 <br><br> (調査) <br> I conducted a survey on environmental issues.
環境問題の調査を実施しました。 <br><br> (調査)	<b>かんきょうもんだいのちょうさをじっししました。</b> <br> I conducted a survey on environmental issues. <br> [sound:4c-s-環境問題の調査を実施しました。.mp3]
I conducted a survey on environmental issues.	<b>環境問題の調査を実施しました。</b> <br> かんきょうもんだいのちょうさをじっししました。 <br><br> (調査) <br> [sound:4c-s-環境問題の調査を実施しました。.mp3]
[sound:4c-k-調整.mp3]	<b>調整</b> <br> ちょうせい <br> regulation, adjustment, tuning, modification, alteration
調整	<b>ちょうせい</b> <br> regulation, adjustment, tuning, modification, alteration <br> [sound:4c-k-調整.mp3]
regulation, adjustment, tuning, modification, alteration	<b>調整</b> <br> ちょうせい <br> [sound:4c-k-調整.mp3]
[sound:4c-s-計画を調整する必要があります。.mp3]	<b>計画を調整する必要があります。</b> <br> けいかくをちょうせいするひつようがあります。 <br><br> (調整) <br> We need to adjust the plan.
計画を調整する必要があります。 <br><br> (調整)	<b>けいかくをちょうせいするひつようがあります。</b> <br> We need to adjust the plan. <br> [sound:4c-s-計画を調整する必要があります。.mp3]
We need to adjust the plan.	<b>計画を調整する必要があります。</b> <br> けいかくをちょうせいするひつようがあります。 <br><br> (調整) <br> [sound:4c-s-計画を調整する必要があります。.mp3]
[sound:4c-k-協調.mp3]	<b>協調</b> <br> きょうちょう <br> cooperation, conciliation, harmony; firm (market) tone
協調	<b>きょうちょう</b> <br> cooperation, conciliation, harmony; firm (market) tone <br> [sound:4c-k-協調.mp3]
cooperation, conciliation, harmony; firm (market) tone	<b>協調</b> <br> きょうちょう <br> [sound:4c-k-協調.mp3]
[sound:4c-s-チームは協調して作業を進めました。.mp3]	<b>チームは協調して作業を進めました。</b> <br> チームはきょうちょうしてさぎょうをすすめました。 <br><br> (協調) <br> The team worked together cooperatively.
チームは協調して作業を進めました。 <br><br> (協調)	<b>チームはきょうちょうしてさぎょうをすすめました。</b> <br> The team worked together cooperatively. <br> [sound:4c-s-チームは協調して作業を進めました。.mp3]
The team worked together cooperatively.	<b>チームは協調して作業を進めました。</b> <br> チームはきょうちょうしてさぎょうをすすめました。 <br><br> (協調) <br> [sound:4c-s-チームは協調して作業を進めました。.mp3]
[sound:4c-k-体.mp3]	<b>体</b> <br> からだ, しんたい <br> body; health
体	<b>からだ, しんたい</b> <br> body; health <br> [sound:4c-k-体.mp3]
body; health	<b>体</b> <br> からだ, しんたい <br> [sound:4c-k-体.mp3]
[sound:4c-s-彼は健康な体を維持しています。.mp3]	<b>彼は健康な体を維持しています。</b> <br> かれはけんこうなからだをいじしています。 <br><br> (体) <br> He maintains a healthy body.
彼は健康な体を維持しています。 <br><br> (体)	<b>かれはけんこうなからだをいじしています。</b> <br> He maintains a healthy body. <br> [sound:4c-s-彼は健康な体を維持しています。.mp3]
He maintains a healthy body.	<b>彼は健康な体を維持しています。</b> <br> かれはけんこうなからだをいじしています。 <br><br> (体) <br> [sound:4c-s-彼は健康な体を維持しています。.mp3]
[sound:4c-k-具体的.mp3]	<b>具体的</b> <br> ぐたいてき <br> concrete, tangible, definite, specific
具体的	<b>ぐたいてき</b> <br> concrete, tangible, definite, specific <br> [sound:4c-k-具体的.mp3]
concrete, tangible, definite, specific	<b>具体的</b> <br> ぐたいてき <br> [sound:4c-k-具体的.mp3]
[sound:4c-s-具体的な例を挙げて説明します。.mp3]	<b>具体的な例を挙げて説明します。</b> <br> ぐたいてきなれいをあげてせつめいします。 <br><br> (具体的) <br> I will explain with a specific example.
具体的な例を挙げて説明します。 <br><br> (具体的)	<b>ぐたいてきなれいをあげてせつめいします。</b> <br> I will explain with a specific example. <br> [sound:4c-s-具体的な例を挙げて説明します。.mp3]
I will explain with a specific example.	<b>具体的な例を挙げて説明します。</b> <br> ぐたいてきなれいをあげてせつめいします。 <br><br> (具体的) <br> [sound:4c-s-具体的な例を挙げて説明します。.mp3]
[sound:4c-k-全体.mp3]	<b>全体</b> <br> ぜんたい <br> whole, entirety, whatever (is the matter)
全体	<b>ぜんたい</b> <br> whole, entirety, whatever (is the matter) <br> [sound:4c-k-全体.mp3]
whole, entirety, whatever (is the matter)	<b>全体</b> <br> ぜんたい <br> [sound:4c-k-全体.mp3]
[sound:4c-s-全体の計画を見直しました。.mp3]	<b>全体の計画を見直しました。</b> <br> ぜんたいのけいかくをみなおしました。 <br><br> (全体) <br> I reviewed the overall plan.
全体の計画を見直しました。 <br><br> (全体)	<b>ぜんたいのけいかくをみなおしました。</b> <br> I reviewed the overall plan. <br> [sound:4c-s-全体の計画を見直しました。.mp3]
I reviewed the overall plan.	<b>全体の計画を見直しました。</b> <br> ぜんたいのけいかくをみなおしました。 <br><br> (全体) <br> [sound:4c-s-全体の計画を見直しました。.mp3]
[sound:4c-k-体制.mp3]	<b>体制</b> <br> たいせい <br> order, system, structure, set-up, organization, organisation
体制	<b>たいせい</b> <br> order, system, structure, set-up, organization, organisation <br> [sound:4c-k-体制.mp3]
order, system, structure, set-up, organization, organisation	<b>体制</b> <br> たいせい <br> [sound:4c-k-体制.mp3]
[sound:4c-s-新しい体制が導入されました。.mp3]	<b>新しい体制が導入されました。</b> <br> あたらしいたいせいがどうにゅうされました。 <br><br> (体制) <br> A new system has been introduced.
新しい体制が導入されました。 <br><br> (体制)	<b>あたらしいたいせいがどうにゅうされました。</b> <br> A new system has been introduced. <br> [sound:4c-s-新しい体制が導入されました。.mp3]
A new system has been introduced.	<b>新しい体制が導入されました。</b> <br> あたらしいたいせいがどうにゅうされました。 <br><br> (体制) <br> [sound:4c-s-新しい体制が導入されました。.mp3]
[sound:4c-k-強化.mp3]	<b>強化</b> <br> きょうか <br> strengthen, intensify, reinforce, solidify, enhancement
強化	<b>きょうか</b> <br> strengthen, intensify, reinforce, solidify, enhancement <br> [sound:4c-k-強化.mp3]
strengthen, intensify, reinforce, solidify, enhancement	<b>強化</b> <br> きょうか <br> [sound:4c-k-強化.mp3]
[sound:4c-s-チームの協力を強化する必要があります。.mp3]	<b>チームの協力を強化する必要があります。</b> <br> チームのきょうりょくをきょうかするひつようがあります。 <br><br> (強化) <br> We need to strengthen team cooperation.
チームの協力を強化する必要があります。 <br><br> (強化)	<b>チームのきょうりょくをきょうかするひつようがあります。</b> <br> We need to strengthen team cooperation. <br> [sound:4c-s-チームの協力を強化する必要があります。.mp3]
We need to strengthen team cooperation.	<b>チームの協力を強化する必要があります。</b> <br> チームのきょうりょくをきょうかするひつようがあります。 <br><br> (強化) <br> [sound:4c-s-チームの協力を強化する必要があります。.mp3]
[sound:4c-k-文化.mp3]	<b>文化</b> <br> ぶんか <br> culture, civilization, civilisation; Bunka era (1804.2.11-1818.4.22)
文化	<b>ぶんか</b> <br> culture, civilization, civilisation; Bunka era (1804.2.11-1818.4.22) <br> [sound:4c-k-文化.mp3]
culture, civilization, civilisation; Bunka era (1804.2.11-1818.4.22)	<b>文化</b> <br> ぶんか <br> [sound:4c-k-文化.mp3]
[sound:4c-s-彼は日本文化に興味があります。.mp3]	<b>彼は日本文化に興味があります。</b> <br> かれはにほんぶんかにきょうみがあります。 <br><br> (文化) <br> He is interested in Japanese culture.
彼は日本文化に興味があります。 <br><br> (文化)	<b>かれはにほんぶんかにきょうみがあります。</b> <br> He is interested in Japanese culture. <br> [sound:4c-s-彼は日本文化に興味があります。.mp3]
He is interested in Japanese culture.	<b>彼は日本文化に興味があります。</b> <br> かれはにほんぶんかにきょうみがあります。 <br><br> (文化) <br> [sound:4c-s-彼は日本文化に興味があります。.mp3]
[sound:4c-k-変化.mp3]	<b>変化</b> <br> へんか <br> change, variation, alteration, mutation, transition, transformation, transfiguration, metamorphosis; variety, diversity; inflection, declension, conjugation; sidestepping (sumo)
変化	<b>へんか</b> <br> change, variation, alteration, mutation, transition, transformation, transfiguration, metamorphosis; variety, diversity; inflection, declension, conjugation; sidestepping (sumo) <br> [sound:4c-k-変化.mp3]
change, variation, alteration, mutation, transition, transformation, transfiguration, metamorphosis; variety, diversity; inflection, declension, conjugation; sidestepping (sumo)	<b>変化</b> <br> へんか <br> [sound:4c-k-変化.mp3]
[sound:4c-s-市場の変化に対応しなければなりません。.mp3]	<b>市場の変化に対応しなければなりません。</b> <br> しじょうのへんかにたいおうしなければなりません。 <br><br> (変化) <br> We must respond to market changes.
市場の変化に対応しなければなりません。 <br><br> (変化)	<b>しじょうのへんかにたいおうしなければなりません。</b> <br> We must respond to market changes. <br> [sound:4c-s-市場の変化に対応しなければなりません。.mp3]
We must respond to market changes.	<b>市場の変化に対応しなければなりません。</b> <br> しじょうのへんかにたいおうしなければなりません。 <br><br> (変化) <br> [sound:4c-s-市場の変化に対応しなければなりません。.mp3]
[sound:4c-k-悪化.mp3]	<b>悪化</b> <br> あっか <br> (suffer) deterioration, growing worse, aggravation, degeneration, corruption
悪化	<b>あっか</b> <br> (suffer) deterioration, growing worse, aggravation, degeneration, corruption <br> [sound:4c-k-悪化.mp3]
(suffer) deterioration, growing worse, aggravation, degeneration, corruption	<b>悪化</b> <br> あっか <br> [sound:4c-k-悪化.mp3]
[sound:4c-s-環境問題が悪化しています。.mp3]	<b>環境問題が悪化しています。</b> <br> かんきょうもんだいがあっかしています。 <br><br> (悪化) <br> Environmental problems are worsening.
環境問題が悪化しています。 <br><br> (悪化)	<b>かんきょうもんだいがあっかしています。</b> <br> Environmental problems are worsening. <br> [sound:4c-s-環境問題が悪化しています。.mp3]
Environmental problems are worsening.	<b>環境問題が悪化しています。</b> <br> かんきょうもんだいがあっかしています。 <br><br> (悪化) <br> [sound:4c-s-環境問題が悪化しています。.mp3]
[sound:4c-k-上田.mp3]	<b>上田</b> <br> じょうでん <br> high rice field, very fertile rice field
上田	<b>じょうでん</b> <br> high rice field, very fertile rice field <br> [sound:4c-k-上田.mp3]
high rice field, very fertile rice field	<b>上田</b> <br> じょうでん <br> [sound:4c-k-上田.mp3]
[sound:4c-s-上田さんは新しいプロジェクトを担当しています。.mp3]	<b>上田さんは新しいプロジェクトを担当しています。</b> <br> うえださんはあたらしいプロジェクトをたんとうしています。 <br><br> (上田) <br> Mr. Ueda is in charge of a new project.
上田さんは新しいプロジェクトを担当しています。 <br><br> (上田)	<b>うえださんはあたらしいプロジェクトをたんとうしています。</b> <br> Mr. Ueda is in charge of a new project. <br> [sound:4c-s-上田さんは新しいプロジェクトを担当しています。.mp3]
Mr. Ueda is in charge of a new project.	<b>上田さんは新しいプロジェクトを担当しています。</b> <br> うえださんはあたらしいプロジェクトをたんとうしています。 <br><br> (上田) <br> [sound:4c-s-上田さんは新しいプロジェクトを担当しています。.mp3]
[sound:4c-k-水田.mp3]	<b>水田</b> <br> すいでん <br> (water-filled) paddy field
水田	<b>すいでん</b> <br> (water-filled) paddy field <br> [sound:4c-k-水田.mp3]
(water-filled) paddy field	<b>水田</b> <br> すいでん <br> [sound:4c-k-水田.mp3]
[sound:4c-s-この地域には広い水田があります。.mp3]	<b>この地域には広い水田があります。</b> <br> このちいきにはひろいすいでんがあります。 <br><br> (水田) <br> This area has vast rice fields.
この地域には広い水田があります。 <br><br> (水田)	<b>このちいきにはひろいすいでんがあります。</b> <br> This area has vast rice fields. <br> [sound:4c-s-この地域には広い水田があります。.mp3]
This area has vast rice fields.	<b>この地域には広い水田があります。</b> <br> このちいきにはひろいすいでんがあります。 <br><br> (水田) <br> [sound:4c-s-この地域には広い水田があります。.mp3]
[sound:4c-k-油田.mp3]	<b>油田</b> <br> ゆでん <br> oil field
油田	<b>ゆでん</b> <br> oil field <br> [sound:4c-k-油田.mp3]
oil field	<b>油田</b> <br> ゆでん <br> [sound:4c-k-油田.mp3]
[sound:4c-s-新しい油田が発見されました。.mp3]	<b>新しい油田が発見されました。</b> <br> あたらしいゆでんがはっけんされました。 <br><br> (油田) <br> A new oil field has been discovered.
新しい油田が発見されました。 <br><br> (油田)	<b>あたらしいゆでんがはっけんされました。</b> <br> A new oil field has been discovered. <br> [sound:4c-s-新しい油田が発見されました。.mp3]
A new oil field has been discovered.	<b>新しい油田が発見されました。</b> <br> あたらしいゆでんがはっけんされました。 <br><br> (油田) <br> [sound:4c-s-新しい油田が発見されました。.mp3]
[sound:4c-k-田舎.mp3]	<b>田舎</b> <br> いなか <br> rural area, countryside, the sticks; hometown
田舎	<b>いなか</b> <br> rural area, countryside, the sticks; hometown <br> [sound:4c-k-田舎.mp3]
rural area, countryside, the sticks; hometown	<b>田舎</b> <br> いなか <br> [sound:4c-k-田舎.mp3]
[sound:4c-s-田舎の生活は静かで快適です。.mp3]	<b>田舎の生活は静かで快適です。</b> <br> いなかのせいかつはしずかでかいてきです。 <br><br> (田舎) <br> Rural life is peaceful and comfortable.
田舎の生活は静かで快適です。 <br><br> (田舎)	<b>いなかのせいかつはしずかでかいてきです。</b> <br> Rural life is peaceful and comfortable. <br> [sound:4c-s-田舎の生活は静かで快適です。.mp3]
Rural life is peaceful and comfortable.	<b>田舎の生活は静かで快適です。</b> <br> いなかのせいかつはしずかでかいてきです。 <br><br> (田舎) <br> [sound:4c-s-田舎の生活は静かで快適です。.mp3]
[sound:4c-k-当局.mp3]	<b>当局</b> <br> とうきょく <br> authorities; this office
当局	<b>とうきょく</b> <br> authorities; this office <br> [sound:4c-k-当局.mp3]
authorities; this office	<b>当局</b> <br> とうきょく <br> [sound:4c-k-当局.mp3]
[sound:4c-s-当局が調査を開始しました。.mp3]	<b>当局が調査を開始しました。</b> <br> とうきょくがちょうさをかいししました。 <br><br> (当局) <br> The authorities have started an investigation.
当局が調査を開始しました。 <br><br> (当局)	<b>とうきょくがちょうさをかいししました。</b> <br> The authorities have started an investigation. <br> [sound:4c-s-当局が調査を開始しました。.mp3]
The authorities have started an investigation.	<b>当局が調査を開始しました。</b> <br> とうきょくがちょうさをかいししました。 <br><br> (当局) <br> [sound:4c-s-当局が調査を開始しました。.mp3]
[sound:4c-k-当時.mp3]	<b>当時</b> <br> とうじ <br> at that time, in those days
当時	<b>とうじ</b> <br> at that time, in those days <br> [sound:4c-k-当時.mp3]
at that time, in those days	<b>当時</b> <br> とうじ <br> [sound:4c-k-当時.mp3]
[sound:4c-s-当時の状況は今とは異なります。.mp3]	<b>当時の状況は今とは異なります。</b> <br> とうじのじょうきょうはいまとはことなります。 <br><br> (当時) <br> The situation at that time was different from now.
当時の状況は今とは異なります。 <br><br> (当時)	<b>とうじのじょうきょうはいまとはことなります。</b> <br> The situation at that time was different from now. <br> [sound:4c-s-当時の状況は今とは異なります。.mp3]
The situation at that time was different from now.	<b>当時の状況は今とは異なります。</b> <br> とうじのじょうきょうはいまとはことなります。 <br><br> (当時) <br> [sound:4c-s-当時の状況は今とは異なります。.mp3]
[sound:4c-k-当初.mp3]	<b>当初</b> <br> とうしょ <br> at first
当初	<b>とうしょ</b> <br> at first <br> [sound:4c-k-当初.mp3]
at first	<b>当初</b> <br> とうしょ <br> [sound:4c-k-当初.mp3]
[sound:4c-s-当初の計画は変更されました。.mp3]	<b>当初の計画は変更されました。</b> <br> とうしょのけいかくはへんこうされました。 <br><br> (当初) <br> The original plan was changed.
当初の計画は変更されました。 <br><br> (当初)	<b>とうしょのけいかくはへんこうされました。</b> <br> The original plan was changed. <br> [sound:4c-s-当初の計画は変更されました。.mp3]
The original plan was changed.	<b>当初の計画は変更されました。</b> <br> とうしょのけいかくはへんこうされました。 <br><br> (当初) <br> [sound:4c-s-当初の計画は変更されました。.mp3]
[sound:4c-k-担当.mp3]	<b>担当</b> <br> たんとう <br> (in) charge
担当	<b>たんとう</b> <br> (in) charge <br> [sound:4c-k-担当.mp3]
(in) charge	<b>担当</b> <br> たんとう <br> [sound:4c-k-担当.mp3]
[sound:4c-s-彼はこのプロジェクトを担当しています。.mp3]	<b>彼はこのプロジェクトを担当しています。</b> <br> かれはこのプロジェクトをたんとうしています。 <br><br> (担当) <br> He is in charge of this project.
彼はこのプロジェクトを担当しています。 <br><br> (担当)	<b>かれはこのプロジェクトをたんとうしています。</b> <br> He is in charge of this project. <br> [sound:4c-s-彼はこのプロジェクトを担当しています。.mp3]
He is in charge of this project.	<b>彼はこのプロジェクトを担当しています。</b> <br> かれはこのプロジェクトをたんとうしています。 <br><br> (担当) <br> [sound:4c-s-彼はこのプロジェクトを担当しています。.mp3]
[sound:4c-k-八.mp3]	<b>八</b> <br> はち, や <br> eight
八	<b>はち, や</b> <br> eight <br> [sound:4c-k-八.mp3]
eight	<b>八</b> <br> はち, や <br> [sound:4c-k-八.mp3]
[sound:4c-s-八人が集まりました。.mp3]	<b>八人が集まりました。</b> <br> はちにんがあつまりました。 <br><br> (八) <br> Eight people gathered.
八人が集まりました。 <br><br> (八)	<b>はちにんがあつまりました。</b> <br> Eight people gathered. <br> [sound:4c-s-八人が集まりました。.mp3]
Eight people gathered.	<b>八人が集まりました。</b> <br> はちにんがあつまりました。 <br><br> (八) <br> [sound:4c-s-八人が集まりました。.mp3]
[sound:4c-k-十八.mp3]	<b>十八</b> <br> じゅうはち <br> 18, eighteen
十八	<b>じゅうはち</b> <br> 18, eighteen <br> [sound:4c-k-十八.mp3]
18, eighteen	<b>十八</b> <br> じゅうはち <br> [sound:4c-k-十八.mp3]
[sound:4c-s-彼は十八歳になりました。.mp3]	<b>彼は十八歳になりました。</b> <br> かれはじゅうはっさいになりました。 <br><br> (十八) <br> He turned eighteen years old.
彼は十八歳になりました。 <br><br> (十八)	<b>かれはじゅうはっさいになりました。</b> <br> He turned eighteen years old. <br> [sound:4c-s-彼は十八歳になりました。.mp3]
He turned eighteen years old.	<b>彼は十八歳になりました。</b> <br> かれはじゅうはっさいになりました。 <br><br> (十八) <br> [sound:4c-s-彼は十八歳になりました。.mp3]
[sound:4c-k-八月.mp3]	<b>八月</b> <br> はちがつ <br> August
八月	<b>はちがつ</b> <br> August <br> [sound:4c-k-八月.mp3]
August	<b>八月</b> <br> はちがつ <br> [sound:4c-k-八月.mp3]
[sound:4c-s-八月は暑いです。.mp3]	<b>八月は暑いです。</b> <br> はちがつはあついです。 <br><br> (八月) <br> August is hot.
八月は暑いです。 <br><br> (八月)	<b>はちがつはあついです。</b> <br> August is hot. <br> [sound:4c-s-八月は暑いです。.mp3]
August is hot.	<b>八月は暑いです。</b> <br> はちがつはあついです。 <br><br> (八月) <br> [sound:4c-s-八月は暑いです。.mp3]
[sound:4c-k-八十.mp3]	<b>八十</b> <br> はちじゅう, やそ <br> eighty
八十	<b>はちじゅう, やそ</b> <br> eighty <br> [sound:4c-k-八十.mp3]
eighty	<b>八十</b> <br> はちじゅう, やそ <br> [sound:4c-k-八十.mp3]
[sound:4c-s-彼のおじいさんは八十歳です。.mp3]	<b>彼のおじいさんは八十歳です。</b> <br> かれのおじいさんははちじゅっさいです。 <br><br> (八十) <br> His grandfather is eighty years old.
彼のおじいさんは八十歳です。 <br><br> (八十)	<b>かれのおじいさんははちじゅっさいです。</b> <br> His grandfather is eighty years old. <br> [sound:4c-s-彼のおじいさんは八十歳です。.mp3]
His grandfather is eighty years old.	<b>彼のおじいさんは八十歳です。</b> <br> かれのおじいさんははちじゅっさいです。 <br><br> (八十) <br> [sound:4c-s-彼のおじいさんは八十歳です。.mp3]
[sound:4c-k-六.mp3]	<b>六</b> <br> ろく, む, むう <br> six
六	<b>ろく, む, むう</b> <br> six <br> [sound:4c-k-六.mp3]
six	<b>六</b> <br> ろく, む, むう <br> [sound:4c-k-六.mp3]
[sound:4c-s-六時に起きます。.mp3]	<b>六時に起きます。</b> <br> ろくじにおきます。 <br><br> (六) <br> I wake up at six o'clock.
六時に起きます。 <br><br> (六)	<b>ろくじにおきます。</b> <br> I wake up at six o'clock. <br> [sound:4c-s-六時に起きます。.mp3]
I wake up at six o'clock.	<b>六時に起きます。</b> <br> ろくじにおきます。 <br><br> (六) <br> [sound:4c-s-六時に起きます。.mp3]
[sound:4c-k-六月.mp3]	<b>六月</b> <br> ろくがつ <br> June
六月	<b>ろくがつ</b> <br> June <br> [sound:4c-k-六月.mp3]
June	<b>六月</b> <br> ろくがつ <br> [sound:4c-k-六月.mp3]
[sound:4c-s-六月は梅雨の季節です。.mp3]	<b>六月は梅雨の季節です。</b> <br> ろくがつはつゆのきせつです。 <br><br> (六月) <br> June is the rainy season.
六月は梅雨の季節です。 <br><br> (六月)	<b>ろくがつはつゆのきせつです。</b> <br> June is the rainy season. <br> [sound:4c-s-六月は梅雨の季節です。.mp3]
June is the rainy season.	<b>六月は梅雨の季節です。</b> <br> ろくがつはつゆのきせつです。 <br><br> (六月) <br> [sound:4c-s-六月は梅雨の季節です。.mp3]
[sound:4c-k-六十.mp3]	<b>六十</b> <br> ろくじゅう, むそ <br> sixty
六十	<b>ろくじゅう, むそ</b> <br> sixty <br> [sound:4c-k-六十.mp3]
sixty	<b>六十</b> <br> ろくじゅう, むそ <br> [sound:4c-k-六十.mp3]
[sound:4c-s-彼は六十歳で退職しました。.mp3]	<b>彼は六十歳で退職しました。</b> <br> かれはろくじゅっさいでたいしょくしました。 <br><br> (六十) <br> He retired at sixty years old.
彼は六十歳で退職しました。 <br><br> (六十)	<b>かれはろくじゅっさいでたいしょくしました。</b> <br> He retired at sixty years old. <br> [sound:4c-s-彼は六十歳で退職しました。.mp3]
He retired at sixty years old.	<b>彼は六十歳で退職しました。</b> <br> かれはろくじゅっさいでたいしょくしました。 <br><br> (六十) <br> [sound:4c-s-彼は六十歳で退職しました。.mp3]
[sound:4c-k-六十四分音符.mp3]	<b>六十四分音符</b> <br> ろくじゅうしぶおんぷ <br> 64th note
六十四分音符	<b>ろくじゅうしぶおんぷ</b> <br> 64th note <br> [sound:4c-k-六十四分音符.mp3]
64th note	<b>六十四分音符</b> <br> ろくじゅうしぶおんぷ <br> [sound:4c-k-六十四分音符.mp3]
[sound:4c-s-六十四分音符はとても短い音符です。.mp3]	<b>六十四分音符はとても短い音符です。</b> <br> ろくじゅうよんぶおんぷはとてもみじかいおんぷです。 <br><br> (六十四分音符) <br> A sixty-fourth note is a very short note.
六十四分音符はとても短い音符です。 <br><br> (六十四分音符)	<b>ろくじゅうよんぶおんぷはとてもみじかいおんぷです。</b> <br> A sixty-fourth note is a very short note. <br> [sound:4c-s-六十四分音符はとても短い音符です。.mp3]
A sixty-fourth note is a very short note.	<b>六十四分音符はとても短い音符です。</b> <br> ろくじゅうよんぶおんぷはとてもみじかいおんぷです。 <br><br> (六十四分音符) <br> [sound:4c-s-六十四分音符はとても短い音符です。.mp3]
[sound:4c-k-契約.mp3]	<b>契約</b> <br> けいやく <br> contract, compact, agreement
契約	<b>けいやく</b> <br> contract, compact, agreement <br> [sound:4c-k-契約.mp3]
contract, compact, agreement	<b>契約</b> <br> けいやく <br> [sound:4c-k-契約.mp3]
[sound:4c-s-新しい契約を結びました。.mp3]	<b>新しい契約を結びました。</b> <br> あたらしいけいやくをむすびました。 <br><br> (契約) <br> I signed a new contract.
新しい契約を結びました。 <br><br> (契約)	<b>あたらしいけいやくをむすびました。</b> <br> I signed a new contract. <br> [sound:4c-s-新しい契約を結びました。.mp3]
I signed a new contract.	<b>新しい契約を結びました。</b> <br> あたらしいけいやくをむすびました。 <br><br> (契約) <br> [sound:4c-s-新しい契約を結びました。.mp3]
[sound:4c-k-条約.mp3]	<b>条約</b> <br> じょうやく <br> treaty, pact
条約	<b>じょうやく</b> <br> treaty, pact <br> [sound:4c-k-条約.mp3]
treaty, pact	<b>条約</b> <br> じょうやく <br> [sound:4c-k-条約.mp3]
[sound:4c-s-その国々は条約を締結しました。.mp3]	<b>その国々は条約を締結しました。</b> <br> そのくにぐにはじょうやくをていけつしました。 <br><br> (条約) <br> The countries signed a treaty.
その国々は条約を締結しました。 <br><br> (条約)	<b>そのくにぐにはじょうやくをていけつしました。</b> <br> The countries signed a treaty. <br> [sound:4c-s-その国々は条約を締結しました。.mp3]
The countries signed a treaty.	<b>その国々は条約を締結しました。</b> <br> そのくにぐにはじょうやくをていけつしました。 <br><br> (条約) <br> [sound:4c-s-その国々は条約を締結しました。.mp3]
[sound:4c-k-公約.mp3]	<b>公約</b> <br> こうやく <br> public commitment or promise
公約	<b>こうやく</b> <br> public commitment or promise <br> [sound:4c-k-公約.mp3]
public commitment or promise	<b>公約</b> <br> こうやく <br> [sound:4c-k-公約.mp3]
[sound:4c-s-彼は公約を守りました。.mp3]	<b>彼は公約を守りました。</b> <br> かれはこうやくをまもりました。 <br><br> (公約) <br> He kept his campaign promise.
彼は公約を守りました。 <br><br> (公約)	<b>かれはこうやくをまもりました。</b> <br> He kept his campaign promise. <br> [sound:4c-s-彼は公約を守りました。.mp3]
He kept his campaign promise.	<b>彼は公約を守りました。</b> <br> かれはこうやくをまもりました。 <br><br> (公約) <br> [sound:4c-s-彼は公約を守りました。.mp3]
[sound:4c-k-約束.mp3]	<b>約束</b> <br> やくそく <br> arrangement, promise, appointment, pact, engagement; convention, rule
約束	<b>やくそく</b> <br> arrangement, promise, appointment, pact, engagement; convention, rule <br> [sound:4c-k-約束.mp3]
arrangement, promise, appointment, pact, engagement; convention, rule	<b>約束</b> <br> やくそく <br> [sound:4c-k-約束.mp3]
[sound:4c-s-友達と約束をしました。.mp3]	<b>友達と約束をしました。</b> <br> ともだちとやくそくをしました。 <br><br> (約束) <br> I made a promise with my friend.
友達と約束をしました。 <br><br> (約束)	<b>ともだちとやくそくをしました。</b> <br> I made a promise with my friend. <br> [sound:4c-s-友達と約束をしました。.mp3]
I made a promise with my friend.	<b>友達と約束をしました。</b> <br> ともだちとやくそくをしました。 <br><br> (約束) <br> [sound:4c-s-友達と約束をしました。.mp3]
[sound:4c-k-主に.mp3]	<b>主に</b> <br> おもに <br> mainly, primarily
主に	<b>おもに</b> <br> mainly, primarily <br> [sound:4c-k-主に.mp3]
mainly, primarily	<b>主に</b> <br> おもに <br> [sound:4c-k-主に.mp3]
[sound:4c-s-この本は主に学生向けです。.mp3]	<b>この本は主に学生向けです。</b> <br> このほんはおもにがくせいむけです。 <br><br> (主に) <br> This book is mainly for students.
この本は主に学生向けです。 <br><br> (主に)	<b>このほんはおもにがくせいむけです。</b> <br> This book is mainly for students. <br> [sound:4c-s-この本は主に学生向けです。.mp3]
This book is mainly for students.	<b>この本は主に学生向けです。</b> <br> このほんはおもにがくせいむけです。 <br><br> (主に) <br> [sound:4c-s-この本は主に学生向けです。.mp3]
[sound:4c-k-喪主.mp3]	<b>喪主</b> <br> もしゅ <br> chief mourner
喪主	<b>もしゅ</b> <br> chief mourner <br> [sound:4c-k-喪主.mp3]
chief mourner	<b>喪主</b> <br> もしゅ <br> [sound:4c-k-喪主.mp3]
[sound:4c-s-喪主が挨拶をしました。.mp3]	<b>喪主が挨拶をしました。</b> <br> もしゅがあいさつをしました。 <br><br> (喪主) <br> The chief mourner gave a speech.
喪主が挨拶をしました。 <br><br> (喪主)	<b>もしゅがあいさつをしました。</b> <br> The chief mourner gave a speech. <br> [sound:4c-s-喪主が挨拶をしました。.mp3]
The chief mourner gave a speech.	<b>喪主が挨拶をしました。</b> <br> もしゅがあいさつをしました。 <br><br> (喪主) <br> [sound:4c-s-喪主が挨拶をしました。.mp3]
[sound:4c-k-民主.mp3]	<b>民主</b> <br> みんしゅ <br> democracy, popular sovereignty; democratic
民主	<b>みんしゅ</b> <br> democracy, popular sovereignty; democratic <br> [sound:4c-k-民主.mp3]
democracy, popular sovereignty; democratic	<b>民主</b> <br> みんしゅ <br> [sound:4c-k-民主.mp3]
[sound:4c-s-民主主義は重要です。.mp3]	<b>民主主義は重要です。</b> <br> みんしゅしゅぎはじゅうようです。 <br><br> (民主) <br> Democracy is important.
民主主義は重要です。 <br><br> (民主)	<b>みんしゅしゅぎはじゅうようです。</b> <br> Democracy is important. <br> [sound:4c-s-民主主義は重要です。.mp3]
Democracy is important.	<b>民主主義は重要です。</b> <br> みんしゅしゅぎはじゅうようです。 <br><br> (民主) <br> [sound:4c-s-民主主義は重要です。.mp3]
[sound:4c-k-主義.mp3]	<b>主義</b> <br> しゅぎ <br> doctrine, rule, principle
主義	<b>しゅぎ</b> <br> doctrine, rule, principle <br> [sound:4c-k-主義.mp3]
doctrine, rule, principle	<b>主義</b> <br> しゅぎ <br> [sound:4c-k-主義.mp3]
[sound:4c-s-彼は平和主義を支持しています。.mp3]	<b>彼は平和主義を支持しています。</b> <br> かれはへいわしゅぎをしじしています。 <br><br> (主義) <br> He supports pacifism.
彼は平和主義を支持しています。 <br><br> (主義)	<b>かれはへいわしゅぎをしじしています。</b> <br> He supports pacifism. <br> [sound:4c-s-彼は平和主義を支持しています。.mp3]
He supports pacifism.	<b>彼は平和主義を支持しています。</b> <br> かれはへいわしゅぎをしじしています。 <br><br> (主義) <br> [sound:4c-s-彼は平和主義を支持しています。.mp3]
[sound:4c-k-課題.mp3]	<b>課題</b> <br> かだい <br> subject, theme, task, challenge, issue
課題	<b>かだい</b> <br> subject, theme, task, challenge, issue <br> [sound:4c-k-課題.mp3]
subject, theme, task, challenge, issue	<b>課題</b> <br> かだい <br> [sound:4c-k-課題.mp3]
[sound:4c-s-課題を解決する必要があります。.mp3]	<b>課題を解決する必要があります。</b> <br> かだいをかいけつするひつようがあります。 <br><br> (課題) <br> We need to solve the issue.
課題を解決する必要があります。 <br><br> (課題)	<b>かだいをかいけつするひつようがあります。</b> <br> We need to solve the issue. <br> [sound:4c-s-課題を解決する必要があります。.mp3]
We need to solve the issue.	<b>課題を解決する必要があります。</b> <br> かだいをかいけつするひつようがあります。 <br><br> (課題) <br> [sound:4c-s-課題を解決する必要があります。.mp3]
[sound:4c-k-問題.mp3]	<b>問題</b> <br> もんだい <br> problem, question
問題	<b>もんだい</b> <br> problem, question <br> [sound:4c-k-問題.mp3]
problem, question	<b>問題</b> <br> もんだい <br> [sound:4c-k-問題.mp3]
[sound:4c-s-この問題は難しいです。.mp3]	<b>この問題は難しいです。</b> <br> このもんだいはむずかしいです。 <br><br> (問題) <br> This problem is difficult.
この問題は難しいです。 <br><br> (問題)	<b>このもんだいはむずかしいです。</b> <br> This problem is difficult. <br> [sound:4c-s-この問題は難しいです。.mp3]
This problem is difficult.	<b>この問題は難しいです。</b> <br> このもんだいはむずかしいです。 <br><br> (問題) <br> [sound:4c-s-この問題は難しいです。.mp3]
[sound:4c-k-話題.mp3]	<b>話題</b> <br> わだい <br> topic, subject
話題	<b>わだい</b> <br> topic, subject <br> [sound:4c-k-話題.mp3]
topic, subject	<b>話題</b> <br> わだい <br> [sound:4c-k-話題.mp3]
[sound:4c-s-その映画は話題になっています。.mp3]	<b>その映画は話題になっています。</b> <br> そのえいがはわだいになっています。 <br><br> (話題) <br> That movie is a hot topic.
その映画は話題になっています。 <br><br> (話題)	<b>そのえいがはわだいになっています。</b> <br> That movie is a hot topic. <br> [sound:4c-s-その映画は話題になっています。.mp3]
That movie is a hot topic.	<b>その映画は話題になっています。</b> <br> そのえいがはわだいになっています。 <br><br> (話題) <br> [sound:4c-s-その映画は話題になっています。.mp3]
[sound:4c-k-題.mp3]	<b>題</b> <br> だい <br> title, subject, theme, topic; problem (on a test), question; counter for questions (on a test)
題	<b>だい</b> <br> title, subject, theme, topic; problem (on a test), question; counter for questions (on a test) <br> [sound:4c-k-題.mp3]
title, subject, theme, topic; problem (on a test), question; counter for questions (on a test)	<b>題</b> <br> だい <br> [sound:4c-k-題.mp3]
[sound:4c-s-この本の題は何ですか？.mp3]	<b>この本の題は何ですか？</b> <br> このほんのだいはなんですか？  <br><br> (題) <br> What is the title of this book?
この本の題は何ですか？ <br><br> (題)	<b>このほんのだいはなんですか？ </b> <br> What is the title of this book? <br> [sound:4c-s-この本の題は何ですか？.mp3]
What is the title of this book?	<b>この本の題は何ですか？</b> <br> このほんのだいはなんですか？  <br><br> (題) <br> [sound:4c-s-この本の題は何ですか？.mp3]
[sound:4c-k-下.mp3]	<b>下</b> <br> もと <br> under (esp. influence or guidance)
下	<b>もと</b> <br> under (esp. influence or guidance) <br> [sound:4c-k-下.mp3]
under (esp. influence or guidance)	<b>下</b> <br> もと <br> [sound:4c-k-下.mp3]
[sound:4c-s-机の下に猫がいます。.mp3]	<b>机の下に猫がいます。</b> <br> つくえのしたにねこがいます。 <br><br> (下) <br> There is a cat under the desk.
机の下に猫がいます。 <br><br> (下)	<b>つくえのしたにねこがいます。</b> <br> There is a cat under the desk. <br> [sound:4c-s-机の下に猫がいます。.mp3]
There is a cat under the desk.	<b>机の下に猫がいます。</b> <br> つくえのしたにねこがいます。 <br><br> (下) <br> [sound:4c-s-机の下に猫がいます。.mp3]
[sound:4c-k-下げる.mp3]	<b>下げる</b> <br> さげる <br> to hang, to lower, to move back, to wear, to dismiss, to grant
下げる	<b>さげる</b> <br> to hang, to lower, to move back, to wear, to dismiss, to grant <br> [sound:4c-k-下げる.mp3]
to hang, to lower, to move back, to wear, to dismiss, to grant	<b>下げる</b> <br> さげる <br> [sound:4c-k-下げる.mp3]
[sound:4c-s-温度を下げてください。.mp3]	<b>温度を下げてください。</b> <br> おんどをさげてください。 <br><br> (下げる) <br> Please lower the temperature.
温度を下げてください。 <br><br> (下げる)	<b>おんどをさげてください。</b> <br> Please lower the temperature. <br> [sound:4c-s-温度を下げてください。.mp3]
Please lower the temperature.	<b>温度を下げてください。</b> <br> おんどをさげてください。 <br><br> (下げる) <br> [sound:4c-s-温度を下げてください。.mp3]
[sound:4c-k-引き下げ.mp3]	<b>引き下げ</b> <br> ひきさげ <br> reduction, cut
引き下げ	<b>ひきさげ</b> <br> reduction, cut <br> [sound:4c-k-引き下げ.mp3]
reduction, cut	<b>引き下げ</b> <br> ひきさげ <br> [sound:4c-k-引き下げ.mp3]
[sound:4c-s-税金の引き下げが議論されています。.mp3]	<b>税金の引き下げが議論されています。</b> <br> ぜいきんのひきさげがぎろんされています。 <br><br> (引き下げ) <br> A tax reduction is being discussed.
税金の引き下げが議論されています。 <br><br> (引き下げ)	<b>ぜいきんのひきさげがぎろんされています。</b> <br> A tax reduction is being discussed. <br> [sound:4c-s-税金の引き下げが議論されています。.mp3]
A tax reduction is being discussed.	<b>税金の引き下げが議論されています。</b> <br> ぜいきんのひきさげがぎろんされています。 <br><br> (引き下げ) <br> [sound:4c-s-税金の引き下げが議論されています。.mp3]
[sound:4c-k-下り.mp3]	<b>下り</b> <br> くだり <br> down-train (going away from Tokyo); down-slope, downward going
下り	<b>くだり</b> <br> down-train (going away from Tokyo); down-slope, downward going <br> [sound:4c-k-下り.mp3]
down-train (going away from Tokyo); down-slope, downward going	<b>下り</b> <br> くだり <br> [sound:4c-k-下り.mp3]
[sound:4c-s-山を下りるのは危険です。.mp3]	<b>山を下りるのは危険です。</b> <br> やまをおりるのはきけんです。 <br><br> (下り) <br> Descending the mountain is dangerous.
山を下りるのは危険です。 <br><br> (下り)	<b>やまをおりるのはきけんです。</b> <br> Descending the mountain is dangerous. <br> [sound:4c-s-山を下りるのは危険です。.mp3]
Descending the mountain is dangerous.	<b>山を下りるのは危険です。</b> <br> やまをおりるのはきけんです。 <br><br> (下り) <br> [sound:4c-s-山を下りるのは危険です。.mp3]
[sound:4c-k-首.mp3]	<b>首</b> <br> くび, クビ <br> neck; head; unemployed person
首	<b>くび, クビ</b> <br> neck; head; unemployed person <br> [sound:4c-k-首.mp3]
neck; head; unemployed person	<b>首</b> <br> くび, クビ <br> [sound:4c-k-首.mp3]
[sound:4c-s-彼は首を痛めました。.mp3]	<b>彼は首を痛めました。</b> <br> かれはくびをいためました。 <br><br> (首) <br> He hurt his neck.
彼は首を痛めました。 <br><br> (首)	<b>かれはくびをいためました。</b> <br> He hurt his neck. <br> [sound:4c-s-彼は首を痛めました。.mp3]
He hurt his neck.	<b>彼は首を痛めました。</b> <br> かれはくびをいためました。 <br><br> (首) <br> [sound:4c-s-彼は首を痛めました。.mp3]
[sound:4c-k-首相.mp3]	<b>首相</b> <br> しゅしょう <br> Prime Minister, Chancellor (Germany, Austria, etc.), Premier
首相	<b>しゅしょう</b> <br> Prime Minister, Chancellor (Germany, Austria, etc.), Premier <br> [sound:4c-k-首相.mp3]
Prime Minister, Chancellor (Germany, Austria, etc.), Premier	<b>首相</b> <br> しゅしょう <br> [sound:4c-k-首相.mp3]
[sound:4c-s-日本の首相が演説しました。.mp3]	<b>日本の首相が演説しました。</b> <br> にほんのしゅしょうがえんぜつしました。 <br><br> (首相) <br> The Prime Minister of Japan gave a speech.
日本の首相が演説しました。 <br><br> (首相)	<b>にほんのしゅしょうがえんぜつしました。</b> <br> The Prime Minister of Japan gave a speech. <br> [sound:4c-s-日本の首相が演説しました。.mp3]
The Prime Minister of Japan gave a speech.	<b>日本の首相が演説しました。</b> <br> にほんのしゅしょうがえんぜつしました。 <br><br> (首相) <br> [sound:4c-s-日本の首相が演説しました。.mp3]
[sound:4c-k-首脳.mp3]	<b>首脳</b> <br> しゅのう <br> head, brains, leading spirit
首脳	<b>しゅのう</b> <br> head, brains, leading spirit <br> [sound:4c-k-首脳.mp3]
head, brains, leading spirit	<b>首脳</b> <br> しゅのう <br> [sound:4c-k-首脳.mp3]
[sound:4c-s-首脳会談が行われました。.mp3]	<b>首脳会談が行われました。</b> <br> しゅのうかいだんがおこなわれました。 <br><br> (首脳) <br> A summit meeting was held.
首脳会談が行われました。 <br><br> (首脳)	<b>しゅのうかいだんがおこなわれました。</b> <br> A summit meeting was held. <br> [sound:4c-s-首脳会談が行われました。.mp3]
A summit meeting was held.	<b>首脳会談が行われました。</b> <br> しゅのうかいだんがおこなわれました。 <br><br> (首脳) <br> [sound:4c-s-首脳会談が行われました。.mp3]
[sound:4c-k-首都.mp3]	<b>首都</b> <br> しゅと <br> capital city, metropolis
首都	<b>しゅと</b> <br> capital city, metropolis <br> [sound:4c-k-首都.mp3]
capital city, metropolis	<b>首都</b> <br> しゅと <br> [sound:4c-k-首都.mp3]
[sound:4c-s-東京は日本の首都です。.mp3]	<b>東京は日本の首都です。</b> <br> とうきょうはにほんのしゅとです。 <br><br> (首都) <br> Tokyo is the capital of Japan.
東京は日本の首都です。 <br><br> (首都)	<b>とうきょうはにほんのしゅとです。</b> <br> Tokyo is the capital of Japan. <br> [sound:4c-s-東京は日本の首都です。.mp3]
Tokyo is the capital of Japan.	<b>東京は日本の首都です。</b> <br> とうきょうはにほんのしゅとです。 <br><br> (首都) <br> [sound:4c-s-東京は日本の首都です。.mp3]
[sound:4c-k-意見.mp3]	<b>意見</b> <br> いけん <br> opinion, view
意見	<b>いけん</b> <br> opinion, view <br> [sound:4c-k-意見.mp3]
opinion, view	<b>意見</b> <br> いけん <br> [sound:4c-k-意見.mp3]
[sound:4c-s-彼の意見はとても参考になります。.mp3]	<b>彼の意見はとても参考になります。</b> <br> かれのいけんはとてもさんこうになります。 <br><br> (意見) <br> His opinion is very helpful.
彼の意見はとても参考になります。 <br><br> (意見)	<b>かれのいけんはとてもさんこうになります。</b> <br> His opinion is very helpful. <br> [sound:4c-s-彼の意見はとても参考になります。.mp3]
His opinion is very helpful.	<b>彼の意見はとても参考になります。</b> <br> かれのいけんはとてもさんこうになります。 <br><br> (意見) <br> [sound:4c-s-彼の意見はとても参考になります。.mp3]
[sound:4c-k-意味.mp3]	<b>意味</b> <br> いみ <br> meaning, significance
意味	<b>いみ</b> <br> meaning, significance <br> [sound:4c-k-意味.mp3]
meaning, significance	<b>意味</b> <br> いみ <br> [sound:4c-k-意味.mp3]
[sound:4c-s-この言葉の意味を教えてください。.mp3]	<b>この言葉の意味を教えてください。</b> <br> このことばのいみをおしえてください。 <br><br> (意味) <br> Please tell me the meaning of this word.
この言葉の意味を教えてください。 <br><br> (意味)	<b>このことばのいみをおしえてください。</b> <br> Please tell me the meaning of this word. <br> [sound:4c-s-この言葉の意味を教えてください。.mp3]
Please tell me the meaning of this word.	<b>この言葉の意味を教えてください。</b> <br> このことばのいみをおしえてください。 <br><br> (意味) <br> [sound:4c-s-この言葉の意味を教えてください。.mp3]
[sound:4c-k-合意.mp3]	<b>合意</b> <br> ごうい <br> agreement, consent, mutual understanding
合意	<b>ごうい</b> <br> agreement, consent, mutual understanding <br> [sound:4c-k-合意.mp3]
agreement, consent, mutual understanding	<b>合意</b> <br> ごうい <br> [sound:4c-k-合意.mp3]
[sound:4c-s-両者は合意に達しました。.mp3]	<b>両者は合意に達しました。</b> <br> りょうしゃはごういにたっしました。 <br><br> (合意) <br> Both parties reached an agreement.
両者は合意に達しました。 <br><br> (合意)	<b>りょうしゃはごういにたっしました。</b> <br> Both parties reached an agreement. <br> [sound:4c-s-両者は合意に達しました。.mp3]
Both parties reached an agreement.	<b>両者は合意に達しました。</b> <br> りょうしゃはごういにたっしました。 <br><br> (合意) <br> [sound:4c-s-両者は合意に達しました。.mp3]
[sound:4c-k-意向.mp3]	<b>意向</b> <br> いこう <br> intention, idea, inclination
意向	<b>いこう</b> <br> intention, idea, inclination <br> [sound:4c-k-意向.mp3]
intention, idea, inclination	<b>意向</b> <br> いこう <br> [sound:4c-k-意向.mp3]
[sound:4c-s-彼の意向を確認しました。.mp3]	<b>彼の意向を確認しました。</b> <br> かれのいこうをかくにんしました。 <br><br> (意向) <br> I confirmed his intention.
彼の意向を確認しました。 <br><br> (意向)	<b>かれのいこうをかくにんしました。</b> <br> I confirmed his intention. <br> [sound:4c-s-彼の意向を確認しました。.mp3]
I confirmed his intention.	<b>彼の意向を確認しました。</b> <br> かれのいこうをかくにんしました。 <br><br> (意向) <br> [sound:4c-s-彼の意向を確認しました。.mp3]
[sound:4c-k-憲法.mp3]	<b>憲法</b> <br> けんぽう <br> constitution
憲法	<b>けんぽう</b> <br> constitution <br> [sound:4c-k-憲法.mp3]
constitution	<b>憲法</b> <br> けんぽう <br> [sound:4c-k-憲法.mp3]
[sound:4c-s-憲法改正が議論されています。.mp3]	<b>憲法改正が議論されています。</b> <br> けんぽうかいせいがぎろんされています。 <br><br> (憲法) <br> Constitutional amendments are being discussed.
憲法改正が議論されています。 <br><br> (憲法)	<b>けんぽうかいせいがぎろんされています。</b> <br> Constitutional amendments are being discussed. <br> [sound:4c-s-憲法改正が議論されています。.mp3]
Constitutional amendments are being discussed.	<b>憲法改正が議論されています。</b> <br> けんぽうかいせいがぎろんされています。 <br><br> (憲法) <br> [sound:4c-s-憲法改正が議論されています。.mp3]
[sound:4c-k-方法.mp3]	<b>方法</b> <br> ほうほう <br> method, process, manner, way, means, technique
方法	<b>ほうほう</b> <br> method, process, manner, way, means, technique <br> [sound:4c-k-方法.mp3]
method, process, manner, way, means, technique	<b>方法</b> <br> ほうほう <br> [sound:4c-k-方法.mp3]
[sound:4c-s-良い方法を見つけました。.mp3]	<b>良い方法を見つけました。</b> <br> よいほうほうをみつけました。 <br><br> (方法) <br> I found a good method.
良い方法を見つけました。 <br><br> (方法)	<b>よいほうほうをみつけました。</b> <br> I found a good method. <br> [sound:4c-s-良い方法を見つけました。.mp3]
I found a good method.	<b>良い方法を見つけました。</b> <br> よいほうほうをみつけました。 <br><br> (方法) <br> [sound:4c-s-良い方法を見つけました。.mp3]
[sound:4c-k-法案.mp3]	<b>法案</b> <br> ほうあん <br> bill (law)
法案	<b>ほうあん</b> <br> bill (law) <br> [sound:4c-k-法案.mp3]
bill (law)	<b>法案</b> <br> ほうあん <br> [sound:4c-k-法案.mp3]
[sound:4c-s-新しい法案が提出されました。.mp3]	<b>新しい法案が提出されました。</b> <br> あたらしいほうあんがていしゅつされました。 <br><br> (法案) <br> A new bill was submitted.
新しい法案が提出されました。 <br><br> (法案)	<b>あたらしいほうあんがていしゅつされました。</b> <br> A new bill was submitted. <br> [sound:4c-s-新しい法案が提出されました。.mp3]
A new bill was submitted.	<b>新しい法案が提出されました。</b> <br> あたらしいほうあんがていしゅつされました。 <br><br> (法案) <br> [sound:4c-s-新しい法案が提出されました。.mp3]
[sound:4c-k-法人.mp3]	<b>法人</b> <br> ほうじん <br> corporate body, corporation, (legal) person, (juridical) person
法人	<b>ほうじん</b> <br> corporate body, corporation, (legal) person, (juridical) person <br> [sound:4c-k-法人.mp3]
corporate body, corporation, (legal) person, (juridical) person	<b>法人</b> <br> ほうじん <br> [sound:4c-k-法人.mp3]
[sound:4c-s-法人税が引き上げられました。.mp3]	<b>法人税が引き上げられました。</b> <br> ほうじんぜいがひきあげられました。 <br><br> (法人) <br> Corporate taxes were raised.
法人税が引き上げられました。 <br><br> (法人)	<b>ほうじんぜいがひきあげられました。</b> <br> Corporate taxes were raised. <br> [sound:4c-s-法人税が引き上げられました。.mp3]
Corporate taxes were raised.	<b>法人税が引き上げられました。</b> <br> ほうじんぜいがひきあげられました。 <br><br> (法人) <br> [sound:4c-s-法人税が引き上げられました。.mp3]
[sound:4c-k-不動産.mp3]	<b>不動産</b> <br> ふどうさん <br> real estate
不動産	<b>ふどうさん</b> <br> real estate <br> [sound:4c-k-不動産.mp3]
real estate	<b>不動産</b> <br> ふどうさん <br> [sound:4c-k-不動産.mp3]
[sound:4c-s-不動産を購入しました。.mp3]	<b>不動産を購入しました。</b> <br> ふどうさんをこうにゅうしました。 <br><br> (不動産) <br> I purchased real estate.
不動産を購入しました。 <br><br> (不動産)	<b>ふどうさんをこうにゅうしました。</b> <br> I purchased real estate. <br> [sound:4c-s-不動産を購入しました。.mp3]
I purchased real estate.	<b>不動産を購入しました。</b> <br> ふどうさんをこうにゅうしました。 <br><br> (不動産) <br> [sound:4c-s-不動産を購入しました。.mp3]
[sound:4c-k-不満.mp3]	<b>不満</b> <br> ふまん <br> dissatisfaction, displeasure, discontent, complaints, unhappiness, disgruntled
不満	<b>ふまん</b> <br> dissatisfaction, displeasure, discontent, complaints, unhappiness, disgruntled <br> [sound:4c-k-不満.mp3]
dissatisfaction, displeasure, discontent, complaints, unhappiness, disgruntled	<b>不満</b> <br> ふまん <br> [sound:4c-k-不満.mp3]
[sound:4c-s-彼は結果に不満を持っています。.mp3]	<b>彼は結果に不満を持っています。</b> <br> かれはけっかにふまんをもっています。 <br><br> (不満) <br> He is dissatisfied with the results.
彼は結果に不満を持っています。 <br><br> (不満)	<b>かれはけっかにふまんをもっています。</b> <br> He is dissatisfied with the results. <br> [sound:4c-s-彼は結果に不満を持っています。.mp3]
He is dissatisfied with the results.	<b>彼は結果に不満を持っています。</b> <br> かれはけっかにふまんをもっています。 <br><br> (不満) <br> [sound:4c-s-彼は結果に不満を持っています。.mp3]
[sound:4c-k-不明.mp3]	<b>不明</b> <br> ふめい <br> unknown, obscure, indistinct, uncertain, ambiguous, ignorant, lack of wisdom, anonymous, unidentified
不明	<b>ふめい</b> <br> unknown, obscure, indistinct, uncertain, ambiguous, ignorant, lack of wisdom, anonymous, unidentified <br> [sound:4c-k-不明.mp3]
unknown, obscure, indistinct, uncertain, ambiguous, ignorant, lack of wisdom, anonymous, unidentified	<b>不明</b> <br> ふめい <br> [sound:4c-k-不明.mp3]
[sound:4c-s-原因はまだ不明です。.mp3]	<b>原因はまだ不明です。</b> <br> げんいんはまだふめいです。 <br><br> (不明) <br> The cause is still unknown.
原因はまだ不明です。 <br><br> (不明)	<b>げんいんはまだふめいです。</b> <br> The cause is still unknown. <br> [sound:4c-s-原因はまだ不明です。.mp3]
The cause is still unknown.	<b>原因はまだ不明です。</b> <br> げんいんはまだふめいです。 <br><br> (不明) <br> [sound:4c-s-原因はまだ不明です。.mp3]
[sound:4c-k-心不全.mp3]	<b>心不全</b> <br> しんふぜん <br> heart failure
心不全	<b>しんふぜん</b> <br> heart failure <br> [sound:4c-k-心不全.mp3]
heart failure	<b>心不全</b> <br> しんふぜん <br> [sound:4c-k-心不全.mp3]
[sound:4c-s-彼は心不全で入院しました。.mp3]	<b>彼は心不全で入院しました。</b> <br> かれはしんふぜんでにゅういんしました。 <br><br> (心不全) <br> He was hospitalized for heart failure.
彼は心不全で入院しました。 <br><br> (心不全)	<b>かれはしんふぜんでにゅういんしました。</b> <br> He was hospitalized for heart failure. <br> [sound:4c-s-彼は心不全で入院しました。.mp3]
He was hospitalized for heart failure.	<b>彼は心不全で入院しました。</b> <br> かれはしんふぜんでにゅういんしました。 <br><br> (心不全) <br> [sound:4c-s-彼は心不全で入院しました。.mp3]
[sound:4c-k-将来.mp3]	<b>将来</b> <br> しょうらい <br> future (usually near), prospects
将来	<b>しょうらい</b> <br> future (usually near), prospects <br> [sound:4c-k-将来.mp3]
future (usually near), prospects	<b>将来</b> <br> しょうらい <br> [sound:4c-k-将来.mp3]
[sound:4c-s-将来の夢を教えてください。.mp3]	<b>将来の夢を教えてください。</b> <br> しょうらいのゆめをおしえてください。 <br><br> (将来) <br> Please tell me about your future dreams.
将来の夢を教えてください。 <br><br> (将来)	<b>しょうらいのゆめをおしえてください。</b> <br> Please tell me about your future dreams. <br> [sound:4c-s-将来の夢を教えてください。.mp3]
Please tell me about your future dreams.	<b>将来の夢を教えてください。</b> <br> しょうらいのゆめをおしえてください。 <br><br> (将来) <br> [sound:4c-s-将来の夢を教えてください。.mp3]
[sound:4c-k-来年.mp3]	<b>来年</b> <br> らいねん <br> next year
来年	<b>らいねん</b> <br> next year <br> [sound:4c-k-来年.mp3]
next year	<b>来年</b> <br> らいねん <br> [sound:4c-k-来年.mp3]
[sound:4c-s-来年はもっと頑張ります。.mp3]	<b>来年はもっと頑張ります。</b> <br> らいねんはもっとがんばります。 <br><br> (来年) <br> I will work harder next year.
来年はもっと頑張ります。 <br><br> (来年)	<b>らいねんはもっとがんばります。</b> <br> I will work harder next year. <br> [sound:4c-s-来年はもっと頑張ります。.mp3]
I will work harder next year.	<b>来年はもっと頑張ります。</b> <br> らいねんはもっとがんばります。 <br><br> (来年) <br> [sound:4c-s-来年はもっと頑張ります。.mp3]
[sound:4c-k-本来.mp3]	<b>本来</b> <br> ほんらい <br> essentially, naturally, by nature, in (and of) itself, originally
本来	<b>ほんらい</b> <br> essentially, naturally, by nature, in (and of) itself, originally <br> [sound:4c-k-本来.mp3]
essentially, naturally, by nature, in (and of) itself, originally	<b>本来</b> <br> ほんらい <br> [sound:4c-k-本来.mp3]
[sound:4c-s-本来の目的を忘れないでください。.mp3]	<b>本来の目的を忘れないでください。</b> <br> ほんらいのもくてきをわすれないでください。 <br><br> (本来) <br> Don't forget the original purpose.
本来の目的を忘れないでください。 <br><br> (本来)	<b>ほんらいのもくてきをわすれないでください。</b> <br> Don't forget the original purpose. <br> [sound:4c-s-本来の目的を忘れないでください。.mp3]
Don't forget the original purpose.	<b>本来の目的を忘れないでください。</b> <br> ほんらいのもくてきをわすれないでください。 <br><br> (本来) <br> [sound:4c-s-本来の目的を忘れないでください。.mp3]
[sound:4c-k-来月.mp3]	<b>来月</b> <br> らいげつ <br> next month
来月	<b>らいげつ</b> <br> next month <br> [sound:4c-k-来月.mp3]
next month	<b>来月</b> <br> らいげつ <br> [sound:4c-k-来月.mp3]
[sound:4c-s-来月、旅行に行きます。.mp3]	<b>来月、旅行に行きます。</b> <br> らいげつ、りょこうにいきます。 <br><br> (来月) <br> I will go on a trip next month.
来月、旅行に行きます。 <br><br> (来月)	<b>らいげつ、りょこうにいきます。</b> <br> I will go on a trip next month. <br> [sound:4c-s-来月、旅行に行きます。.mp3]
I will go on a trip next month.	<b>来月、旅行に行きます。</b> <br> らいげつ、りょこうにいきます。 <br><br> (来月) <br> [sound:4c-s-来月、旅行に行きます。.mp3]
[sound:4c-k-作業.mp3]	<b>作業</b> <br> さぎょう <br> work, operation, manufacturing, fatigue duty
作業	<b>さぎょう</b> <br> work, operation, manufacturing, fatigue duty <br> [sound:4c-k-作業.mp3]
work, operation, manufacturing, fatigue duty	<b>作業</b> <br> さぎょう <br> [sound:4c-k-作業.mp3]
[sound:4c-s-作業が順調に進んでいます。.mp3]	<b>作業が順調に進んでいます。</b> <br> さぎょうがじゅんちょうにすすんでいます。 <br><br> (作業) <br> The work is progressing smoothly.
作業が順調に進んでいます。 <br><br> (作業)	<b>さぎょうがじゅんちょうにすすんでいます。</b> <br> The work is progressing smoothly. <br> [sound:4c-s-作業が順調に進んでいます。.mp3]
The work is progressing smoothly.	<b>作業が順調に進んでいます。</b> <br> さぎょうがじゅんちょうにすすんでいます。 <br><br> (作業) <br> [sound:4c-s-作業が順調に進んでいます。.mp3]
[sound:4c-k-作品.mp3]	<b>作品</b> <br> さくひん <br> work (e.g. book, film, composition, etc.), opus, performance, production
作品	<b>さくひん</b> <br> work (e.g. book, film, composition, etc.), opus, performance, production <br> [sound:4c-k-作品.mp3]
work (e.g. book, film, composition, etc.), opus, performance, production	<b>作品</b> <br> さくひん <br> [sound:4c-k-作品.mp3]
[sound:4c-s-彼の新しい作品を見ました。.mp3]	<b>彼の新しい作品を見ました。</b> <br> かれのあたらしいさくひんをみました。 <br><br> (作品) <br> I saw his new work.
彼の新しい作品を見ました。 <br><br> (作品)	<b>かれのあたらしいさくひんをみました。</b> <br> I saw his new work. <br> [sound:4c-s-彼の新しい作品を見ました。.mp3]
I saw his new work.	<b>彼の新しい作品を見ました。</b> <br> かれのあたらしいさくひんをみました。 <br><br> (作品) <br> [sound:4c-s-彼の新しい作品を見ました。.mp3]
[sound:4c-k-作家.mp3]	<b>作家</b> <br> さっか <br> author, writer, novelist, artist
作家	<b>さっか</b> <br> author, writer, novelist, artist <br> [sound:4c-k-作家.mp3]
author, writer, novelist, artist	<b>作家</b> <br> さっか <br> [sound:4c-k-作家.mp3]
[sound:4c-s-彼は有名な作家です。.mp3]	<b>彼は有名な作家です。</b> <br> かれはゆうめいなさっかです。 <br><br> (作家) <br> He is a famous writer.
彼は有名な作家です。 <br><br> (作家)	<b>かれはゆうめいなさっかです。</b> <br> He is a famous writer. <br> [sound:4c-s-彼は有名な作家です。.mp3]
He is a famous writer.	<b>彼は有名な作家です。</b> <br> かれはゆうめいなさっかです。 <br><br> (作家) <br> [sound:4c-s-彼は有名な作家です。.mp3]
[sound:4c-k-作戦.mp3]	<b>作戦</b> <br> さくせん <br> tactics, strategy; military or naval operations
作戦	<b>さくせん</b> <br> tactics, strategy; military or naval operations <br> [sound:4c-k-作戦.mp3]
tactics, strategy; military or naval operations	<b>作戦</b> <br> さくせん <br> [sound:4c-k-作戦.mp3]
[sound:4c-s-新しい作戦を立てました。.mp3]	<b>新しい作戦を立てました。</b> <br> あたらしいさくせんをたてました。 <br><br> (作戦) <br> I devised a new strategy.
新しい作戦を立てました。 <br><br> (作戦)	<b>あたらしいさくせんをたてました。</b> <br> I devised a new strategy. <br> [sound:4c-s-新しい作戦を立てました。.mp3]
I devised a new strategy.	<b>新しい作戦を立てました。</b> <br> あたらしいさくせんをたてました。 <br><br> (作戦) <br> [sound:4c-s-新しい作戦を立てました。.mp3]
[sound:4c-k-性格.mp3]	<b>性格</b> <br> せいかく <br> character, personality
性格	<b>せいかく</b> <br> character, personality <br> [sound:4c-k-性格.mp3]
character, personality	<b>性格</b> <br> せいかく <br> [sound:4c-k-性格.mp3]
[sound:4c-s-彼は明るい性格です。.mp3]	<b>彼は明るい性格です。</b> <br> かれはあかるいせいかくです。 <br><br> (性格) <br> He has a cheerful personality.
彼は明るい性格です。 <br><br> (性格)	<b>かれはあかるいせいかくです。</b> <br> He has a cheerful personality. <br> [sound:4c-s-彼は明るい性格です。.mp3]
He has a cheerful personality.	<b>彼は明るい性格です。</b> <br> かれはあかるいせいかくです。 <br><br> (性格) <br> [sound:4c-s-彼は明るい性格です。.mp3]
[sound:4c-k-必要性.mp3]	<b>必要性</b> <br> ひつようせい <br> necessity
必要性	<b>ひつようせい</b> <br> necessity <br> [sound:4c-k-必要性.mp3]
necessity	<b>必要性</b> <br> ひつようせい <br> [sound:4c-k-必要性.mp3]
[sound:4c-s-この技術の必要性が高まっています。.mp3]	<b>この技術の必要性が高まっています。</b> <br> このぎじゅつのひつようせいがたかまっています。 <br><br> (必要性) <br> The necessity of this technology is increasing.
この技術の必要性が高まっています。 <br><br> (必要性)	<b>このぎじゅつのひつようせいがたかまっています。</b> <br> The necessity of this technology is increasing. <br> [sound:4c-s-この技術の必要性が高まっています。.mp3]
The necessity of this technology is increasing.	<b>この技術の必要性が高まっています。</b> <br> このぎじゅつのひつようせいがたかまっています。 <br><br> (必要性) <br> [sound:4c-s-この技術の必要性が高まっています。.mp3]
[sound:4c-k-活性.mp3]	<b>活性</b> <br> かっせい <br> activity
活性	<b>かっせい</b> <br> activity <br> [sound:4c-k-活性.mp3]
activity	<b>活性</b> <br> かっせい <br> [sound:4c-k-活性.mp3]
[sound:4c-s-この薬は細胞の活性を促進します。.mp3]	<b>この薬は細胞の活性を促進します。</b> <br> このくすりはさいぼうのかっせいをそくしんします。 <br><br> (活性) <br> This medicine promotes cell activity.
この薬は細胞の活性を促進します。 <br><br> (活性)	<b>このくすりはさいぼうのかっせいをそくしんします。</b> <br> This medicine promotes cell activity. <br> [sound:4c-s-この薬は細胞の活性を促進します。.mp3]
This medicine promotes cell activity.	<b>この薬は細胞の活性を促進します。</b> <br> このくすりはさいぼうのかっせいをそくしんします。 <br><br> (活性) <br> [sound:4c-s-この薬は細胞の活性を促進します。.mp3]
[sound:4c-k-個性.mp3]	<b>個性</b> <br> こせい <br> individuality, personality, idiosyncrasy
個性	<b>こせい</b> <br> individuality, personality, idiosyncrasy <br> [sound:4c-k-個性.mp3]
individuality, personality, idiosyncrasy	<b>個性</b> <br> こせい <br> [sound:4c-k-個性.mp3]
[sound:4c-s-彼の個性が際立っています。.mp3]	<b>彼の個性が際立っています。</b> <br> かれのこせいがきわだっています。 <br><br> (個性) <br> His individuality stands out.
彼の個性が際立っています。 <br><br> (個性)	<b>かれのこせいがきわだっています。</b> <br> His individuality stands out. <br> [sound:4c-s-彼の個性が際立っています。.mp3]
His individuality stands out.	<b>彼の個性が際立っています。</b> <br> かれのこせいがきわだっています。 <br><br> (個性) <br> [sound:4c-s-彼の個性が際立っています。.mp3]
[sound:4c-k-国際的.mp3]	<b>国際的</b> <br> こくさいてき <br> international
国際的	<b>こくさいてき</b> <br> international <br> [sound:4c-k-国際的.mp3]
international	<b>国際的</b> <br> こくさいてき <br> [sound:4c-k-国際的.mp3]
[sound:4c-s-国際的な会議が開催されました。.mp3]	<b>国際的な会議が開催されました。</b> <br> こくさいてきなかいぎがかいさいされました。 <br><br> (国際的) <br> An international conference was held.
国際的な会議が開催されました。 <br><br> (国際的)	<b>こくさいてきなかいぎがかいさいされました。</b> <br> An international conference was held. <br> [sound:4c-s-国際的な会議が開催されました。.mp3]
An international conference was held.	<b>国際的な会議が開催されました。</b> <br> こくさいてきなかいぎがかいさいされました。 <br><br> (国際的) <br> [sound:4c-s-国際的な会議が開催されました。.mp3]
[sound:4c-k-基本的.mp3]	<b>基本的</b> <br> きほんてき <br> fundamental, standard, basic
基本的	<b>きほんてき</b> <br> fundamental, standard, basic <br> [sound:4c-k-基本的.mp3]
fundamental, standard, basic	<b>基本的</b> <br> きほんてき <br> [sound:4c-k-基本的.mp3]
[sound:4c-s-基本的なルールを守ってください。.mp3]	<b>基本的なルールを守ってください。</b> <br> きほんてきなるーるをまもってください。 <br><br> (基本的) <br> Please follow basic rules.
基本的なルールを守ってください。 <br><br> (基本的)	<b>きほんてきなるーるをまもってください。</b> <br> Please follow basic rules. <br> [sound:4c-s-基本的なルールを守ってください。.mp3]
Please follow basic rules.	<b>基本的なルールを守ってください。</b> <br> きほんてきなるーるをまもってください。 <br><br> (基本的) <br> [sound:4c-s-基本的なルールを守ってください。.mp3]
[sound:4c-k-公的.mp3]	<b>公的</b> <br> こうてき <br> public, official
公的	<b>こうてき</b> <br> public, official <br> [sound:4c-k-公的.mp3]
public, official	<b>公的</b> <br> こうてき <br> [sound:4c-k-公的.mp3]
[sound:4c-s-公的な文書を提出しました。.mp3]	<b>公的な文書を提出しました。</b> <br> こうてきなぶんしょをていしゅつしました。 <br><br> (公的) <br> I submitted an official document.
公的な文書を提出しました。 <br><br> (公的)	<b>こうてきなぶんしょをていしゅつしました。</b> <br> I submitted an official document. <br> [sound:4c-s-公的な文書を提出しました。.mp3]
I submitted an official document.	<b>公的な文書を提出しました。</b> <br> こうてきなぶんしょをていしゅつしました。 <br><br> (公的) <br> [sound:4c-s-公的な文書を提出しました。.mp3]
[sound:4c-k-政治的.mp3]	<b>政治的</b> <br> せいじてき <br> political
政治的	<b>せいじてき</b> <br> political <br> [sound:4c-k-政治的.mp3]
political	<b>政治的</b> <br> せいじてき <br> [sound:4c-k-政治的.mp3]
[sound:4c-s-政治的な話題について議論しました。.mp3]	<b>政治的な話題について議論しました。</b> <br> せいじてきなわだいについてぎろんしました。 <br><br> (政治的) <br> We discussed political topics.
政治的な話題について議論しました。 <br><br> (政治的)	<b>せいじてきなわだいについてぎろんしました。</b> <br> We discussed political topics. <br> [sound:4c-s-政治的な話題について議論しました。.mp3]
We discussed political topics.	<b>政治的な話題について議論しました。</b> <br> せいじてきなわだいについてぎろんしました。 <br><br> (政治的) <br> [sound:4c-s-政治的な話題について議論しました。.mp3]
[sound:4c-k-主要.mp3]	<b>主要</b> <br> しゅよう <br> chief, main, principal, major
主要	<b>しゅよう</b> <br> chief, main, principal, major <br> [sound:4c-k-主要.mp3]
chief, main, principal, major	<b>主要</b> <br> しゅよう <br> [sound:4c-k-主要.mp3]
[sound:4c-s-彼は主要な役割を果たしました。.mp3]	<b>彼は主要な役割を果たしました。</b> <br> かれはしゅようなやくわりをはたしました。 <br><br> (主要) <br> He played a key role.
彼は主要な役割を果たしました。 <br><br> (主要)	<b>かれはしゅようなやくわりをはたしました。</b> <br> He played a key role. <br> [sound:4c-s-彼は主要な役割を果たしました。.mp3]
He played a key role.	<b>彼は主要な役割を果たしました。</b> <br> かれはしゅようなやくわりをはたしました。 <br><br> (主要) <br> [sound:4c-s-彼は主要な役割を果たしました。.mp3]
[sound:4c-k-需要.mp3]	<b>需要</b> <br> じゅよう <br> demand, request
需要	<b>じゅよう</b> <br> demand, request <br> [sound:4c-k-需要.mp3]
demand, request	<b>需要</b> <br> じゅよう <br> [sound:4c-k-需要.mp3]
[sound:4c-s-この商品の需要が高まっています。.mp3]	<b>この商品の需要が高まっています。</b> <br> このしょうひんのじゅようがたかまっています。 <br><br> (需要) <br> Demand for this product is increasing.
この商品の需要が高まっています。 <br><br> (需要)	<b>このしょうひんのじゅようがたかまっています。</b> <br> Demand for this product is increasing. <br> [sound:4c-s-この商品の需要が高まっています。.mp3]
Demand for this product is increasing.	<b>この商品の需要が高まっています。</b> <br> このしょうひんのじゅようがたかまっています。 <br><br> (需要) <br> [sound:4c-s-この商品の需要が高まっています。.mp3]
[sound:4c-k-要請.mp3]	<b>要請</b> <br> ようせい <br> claim, demand, request, application
要請	<b>ようせい</b> <br> claim, demand, request, application <br> [sound:4c-k-要請.mp3]
claim, demand, request, application	<b>要請</b> <br> ようせい <br> [sound:4c-k-要請.mp3]
[sound:4c-s-政府は協力を要請しました。.mp3]	<b>政府は協力を要請しました。</b> <br> せいふはきょうりょくをようせいしました。 <br><br> (要請) <br> The government requested cooperation.
政府は協力を要請しました。 <br><br> (要請)	<b>せいふはきょうりょくをようせいしました。</b> <br> The government requested cooperation. <br> [sound:4c-s-政府は協力を要請しました。.mp3]
The government requested cooperation.	<b>政府は協力を要請しました。</b> <br> せいふはきょうりょくをようせいしました。 <br><br> (要請) <br> [sound:4c-s-政府は協力を要請しました。.mp3]
[sound:4c-k-必要性.mp3]	<b>必要性</b> <br> ひつようせい <br> necessity
必要性	<b>ひつようせい</b> <br> necessity <br> [sound:4c-k-必要性.mp3]
necessity	<b>必要性</b> <br> ひつようせい <br> [sound:4c-k-必要性.mp3]
[sound:4c-s-このシステムの必要性を説明してください。.mp3]	<b>このシステムの必要性を説明してください。</b> <br> このシステムのひつようせいをせつめいしてください。 <br><br> (必要性) <br> Please explain the necessity of this system.
このシステムの必要性を説明してください。 <br><br> (必要性)	<b>このシステムのひつようせいをせつめいしてください。</b> <br> Please explain the necessity of this system. <br> [sound:4c-s-このシステムの必要性を説明してください。.mp3]
Please explain the necessity of this system.	<b>このシステムの必要性を説明してください。</b> <br> このシステムのひつようせいをせつめいしてください。 <br><br> (必要性) <br> [sound:4c-s-このシステムの必要性を説明してください。.mp3]
[sound:4c-k-費用.mp3]	<b>費用</b> <br> ひよう <br> cost, expense
費用	<b>ひよう</b> <br> cost, expense <br> [sound:4c-k-費用.mp3]
cost, expense	<b>費用</b> <br> ひよう <br> [sound:4c-k-費用.mp3]
[sound:4c-s-このプロジェクトの費用は高いです。.mp3]	<b>このプロジェクトの費用は高いです。</b> <br> このプロジェクトのひようはたかいです。 <br><br> (費用) <br> This project's cost is high.
このプロジェクトの費用は高いです。 <br><br> (費用)	<b>このプロジェクトのひようはたかいです。</b> <br> This project's cost is high. <br> [sound:4c-s-このプロジェクトの費用は高いです。.mp3]
This project's cost is high.	<b>このプロジェクトの費用は高いです。</b> <br> このプロジェクトのひようはたかいです。 <br><br> (費用) <br> [sound:4c-s-このプロジェクトの費用は高いです。.mp3]
[sound:4c-k-利用.mp3]	<b>利用</b> <br> りよう <br> use, utilization, utilisation, application
利用	<b>りよう</b> <br> use, utilization, utilisation, application <br> [sound:4c-k-利用.mp3]
use, utilization, utilisation, application	<b>利用</b> <br> りよう <br> [sound:4c-k-利用.mp3]
[sound:4c-s-インターネットの利用が増えています。.mp3]	<b>インターネットの利用が増えています。</b> <br> インターネットのりようがふえています。 <br><br> (利用) <br> Internet usage is increasing.
インターネットの利用が増えています。 <br><br> (利用)	<b>インターネットのりようがふえています。</b> <br> Internet usage is increasing. <br> [sound:4c-s-インターネットの利用が増えています。.mp3]
Internet usage is increasing.	<b>インターネットの利用が増えています。</b> <br> インターネットのりようがふえています。 <br><br> (利用) <br> [sound:4c-s-インターネットの利用が増えています。.mp3]
[sound:4c-k-運用.mp3]	<b>運用</b> <br> うんよう <br> making use of, application, investment, practical use
運用	<b>うんよう</b> <br> making use of, application, investment, practical use <br> [sound:4c-k-運用.mp3]
making use of, application, investment, practical use	<b>運用</b> <br> うんよう <br> [sound:4c-k-運用.mp3]
[sound:4c-s-このシステムは適切に運用されています。.mp3]	<b>このシステムは適切に運用されています。</b> <br> このシステムはてきせつにうんようされています。 <br><br> (運用) <br> This system is being operated properly.
このシステムは適切に運用されています。 <br><br> (運用)	<b>このシステムはてきせつにうんようされています。</b> <br> This system is being operated properly. <br> [sound:4c-s-このシステムは適切に運用されています。.mp3]
This system is being operated properly.	<b>このシステムは適切に運用されています。</b> <br> このシステムはてきせつにうんようされています。 <br><br> (運用) <br> [sound:4c-s-このシステムは適切に運用されています。.mp3]
[sound:4c-k-乗用車.mp3]	<b>乗用車</b> <br> じょうようしゃ <br> passenger vehicle, automobile
乗用車	<b>じょうようしゃ</b> <br> passenger vehicle, automobile <br> [sound:4c-k-乗用車.mp3]
passenger vehicle, automobile	<b>乗用車</b> <br> じょうようしゃ <br> [sound:4c-k-乗用車.mp3]
[sound:4c-s-彼は新しい乗用車を購入しました。.mp3]	<b>彼は新しい乗用車を購入しました。</b> <br> かれはあたらしいじょうようしゃをこうにゅうしました。 <br><br> (乗用車) <br> He purchased a new car.
彼は新しい乗用車を購入しました。 <br><br> (乗用車)	<b>かれはあたらしいじょうようしゃをこうにゅうしました。</b> <br> He purchased a new car. <br> [sound:4c-s-彼は新しい乗用車を購入しました。.mp3]
He purchased a new car.	<b>彼は新しい乗用車を購入しました。</b> <br> かれはあたらしいじょうようしゃをこうにゅうしました。 <br><br> (乗用車) <br> [sound:4c-s-彼は新しい乗用車を購入しました。.mp3]
[sound:4c-k-体制.mp3]	<b>体制</b> <br> たいせい <br> order, system, structure, set-up, organization, organisation
体制	<b>たいせい</b> <br> order, system, structure, set-up, organization, organisation <br> [sound:4c-k-体制.mp3]
order, system, structure, set-up, organization, organisation	<b>体制</b> <br> たいせい <br> [sound:4c-k-体制.mp3]
[sound:4c-s-新しい経営体制が導入されました。.mp3]	<b>新しい経営体制が導入されました。</b> <br> あたらしいけいえいたいせいがどうにゅうされました。 <br><br> (体制) <br> A new management system has been introduced.
新しい経営体制が導入されました。 <br><br> (体制)	<b>あたらしいけいえいたいせいがどうにゅうされました。</b> <br> A new management system has been introduced. <br> [sound:4c-s-新しい経営体制が導入されました。.mp3]
A new management system has been introduced.	<b>新しい経営体制が導入されました。</b> <br> あたらしいけいえいたいせいがどうにゅうされました。 <br><br> (体制) <br> [sound:4c-s-新しい経営体制が導入されました。.mp3]
[sound:4c-k-制裁.mp3]	<b>制裁</b> <br> せいさい <br> restraint, sanctions, punishment
制裁	<b>せいさい</b> <br> restraint, sanctions, punishment <br> [sound:4c-k-制裁.mp3]
restraint, sanctions, punishment	<b>制裁</b> <br> せいさい <br> [sound:4c-k-制裁.mp3]
[sound:4c-s-国際制裁が強化されました。.mp3]	<b>国際制裁が強化されました。</b> <br> こくさいせいさいがきょうかされました。 <br><br> (制裁) <br> International sanctions have been strengthened.
国際制裁が強化されました。 <br><br> (制裁)	<b>こくさいせいさいがきょうかされました。</b> <br> International sanctions have been strengthened. <br> [sound:4c-s-国際制裁が強化されました。.mp3]
International sanctions have been strengthened.	<b>国際制裁が強化されました。</b> <br> こくさいせいさいがきょうかされました。 <br><br> (制裁) <br> [sound:4c-s-国際制裁が強化されました。.mp3]
[sound:4c-k-税制.mp3]	<b>税制</b> <br> ぜいせい <br> tax system
税制	<b>ぜいせい</b> <br> tax system <br> [sound:4c-k-税制.mp3]
tax system	<b>税制</b> <br> ぜいせい <br> [sound:4c-k-税制.mp3]
[sound:4c-s-税制改革が進行中です。.mp3]	<b>税制改革が進行中です。</b> <br> ぜいせいかいかくがしんこうちゅうです。 <br><br> (税制) <br> Tax reform is in progress.
税制改革が進行中です。 <br><br> (税制)	<b>ぜいせいかいかくがしんこうちゅうです。</b> <br> Tax reform is in progress. <br> [sound:4c-s-税制改革が進行中です。.mp3]
Tax reform is in progress.	<b>税制改革が進行中です。</b> <br> ぜいせいかいかくがしんこうちゅうです。 <br><br> (税制) <br> [sound:4c-s-税制改革が進行中です。.mp3]
[sound:4c-k-強制.mp3]	<b>強制</b> <br> きょうせい <br> obligation, coercion, compulsion, enforcement
強制	<b>きょうせい</b> <br> obligation, coercion, compulsion, enforcement <br> [sound:4c-k-強制.mp3]
obligation, coercion, compulsion, enforcement	<b>強制</b> <br> きょうせい <br> [sound:4c-k-強制.mp3]
[sound:4c-s-彼は強制的に退職されました。.mp3]	<b>彼は強制的に退職されました。</b> <br> かれはきょうせいてきにたいしょくされました。 <br><br> (強制) <br> He was forced to resign.
彼は強制的に退職されました。 <br><br> (強制)	<b>かれはきょうせいてきにたいしょくされました。</b> <br> He was forced to resign. <br> [sound:4c-s-彼は強制的に退職されました。.mp3]
He was forced to resign.	<b>彼は強制的に退職されました。</b> <br> かれはきょうせいてきにたいしょくされました。 <br><br> (強制) <br> [sound:4c-s-彼は強制的に退職されました。.mp3]
[sound:4c-k-自治.mp3]	<b>自治</b> <br> じち <br> self-government, autonomy
自治	<b>じち</b> <br> self-government, autonomy <br> [sound:4c-k-自治.mp3]
self-government, autonomy	<b>自治</b> <br> じち <br> [sound:4c-k-自治.mp3]
[sound:4c-s-この地域は自治が認められています。.mp3]	<b>この地域は自治が認められています。</b> <br> このちいきはじちがみとめられています。 <br><br> (自治) <br> This area is granted autonomy.
この地域は自治が認められています。 <br><br> (自治)	<b>このちいきはじちがみとめられています。</b> <br> This area is granted autonomy. <br> [sound:4c-s-この地域は自治が認められています。.mp3]
This area is granted autonomy.	<b>この地域は自治が認められています。</b> <br> このちいきはじちがみとめられています。 <br><br> (自治) <br> [sound:4c-s-この地域は自治が認められています。.mp3]
[sound:4c-k-自治体.mp3]	<b>自治体</b> <br> じちたい <br> self-governing body, municipality, autonomous entity
自治体	<b>じちたい</b> <br> self-governing body, municipality, autonomous entity <br> [sound:4c-k-自治体.mp3]
self-governing body, municipality, autonomous entity	<b>自治体</b> <br> じちたい <br> [sound:4c-k-自治体.mp3]
[sound:4c-s-自治体が新しい政策を発表しました。.mp3]	<b>自治体が新しい政策を発表しました。</b> <br> じちたいがあたらしいせいさくをはっぴょうしました。 <br><br> (自治体) <br> The local government announced a new policy.
自治体が新しい政策を発表しました。 <br><br> (自治体)	<b>じちたいがあたらしいせいさくをはっぴょうしました。</b> <br> The local government announced a new policy. <br> [sound:4c-s-自治体が新しい政策を発表しました。.mp3]
The local government announced a new policy.	<b>自治体が新しい政策を発表しました。</b> <br> じちたいがあたらしいせいさくをはっぴょうしました。 <br><br> (自治体) <br> [sound:4c-s-自治体が新しい政策を発表しました。.mp3]
[sound:4c-k-政治的.mp3]	<b>政治的</b> <br> せいじてき <br> political
政治的	<b>せいじてき</b> <br> political <br> [sound:4c-k-政治的.mp3]
political	<b>政治的</b> <br> せいじてき <br> [sound:4c-k-政治的.mp3]
[sound:4c-s-政治的な決定は慎重に行われるべきです。.mp3]	<b>政治的な決定は慎重に行われるべきです。</b> <br> せいじてきなけっていはしんちょうにおこなわれるべきです。 <br><br> (政治的) <br> Political decisions should be made carefully.
政治的な決定は慎重に行われるべきです。 <br><br> (政治的)	<b>せいじてきなけっていはしんちょうにおこなわれるべきです。</b> <br> Political decisions should be made carefully. <br> [sound:4c-s-政治的な決定は慎重に行われるべきです。.mp3]
Political decisions should be made carefully.	<b>政治的な決定は慎重に行われるべきです。</b> <br> せいじてきなけっていはしんちょうにおこなわれるべきです。 <br><br> (政治的) <br> [sound:4c-s-政治的な決定は慎重に行われるべきです。.mp3]
[sound:4c-k-明治.mp3]	<b>明治</b> <br> めいじ <br> Meiji era (1868.9.8-1912.7.30)
明治	<b>めいじ</b> <br> Meiji era (1868.9.8-1912.7.30) <br> [sound:4c-k-明治.mp3]
Meiji era (1868.9.8-1912.7.30)	<b>明治</b> <br> めいじ <br> [sound:4c-k-明治.mp3]
[sound:4c-s-明治時代の文化を研究しています。.mp3]	<b>明治時代の文化を研究しています。</b> <br> めいじじだいのぶんかをけんきゅうしています。 <br><br> (明治) <br> I'm researching the culture of the Meiji era.
明治時代の文化を研究しています。 <br><br> (明治)	<b>めいじじだいのぶんかをけんきゅうしています。</b> <br> I'm researching the culture of the Meiji era. <br> [sound:4c-s-明治時代の文化を研究しています。.mp3]
I'm researching the culture of the Meiji era.	<b>明治時代の文化を研究しています。</b> <br> めいじじだいのぶんかをけんきゅうしています。 <br><br> (明治) <br> [sound:4c-s-明治時代の文化を研究しています。.mp3]
[sound:4c-k-態度.mp3]	<b>態度</b> <br> たいど <br> attitude, manner, behaviour
態度	<b>たいど</b> <br> attitude, manner, behaviour <br> [sound:4c-k-態度.mp3]
attitude, manner, behaviour	<b>態度</b> <br> たいど <br> [sound:4c-k-態度.mp3]
[sound:4c-s-彼の態度はとても丁寧です。.mp3]	<b>彼の態度はとても丁寧です。</b> <br> かれのたいどはとてもていねいです。 <br><br> (態度) <br> His attitude is very polite.
彼の態度はとても丁寧です。 <br><br> (態度)	<b>かれのたいどはとてもていねいです。</b> <br> His attitude is very polite. <br> [sound:4c-s-彼の態度はとても丁寧です。.mp3]
His attitude is very polite.	<b>彼の態度はとても丁寧です。</b> <br> かれのたいどはとてもていねいです。 <br><br> (態度) <br> [sound:4c-s-彼の態度はとても丁寧です。.mp3]
[sound:4c-k-何度.mp3]	<b>何度</b> <br> なんど <br> how many times?, how often?
何度	<b>なんど</b> <br> how many times?, how often? <br> [sound:4c-k-何度.mp3]
how many times?, how often?	<b>何度</b> <br> なんど <br> [sound:4c-k-何度.mp3]
[sound:4c-s-何度も練習すれば上達します。.mp3]	<b>何度も練習すれば上達します。</b> <br> なんどもれんしゅうすればじょうたつします。 <br><br> (何度) <br> If you practice many times, you will improve.
何度も練習すれば上達します。 <br><br> (何度)	<b>なんどもれんしゅうすればじょうたつします。</b> <br> If you practice many times, you will improve. <br> [sound:4c-s-何度も練習すれば上達します。.mp3]
If you practice many times, you will improve.	<b>何度も練習すれば上達します。</b> <br> なんどもれんしゅうすればじょうたつします。 <br><br> (何度) <br> [sound:4c-s-何度も練習すれば上達します。.mp3]
[sound:4c-k-前年度.mp3]	<b>前年度</b> <br> ぜんねんど <br> preceding fiscal year
前年度	<b>ぜんねんど</b> <br> preceding fiscal year <br> [sound:4c-k-前年度.mp3]
preceding fiscal year	<b>前年度</b> <br> ぜんねんど <br> [sound:4c-k-前年度.mp3]
[sound:4c-s-前年度の売上が発表されました。.mp3]	<b>前年度の売上が発表されました。</b> <br> ぜんねんどのうりあげがはっぴょうされました。 <br><br> (前年度) <br> Last year's sales figures have been announced.
前年度の売上が発表されました。 <br><br> (前年度)	<b>ぜんねんどのうりあげがはっぴょうされました。</b> <br> Last year's sales figures have been announced. <br> [sound:4c-s-前年度の売上が発表されました。.mp3]
Last year's sales figures have been announced.	<b>前年度の売上が発表されました。</b> <br> ぜんねんどのうりあげがはっぴょうされました。 <br><br> (前年度) <br> [sound:4c-s-前年度の売上が発表されました。.mp3]
[sound:4c-k-年度.mp3]	<b>年度</b> <br> ねんど <br> year, fiscal year, school year, term
年度	<b>ねんど</b> <br> year, fiscal year, school year, term <br> [sound:4c-k-年度.mp3]
year, fiscal year, school year, term	<b>年度</b> <br> ねんど <br> [sound:4c-k-年度.mp3]
[sound:4c-s-この年度の予算が決まりました。.mp3]	<b>この年度の予算が決まりました。</b> <br> このねんどのよさんがきまりました。 <br><br> (年度) <br> The budget for this fiscal year has been set.
この年度の予算が決まりました。 <br><br> (年度)	<b>このねんどのよさんがきまりました。</b> <br> The budget for this fiscal year has been set. <br> [sound:4c-s-この年度の予算が決まりました。.mp3]
The budget for this fiscal year has been set.	<b>この年度の予算が決まりました。</b> <br> このねんどのよさんがきまりました。 <br><br> (年度) <br> [sound:4c-s-この年度の予算が決まりました。.mp3]
[sound:4c-k-事務局.mp3]	<b>事務局</b> <br> じむきょく <br> secretariat, executive office
事務局	<b>じむきょく</b> <br> secretariat, executive office <br> [sound:4c-k-事務局.mp3]
secretariat, executive office	<b>事務局</b> <br> じむきょく <br> [sound:4c-k-事務局.mp3]
[sound:4c-s-事務局が会議の準備を進めています。.mp3]	<b>事務局が会議の準備を進めています。</b> <br> じむきょくがかいぎのじゅんびをすすめています。 <br><br> (事務局) <br> The secretariat is preparing for the meeting.
事務局が会議の準備を進めています。 <br><br> (事務局)	<b>じむきょくがかいぎのじゅんびをすすめています。</b> <br> The secretariat is preparing for the meeting. <br> [sound:4c-s-事務局が会議の準備を進めています。.mp3]
The secretariat is preparing for the meeting.	<b>事務局が会議の準備を進めています。</b> <br> じむきょくがかいぎのじゅんびをすすめています。 <br><br> (事務局) <br> [sound:4c-s-事務局が会議の準備を進めています。.mp3]
[sound:4c-k-事務所.mp3]	<b>事務所</b> <br> じむしょ <br> office
事務所	<b>じむしょ</b> <br> office <br> [sound:4c-k-事務所.mp3]
office	<b>事務所</b> <br> じむしょ <br> [sound:4c-k-事務所.mp3]
[sound:4c-s-新しい事務所が開設されました。.mp3]	<b>新しい事務所が開設されました。</b> <br> あたらしいじむしょがかいせつされました。 <br><br> (事務所) <br> A new office has been established.
新しい事務所が開設されました。 <br><br> (事務所)	<b>あたらしいじむしょがかいせつされました。</b> <br> A new office has been established. <br> [sound:4c-s-新しい事務所が開設されました。.mp3]
A new office has been established.	<b>新しい事務所が開設されました。</b> <br> あたらしいじむしょがかいせつされました。 <br><br> (事務所) <br> [sound:4c-s-新しい事務所が開設されました。.mp3]
[sound:4c-k-業務.mp3]	<b>業務</b> <br> ぎょうむ <br> business, affairs, duties, work, procedure, task, action, function
業務	<b>ぎょうむ</b> <br> business, affairs, duties, work, procedure, task, action, function <br> [sound:4c-k-業務.mp3]
business, affairs, duties, work, procedure, task, action, function	<b>業務</b> <br> ぎょうむ <br> [sound:4c-k-業務.mp3]
[sound:4c-s-彼の業務はデータ分析です。.mp3]	<b>彼の業務はデータ分析です。</b> <br> かれのぎょうむはデータぶんせきです。 <br><br> (業務) <br> His job is data analysis.
彼の業務はデータ分析です。 <br><br> (業務)	<b>かれのぎょうむはデータぶんせきです。</b> <br> His job is data analysis. <br> [sound:4c-s-彼の業務はデータ分析です。.mp3]
His job is data analysis.	<b>彼の業務はデータ分析です。</b> <br> かれのぎょうむはデータぶんせきです。 <br><br> (業務) <br> [sound:4c-s-彼の業務はデータ分析です。.mp3]
[sound:4c-k-常務.mp3]	<b>常務</b> <br> じょうむ <br> managing director, executive director; routine business, regular business
常務	<b>じょうむ</b> <br> managing director, executive director; routine business, regular business <br> [sound:4c-k-常務.mp3]
managing director, executive director; routine business, regular business	<b>常務</b> <br> じょうむ <br> [sound:4c-k-常務.mp3]
[sound:4c-s-常務が新しい戦略を発表しました。.mp3]	<b>常務が新しい戦略を発表しました。</b> <br> じょうむがあたらしいせんりゃくをはっぴょうしました。 <br><br> (常務) <br> The executive director announced a new strategy.
常務が新しい戦略を発表しました。 <br><br> (常務)	<b>じょうむがあたらしいせんりゃくをはっぴょうしました。</b> <br> The executive director announced a new strategy. <br> [sound:4c-s-常務が新しい戦略を発表しました。.mp3]
The executive director announced a new strategy.	<b>常務が新しい戦略を発表しました。</b> <br> じょうむがあたらしいせんりゃくをはっぴょうしました。 <br><br> (常務) <br> [sound:4c-s-常務が新しい戦略を発表しました。.mp3]
[sound:4c-k-勉強.mp3]	<b>勉強</b> <br> べんきょう <br> study; diligence; discount, reduction
勉強	<b>べんきょう</b> <br> study; diligence; discount, reduction <br> [sound:4c-k-勉強.mp3]
study; diligence; discount, reduction	<b>勉強</b> <br> べんきょう <br> [sound:4c-k-勉強.mp3]
[sound:4c-s-毎日1時間勉強しています。.mp3]	<b>毎日1時間勉強しています。</b> <br> まいにちいちじかんべんきょうしています。 <br><br> (勉強) <br> I study for one hour every day.
毎日1時間勉強しています。 <br><br> (勉強)	<b>まいにちいちじかんべんきょうしています。</b> <br> I study for one hour every day. <br> [sound:4c-s-毎日1時間勉強しています。.mp3]
I study for one hour every day.	<b>毎日1時間勉強しています。</b> <br> まいにちいちじかんべんきょうしています。 <br><br> (勉強) <br> [sound:4c-s-毎日1時間勉強しています。.mp3]
[sound:4c-k-強める.mp3]	<b>強める</b> <br> つよめる <br> to strengthen, to emphasize, to emphasise
強める	<b>つよめる</b> <br> to strengthen, to emphasize, to emphasise <br> [sound:4c-k-強める.mp3]
to strengthen, to emphasize, to emphasise	<b>強める</b> <br> つよめる <br> [sound:4c-k-強める.mp3]
[sound:4c-s-彼は自信を強めるために努力しています。.mp3]	<b>彼は自信を強めるために努力しています。</b> <br> かれはじしんをつよめるためにどりょくしています。 <br><br> (強める) <br> He is working hard to build his confidence.
彼は自信を強めるために努力しています。 <br><br> (強める)	<b>かれはじしんをつよめるためにどりょくしています。</b> <br> He is working hard to build his confidence. <br> [sound:4c-s-彼は自信を強めるために努力しています。.mp3]
He is working hard to build his confidence.	<b>彼は自信を強めるために努力しています。</b> <br> かれはじしんをつよめるためにどりょくしています。 <br><br> (強める) <br> [sound:4c-s-彼は自信を強めるために努力しています。.mp3]
[sound:4c-k-強硬.mp3]	<b>強硬</b> <br> きょうこう <br> firm, vigorous, unbending, unyielding, strong, stubborn
強硬	<b>きょうこう</b> <br> firm, vigorous, unbending, unyielding, strong, stubborn <br> [sound:4c-k-強硬.mp3]
firm, vigorous, unbending, unyielding, strong, stubborn	<b>強硬</b> <br> きょうこう <br> [sound:4c-k-強硬.mp3]
[sound:4c-s-政府は強硬な対応を取ることを決定しました。.mp3]	<b>政府は強硬な対応を取ることを決定しました。</b> <br> せいふはきょうこうなたいおうをとることをけっていしました。 <br><br> (強硬) <br> The government decided to take a tough stance.
政府は強硬な対応を取ることを決定しました。 <br><br> (強硬)	<b>せいふはきょうこうなたいおうをとることをけっていしました。</b> <br> The government decided to take a tough stance. <br> [sound:4c-s-政府は強硬な対応を取ることを決定しました。.mp3]
The government decided to take a tough stance.	<b>政府は強硬な対応を取ることを決定しました。</b> <br> せいふはきょうこうなたいおうをとることをけっていしました。 <br><br> (強硬) <br> [sound:4c-s-政府は強硬な対応を取ることを決定しました。.mp3]
[sound:4c-k-強力.mp3]	<b>強力</b> <br> きょうりょく <br> powerful, strong
強力	<b>きょうりょく</b> <br> powerful, strong <br> [sound:4c-k-強力.mp3]
powerful, strong	<b>強力</b> <br> きょうりょく <br> [sound:4c-k-強力.mp3]
[sound:4c-s-このチームは非常に強力です。.mp3]	<b>このチームは非常に強力です。</b> <br> このチームはひじょうにきょうりょくです。 <br><br> (強力) <br> This team is extremely strong.
このチームは非常に強力です。 <br><br> (強力)	<b>このチームはひじょうにきょうりょくです。</b> <br> This team is extremely strong. <br> [sound:4c-s-このチームは非常に強力です。.mp3]
This team is extremely strong.	<b>このチームは非常に強力です。</b> <br> このチームはひじょうにきょうりょくです。 <br><br> (強力) <br> [sound:4c-s-このチームは非常に強力です。.mp3]
[sound:4c-k-気持ち.mp3]	<b>気持ち</b> <br> きもち <br> feeling, sensation, mood
気持ち	<b>きもち</b> <br> feeling, sensation, mood <br> [sound:4c-k-気持ち.mp3]
feeling, sensation, mood	<b>気持ち</b> <br> きもち <br> [sound:4c-k-気持ち.mp3]
[sound:4c-s-彼の気持ちを理解したいです。.mp3]	<b>彼の気持ちを理解したいです。</b> <br> かれのきもちをりかいしたいです。 <br><br> (気持ち) <br> I want to understand his feelings.
彼の気持ちを理解したいです。 <br><br> (気持ち)	<b>かれのきもちをりかいしたいです。</b> <br> I want to understand his feelings. <br> [sound:4c-s-彼の気持ちを理解したいです。.mp3]
I want to understand his feelings.	<b>彼の気持ちを理解したいです。</b> <br> かれのきもちをりかいしたいです。 <br><br> (気持ち) <br> [sound:4c-s-彼の気持ちを理解したいです。.mp3]
[sound:4c-k-電気.mp3]	<b>電気</b> <br> でんき <br> electricity; (electric) light
電気	<b>でんき</b> <br> electricity; (electric) light <br> [sound:4c-k-電気.mp3]
electricity; (electric) light	<b>電気</b> <br> でんき <br> [sound:4c-k-電気.mp3]
[sound:4c-s-電気の使用量を減らしましょう。.mp3]	<b>電気の使用量を減らしましょう。</b> <br> でんきのしようりょうをへらしましょう。 <br><br> (電気) <br> Let's reduce electricity usage.
電気の使用量を減らしましょう。 <br><br> (電気)	<b>でんきのしようりょうをへらしましょう。</b> <br> Let's reduce electricity usage. <br> [sound:4c-s-電気の使用量を減らしましょう。.mp3]
Let's reduce electricity usage.	<b>電気の使用量を減らしましょう。</b> <br> でんきのしようりょうをへらしましょう。 <br><br> (電気) <br> [sound:4c-s-電気の使用量を減らしましょう。.mp3]
[sound:4c-k-病気.mp3]	<b>病気</b> <br> びょうき <br> illness, disease, sickness
病気	<b>びょうき</b> <br> illness, disease, sickness <br> [sound:4c-k-病気.mp3]
illness, disease, sickness	<b>病気</b> <br> びょうき <br> [sound:4c-k-病気.mp3]
[sound:4c-s-病気の予防に気をつけています。.mp3]	<b>病気の予防に気をつけています。</b> <br> びょうきのよぼうにきをつけています。 <br><br> (病気) <br> I'm careful to prevent illness.
病気の予防に気をつけています。 <br><br> (病気)	<b>びょうきのよぼうにきをつけています。</b> <br> I'm careful to prevent illness. <br> [sound:4c-s-病気の予防に気をつけています。.mp3]
I'm careful to prevent illness.	<b>病気の予防に気をつけています。</b> <br> びょうきのよぼうにきをつけています。 <br><br> (病気) <br> [sound:4c-s-病気の予防に気をつけています。.mp3]
[sound:4c-k-一気.mp3]	<b>一気</b> <br> いっき <br> drink! (said repeatedly as a party cheer)
一気	<b>いっき</b> <br> drink! (said repeatedly as a party cheer) <br> [sound:4c-k-一気.mp3]
drink! (said repeatedly as a party cheer)	<b>一気</b> <br> いっき <br> [sound:4c-k-一気.mp3]
[sound:4c-s-彼は一気に本を読み終えました。.mp3]	<b>彼は一気に本を読み終えました。</b> <br> かれはいっきにほんをよみおえました。 <br><br> (一気) <br> He finished reading the book in one go.
彼は一気に本を読み終えました。 <br><br> (一気)	<b>かれはいっきにほんをよみおえました。</b> <br> He finished reading the book in one go. <br> [sound:4c-s-彼は一気に本を読み終えました。.mp3]
He finished reading the book in one go.	<b>彼は一気に本を読み終えました。</b> <br> かれはいっきにほんをよみおえました。 <br><br> (一気) <br> [sound:4c-s-彼は一気に本を読み終えました。.mp3]
[sound:4c-k-小学生.mp3]	<b>小学生</b> <br> しょうがくせい <br> elementary school student, primary school student, grade school student
小学生	<b>しょうがくせい</b> <br> elementary school student, primary school student, grade school student <br> [sound:4c-k-小学生.mp3]
elementary school student, primary school student, grade school student	<b>小学生</b> <br> しょうがくせい <br> [sound:4c-k-小学生.mp3]
[sound:4c-s-小学生は元気いっぱいです。.mp3]	<b>小学生は元気いっぱいです。</b> <br> しょうがくせいはげんきいっぱいです。 <br><br> (小学生) <br> Elementary school students are full of energy.
小学生は元気いっぱいです。 <br><br> (小学生)	<b>しょうがくせいはげんきいっぱいです。</b> <br> Elementary school students are full of energy. <br> [sound:4c-s-小学生は元気いっぱいです。.mp3]
Elementary school students are full of energy.	<b>小学生は元気いっぱいです。</b> <br> しょうがくせいはげんきいっぱいです。 <br><br> (小学生) <br> [sound:4c-s-小学生は元気いっぱいです。.mp3]
[sound:4c-k-中小企業.mp3]	<b>中小企業</b> <br> ちゅうしょうきぎょう <br> small to medium enterprises, smaller companies
中小企業	<b>ちゅうしょうきぎょう</b> <br> small to medium enterprises, smaller companies <br> [sound:4c-k-中小企業.mp3]
small to medium enterprises, smaller companies	<b>中小企業</b> <br> ちゅうしょうきぎょう <br> [sound:4c-k-中小企業.mp3]
[sound:4c-s-中小企業の支援策が発表されました。.mp3]	<b>中小企業の支援策が発表されました。</b> <br> ちゅうしょうきぎょうのしえんさくがはっぴょうされました。 <br><br> (中小企業) <br> Support measures for small and medium-sized enterprises have been announced.
中小企業の支援策が発表されました。 <br><br> (中小企業)	<b>ちゅうしょうきぎょうのしえんさくがはっぴょうされました。</b> <br> Support measures for small and medium-sized enterprises have been announced. <br> [sound:4c-s-中小企業の支援策が発表されました。.mp3]
Support measures for small and medium-sized enterprises have been announced.	<b>中小企業の支援策が発表されました。</b> <br> ちゅうしょうきぎょうのしえんさくがはっぴょうされました。 <br><br> (中小企業) <br> [sound:4c-s-中小企業の支援策が発表されました。.mp3]
[sound:4c-k-小学.mp3]	<b>小学</b> <br> しょうがく <br> elementary school, primary school, grade school
小学	<b>しょうがく</b> <br> elementary school, primary school, grade school <br> [sound:4c-k-小学.mp3]
elementary school, primary school, grade school	<b>小学</b> <br> しょうがく <br> [sound:4c-k-小学.mp3]
[sound:4c-s-彼は小学三年生です。.mp3]	<b>彼は小学三年生です。</b> <br> かれはしょうがくさんねんせいです。 <br><br> (小学) <br> He is a third-grade elementary school student.
彼は小学三年生です。 <br><br> (小学)	<b>かれはしょうがくさんねんせいです。</b> <br> He is a third-grade elementary school student. <br> [sound:4c-s-彼は小学三年生です。.mp3]
He is a third-grade elementary school student.	<b>彼は小学三年生です。</b> <br> かれはしょうがくさんねんせいです。 <br><br> (小学) <br> [sound:4c-s-彼は小学三年生です。.mp3]
[sound:4c-k-小型.mp3]	<b>小型</b> <br> こがた <br> small size, tiny
小型	<b>こがた</b> <br> small size, tiny <br> [sound:4c-k-小型.mp3]
small size, tiny	<b>小型</b> <br> こがた <br> [sound:4c-k-小型.mp3]
[sound:4c-s-このカメラは小型で便利です。.mp3]	<b>このカメラは小型で便利です。</b> <br> このカメラはこがたでべんりです。 <br><br> (小型) <br> This camera is compact and convenient.
このカメラは小型で便利です。 <br><br> (小型)	<b>このカメラはこがたでべんりです。</b> <br> This camera is compact and convenient. <br> [sound:4c-s-このカメラは小型で便利です。.mp3]
This camera is compact and convenient.	<b>このカメラは小型で便利です。</b> <br> このカメラはこがたでべんりです。 <br><br> (小型) <br> [sound:4c-s-このカメラは小型で便利です。.mp3]
[sound:4c-k-七十.mp3]	<b>七十</b> <br> しちじゅう, ななじゅう, ななそ <br> seventy
七十	<b>しちじゅう, ななじゅう, ななそ</b> <br> seventy <br> [sound:4c-k-七十.mp3]
seventy	<b>七十</b> <br> しちじゅう, ななじゅう, ななそ <br> [sound:4c-k-七十.mp3]
[sound:4c-s-七十歳の誕生日を祝いました。.mp3]	<b>七十歳の誕生日を祝いました。</b> <br> ななじゅっさいのたんじょうびをいわいました。 <br><br> (七十) <br> We celebrated his seventieth birthday.
七十歳の誕生日を祝いました。 <br><br> (七十)	<b>ななじゅっさいのたんじょうびをいわいました。</b> <br> We celebrated his seventieth birthday. <br> [sound:4c-s-七十歳の誕生日を祝いました。.mp3]
We celebrated his seventieth birthday.	<b>七十歳の誕生日を祝いました。</b> <br> ななじゅっさいのたんじょうびをいわいました。 <br><br> (七十) <br> [sound:4c-s-七十歳の誕生日を祝いました。.mp3]
[sound:4c-k-四十七士.mp3]	<b>四十七士</b> <br> しじゅうしちし <br> The 47 Ronin
四十七士	<b>しじゅうしちし</b> <br> The 47 Ronin <br> [sound:4c-k-四十七士.mp3]
The 47 Ronin	<b>四十七士</b> <br> しじゅうしちし <br> [sound:4c-k-四十七士.mp3]
[sound:4c-s-四十七士の物語は有名です。.mp3]	<b>四十七士の物語は有名です。</b> <br> しじゅうしちしのものがたりはゆうめいです。 <br><br> (四十七士) <br> The story of the Forty-Seven Ronin is famous.
四十七士の物語は有名です。 <br><br> (四十七士)	<b>しじゅうしちしのものがたりはゆうめいです。</b> <br> The story of the Forty-Seven Ronin is famous. <br> [sound:4c-s-四十七士の物語は有名です。.mp3]
The story of the Forty-Seven Ronin is famous.	<b>四十七士の物語は有名です。</b> <br> しじゅうしちしのものがたりはゆうめいです。 <br><br> (四十七士) <br> [sound:4c-s-四十七士の物語は有名です。.mp3]
[sound:4c-k-七つ.mp3]	<b>七つ</b> <br> ななつ <br> seven
七つ	<b>ななつ</b> <br> seven <br> [sound:4c-k-七つ.mp3]
seven	<b>七つ</b> <br> ななつ <br> [sound:4c-k-七つ.mp3]
[sound:4c-s-七つの異なる選択肢があります。.mp3]	<b>七つの異なる選択肢があります。</b> <br> ななつのことなるせんたくしがあります。 <br><br> (七つ) <br> There are seven different options.
七つの異なる選択肢があります。 <br><br> (七つ)	<b>ななつのことなるせんたくしがあります。</b> <br> There are seven different options. <br> [sound:4c-s-七つの異なる選択肢があります。.mp3]
There are seven different options.	<b>七つの異なる選択肢があります。</b> <br> ななつのことなるせんたくしがあります。 <br><br> (七つ) <br> [sound:4c-s-七つの異なる選択肢があります。.mp3]
[sound:4c-k-七七日.mp3]	<b>七七日</b> <br> しちしちにち, なななぬか, なななのか <br> 49th day after death
七七日	<b>しちしちにち, なななぬか, なななのか</b> <br> 49th day after death <br> [sound:4c-k-七七日.mp3]
49th day after death	<b>七七日</b> <br> しちしちにち, なななぬか, なななのか <br> [sound:4c-k-七七日.mp3]
[sound:4c-s-七七日の法要が行われました。.mp3]	<b>七七日の法要が行われました。</b> <br> しちしちにちのほうようがおこなわれました。 <br><br> (七七日) <br> The 49-day memorial service was held.
七七日の法要が行われました。 <br><br> (七七日)	<b>しちしちにちのほうようがおこなわれました。</b> <br> The 49-day memorial service was held. <br> [sound:4c-s-七七日の法要が行われました。.mp3]
The 49-day memorial service was held.	<b>七七日の法要が行われました。</b> <br> しちしちにちのほうようがおこなわれました。 <br><br> (七七日) <br> [sound:4c-s-七七日の法要が行われました。.mp3]
[sound:4c-k-成立.mp3]	<b>成立</b> <br> せいりつ <br> coming into existence, arrangements, establishment, conclusion, completion
成立	<b>せいりつ</b> <br> coming into existence, arrangements, establishment, conclusion, completion <br> [sound:4c-k-成立.mp3]
coming into existence, arrangements, establishment, conclusion, completion	<b>成立</b> <br> せいりつ <br> [sound:4c-k-成立.mp3]
[sound:4c-s-新しい法案が成立しました。.mp3]	<b>新しい法案が成立しました。</b> <br> あたらしいほうあんがせいりつしました。 <br><br> (成立) <br> A new bill has been enacted.
新しい法案が成立しました。 <br><br> (成立)	<b>あたらしいほうあんがせいりつしました。</b> <br> A new bill has been enacted. <br> [sound:4c-s-新しい法案が成立しました。.mp3]
A new bill has been enacted.	<b>新しい法案が成立しました。</b> <br> あたらしいほうあんがせいりつしました。 <br><br> (成立) <br> [sound:4c-s-新しい法案が成立しました。.mp3]
[sound:4c-k-編成.mp3]	<b>編成</b> <br> へんせい <br> composition, formation, organization, organisation, compilation
編成	<b>へんせい</b> <br> composition, formation, organization, organisation, compilation <br> [sound:4c-k-編成.mp3]
composition, formation, organization, organisation, compilation	<b>編成</b> <br> へんせい <br> [sound:4c-k-編成.mp3]
[sound:4c-s-新しいチームの編成が完了しました。.mp3]	<b>新しいチームの編成が完了しました。</b> <br> あたらしいチームのへんせいがかんりょうしました。 <br><br> (編成) <br> The formation of the new team is complete.
新しいチームの編成が完了しました。 <br><br> (編成)	<b>あたらしいチームのへんせいがかんりょうしました。</b> <br> The formation of the new team is complete. <br> [sound:4c-s-新しいチームの編成が完了しました。.mp3]
The formation of the new team is complete.	<b>新しいチームの編成が完了しました。</b> <br> あたらしいチームのへんせいがかんりょうしました。 <br><br> (編成) <br> [sound:4c-s-新しいチームの編成が完了しました。.mp3]
[sound:4c-k-結成.mp3]	<b>結成</b> <br> けっせい <br> formation
結成	<b>けっせい</b> <br> formation <br> [sound:4c-k-結成.mp3]
formation	<b>結成</b> <br> けっせい <br> [sound:4c-k-結成.mp3]
[sound:4c-s-新しいバンドが結成されました。.mp3]	<b>新しいバンドが結成されました。</b> <br> あたらしいバンドがけっせいされました。 <br><br> (結成) <br> A new band has been formed.
新しいバンドが結成されました。 <br><br> (結成)	<b>あたらしいバンドがけっせいされました。</b> <br> A new band has been formed. <br> [sound:4c-s-新しいバンドが結成されました。.mp3]
A new band has been formed.	<b>新しいバンドが結成されました。</b> <br> あたらしいバンドがけっせいされました。 <br><br> (結成) <br> [sound:4c-s-新しいバンドが結成されました。.mp3]
[sound:4c-k-構成.mp3]	<b>構成</b> <br> こうせい <br> organization, organisation, configuration, composition
構成	<b>こうせい</b> <br> organization, organisation, configuration, composition <br> [sound:4c-k-構成.mp3]
organization, organisation, configuration, composition	<b>構成</b> <br> こうせい <br> [sound:4c-k-構成.mp3]
[sound:4c-s-この組織は五つの部門で構成されています。.mp3]	<b>この組織は五つの部門で構成されています。</b> <br> このそしきはいつつのぶもんでこうせいされています。 <br><br> (構成) <br> This organization consists of five departments.
この組織は五つの部門で構成されています。 <br><br> (構成)	<b>このそしきはいつつのぶもんでこうせいされています。</b> <br> This organization consists of five departments. <br> [sound:4c-s-この組織は五つの部門で構成されています。.mp3]
This organization consists of five departments.	<b>この組織は五つの部門で構成されています。</b> <br> このそしきはいつつのぶもんでこうせいされています。 <br><br> (構成) <br> [sound:4c-s-この組織は五つの部門で構成されています。.mp3]
[sound:4c-k-早期.mp3]	<b>早期</b> <br> そうき <br> early stage
早期	<b>そうき</b> <br> early stage <br> [sound:4c-k-早期.mp3]
early stage	<b>早期</b> <br> そうき <br> [sound:4c-k-早期.mp3]
[sound:4c-s-早期治療が重要です。.mp3]	<b>早期治療が重要です。</b> <br> そうきちりょうがじゅうようです。 <br><br> (早期) <br> Early treatment is important.
早期治療が重要です。 <br><br> (早期)	<b>そうきちりょうがじゅうようです。</b> <br> Early treatment is important. <br> [sound:4c-s-早期治療が重要です。.mp3]
Early treatment is important.	<b>早期治療が重要です。</b> <br> そうきちりょうがじゅうようです。 <br><br> (早期) <br> [sound:4c-s-早期治療が重要です。.mp3]
[sound:4c-k-長期.mp3]	<b>長期</b> <br> ちょうき <br> long time period
長期	<b>ちょうき</b> <br> long time period <br> [sound:4c-k-長期.mp3]
long time period	<b>長期</b> <br> ちょうき <br> [sound:4c-k-長期.mp3]
[sound:4c-s-長期計画を立てましょう。.mp3]	<b>長期計画を立てましょう。</b> <br> ちょうきけいかくをたてましょう。 <br><br> (長期) <br> Let's create a long-term plan.
長期計画を立てましょう。 <br><br> (長期)	<b>ちょうきけいかくをたてましょう。</b> <br> Let's create a long-term plan. <br> [sound:4c-s-長期計画を立てましょう。.mp3]
Let's create a long-term plan.	<b>長期計画を立てましょう。</b> <br> ちょうきけいかくをたてましょう。 <br><br> (長期) <br> [sound:4c-s-長期計画を立てましょう。.mp3]
[sound:4c-k-期限.mp3]	<b>期限</b> <br> きげん <br> term, period, time frame; time limit, deadline, cutoff (date)
期限	<b>きげん</b> <br> term, period, time frame; time limit, deadline, cutoff (date) <br> [sound:4c-k-期限.mp3]
term, period, time frame; time limit, deadline, cutoff (date)	<b>期限</b> <br> きげん <br> [sound:4c-k-期限.mp3]
[sound:4c-s-提出期限は来週です。.mp3]	<b>提出期限は来週です。</b> <br> ていしゅつきげんはらいしゅうです。 <br><br> (期限) <br> The submission deadline is next week.
提出期限は来週です。 <br><br> (期限)	<b>ていしゅつきげんはらいしゅうです。</b> <br> The submission deadline is next week. <br> [sound:4c-s-提出期限は来週です。.mp3]
The submission deadline is next week.	<b>提出期限は来週です。</b> <br> ていしゅつきげんはらいしゅうです。 <br><br> (期限) <br> [sound:4c-s-提出期限は来週です。.mp3]
[sound:4c-k-次期.mp3]	<b>次期</b> <br> じき <br> next term, next period; next version, next release
次期	<b>じき</b> <br> next term, next period; next version, next release <br> [sound:4c-k-次期.mp3]
next term, next period; next version, next release	<b>次期</b> <br> じき <br> [sound:4c-k-次期.mp3]
[sound:4c-s-次期大統領選挙について議論されています。.mp3]	<b>次期大統領選挙について議論されています。</b> <br> じきだいとうりょうせんきょについてぎろんされています。 <br><br> (次期) <br> The next presidential election is being discussed.
次期大統領選挙について議論されています。 <br><br> (次期)	<b>じきだいとうりょうせんきょについてぎろんされています。</b> <br> The next presidential election is being discussed. <br> [sound:4c-s-次期大統領選挙について議論されています。.mp3]
The next presidential election is being discussed.	<b>次期大統領選挙について議論されています。</b> <br> じきだいとうりょうせんきょについてぎろんされています。 <br><br> (次期) <br> [sound:4c-s-次期大統領選挙について議論されています。.mp3]
[sound:4c-k-公共.mp3]	<b>公共</b> <br> こうきょう <br> public, community, public service, society, communal
公共	<b>こうきょう</b> <br> public, community, public service, society, communal <br> [sound:4c-k-公共.mp3]
public, community, public service, society, communal	<b>公共</b> <br> こうきょう <br> [sound:4c-k-公共.mp3]
[sound:4c-s-公共交通機関を利用しましょう。.mp3]	<b>公共交通機関を利用しましょう。</b> <br> こうきょうこうつうきかんをりようしましょう。 <br><br> (公共) <br> Let's use public transportation.
公共交通機関を利用しましょう。 <br><br> (公共)	<b>こうきょうこうつうきかんをりようしましょう。</b> <br> Let's use public transportation. <br> [sound:4c-s-公共交通機関を利用しましょう。.mp3]
Let's use public transportation.	<b>公共交通機関を利用しましょう。</b> <br> こうきょうこうつうきかんをりようしましょう。 <br><br> (公共) <br> [sound:4c-s-公共交通機関を利用しましょう。.mp3]
[sound:4c-k-公式.mp3]	<b>公式</b> <br> こうしき <br> formality, formal, official; formula
公式	<b>こうしき</b> <br> formality, formal, official; formula <br> [sound:4c-k-公式.mp3]
formality, formal, official; formula	<b>公式</b> <br> こうしき <br> [sound:4c-k-公式.mp3]
[sound:4c-s-公式発表が行われました。.mp3]	<b>公式発表が行われました。</b> <br> こうしきはっぴょうがおこなわれました。 <br><br> (公式) <br> An official announcement was made.
公式発表が行われました。 <br><br> (公式)	<b>こうしきはっぴょうがおこなわれました。</b> <br> An official announcement was made. <br> [sound:4c-s-公式発表が行われました。.mp3]
An official announcement was made.	<b>公式発表が行われました。</b> <br> こうしきはっぴょうがおこなわれました。 <br><br> (公式) <br> [sound:4c-s-公式発表が行われました。.mp3]
[sound:4c-k-公明党.mp3]	<b>公明党</b> <br> こうめいとう <br> New Komeito (Japanese political party), New Clean Government Party, Justice Party
公明党	<b>こうめいとう</b> <br> New Komeito (Japanese political party), New Clean Government Party, Justice Party <br> [sound:4c-k-公明党.mp3]
New Komeito (Japanese political party), New Clean Government Party, Justice Party	<b>公明党</b> <br> こうめいとう <br> [sound:4c-k-公明党.mp3]
[sound:4c-s-公明党の代表が演説しました。.mp3]	<b>公明党の代表が演説しました。</b> <br> こうめいとうのだいひょうがえんぜつしました。 <br><br> (公明党) <br> A representative of the Komeito Party gave a speech.
公明党の代表が演説しました。 <br><br> (公明党)	<b>こうめいとうのだいひょうがえんぜつしました。</b> <br> A representative of the Komeito Party gave a speech. <br> [sound:4c-s-公明党の代表が演説しました。.mp3]
A representative of the Komeito Party gave a speech.	<b>公明党の代表が演説しました。</b> <br> こうめいとうのだいひょうがえんぜつしました。 <br><br> (公明党) <br> [sound:4c-s-公明党の代表が演説しました。.mp3]
[sound:4c-k-公的.mp3]	<b>公的</b> <br> こうてき <br> public, official
公的	<b>こうてき</b> <br> public, official <br> [sound:4c-k-公的.mp3]
public, official	<b>公的</b> <br> こうてき <br> [sound:4c-k-公的.mp3]
[sound:4c-s-公的な文書を提出しました。.mp3]	<b>公的な文書を提出しました。</b> <br> こうてきなぶんしょをていしゅつしました。 <br><br> (公的) <br> I submitted an official document.
公的な文書を提出しました。 <br><br> (公的)	<b>こうてきなぶんしょをていしゅつしました。</b> <br> I submitted an official document. <br> [sound:4c-s-公的な文書を提出しました。.mp3]
I submitted an official document.	<b>公的な文書を提出しました。</b> <br> こうてきなぶんしょをていしゅつしました。 <br><br> (公的) <br> [sound:4c-s-公的な文書を提出しました。.mp3]
[sound:4c-k-持ち.mp3]	<b>持ち</b> <br> もち <br> hold, charge, keep possession, in charge; wear, durability, life, draw; usage
持ち	<b>もち</b> <br> hold, charge, keep possession, in charge; wear, durability, life, draw; usage <br> [sound:4c-k-持ち.mp3]
hold, charge, keep possession, in charge; wear, durability, life, draw; usage	<b>持ち</b> <br> もち <br> [sound:4c-k-持ち.mp3]
[sound:4c-s-彼の持ち物を管理しています。.mp3]	<b>彼の持ち物を管理しています。</b> <br> かれのもちものをかんりしています。 <br><br> (持ち) <br> I am managing his belongings.
彼の持ち物を管理しています。 <br><br> (持ち)	<b>かれのもちものをかんりしています。</b> <br> I am managing his belongings. <br> [sound:4c-s-彼の持ち物を管理しています。.mp3]
I am managing his belongings.	<b>彼の持ち物を管理しています。</b> <br> かれのもちものをかんりしています。 <br><br> (持ち) <br> [sound:4c-s-彼の持ち物を管理しています。.mp3]
[sound:4c-k-持つ.mp3]	<b>持つ</b> <br> もつ <br> to hold, to carry; to possess
持つ	<b>もつ</b> <br> to hold, to carry; to possess <br> [sound:4c-k-持つ.mp3]
to hold, to carry; to possess	<b>持つ</b> <br> もつ <br> [sound:4c-k-持つ.mp3]
[sound:4c-s-彼は強い信念を持っています。.mp3]	<b>彼は強い信念を持っています。</b> <br> かれはつよいしんねんをもっています。 <br><br> (持つ) <br> He has strong beliefs.
彼は強い信念を持っています。 <br><br> (持つ)	<b>かれはつよいしんねんをもっています。</b> <br> He has strong beliefs. <br> [sound:4c-s-彼は強い信念を持っています。.mp3]
He has strong beliefs.	<b>彼は強い信念を持っています。</b> <br> かれはつよいしんねんをもっています。 <br><br> (持つ) <br> [sound:4c-s-彼は強い信念を持っています。.mp3]
[sound:4c-k-持ち込む.mp3]	<b>持ち込む</b> <br> もちこむ <br> to lodge, to take something into ..., to bring in
持ち込む	<b>もちこむ</b> <br> to lodge, to take something into ..., to bring in <br> [sound:4c-k-持ち込む.mp3]
to lodge, to take something into ..., to bring in	<b>持ち込む</b> <br> もちこむ <br> [sound:4c-k-持ち込む.mp3]
[sound:4c-s-食べ物を持ち込まないでください。.mp3]	<b>食べ物を持ち込まないでください。</b> <br> たべものをもちこまないでください。 <br><br> (持ち込む) <br> Please do not bring food inside.
食べ物を持ち込まないでください。 <br><br> (持ち込む)	<b>たべものをもちこまないでください。</b> <br> Please do not bring food inside. <br> [sound:4c-s-食べ物を持ち込まないでください。.mp3]
Please do not bring food inside.	<b>食べ物を持ち込まないでください。</b> <br> たべものをもちこまないでください。 <br><br> (持ち込む) <br> [sound:4c-s-食べ物を持ち込まないでください。.mp3]
[sound:4c-k-保持.mp3]	<b>保持</b> <br> ほじ <br> retention, maintenance, preservation
保持	<b>ほじ</b> <br> retention, maintenance, preservation <br> [sound:4c-k-保持.mp3]
retention, maintenance, preservation	<b>保持</b> <br> ほじ <br> [sound:4c-k-保持.mp3]
[sound:4c-s-このデータは安全に保持されています。.mp3]	<b>このデータは安全に保持されています。</b> <br> このデータはあんぜんにほじされています。 <br><br> (保持) <br> This data is securely stored.
このデータは安全に保持されています。 <br><br> (保持)	<b>このデータはあんぜんにほじされています。</b> <br> This data is securely stored. <br> [sound:4c-s-このデータは安全に保持されています。.mp3]
This data is securely stored.	<b>このデータは安全に保持されています。</b> <br> このデータはあんぜんにほじされています。 <br><br> (保持) <br> [sound:4c-s-このデータは安全に保持されています。.mp3]
[sound:4c-k-野党.mp3]	<b>野党</b> <br> やとう <br> opposition party, political opposition, opposition
野党	<b>やとう</b> <br> opposition party, political opposition, opposition <br> [sound:4c-k-野党.mp3]
opposition party, political opposition, opposition	<b>野党</b> <br> やとう <br> [sound:4c-k-野党.mp3]
[sound:4c-s-野党が新しい法案を提出しました。.mp3]	<b>野党が新しい法案を提出しました。</b> <br> やとうがあたらしいほうあんをていしゅつしました。 <br><br> (野党) <br> The opposition party submitted a new bill.
野党が新しい法案を提出しました。 <br><br> (野党)	<b>やとうがあたらしいほうあんをていしゅつしました。</b> <br> The opposition party submitted a new bill. <br> [sound:4c-s-野党が新しい法案を提出しました。.mp3]
The opposition party submitted a new bill.	<b>野党が新しい法案を提出しました。</b> <br> やとうがあたらしいほうあんをていしゅつしました。 <br><br> (野党) <br> [sound:4c-s-野党が新しい法案を提出しました。.mp3]
[sound:4c-k-与野党.mp3]	<b>与野党</b> <br> よやとう <br> (political) parties in and out of power, majority and minority parties
与野党	<b>よやとう</b> <br> (political) parties in and out of power, majority and minority parties <br> [sound:4c-k-与野党.mp3]
(political) parties in and out of power, majority and minority parties	<b>与野党</b> <br> よやとう <br> [sound:4c-k-与野党.mp3]
[sound:4c-s-与野党の協議が行われました。.mp3]	<b>与野党の協議が行われました。</b> <br> よやとうのきょうぎがおこなわれました。 <br><br> (与野党) <br> Discussions between the ruling and opposition parties were held.
与野党の協議が行われました。 <br><br> (与野党)	<b>よやとうのきょうぎがおこなわれました。</b> <br> Discussions between the ruling and opposition parties were held. <br> [sound:4c-s-与野党の協議が行われました。.mp3]
Discussions between the ruling and opposition parties were held.	<b>与野党の協議が行われました。</b> <br> よやとうのきょうぎがおこなわれました。 <br><br> (与野党) <br> [sound:4c-s-与野党の協議が行われました。.mp3]
[sound:4c-k-野菜.mp3]	<b>野菜</b> <br> やさい <br> vegetable
野菜	<b>やさい</b> <br> vegetable <br> [sound:4c-k-野菜.mp3]
vegetable	<b>野菜</b> <br> やさい <br> [sound:4c-k-野菜.mp3]
[sound:4c-s-新鮮な野菜を買いました。.mp3]	<b>新鮮な野菜を買いました。</b> <br> しんせんなやさいをかいました。 <br><br> (野菜) <br> I bought fresh vegetables.
新鮮な野菜を買いました。 <br><br> (野菜)	<b>しんせんなやさいをかいました。</b> <br> I bought fresh vegetables. <br> [sound:4c-s-新鮮な野菜を買いました。.mp3]
I bought fresh vegetables.	<b>新鮮な野菜を買いました。</b> <br> しんせんなやさいをかいました。 <br><br> (野菜) <br> [sound:4c-s-新鮮な野菜を買いました。.mp3]
[sound:4c-k-上野.mp3]	<b>上野</b> <br> うえの <br> section of Tokyo
上野	<b>うえの</b> <br> section of Tokyo <br> [sound:4c-k-上野.mp3]
section of Tokyo	<b>上野</b> <br> うえの <br> [sound:4c-k-上野.mp3]
[sound:4c-s-上野動物園に行きました。.mp3]	<b>上野動物園に行きました。</b> <br> うえのどうぶつえんにいきました。 <br><br> (上野) <br> I went to Ueno Zoo.
上野動物園に行きました。 <br><br> (上野)	<b>うえのどうぶつえんにいきました。</b> <br> I went to Ueno Zoo. <br> [sound:4c-s-上野動物園に行きました。.mp3]
I went to Ueno Zoo.	<b>上野動物園に行きました。</b> <br> うえのどうぶつえんにいきました。 <br><br> (上野) <br> [sound:4c-s-上野動物園に行きました。.mp3]
[sound:4c-k-協定.mp3]	<b>協定</b> <br> きょうてい <br> arrangement, pact, agreement
協定	<b>きょうてい</b> <br> arrangement, pact, agreement <br> [sound:4c-k-協定.mp3]
arrangement, pact, agreement	<b>協定</b> <br> きょうてい <br> [sound:4c-k-協定.mp3]
[sound:4c-s-両国は新しい協定を結びました。.mp3]	<b>両国は新しい協定を結びました。</b> <br> りょうこくはあたらしいきょうていをむすびました。 <br><br> (協定) <br> Both countries signed a new agreement.
両国は新しい協定を結びました。 <br><br> (協定)	<b>りょうこくはあたらしいきょうていをむすびました。</b> <br> Both countries signed a new agreement. <br> [sound:4c-s-両国は新しい協定を結びました。.mp3]
Both countries signed a new agreement.	<b>両国は新しい協定を結びました。</b> <br> りょうこくはあたらしいきょうていをむすびました。 <br><br> (協定) <br> [sound:4c-s-両国は新しい協定を結びました。.mp3]
[sound:4c-k-協力.mp3]	<b>協力</b> <br> きょうりょく <br> cooperation, collaboration
協力	<b>きょうりょく</b> <br> cooperation, collaboration <br> [sound:4c-k-協力.mp3]
cooperation, collaboration	<b>協力</b> <br> きょうりょく <br> [sound:4c-k-協力.mp3]
[sound:4c-s-皆で協力して問題を解決しました。.mp3]	<b>皆で協力して問題を解決しました。</b> <br> みんなできょうりょくしてもんだいをかいけつしました。 <br><br> (協力) <br> We worked together to solve the problem.
皆で協力して問題を解決しました。 <br><br> (協力)	<b>みんなできょうりょくしてもんだいをかいけつしました。</b> <br> We worked together to solve the problem. <br> [sound:4c-s-皆で協力して問題を解決しました。.mp3]
We worked together to solve the problem.	<b>皆で協力して問題を解決しました。</b> <br> みんなできょうりょくしてもんだいをかいけつしました。 <br><br> (協力) <br> [sound:4c-s-皆で協力して問題を解決しました。.mp3]
[sound:4c-k-協調.mp3]	<b>協調</b> <br> きょうちょう <br> cooperation, conciliation, harmony; firm (market) tone
協調	<b>きょうちょう</b> <br> cooperation, conciliation, harmony; firm (market) tone <br> [sound:4c-k-協調.mp3]
cooperation, conciliation, harmony; firm (market) tone	<b>協調</b> <br> きょうちょう <br> [sound:4c-k-協調.mp3]
[sound:4c-s-協調して作業を進めましょう。.mp3]	<b>協調して作業を進めましょう。</b> <br> きょうちょうしてさぎょうをすすめましょう。 <br><br> (協調) <br> Let's proceed with our work cooperatively.
協調して作業を進めましょう。 <br><br> (協調)	<b>きょうちょうしてさぎょうをすすめましょう。</b> <br> Let's proceed with our work cooperatively. <br> [sound:4c-s-協調して作業を進めましょう。.mp3]
Let's proceed with our work cooperatively.	<b>協調して作業を進めましょう。</b> <br> きょうちょうしてさぎょうをすすめましょう。 <br><br> (協調) <br> [sound:4c-s-協調して作業を進めましょう。.mp3]
[sound:4c-k-妥協.mp3]	<b>妥協</b> <br> だきょう <br> compromise, giving in
妥協	<b>だきょう</b> <br> compromise, giving in <br> [sound:4c-k-妥協.mp3]
compromise, giving in	<b>妥協</b> <br> だきょう <br> [sound:4c-k-妥協.mp3]
[sound:4c-s-両者は妥協案に合意しました。.mp3]	<b>両者は妥協案に合意しました。</b> <br> りょうしゃはだきょうあんにごういしました。 <br><br> (妥協) <br> Both parties agreed on a compromise.
両者は妥協案に合意しました。 <br><br> (妥協)	<b>りょうしゃはだきょうあんにごういしました。</b> <br> Both parties agreed on a compromise. <br> [sound:4c-s-両者は妥協案に合意しました。.mp3]
Both parties agreed on a compromise.	<b>両者は妥協案に合意しました。</b> <br> りょうしゃはだきょうあんにごういしました。 <br><br> (妥協) <br> [sound:4c-s-両者は妥協案に合意しました。.mp3]
[sound:4c-k-取っ手.mp3]	<b>取っ手</b> <br> とって, はしゅ <br> handle, grip, knob
取っ手	<b>とって, はしゅ</b> <br> handle, grip, knob <br> [sound:4c-k-取っ手.mp3]
handle, grip, knob	<b>取っ手</b> <br> とって, はしゅ <br> [sound:4c-k-取っ手.mp3]
[sound:4c-s-ドアの取っ手を修理しました。.mp3]	<b>ドアの取っ手を修理しました。</b> <br> ドアのとってをしゅうりしました。 <br><br> (取っ手) <br> I repaired the door handle.
ドアの取っ手を修理しました。 <br><br> (取っ手)	<b>ドアのとってをしゅうりしました。</b> <br> I repaired the door handle. <br> [sound:4c-s-ドアの取っ手を修理しました。.mp3]
I repaired the door handle.	<b>ドアの取っ手を修理しました。</b> <br> ドアのとってをしゅうりしました。 <br><br> (取っ手) <br> [sound:4c-s-ドアの取っ手を修理しました。.mp3]
[sound:4c-k-取締役.mp3]	<b>取締役</b> <br> とりしまりやく <br> company director, board member
取締役	<b>とりしまりやく</b> <br> company director, board member <br> [sound:4c-k-取締役.mp3]
company director, board member	<b>取締役</b> <br> とりしまりやく <br> [sound:4c-k-取締役.mp3]
[sound:4c-s-彼は会社の取締役です。.mp3]	<b>彼は会社の取締役です。</b> <br> かれはかいしゃのとりしまりやくです。 <br><br> (取締役) <br> He is the company director.
彼は会社の取締役です。 <br><br> (取締役)	<b>かれはかいしゃのとりしまりやくです。</b> <br> He is the company director. <br> [sound:4c-s-彼は会社の取締役です。.mp3]
He is the company director.	<b>彼は会社の取締役です。</b> <br> かれはかいしゃのとりしまりやくです。 <br><br> (取締役) <br> [sound:4c-s-彼は会社の取締役です。.mp3]
[sound:4c-k-聴取.mp3]	<b>聴取</b> <br> ちょうしゅ <br> listening, hearing, audition, radio reception
聴取	<b>ちょうしゅ</b> <br> listening, hearing, audition, radio reception <br> [sound:4c-k-聴取.mp3]
listening, hearing, audition, radio reception	<b>聴取</b> <br> ちょうしゅ <br> [sound:4c-k-聴取.mp3]
[sound:4c-s-警察が事件の聴取を行いました。.mp3]	<b>警察が事件の聴取を行いました。</b> <br> けいさつがじけんのちょうしゅをおこないました。 <br><br> (聴取) <br> The police conducted an interview regarding the case.
警察が事件の聴取を行いました。 <br><br> (聴取)	<b>けいさつがじけんのちょうしゅをおこないました。</b> <br> The police conducted an interview regarding the case. <br> [sound:4c-s-警察が事件の聴取を行いました。.mp3]
The police conducted an interview regarding the case.	<b>警察が事件の聴取を行いました。</b> <br> けいさつがじけんのちょうしゅをおこないました。 <br><br> (聴取) <br> [sound:4c-s-警察が事件の聴取を行いました。.mp3]
[sound:4c-k-取り組み.mp3]	<b>取り組み</b> <br> とりくみ <br> bout (in sports, etc.), match; effort, initiative, dealing with, grappling with, wrestling with
取り組み	<b>とりくみ</b> <br> bout (in sports, etc.), match; effort, initiative, dealing with, grappling with, wrestling with <br> [sound:4c-k-取り組み.mp3]
bout (in sports, etc.), match; effort, initiative, dealing with, grappling with, wrestling with	<b>取り組み</b> <br> とりくみ <br> [sound:4c-k-取り組み.mp3]
[sound:4c-s-環境保護の取り組みが重要です。.mp3]	<b>環境保護の取り組みが重要です。</b> <br> かんきょうほごのとりくみがじゅうようです。 <br><br> (取り組み) <br> Environmental protection efforts are important.
環境保護の取り組みが重要です。 <br><br> (取り組み)	<b>かんきょうほごのとりくみがじゅうようです。</b> <br> Environmental protection efforts are important. <br> [sound:4c-s-環境保護の取り組みが重要です。.mp3]
Environmental protection efforts are important.	<b>環境保護の取り組みが重要です。</b> <br> かんきょうほごのとりくみがじゅうようです。 <br><br> (取り組み) <br> [sound:4c-s-環境保護の取り組みが重要です。.mp3]
[sound:4c-k-京都.mp3]	<b>京都</b> <br> きょうと <br> Kyoto
京都	<b>きょうと</b> <br> Kyoto <br> [sound:4c-k-京都.mp3]
Kyoto	<b>京都</b> <br> きょうと <br> [sound:4c-k-京都.mp3]
[sound:4c-s-京都には美しい寺院があります。.mp3]	<b>京都には美しい寺院があります。</b> <br> きょうとにはうつくしいじいんがあります。 <br><br> (京都) <br> Kyoto has beautiful temples.
京都には美しい寺院があります。 <br><br> (京都)	<b>きょうとにはうつくしいじいんがあります。</b> <br> Kyoto has beautiful temples. <br> [sound:4c-s-京都には美しい寺院があります。.mp3]
Kyoto has beautiful temples.	<b>京都には美しい寺院があります。</b> <br> きょうとにはうつくしいじいんがあります。 <br><br> (京都) <br> [sound:4c-s-京都には美しい寺院があります。.mp3]
[sound:4c-k-首都.mp3]	<b>首都</b> <br> しゅと <br> capital city, metropolis
首都	<b>しゅと</b> <br> capital city, metropolis <br> [sound:4c-k-首都.mp3]
capital city, metropolis	<b>首都</b> <br> しゅと <br> [sound:4c-k-首都.mp3]
[sound:4c-s-首都の人口が増加しています。.mp3]	<b>首都の人口が増加しています。</b> <br> しゅとのじんこうがぞうかしています。 <br><br> (首都) <br> The population of the capital city is increasing.
首都の人口が増加しています。 <br><br> (首都)	<b>しゅとのじんこうがぞうかしています。</b> <br> The population of the capital city is increasing. <br> [sound:4c-s-首都の人口が増加しています。.mp3]
The population of the capital city is increasing.	<b>首都の人口が増加しています。</b> <br> しゅとのじんこうがぞうかしています。 <br><br> (首都) <br> [sound:4c-s-首都の人口が増加しています。.mp3]
[sound:4c-k-首都圏.mp3]	<b>首都圏</b> <br> しゅとけん <br> the capital city (often Tokyo) area (typically within 50 km of city's centre) (center)
首都圏	<b>しゅとけん</b> <br> the capital city (often Tokyo) area (typically within 50 km of city's centre) (center) <br> [sound:4c-k-首都圏.mp3]
the capital city (often Tokyo) area (typically within 50 km of city's centre) (center)	<b>首都圏</b> <br> しゅとけん <br> [sound:4c-k-首都圏.mp3]
[sound:4c-s-首都圏の交通が混雑しています。.mp3]	<b>首都圏の交通が混雑しています。</b> <br> しゅとけんのこうつうがこんざつしています。 <br><br> (首都圏) <br> Traffic in the metropolitan area is congested.
首都圏の交通が混雑しています。 <br><br> (首都圏)	<b>しゅとけんのこうつうがこんざつしています。</b> <br> Traffic in the metropolitan area is congested. <br> [sound:4c-s-首都圏の交通が混雑しています。.mp3]
Traffic in the metropolitan area is congested.	<b>首都圏の交通が混雑しています。</b> <br> しゅとけんのこうつうがこんざつしています。 <br><br> (首都圏) <br> [sound:4c-s-首都圏の交通が混雑しています。.mp3]
[sound:4c-k-都道府県.mp3]	<b>都道府県</b> <br> とどうふけん <br> administrative divisions of Japan: Tokyo-to, Hokkai-do, Osaka-fu, Kyoto-fu and remaining prefectures
都道府県	<b>とどうふけん</b> <br> administrative divisions of Japan: Tokyo-to, Hokkai-do, Osaka-fu, Kyoto-fu and remaining prefectures <br> [sound:4c-k-都道府県.mp3]
administrative divisions of Japan: Tokyo-to, Hokkai-do, Osaka-fu, Kyoto-fu and remaining prefectures	<b>都道府県</b> <br> とどうふけん <br> [sound:4c-k-都道府県.mp3]
[sound:4c-s-都道府県の行政が発表されました。.mp3]	<b>都道府県の行政が発表されました。</b> <br> とどうふけんのぎょうせいがはっぴょうされました。 <br><br> (都道府県) <br> The prefectural government announced a new policy.
都道府県の行政が発表されました。 <br><br> (都道府県)	<b>とどうふけんのぎょうせいがはっぴょうされました。</b> <br> The prefectural government announced a new policy. <br> [sound:4c-s-都道府県の行政が発表されました。.mp3]
The prefectural government announced a new policy.	<b>都道府県の行政が発表されました。</b> <br> とどうふけんのぎょうせいがはっぴょうされました。 <br><br> (都道府県) <br> [sound:4c-s-都道府県の行政が発表されました。.mp3]
[sound:4c-k-緩和.mp3]	<b>緩和</b> <br> かんわ <br> relief, mitigation, alleviation, relaxation, softening
緩和	<b>かんわ</b> <br> relief, mitigation, alleviation, relaxation, softening <br> [sound:4c-k-緩和.mp3]
relief, mitigation, alleviation, relaxation, softening	<b>緩和</b> <br> かんわ <br> [sound:4c-k-緩和.mp3]
[sound:4c-s-規制の緩和が検討されています。.mp3]	<b>規制の緩和が検討されています。</b> <br> きせいのかんわがけんとうされています。 <br><br> (緩和) <br> Relaxation of regulations is being considered.
規制の緩和が検討されています。 <br><br> (緩和)	<b>きせいのかんわがけんとうされています。</b> <br> Relaxation of regulations is being considered. <br> [sound:4c-s-規制の緩和が検討されています。.mp3]
Relaxation of regulations is being considered.	<b>規制の緩和が検討されています。</b> <br> きせいのかんわがけんとうされています。 <br><br> (緩和) <br> [sound:4c-s-規制の緩和が検討されています。.mp3]
[sound:4c-k-朝鮮民主主義人民共和国.mp3]	<b>朝鮮民主主義人民共和国</b> <br> ちょうせんみんしゅしゅぎじんみんきょうわこく <br> Democratic People's Republic of Korea (North Korea), DPRK
朝鮮民主主義人民共和国	<b>ちょうせんみんしゅしゅぎじんみんきょうわこく</b> <br> Democratic People's Republic of Korea (North Korea), DPRK <br> [sound:4c-k-朝鮮民主主義人民共和国.mp3]
Democratic People's Republic of Korea (North Korea), DPRK	<b>朝鮮民主主義人民共和国</b> <br> ちょうせんみんしゅしゅぎじんみんきょうわこく <br> [sound:4c-k-朝鮮民主主義人民共和国.mp3]
[sound:4c-s-朝鮮民主主義人民共和国の状況が報道されました。.mp3]	<b>朝鮮民主主義人民共和国の状況が報道されました。</b> <br> ちょうせんみんしゅしゅぎじんみんきょうわこくのじょうきょうがほうどうされました。 <br><br> (朝鮮民主主義人民共和国) <br> The situation in North Korea was reported.
朝鮮民主主義人民共和国の状況が報道されました。 <br><br> (朝鮮民主主義人民共和国)	<b>ちょうせんみんしゅしゅぎじんみんきょうわこくのじょうきょうがほうどうされました。</b> <br> The situation in North Korea was reported. <br> [sound:4c-s-朝鮮民主主義人民共和国の状況が報道されました。.mp3]
The situation in North Korea was reported.	<b>朝鮮民主主義人民共和国の状況が報道されました。</b> <br> ちょうせんみんしゅしゅぎじんみんきょうわこくのじょうきょうがほうどうされました。 <br><br> (朝鮮民主主義人民共和国) <br> [sound:4c-s-朝鮮民主主義人民共和国の状況が報道されました。.mp3]
[sound:4c-k-和解.mp3]	<b>和解</b> <br> わかい, わげ <br> reconciliation, settlement, accommodation, compromise, mediation, rapprochement; (legal) settlement; translation of a foreign language into Japanese
和解	<b>わかい, わげ</b> <br> reconciliation, settlement, accommodation, compromise, mediation, rapprochement; (legal) settlement; translation of a foreign language into Japanese <br> [sound:4c-k-和解.mp3]
reconciliation, settlement, accommodation, compromise, mediation, rapprochement; (legal) settlement; translation of a foreign language into Japanese	<b>和解</b> <br> わかい, わげ <br> [sound:4c-k-和解.mp3]
[sound:4c-s-両者は和解しました。.mp3]	<b>両者は和解しました。</b> <br> りょうしゃはわかいしました。 <br><br> (和解) <br> Both parties reconciled.
両者は和解しました。 <br><br> (和解)	<b>りょうしゃはわかいしました。</b> <br> Both parties reconciled. <br> [sound:4c-s-両者は和解しました。.mp3]
Both parties reconciled.	<b>両者は和解しました。</b> <br> りょうしゃはわかいしました。 <br><br> (和解) <br> [sound:4c-s-両者は和解しました。.mp3]
[sound:4c-k-共和.mp3]	<b>共和</b> <br> きょうわ <br> republicanism, cooperation
共和	<b>きょうわ</b> <br> republicanism, cooperation <br> [sound:4c-k-共和.mp3]
republicanism, cooperation	<b>共和</b> <br> きょうわ <br> [sound:4c-k-共和.mp3]
[sound:4c-s-共和政体が採用されました。.mp3]	<b>共和政体が採用されました。</b> <br> きょうわせいたいがさいようされました。 <br><br> (共和) <br> A republican system was adopted.
共和政体が採用されました。 <br><br> (共和)	<b>きょうわせいたいがさいようされました。</b> <br> A republican system was adopted. <br> [sound:4c-s-共和政体が採用されました。.mp3]
A republican system was adopted.	<b>共和政体が採用されました。</b> <br> きょうわせいたいがさいようされました。 <br><br> (共和) <br> [sound:4c-s-共和政体が採用されました。.mp3]
[sound:4c-k-統合.mp3]	<b>統合</b> <br> とうごう <br> integration, unification, synthesis; integrated, built-in
統合	<b>とうごう</b> <br> integration, unification, synthesis; integrated, built-in <br> [sound:4c-k-統合.mp3]
integration, unification, synthesis; integrated, built-in	<b>統合</b> <br> とうごう <br> [sound:4c-k-統合.mp3]
[sound:4c-s-両社は統合されました。.mp3]	<b>両社は統合されました。</b> <br> りょうしゃはとうごうされました。 <br><br> (統合) <br> Both companies merged.
両社は統合されました。 <br><br> (統合)	<b>りょうしゃはとうごうされました。</b> <br> Both companies merged. <br> [sound:4c-s-両社は統合されました。.mp3]
Both companies merged.	<b>両社は統合されました。</b> <br> りょうしゃはとうごうされました。 <br><br> (統合) <br> [sound:4c-s-両社は統合されました。.mp3]
[sound:4c-k-統計.mp3]	<b>統計</b> <br> とうけい <br> statistics
統計	<b>とうけい</b> <br> statistics <br> [sound:4c-k-統計.mp3]
statistics	<b>統計</b> <br> とうけい <br> [sound:4c-k-統計.mp3]
[sound:4c-s-統計データを分析しています。.mp3]	<b>統計データを分析しています。</b> <br> とうけいデータをぶんせきしています。 <br><br> (統計) <br> I am analyzing statistical data.
統計データを分析しています。 <br><br> (統計)	<b>とうけいデータをぶんせきしています。</b> <br> I am analyzing statistical data. <br> [sound:4c-s-統計データを分析しています。.mp3]
I am analyzing statistical data.	<b>統計データを分析しています。</b> <br> とうけいデータをぶんせきしています。 <br><br> (統計) <br> [sound:4c-s-統計データを分析しています。.mp3]
[sound:4c-k-統治.mp3]	<b>統治</b> <br> とうち, とうじ <br> rule, reign, government, governing
統治	<b>とうち, とうじ</b> <br> rule, reign, government, governing <br> [sound:4c-k-統治.mp3]
rule, reign, government, governing	<b>統治</b> <br> とうち, とうじ <br> [sound:4c-k-統治.mp3]
[sound:4c-s-その国の統治制度が改革されました。.mp3]	<b>その国の統治制度が改革されました。</b> <br> そのくにのとうちせいどがかいかくされました。 <br><br> (統治) <br> The governance system of that country has been reformed.
その国の統治制度が改革されました。 <br><br> (統治)	<b>そのくにのとうちせいどがかいかくされました。</b> <br> The governance system of that country has been reformed. <br> [sound:4c-s-その国の統治制度が改革されました。.mp3]
The governance system of that country has been reformed.	<b>その国の統治制度が改革されました。</b> <br> そのくにのとうちせいどがかいかくされました。 <br><br> (統治) <br> [sound:4c-s-その国の統治制度が改革されました。.mp3]
[sound:4c-k-伝統的.mp3]	<b>伝統的</b> <br> でんとうてき <br> traditional, conventional
伝統的	<b>でんとうてき</b> <br> traditional, conventional <br> [sound:4c-k-伝統的.mp3]
traditional, conventional	<b>伝統的</b> <br> でんとうてき <br> [sound:4c-k-伝統的.mp3]
[sound:4c-s-伝統的な祭りに参加しました。.mp3]	<b>伝統的な祭りに参加しました。</b> <br> でんとうてきなまつりにさんかしました。 <br><br> (伝統的) <br> I participated in a traditional festival.
伝統的な祭りに参加しました。 <br><br> (伝統的)	<b>でんとうてきなまつりにさんかしました。</b> <br> I participated in a traditional festival. <br> [sound:4c-s-伝統的な祭りに参加しました。.mp3]
I participated in a traditional festival.	<b>伝統的な祭りに参加しました。</b> <br> でんとうてきなまつりにさんかしました。 <br><br> (伝統的) <br> [sound:4c-s-伝統的な祭りに参加しました。.mp3]
[sound:4c-k-以下.mp3]	<b>以下</b> <br> いか, いげ <br> not exceeding, and downward, ... and below; below (e.g. standard), under (e.g. a level); the below-mentioned, the following, the rest
以下	<b>いか, いげ</b> <br> not exceeding, and downward, ... and below; below (e.g. standard), under (e.g. a level); the below-mentioned, the following, the rest <br> [sound:4c-k-以下.mp3]
not exceeding, and downward, ... and below; below (e.g. standard), under (e.g. a level); the below-mentioned, the following, the rest	<b>以下</b> <br> いか, いげ <br> [sound:4c-k-以下.mp3]
[sound:4c-s-以下のルールに従ってください。.mp3]	<b>以下のルールに従ってください。</b> <br> いかのルールにしたがってください。 <br><br> (以下) <br> Please follow the rules below.
以下のルールに従ってください。 <br><br> (以下)	<b>いかのルールにしたがってください。</b> <br> Please follow the rules below. <br> [sound:4c-s-以下のルールに従ってください。.mp3]
Please follow the rules below.	<b>以下のルールに従ってください。</b> <br> いかのルールにしたがってください。 <br><br> (以下) <br> [sound:4c-s-以下のルールに従ってください。.mp3]
